"GEOID","NAME","total_pop","median_hh_income","white","black","ai_an","asian","hi_pi","hisp_lat","pct_white","pct_black","pct_ai_an","pct_asian","pct_hi_pi","pct_hisp_lat","pct_poc","total_hh","total_hh_owner","total_hh_renter","pct_owners","pct_renters","total_owner_more_than_4","total_owner_less_than_4","total_renter_more_than_4","total_renter_less_than_4","total_hh_more_than_4","total_hh_less_than_4","pct_owner_more_than_4","pct_renter_more_than_4","pct_total_hh_more_than_4","poc_bin","income_bin"
"01001","Autauga County, Alabama",55380,58731,41315,10524,140,573,5,1565,74.6,19,0.3,1,0,2.8,25.4,21397,15682,5715,73.29,26.71,1568,14114,553,5162,2121,19276,10,9.7,9.9,"25% - 50% P.O.C.","$52000 - $60000"
"01003","Baldwin County, Alabama",212830,58320,176803,19525,1391,1955,9,9711,83.1,9.2,0.7,0.9,0,4.6,16.9,80930,60896,20034,75.25,24.75,4508,56388,1633,18401,6141,74789,7.4,8.2,7.6,"Less than 25% P.O.C.","$52000 - $60000"
"01005","Barbour County, Alabama",25361,32525,11618,12031,74,121,1,1105,45.8,47.4,0.3,0.5,0,4.4,54.2,9345,5691,3654,60.9,39.1,352,5339,348,3306,700,8645,6.2,9.5,7.5,"50% - 75% P.O.C.","Less than $44000"
"01007","Bibb County, Alabama",22493,47542,16763,4981,30,27,0,579,74.5,22.1,0.1,0.1,0,2.6,25.5,6891,5128,1763,74.42,25.58,428,4700,134,1629,562,6329,8.3,7.6,8.2,"25% - 50% P.O.C.","$44000 - $52000"
"01009","Blount County, Alabama",57681,49358,50121,881,40,212,25,5342,86.9,1.5,0.1,0.4,0,9.3,13.1,20847,16423,4424,78.78,21.22,1663,14760,268,4156,1931,18916,10.1,6.1,9.3,"Less than 25% P.O.C.","$44000 - $52000"
"01011","Bullock County, Alabama",10248,37785,2191,7666,0,50,0,262,21.4,74.8,0,0.5,0,2.6,78.6,3521,2504,1017,71.12,28.88,105,2399,73,944,178,3343,4.2,7.2,5.1,"75% or more P.O.C.","Less than $44000"
"01013","Butler County, Alabama",19828,40688,10232,8928,11,69,0,277,51.6,45,0.1,0.3,0,1.4,48.4,6506,4551,1955,69.95,30.05,229,4322,134,1821,363,6143,5,6.9,5.6,"25% - 50% P.O.C.","Less than $44000"
"01015","Calhoun County, Alabama",114618,47255,82608,23682,220,1007,14,4352,72.1,20.7,0.2,0.9,0,3.8,27.9,44605,31254,13351,70.07,29.93,2300,28954,1285,12066,3585,41020,7.4,9.6,8,"25% - 50% P.O.C.","$44000 - $52000"
"01017","Chambers County, Alabama",33660,42289,18697,13316,112,376,0,800,55.5,39.6,0.3,1.1,0,2.4,44.5,13448,9072,4376,67.46,32.54,551,8521,418,3958,969,12479,6.1,9.6,7.2,"25% - 50% P.O.C.","Less than $44000"
"01019","Cherokee County, Alabama",25903,41919,23759,1191,280,64,0,413,91.7,4.6,1.1,0.2,0,1.6,8.3,10737,8304,2433,77.34,22.66,664,7640,141,2292,805,9932,8,5.8,7.5,"Less than 25% P.O.C.","Less than $44000"
"01021","Chilton County, Alabama",44055,47468,35302,4041,39,195,0,3457,80.1,9.2,0.1,0.4,0,7.8,19.9,16927,12610,4317,74.5,25.5,1017,11593,390,3927,1407,15520,8.1,9,8.3,"Less than 25% P.O.C.","$44000 - $52000"
"01023","Choctaw County, Alabama",12925,35892,7287,5500,8,17,0,53,56.4,42.6,0.1,0.1,0,0.4,43.6,5300,4288,1012,80.91,19.09,353,3935,73,939,426,4874,8.2,7.2,8,"25% - 50% P.O.C.","Less than $44000"
"01025","Clarke County, Alabama",24128,37404,12720,11044,26,104,0,79,52.7,45.8,0.1,0.4,0,0.3,47.3,9090,6372,2718,70.1,29.9,453,5919,124,2594,577,8513,7.1,4.6,6.3,"25% - 50% P.O.C.","Less than $44000"
"01027","Clay County, Alabama",13337,40845,10717,2068,0,21,0,419,80.4,15.5,0,0.2,0,3.1,19.6,5198,3922,1276,75.45,24.55,323,3599,75,1201,398,4800,8.2,5.9,7.7,"Less than 25% P.O.C.","Less than $44000"
"01029","Cleburne County, Alabama",14916,44741,13826,410,14,3,0,367,92.7,2.7,0.1,0,0,2.5,7.3,5680,4324,1356,76.13,23.87,346,3978,137,1219,483,5197,8,10.1,8.5,"Less than 25% P.O.C.","$44000 - $52000"
"01031","Coffee County, Alabama",51662,55637,36239,8680,601,745,0,3763,70.1,16.8,1.2,1.4,0,7.3,29.9,19924,13099,6825,65.74,34.26,1057,12042,662,6163,1719,18205,8.1,9.7,8.6,"25% - 50% P.O.C.","$52000 - $60000"
"01033","Colbert County, Alabama",54771,48065,42830,8809,319,259,51,1557,78.2,16.1,0.6,0.5,0.1,2.8,21.8,21880,15796,6084,72.19,27.81,1012,14784,281,5803,1293,20587,6.4,4.6,5.9,"Less than 25% P.O.C.","$44000 - $52000"
"01035","Conecuh County, Alabama",12394,37837,6203,5919,25,56,0,84,50,47.8,0.2,0.5,0,0.7,50,4553,3465,1088,76.1,23.9,176,3289,51,1037,227,4326,5.1,4.7,5,"50% - 75% P.O.C.","Less than $44000"
"01037","Coosa County, Alabama",10757,38990,6970,3615,8,0,0,109,64.8,33.6,0.1,0,0,1,35.2,4032,3195,837,79.24,20.76,199,2996,31,806,230,3802,6.2,3.7,5.7,"25% - 50% P.O.C.","Less than $44000"
"01039","Covington County, Alabama",37200,42189,30984,4981,22,142,34,629,83.3,13.4,0.1,0.4,0.1,1.7,16.7,14852,11061,3791,74.47,25.53,888,10173,273,3518,1161,13691,8,7.2,7.8,"Less than 25% P.O.C.","Less than $44000"
"01041","Crenshaw County, Alabama",13844,43163,9827,3202,92,175,9,110,71,23.1,0.7,1.3,0.1,0.8,29,4943,3731,1212,75.48,24.52,157,3574,73,1139,230,4713,4.2,6,4.7,"25% - 50% P.O.C.","Less than $44000"
"01043","Cullman County, Alabama",82853,44918,76129,1034,234,314,0,3611,91.9,1.2,0.3,0.4,0,4.4,8.1,31034,23216,7818,74.81,25.19,2069,21147,582,7236,2651,28383,8.9,7.4,8.5,"Less than 25% P.O.C.","$44000 - $52000"
"01045","Dale County, Alabama",49277,47214,33787,9749,280,603,4,3210,68.6,19.8,0.6,1.2,0,6.5,31.4,18806,11300,7506,60.09,39.91,609,10691,940,6566,1549,17257,5.4,12.5,8.2,"25% - 50% P.O.C.","$44000 - $52000"
"01047","Dallas County, Alabama",39149,33845,10694,27572,37,222,5,419,27.3,70.4,0.1,0.6,0,1.1,72.7,15910,9441,6469,59.34,40.66,648,8793,608,5861,1256,14654,6.9,9.4,7.9,"50% - 75% P.O.C.","Less than $44000"
"01049","DeKalb County, Alabama",71310,40440,57359,1021,766,86,150,10376,80.4,1.4,1.1,0.1,0.2,14.6,19.6,26040,18627,7413,71.53,28.47,1771,16856,997,6416,2768,23272,9.5,13.4,10.6,"Less than 25% P.O.C.","Less than $44000"
"01051","Elmore County, Alabama",81144,60891,59364,17223,211,439,0,2404,73.2,21.2,0.3,0.5,0,3,26.8,29708,21763,7945,73.26,26.74,1727,20036,732,7213,2459,27249,7.9,9.2,8.3,"25% - 50% P.O.C.","$60000 or more"
"01053","Escambia County, Alabama",37057,36275,22321,11850,1476,102,55,865,60.2,32,4,0.3,0.1,2.3,39.8,13089,8943,4146,68.32,31.68,695,8248,209,3937,904,12185,7.8,5,6.9,"25% - 50% P.O.C.","Less than $44000"
"01055","Etowah County, Alabama",102748,44637,80001,15861,377,764,24,3982,77.9,15.4,0.4,0.7,0,3.9,22.1,38942,28267,10675,72.59,27.41,1712,26555,754,9921,2466,36476,6.1,7.1,6.3,"Less than 25% P.O.C.","$44000 - $52000"
"01057","Fayette County, Alabama",16494,39856,13937,1843,0,78,7,297,84.5,11.2,0,0.5,0,1.8,15.5,6802,5255,1547,77.26,22.74,323,4932,124,1423,447,6355,6.1,8,6.6,"Less than 25% P.O.C.","Less than $44000"
"01059","Franklin County, Alabama",31466,43514,24181,1349,88,117,0,5400,76.8,4.3,0.3,0.4,0,17.2,23.2,11048,7821,3227,70.79,29.21,777,7044,425,2802,1202,9846,9.9,13.2,10.9,"Less than 25% P.O.C.","Less than $44000"
"01061","Geneva County, Alabama",26417,41732,22151,2487,236,115,12,1051,83.9,9.4,0.9,0.4,0,4,16.1,10383,7476,2907,72,28,432,7044,240,2667,672,9711,5.8,8.3,6.5,"Less than 25% P.O.C.","Less than $44000"
"01063","Greene County, Alabama",8324,24145,1435,6614,37,0,0,145,17.2,79.5,0.4,0,0,1.7,82.8,2951,1979,972,67.06,32.94,69,1910,41,931,110,2841,3.5,4.2,3.7,"75% or more P.O.C.","Less than $44000"
"01065","Hale County, Alabama",14809,34046,5854,8792,30,33,0,4,39.5,59.4,0.2,0.2,0,0,60.5,5650,4285,1365,75.84,24.16,272,4013,87,1278,359,5291,6.3,6.4,6.4,"50% - 75% P.O.C.","Less than $44000"
"01067","Henry County, Alabama",17133,50017,11851,4549,30,68,17,449,69.2,26.6,0.2,0.4,0.1,2.6,30.8,6630,5525,1105,83.33,16.67,414,5111,48,1057,462,6168,7.5,4.3,7,"25% - 50% P.O.C.","$44000 - $52000"
"01069","Houston County, Alabama",104702,47580,69580,28021,262,909,45,3479,66.5,26.8,0.3,0.9,0,3.3,33.5,39311,25829,13482,65.7,34.3,1801,24028,981,12501,2782,36529,7,7.3,7.1,"25% - 50% P.O.C.","$44000 - $52000"
"01071","Jackson County, Alabama",51852,41769,46277,1775,582,232,55,1519,89.2,3.4,1.1,0.4,0.1,2.9,10.8,20695,15629,5066,75.52,24.48,1104,14525,392,4674,1496,19199,7.1,7.7,7.2,"Less than 25% P.O.C.","Less than $44000"
"01073","Jefferson County, Alabama",659680,53901,329108,282363,1052,10335,201,25557,49.9,42.8,0.2,1.6,0,3.9,50.1,261231,163799,97432,62.7,37.3,12539,151260,5886,91546,18425,242806,7.7,6,7.1,"50% - 75% P.O.C.","$52000 - $60000"
"01075","Lamar County, Alabama",13885,38364,11940,1479,3,17,0,229,86,10.7,0,0.1,0,1.6,14,5856,4429,1427,75.63,24.37,397,4032,10,1417,407,5449,9,0.7,7,"Less than 25% P.O.C.","Less than $44000"
"01077","Lauderdale County, Alabama",92556,48094,78414,9388,363,593,62,2476,84.7,10.1,0.4,0.6,0.1,2.7,15.3,38471,26214,12257,68.14,31.86,1901,24313,480,11777,2381,36090,7.3,3.9,6.2,"Less than 25% P.O.C.","$44000 - $52000"
"01079","Lawrence County, Alabama",33058,44886,25285,3496,1852,65,27,724,76.5,10.6,5.6,0.2,0.1,2.2,23.5,12677,9845,2832,77.66,22.34,475,9370,246,2586,721,11956,4.8,8.7,5.7,"Less than 25% P.O.C.","$44000 - $52000"
"01081","Lee County, Alabama",161152,51463,108684,36623,296,6626,0,5925,67.4,22.7,0.2,4.1,0,3.7,32.6,60237,37111,23126,61.61,38.39,3300,33811,1016,22110,4316,55921,8.9,4.4,7.2,"25% - 50% P.O.C.","$44000 - $52000"
"01083","Limestone County, Alabama",94727,59686,72508,12880,648,1301,54,5700,76.5,13.6,0.7,1.4,0.1,6,23.5,32143,24951,7192,77.62,22.38,2004,22947,841,6351,2845,29298,8,11.7,8.9,"Less than 25% P.O.C.","$52000 - $60000"
"01085","Lowndes County, Alabama",10079,30036,2485,7495,13,0,0,50,24.7,74.4,0.1,0,0,0.5,75.3,4251,3157,1094,74.26,25.74,171,2986,133,961,304,3947,5.4,12.2,7.2,"75% or more P.O.C.","Less than $44000"
"01087","Macon County, Alabama",18708,33370,2966,15442,16,32,0,152,15.9,82.5,0.1,0.2,0,0.8,84.1,7474,4894,2580,65.48,34.52,282,4612,180,2400,462,7012,5.8,7,6.2,"75% or more P.O.C.","Less than $44000"
"01089","Madison County, Alabama",362276,65449,234316,87115,2044,9492,290,17928,64.7,24,0.6,2.6,0.1,4.9,35.3,148189,99046,49143,66.84,33.16,7495,91551,3258,45885,10753,137436,7.6,6.6,7.3,"25% - 50% P.O.C.","$60000 or more"
"01091","Marengo County, Alabama",19321,33241,8672,10348,21,0,0,196,44.9,53.6,0.1,0,0,1,55.1,7361,5262,2099,71.48,28.52,300,4962,13,2086,313,7048,5.7,0.6,4.3,"50% - 75% P.O.C.","Less than $44000"
"01093","Marion County, Alabama",29866,35930,27433,1025,141,54,0,777,91.9,3.4,0.5,0.2,0,2.6,8.1,11997,9015,2982,75.14,24.86,591,8424,178,2804,769,11228,6.6,6,6.4,"Less than 25% P.O.C.","Less than $44000"
"01095","Marshall County, Alabama",95643,45983,77236,2549,349,573,51,13357,80.8,2.7,0.4,0.6,0.1,14,19.2,34883,24480,10403,70.18,29.82,1951,22529,1389,9014,3340,31543,8,13.4,9.6,"Less than 25% P.O.C.","$44000 - $52000"
"01097","Mobile County, Alabama",414114,47583,235599,147186,3140,7837,47,12018,56.9,35.5,0.8,1.9,0,2.9,43.1,156251,100853,55398,64.55,35.45,7955,92898,4457,50941,12412,143839,7.9,8,7.9,"25% - 50% P.O.C.","$44000 - $52000"
"01099","Monroe County, Alabama",21270,30441,11544,9010,372,58,6,81,54.3,42.4,1.7,0.3,0,0.4,45.7,8166,5197,2969,63.64,36.36,287,4910,63,2906,350,7816,5.5,2.1,4.3,"25% - 50% P.O.C.","Less than $44000"
"01101","Montgomery County, Alabama",226941,50124,76937,131160,323,6362,49,7978,33.9,57.8,0.1,2.8,0,3.5,66.1,89527,52265,37262,58.38,41.62,3286,48979,3124,34138,6410,83117,6.3,8.4,7.2,"50% - 75% P.O.C.","$44000 - $52000"
"01103","Morgan County, Alabama",119213,52156,90163,15132,565,760,66,9962,75.6,12.7,0.5,0.6,0.1,8.4,24.4,45918,33392,12526,72.72,27.28,2848,30544,1030,11496,3878,42040,8.5,8.2,8.4,"Less than 25% P.O.C.","$52000 - $60000"
"01105","Perry County, Alabama",9293,23447,2727,6441,3,8,0,110,29.3,69.3,0,0.1,0,1.2,70.7,3070,2206,864,71.86,28.14,150,2056,11,853,161,2909,6.8,1.3,5.2,"50% - 75% P.O.C.","Less than $44000"
"01107","Pickens County, Alabama",20243,39848,10860,8065,28,12,12,985,53.6,39.8,0.1,0.1,0.1,4.9,46.4,7637,5747,1890,75.25,24.75,441,5306,141,1749,582,7055,7.7,7.5,7.6,"25% - 50% P.O.C.","Less than $44000"
"01109","Pike County, Alabama",33333,37446,18672,12194,188,734,3,750,56,36.6,0.6,2.2,0,2.3,44,11601,7225,4376,62.28,37.72,491,6734,175,4201,666,10935,6.8,4,5.7,"25% - 50% P.O.C.","Less than $44000"
"01111","Randolph County, Alabama",22647,43395,17052,4455,38,47,0,668,75.3,19.7,0.2,0.2,0,2.9,24.7,8702,6670,2032,76.65,23.35,454,6216,162,1870,616,8086,6.8,8,7.1,"Less than 25% P.O.C.","Less than $44000"
"01113","Russell County, Alabama",57952,42443,26696,25158,153,506,23,3182,46.1,43.4,0.3,0.9,0,5.5,53.9,23262,13999,9263,60.18,39.82,950,13049,625,8638,1575,21687,6.8,6.7,6.8,"50% - 75% P.O.C.","Less than $44000"
"01115","St. Clair County, Alabama",87989,58308,75556,8418,304,703,11,2133,85.9,9.6,0.3,0.8,0,2.4,14.1,32036,25595,6441,79.89,20.11,2210,23385,710,5731,2920,29116,8.6,11,9.1,"Less than 25% P.O.C.","$52000 - $60000"
"01117","Shelby County, Alabama",213432,77799,166190,25665,559,4399,51,12208,77.9,12,0.3,2.1,0,5.7,22.1,79630,64123,15507,80.53,19.47,4784,59339,988,14519,5772,73858,7.5,6.4,7.2,"Less than 25% P.O.C.","$60000 or more"
"01119","Sumter County, Alabama",12797,24320,3175,9203,9,274,0,68,24.8,71.9,0.1,2.1,0,0.5,75.2,5202,3333,1869,64.07,35.93,249,3084,35,1834,284,4918,7.5,1.9,5.5,"75% or more P.O.C.","Less than $44000"
"01121","Talladega County, Alabama",80387,41325,50344,26022,342,494,23,1842,62.6,32.4,0.4,0.6,0,2.3,37.4,31395,22382,9013,71.29,28.71,1571,20811,533,8480,2104,29291,7,5.9,6.7,"25% - 50% P.O.C.","Less than $44000"
"01123","Tallapoosa County, Alabama",40541,45828,27922,10934,90,145,0,981,68.9,27,0.2,0.4,0,2.4,31.1,16205,12131,4074,74.86,25.14,526,11605,240,3834,766,15439,4.3,5.9,4.7,"25% - 50% P.O.C.","$44000 - $52000"
"01125","Tuscaloosa County, Alabama",207305,53326,127593,66113,332,3335,93,7702,61.5,31.9,0.2,1.6,0,3.7,38.5,72461,46191,26270,63.75,36.25,4214,41977,1398,24872,5612,66849,9.1,5.3,7.7,"25% - 50% P.O.C.","$52000 - $60000"
"01127","Walker County, Alabama",64110,43629,57024,3953,98,313,0,1595,88.9,6.2,0.2,0.5,0,2.5,11.1,25019,19327,5692,77.25,22.75,1377,17950,631,5061,2008,23011,7.1,11.1,8,"Less than 25% P.O.C.","Less than $44000"
"01129","Washington County, Alabama",16541,41370,10743,3894,1209,42,0,241,64.9,23.5,7.3,0.3,0,1.5,35.1,5990,4951,1039,82.65,17.35,361,4590,177,862,538,5452,7.3,17,9,"25% - 50% P.O.C.","Less than $44000"
"01131","Wilcox County, Alabama",10681,31014,2867,7410,10,3,0,57,26.8,69.4,0.1,0,0,0.5,73.2,3854,2617,1237,67.9,32.1,206,2411,61,1176,267,3587,7.9,4.9,6.9,"50% - 75% P.O.C.","Less than $44000"
"01133","Winston County, Alabama",23784,35788,22285,174,81,37,12,750,93.7,0.7,0.3,0.2,0.1,3.2,6.3,9592,7617,1975,79.41,20.59,375,7242,97,1878,472,9120,4.9,4.9,4.9,"Less than 25% P.O.C.","Less than $44000"
"02013","Aleutians East Borough, Alaska",3385,69250,447,109,1553,666,34,305,13.2,3.2,45.9,19.7,1,9,86.8,890,568,322,63.82,36.18,60,508,28,294,88,802,10.6,8.7,9.9,"75% or more P.O.C.","$60000 or more"
"02016","Aleutians West Census Area, Alaska",5698,87466,1358,191,597,2258,151,801,23.8,3.4,10.5,39.6,2.7,14.1,76.2,1187,335,852,28.22,71.78,32,303,87,765,119,1068,9.6,10.2,10,"75% or more P.O.C.","$60000 or more"
"02020","Anchorage Municipality, Alaska",293531,84928,169960,15486,21640,27683,7088,26927,57.9,5.3,7.4,9.4,2.4,9.2,42.1,106567,65367,41200,61.34,38.66,7432,57935,4464,36736,11896,94671,11.4,10.8,11.2,"25% - 50% P.O.C.","$60000 or more"
"02050","Bethel Census Area, Alaska",18134,53553,1764,134,14960,195,39,471,9.7,0.7,82.5,1.1,0.2,2.6,90.3,4489,2611,1878,58.16,41.84,974,1637,461,1417,1435,3054,37.3,24.5,32,"75% or more P.O.C.","$52000 - $60000"
"02060","Bristol Bay Borough, Alaska",875,79808,445,5,299,2,2,32,50.9,0.6,34.2,0.2,0.2,3.7,49.1,314,169,145,53.82,46.18,12,157,15,130,27,287,7.1,10.3,8.6,"25% - 50% P.O.C.","$60000 or more"
"02068","Denali Borough, Alaska",2246,81719,1892,26,49,58,0,7,84.2,1.2,2.2,2.6,0,0.3,15.8,613,500,113,81.57,18.43,41,459,0,113,41,572,8.2,0,6.7,"Less than 25% P.O.C.","$60000 or more"
"02070","Dillingham Census Area, Alaska",4961,56898,764,79,3518,67,3,184,15.4,1.6,70.9,1.4,0.1,3.7,84.6,1427,885,542,62.02,37.98,242,643,99,443,341,1086,27.3,18.3,23.9,"75% or more P.O.C.","$52000 - $60000"
"02090","Fairbanks North Star Borough, Alaska",99072,76992,69282,4236,7204,3064,506,7972,69.9,4.3,7.3,3.1,0.5,8,30.1,36188,21322,14866,58.92,41.08,2375,18947,1374,13492,3749,32439,11.1,9.2,10.4,"25% - 50% P.O.C.","$60000 or more"
"02100","Haines Borough, Alaska",2518,58059,1952,0,219,33,4,113,77.5,0,8.7,1.3,0.2,4.5,22.5,1007,669,338,66.43,33.57,55,614,18,320,73,934,8.2,5.3,7.2,"Less than 25% P.O.C.","$52000 - $60000"
"02105","Hoonah-Angoon Census Area, Alaska",2139,59803,937,65,769,34,0,146,43.8,3,36,1.6,0,6.8,56.2,791,597,194,75.47,24.53,40,557,22,172,62,729,6.7,11.3,7.8,"50% - 75% P.O.C.","$52000 - $60000"
"02110","Juneau City and Borough, Alaska",32227,88390,20844,316,3305,2079,320,2186,64.7,1,10.3,6.5,1,6.8,35.3,12676,8212,4464,64.78,35.22,696,7516,325,4139,1021,11655,8.5,7.3,8.1,"25% - 50% P.O.C.","$60000 or more"
"02122","Kenai Peninsula Borough, Alaska",58464,66064,46726,313,4514,917,195,2428,79.9,0.5,7.7,1.6,0.3,4.2,20.1,21630,15750,5880,72.82,27.18,1357,14393,727,5153,2084,19546,8.6,12.4,9.6,"Less than 25% P.O.C.","$60000 or more"
"02130","Ketchikan Gateway Borough, Alaska",13800,72728,8827,104,1853,1101,27,727,64,0.8,13.4,8,0.2,5.3,36,5397,3322,2075,61.55,38.45,408,2914,137,1938,545,4852,12.3,6.6,10.1,"25% - 50% P.O.C.","$60000 or more"
"02150","Kodiak Island Borough, Alaska",13451,85839,6595,28,1610,3052,45,1198,49,0.2,12,22.7,0.3,8.9,51,4261,2326,1935,54.59,45.41,402,1924,278,1657,680,3581,17.3,14.4,16,"50% - 75% P.O.C.","$60000 or more"
"02158","Kusilvak Census Area, Alaska",8250,36754,295,8,7582,11,5,93,3.6,0.1,91.9,0.1,0.1,1.1,96.4,1724,1236,488,71.69,28.31,644,592,217,271,861,863,52.1,44.5,49.9,"75% or more P.O.C.","Less than $44000"
"02164","Lake and Peninsula Borough, Alaska",1393,44135,292,16,972,23,5,2,21,1.1,69.8,1.7,0.4,0.1,79,421,301,120,71.5,28.5,48,253,25,95,73,348,15.9,20.8,17.3,"75% or more P.O.C.","$44000 - $52000"
"02170","Matanuska-Susitna Borough, Alaska",105369,75493,83473,1207,6366,1446,237,5198,79.2,1.1,6,1.4,0.2,4.9,20.8,31217,24059,7158,77.07,22.93,3474,20585,648,6510,4122,27095,14.4,9.1,13.2,"Less than 25% P.O.C.","$60000 or more"
"02180","Nome Census Area, Alaska",9988,61048,1464,83,7426,153,14,274,14.7,0.8,74.3,1.5,0.1,2.7,85.3,2844,1720,1124,60.48,39.52,597,1123,231,893,828,2016,34.7,20.6,29.1,"75% or more P.O.C.","$60000 or more"
"02185","North Slope Borough, Alaska",9792,79306,3027,141,4977,527,182,199,30.9,1.4,50.8,5.4,1.9,2,69.1,1979,1042,937,52.65,47.35,416,626,283,654,699,1280,39.9,30.2,35.3,"50% - 75% P.O.C.","$60000 or more"
"02188","Northwest Arctic Borough, Alaska",7715,60906,831,83,6332,77,8,112,10.8,1.1,82.1,1,0.1,1.5,89.2,1795,1009,786,56.21,43.79,394,615,172,614,566,1229,39,21.9,31.5,"75% or more P.O.C.","$60000 or more"
"02195","Petersburg Borough, Alaska",3257,69948,2133,33,238,149,19,381,65.5,1,7.3,4.6,0.6,11.7,34.5,1187,817,370,68.83,31.17,92,725,14,356,106,1081,11.3,3.8,8.9,"25% - 50% P.O.C.","$60000 or more"
"02198","Prince of Wales-Hyder Census Area, Alaska",6407,52379,2900,29,2466,91,40,247,45.3,0.5,38.5,1.4,0.6,3.9,54.7,2371,1725,646,72.75,27.25,167,1558,79,567,246,2125,9.7,12.2,10.4,"50% - 75% P.O.C.","$52000 - $60000"
"02220","Sitka City and Borough, Alaska",8640,73682,5320,61,1063,575,8,584,61.6,0.7,12.3,6.7,0.1,6.8,38.4,3547,2102,1445,59.26,40.74,100,2002,73,1372,173,3374,4.8,5.1,4.9,"25% - 50% P.O.C.","$60000 or more"
"02230","Skagway Municipality, Alaska",1107,73906,909,37,56,9,0,63,82.1,3.3,5.1,0.8,0,5.7,17.9,375,200,175,53.33,46.67,13,187,2,173,15,360,6.5,1.1,4,"Less than 25% P.O.C.","$60000 or more"
"02240","Southeast Fairbanks Census Area, Alaska",6878,70056,5066,22,954,183,4,417,73.7,0.3,13.9,2.7,0.1,6.1,26.3,2170,1595,575,73.5,26.5,203,1392,72,503,275,1895,12.7,12.5,12.7,"25% - 50% P.O.C.","$60000 or more"
"02261","Valdez-Cordova Census Area, Alaska",9243,79867,6406,35,1284,376,58,484,69.3,0.4,13.9,4.1,0.6,5.2,30.7,3177,2371,806,74.63,25.37,91,2280,72,734,163,3014,3.8,8.9,5.1,"25% - 50% P.O.C.","$60000 or more"
"02275","Wrangell City and Borough, Alaska",2502,53894,1548,1,555,18,9,126,61.9,0,22.2,0.7,0.4,5,38.1,1027,697,330,67.87,32.13,39,658,18,312,57,970,5.6,5.5,5.6,"25% - 50% P.O.C.","$52000 - $60000"
"02282","Yakutat City and Borough, Alaska",649,71607,281,5,234,32,8,50,43.3,0.8,36.1,4.9,1.2,7.7,56.7,219,145,74,66.21,33.79,20,125,4,70,24,195,13.8,5.4,11,"50% - 75% P.O.C.","$60000 or more"
"02290","Yukon-Koyukuk Census Area, Alaska",5377,41413,1159,4,3676,38,2,143,21.6,0.1,68.4,0.7,0,2.7,78.4,1856,1344,512,72.41,27.59,163,1181,64,448,227,1629,12.1,12.5,12.2,"75% or more P.O.C.","Less than $44000"
"04001","Apache County, Arizona",71511,32508,13022,373,52285,246,16,4531,18.2,0.5,73.1,0.3,0,6.3,81.8,20867,16462,4405,78.89,21.11,2498,13964,826,3579,3324,17543,15.2,18.8,15.9,"75% or more P.O.C.","Less than $44000"
"04003","Cochise County, Arizona",125867,49260,69216,4620,1142,2431,419,44626,55,3.7,0.9,1.9,0.3,35.5,45,50163,34577,15586,68.93,31.07,2491,32086,1786,13800,4277,45886,7.2,11.5,8.5,"25% - 50% P.O.C.","$44000 - $52000"
"04005","Coconino County, Arizona",141274,59460,76361,1576,36395,2638,235,19931,54.1,1.1,25.8,1.9,0.2,14.1,45.9,47447,28962,18485,61.04,38.96,3628,25334,1471,17014,5099,42348,12.5,8,10.7,"25% - 50% P.O.C.","$52000 - $60000"
"04007","Gila County, Arizona",53546,43524,33334,348,8607,421,0,10038,62.3,0.6,16.1,0.8,0,18.7,37.7,21945,16581,5364,75.56,24.44,1678,14903,479,4885,2157,19788,10.1,8.9,9.8,"25% - 50% P.O.C.","Less than $44000"
"04009","Graham County, Arizona",37996,51353,19324,693,4759,240,46,12543,50.9,1.8,12.5,0.6,0.1,33,49.1,11017,7741,3276,70.26,29.74,1369,6372,575,2701,1944,9073,17.7,17.6,17.6,"25% - 50% P.O.C.","$44000 - $52000"
"04011","Greenlee County, Arizona",9522,63473,4439,195,341,52,0,4456,46.6,2,3.6,0.5,0,46.8,53.4,3132,1523,1609,48.63,51.37,147,1376,324,1285,471,2661,9.7,20.1,15,"50% - 75% P.O.C.","$60000 or more"
"04012","La Paz County, Arizona",20793,34643,11935,183,2391,151,10,5735,57.4,0.9,11.5,0.7,0,27.6,42.6,9346,6686,2660,71.54,28.46,348,6338,254,2406,602,8744,5.2,9.5,6.4,"25% - 50% P.O.C.","Less than $44000"
"04013","Maricopa County, Arizona",4328810,64468,2391279,230036,70012,177034,8690,1341560,55.2,5.3,1.6,4.1,0.2,31,44.8,1552096,965292,586804,62.19,37.81,111632,853660,72977,513827,184609,1367487,11.6,12.4,11.9,"25% - 50% P.O.C.","$60000 or more"
"04015","Mohave County, Arizona",207695,45587,160529,2069,4147,2228,415,34160,77.3,1,2,1.1,0.2,16.4,22.7,86889,60192,26697,69.27,30.73,3305,56887,2947,23750,6252,80637,5.5,11,7.2,"Less than 25% P.O.C.","$44000 - $52000"
"04017","Navajo County, Arizona",109270,40067,45109,808,47561,643,141,12479,41.3,0.7,43.5,0.6,0.1,11.4,58.7,34990,24067,10923,68.78,31.22,3412,20655,1848,9075,5260,29730,14.2,16.9,15,"50% - 75% P.O.C.","Less than $44000"
"04019","Pima County, Arizona",1027207,53379,531408,33479,25212,28691,1413,382585,51.7,3.3,2.5,2.8,0.1,37.2,48.3,404739,255677,149062,63.17,36.83,21579,234098,13074,135988,34653,370086,8.4,8.8,8.6,"25% - 50% P.O.C.","$52000 - $60000"
"04021","Pinal County, Arizona",432793,58174,245773,17675,18616,6826,1243,130511,56.8,4.1,4.3,1.6,0.3,30.2,43.2,141300,108402,32898,76.72,23.28,12242,96160,6437,26461,18679,122621,11.3,19.6,13.2,"25% - 50% P.O.C.","$52000 - $60000"
"04023","Santa Cruz County, Arizona",46480,41259,6904,110,104,387,0,38793,14.9,0.2,0.2,0.8,0,83.5,85.1,15853,10725,5128,67.65,32.35,1419,9306,777,4351,2196,13657,13.2,15.2,13.9,"75% or more P.O.C.","Less than $44000"
"04025","Yavapai County, Arizona",228067,52451,183497,1424,2891,2107,132,33166,80.5,0.6,1.3,0.9,0.1,14.5,19.5,98386,70821,27565,71.98,28.02,4142,66679,2716,24849,6858,91528,5.8,9.9,7,"Less than 25% P.O.C.","$52000 - $60000"
"04027","Yuma County, Arizona",209468,45243,64877,3518,1933,2502,118,133549,31,1.7,0.9,1.2,0.1,63.8,69,73098,49048,24050,67.1,32.9,6870,42178,3637,20413,10507,62591,14,15.1,14.4,"50% - 75% P.O.C.","$44000 - $52000"
"05001","Arkansas County, Arkansas",17914,46696,12497,4636,30,8,0,572,69.8,25.9,0.2,0,0,3.2,30.2,7491,4883,2608,65.18,34.82,288,4595,146,2462,434,7057,5.9,5.6,5.8,"25% - 50% P.O.C.","$44000 - $52000"
"05003","Ashley County, Arkansas",20270,44744,13831,5123,45,39,0,1101,68.2,25.3,0.2,0.2,0,5.4,31.8,7757,6010,1747,77.48,22.52,423,5587,79,1668,502,7255,7,4.5,6.5,"25% - 50% P.O.C.","$44000 - $52000"
"05005","Baxter County, Arkansas",41427,42260,39235,67,175,180,18,987,94.7,0.2,0.4,0.4,0,2.4,5.3,18435,14038,4397,76.15,23.85,699,13339,354,4043,1053,17382,5,8.1,5.7,"Less than 25% P.O.C.","Less than $44000"
"05007","Benton County, Arkansas",265759,66362,194883,4385,3360,10194,1620,44161,73.3,1.6,1.3,3.8,0.6,16.6,26.7,97249,64742,32507,66.57,33.43,7892,56850,3801,28706,11693,85556,12.2,11.7,12,"25% - 50% P.O.C.","$60000 or more"
"05009","Boone County, Arkansas",37331,45374,35043,125,212,139,32,931,93.9,0.3,0.6,0.4,0.1,2.5,6.1,15034,10793,4241,71.79,28.21,897,9896,372,3869,1269,13765,8.3,8.8,8.4,"Less than 25% P.O.C.","$44000 - $52000"
"05011","Bradley County, Arkansas",10874,43184,6035,3132,0,7,0,1673,55.5,28.8,0,0.1,0,15.4,44.5,4419,2880,1539,65.17,34.83,284,2596,139,1400,423,3996,9.9,9,9.6,"25% - 50% P.O.C.","Less than $44000"
"05013","Calhoun County, Arkansas",5192,46417,3762,1115,9,0,16,207,72.5,21.5,0.2,0,0.3,4,27.5,1850,1569,281,84.81,15.19,81,1488,10,271,91,1759,5.2,3.6,4.9,"25% - 50% P.O.C.","$44000 - $52000"
"05015","Carroll County, Arkansas",27965,46110,22266,140,206,387,257,4183,79.6,0.5,0.7,1.4,0.9,15,20.4,11139,8436,2703,75.73,24.27,803,7633,404,2299,1207,9932,9.5,14.9,10.8,"Less than 25% P.O.C.","$44000 - $52000"
"05017","Chicot County, Arkansas",10615,34147,4111,5719,15,62,0,584,38.7,53.9,0.1,0.6,0,5.5,61.3,4068,2513,1555,61.77,38.23,171,2342,291,1264,462,3606,6.8,18.7,11.4,"50% - 75% P.O.C.","Less than $44000"
"05019","Clark County, Arkansas",22386,41620,15377,5426,80,156,7,1059,68.7,24.2,0.4,0.7,0,4.7,31.3,8446,4859,3587,57.53,42.47,383,4476,186,3401,569,7877,7.9,5.2,6.7,"25% - 50% P.O.C.","Less than $44000"
"05021","Clay County, Arkansas",14889,37233,14195,100,44,4,0,307,95.3,0.7,0.3,0,0,2.1,4.7,6444,4344,2100,67.41,32.59,254,4090,202,1898,456,5988,5.8,9.6,7.1,"Less than 25% P.O.C.","Less than $44000"
"05023","Cleburne County, Arkansas",25100,44483,23763,98,294,167,0,609,94.7,0.4,1.2,0.7,0,2.4,5.3,10783,8110,2673,75.21,24.79,522,7588,180,2493,702,10081,6.4,6.7,6.5,"Less than 25% P.O.C.","$44000 - $52000"
"05025","Cleveland County, Arkansas",8128,46684,6874,1040,14,0,0,101,84.6,12.8,0.2,0,0,1.2,15.4,3217,2446,771,76.03,23.97,186,2260,25,746,211,3006,7.6,3.2,6.6,"Less than 25% P.O.C.","$44000 - $52000"
"05027","Columbia County, Arkansas",23776,36193,14093,8540,44,254,0,645,59.3,35.9,0.2,1.1,0,2.7,40.7,8562,6029,2533,70.42,29.58,454,5575,280,2253,734,7828,7.5,11.1,8.6,"25% - 50% P.O.C.","Less than $44000"
"05029","Conway County, Arkansas",20858,42802,17017,2140,53,62,0,818,81.6,10.3,0.3,0.3,0,3.9,18.4,8309,5590,2719,67.28,32.72,521,5069,165,2554,686,7623,9.3,6.1,8.3,"Less than 25% P.O.C.","Less than $44000"
"05031","Craighead County, Arkansas",107345,47286,81616,15565,206,1510,7,5421,76,14.5,0.2,1.4,0,5.1,24,41375,23623,17752,57.09,42.91,1938,21685,1588,16164,3526,37849,8.2,8.9,8.5,"Less than 25% P.O.C.","$44000 - $52000"
"05033","Crawford County, Arkansas",62739,46828,52869,873,1125,1159,15,4852,84.3,1.4,1.8,1.8,0,7.7,15.7,23958,18211,5747,76.01,23.99,2033,16178,769,4978,2802,21156,11.2,13.4,11.7,"Less than 25% P.O.C.","$44000 - $52000"
"05035","Crittenden County, Arkansas",48672,40161,20435,23276,129,337,21,1246,42,47.8,0.3,0.7,0,2.6,58,19074,10956,8118,57.44,42.56,922,10034,854,7264,1776,17298,8.4,10.5,9.3,"50% - 75% P.O.C.","Less than $44000"
"05037","Cross County, Arkansas",16824,46787,12223,3141,35,5,0,167,72.7,18.7,0.2,0,0,1,27.3,6653,4447,2206,66.84,33.16,527,3920,187,2019,714,5939,11.9,8.5,10.7,"25% - 50% P.O.C.","$44000 - $52000"
"05039","Dallas County, Arkansas",7279,38072,3867,3146,41,4,18,98,53.1,43.2,0.6,0.1,0.2,1.3,46.9,2969,2010,959,67.7,32.3,175,1835,63,896,238,2731,8.7,6.6,8,"25% - 50% P.O.C.","Less than $44000"
"05041","Desha County, Arkansas",11709,31893,5296,5456,24,51,0,718,45.2,46.6,0.2,0.4,0,6.1,54.8,5204,3199,2005,61.47,38.53,229,2970,282,1723,511,4693,7.2,14.1,9.8,"50% - 75% P.O.C.","Less than $44000"
"05043","Drew County, Arkansas",18417,46997,12206,5269,0,60,0,632,66.3,28.6,0,0.3,0,3.4,33.7,7157,4845,2312,67.7,32.3,227,4618,239,2073,466,6691,4.7,10.3,6.5,"25% - 50% P.O.C.","$44000 - $52000"
"05045","Faulkner County, Arkansas",123624,52827,98945,14018,475,1641,154,5060,80,11.3,0.4,1.3,0.1,4.1,20,44575,27776,16799,62.31,37.69,2592,25184,1193,15606,3785,40790,9.3,7.1,8.5,"Less than 25% P.O.C.","$52000 - $60000"
"05047","Franklin County, Arkansas",17738,38923,16327,169,202,146,33,536,92,1,1.1,0.8,0.2,3,8,6723,4740,1983,70.5,29.5,264,4476,237,1746,501,6222,5.6,12,7.5,"Less than 25% P.O.C.","Less than $44000"
"05049","Fulton County, Arkansas",12231,35405,11608,58,40,8,9,196,94.9,0.5,0.3,0.1,0.1,1.6,5.1,4973,3965,1008,79.73,20.27,272,3693,101,907,373,4600,6.9,10,7.5,"Less than 25% P.O.C.","Less than $44000"
"05051","Garland County, Arkansas",98555,44777,80875,8055,835,588,0,5553,82.1,8.2,0.8,0.6,0,5.6,17.9,40209,27270,12939,67.82,32.18,1639,25631,1128,11811,2767,37442,6,8.7,6.9,"Less than 25% P.O.C.","$44000 - $52000"
"05053","Grant County, Arkansas",18126,55388,16779,465,28,7,13,498,92.6,2.6,0.2,0,0.1,2.7,7.4,6863,5499,1364,80.13,19.87,521,4978,186,1178,707,6156,9.5,13.6,10.3,"Less than 25% P.O.C.","$52000 - $60000"
"05055","Greene County, Arkansas",44937,47056,41791,861,121,164,15,1281,93,1.9,0.3,0.4,0,2.9,7,17254,11561,5693,67,33,1060,10501,452,5241,1512,15742,9.2,7.9,8.8,"Less than 25% P.O.C.","$44000 - $52000"
"05057","Hempstead County, Arkansas",21842,42860,11927,6548,69,26,73,2800,54.6,30,0.3,0.1,0.3,12.8,45.4,8094,5607,2487,69.27,30.73,590,5017,195,2292,785,7309,10.5,7.8,9.7,"25% - 50% P.O.C.","Less than $44000"
"05059","Hot Spring County, Arkansas",33597,43889,27729,3816,152,133,8,1176,82.5,11.4,0.5,0.4,0,3.5,17.5,12599,9809,2790,77.86,22.14,603,9206,275,2515,878,11721,6.1,9.9,7,"Less than 25% P.O.C.","Less than $44000"
"05061","Howard County, Arkansas",13311,36059,8538,2779,31,36,12,1669,64.1,20.9,0.2,0.3,0.1,12.5,35.9,5142,3545,1597,68.94,31.06,365,3180,70,1527,435,4707,10.3,4.4,8.5,"25% - 50% P.O.C.","Less than $44000"
"05063","Independence County, Arkansas",37427,44319,33201,678,70,264,8,2363,88.7,1.8,0.2,0.7,0,6.3,11.3,14322,10261,4061,71.65,28.35,990,9271,430,3631,1420,12902,9.6,10.6,9.9,"Less than 25% P.O.C.","$44000 - $52000"
"05065","Izard County, Arkansas",13570,42876,12611,248,130,0,0,314,92.9,1.8,1,0,0,2.3,7.1,4851,3690,1161,76.07,23.93,172,3518,73,1088,245,4606,4.7,6.3,5.1,"Less than 25% P.O.C.","Less than $44000"
"05067","Jackson County, Arkansas",17027,34109,13082,2078,26,8,6,492,76.8,12.2,0.2,0,0,2.9,23.2,6137,4257,1880,69.37,30.63,355,3902,138,1742,493,5644,8.3,7.3,8,"Less than 25% P.O.C.","Less than $44000"
"05069","Jefferson County, Arkansas",69282,40726,26940,39135,196,660,89,1455,38.9,56.5,0.3,1,0.1,2.1,61.1,26801,16644,10157,62.1,37.9,935,15709,812,9345,1747,25054,5.6,8,6.5,"50% - 75% P.O.C.","Less than $44000"
"05071","Johnson County, Arkansas",26372,38511,20881,411,63,543,20,3671,79.2,1.6,0.2,2.1,0.1,13.9,20.8,9682,6818,2864,70.42,29.58,754,6064,257,2607,1011,8671,11.1,9,10.4,"Less than 25% P.O.C.","Less than $44000"
"05073","Lafayette County, Arkansas",6800,32397,3984,2432,28,27,0,182,58.6,35.8,0.4,0.4,0,2.7,41.4,2784,2202,582,79.09,20.91,163,2039,30,552,193,2591,7.4,5.2,6.9,"25% - 50% P.O.C.","Less than $44000"
"05075","Lawrence County, Arkansas",16549,39993,15765,186,44,25,2,256,95.3,1.1,0.3,0.2,0,1.5,4.7,6463,4351,2112,67.32,32.68,306,4045,216,1896,522,5941,7,10.2,8.1,"Less than 25% P.O.C.","Less than $44000"
"05077","Lee County, Arkansas",9194,29681,3773,5087,22,15,0,230,41,55.3,0.2,0.2,0,2.5,59,3206,1917,1289,59.79,40.21,125,1792,63,1226,188,3018,6.5,4.9,5.9,"50% - 75% P.O.C.","Less than $44000"
"05079","Lincoln County, Arkansas",13455,46596,8638,4106,63,0,0,529,64.2,30.5,0.5,0,0,3.9,35.8,3773,2910,863,77.13,22.87,284,2626,20,843,304,3469,9.8,2.3,8.1,"25% - 50% P.O.C.","$44000 - $52000"
"05081","Little River County, Arkansas",12347,45113,9000,2710,129,42,0,189,72.9,21.9,1,0.3,0,1.5,27.1,5363,3836,1527,71.53,28.47,305,3531,116,1411,421,4942,8,7.6,7.9,"25% - 50% P.O.C.","$44000 - $52000"
"05083","Logan County, Arkansas",21668,41466,19596,298,183,474,0,645,90.4,1.4,0.8,2.2,0,3,9.6,8417,6202,2215,73.68,26.32,570,5632,274,1941,844,7573,9.2,12.4,10,"Less than 25% P.O.C.","Less than $44000"
"05085","Lonoke County, Arkansas",72528,59094,62375,4089,475,568,193,3241,86,5.6,0.7,0.8,0.3,4.5,14,26895,18624,8271,69.25,30.75,1686,16938,762,7509,2448,24447,9.1,9.2,9.1,"Less than 25% P.O.C.","$52000 - $60000"
"05087","Madison County, Arkansas",16211,41682,14482,16,165,195,95,928,89.3,0.1,1,1.2,0.6,5.7,10.7,6279,4899,1380,78.02,21.98,312,4587,255,1125,567,5712,6.4,18.5,9,"Less than 25% P.O.C.","Less than $44000"
"05089","Marion County, Arkansas",16476,36719,15504,80,107,147,0,379,94.1,0.5,0.6,0.9,0,2.3,5.9,6782,5348,1434,78.86,21.14,226,5122,89,1345,315,6467,4.2,6.2,4.6,"Less than 25% P.O.C.","Less than $44000"
"05091","Miller County, Arkansas",43572,43371,29835,10738,301,173,17,1450,68.5,24.6,0.7,0.4,0,3.3,31.5,16426,10619,5807,64.65,35.35,840,9779,427,5380,1267,15159,7.9,7.4,7.7,"25% - 50% P.O.C.","Less than $44000"
"05093","Mississippi County, Arkansas",42126,39962,24550,14212,24,238,33,1740,58.3,33.7,0.1,0.6,0.1,4.1,41.7,16389,9237,7152,56.36,43.64,849,8388,597,6555,1446,14943,9.2,8.3,8.8,"25% - 50% P.O.C.","Less than $44000"
"05095","Monroe County, Arkansas",7050,38468,3818,3030,21,30,0,45,54.2,43,0.3,0.4,0,0.6,45.8,3333,1996,1337,59.89,40.11,142,1854,122,1215,264,3069,7.1,9.1,7.9,"25% - 50% P.O.C.","Less than $44000"
"05097","Montgomery County, Arkansas",8950,35741,8138,26,132,36,0,388,90.9,0.3,1.5,0.4,0,4.3,9.1,3754,3053,701,81.33,18.67,154,2899,30,671,184,3570,5,4.3,4.9,"Less than 25% P.O.C.","Less than $44000"
"05099","Nevada County, Arkansas",8351,38042,5245,2884,13,3,2,2,62.8,34.5,0.2,0,0,0,37.2,3397,2274,1123,66.94,33.06,62,2212,25,1098,87,3310,2.7,2.2,2.6,"25% - 50% P.O.C.","Less than $44000"
"05101","Newton County, Arkansas",7812,38082,7335,2,196,51,60,33,93.9,0,2.5,0.7,0.8,0.4,6.1,2936,2472,464,84.2,15.8,220,2252,51,413,271,2665,8.9,11,9.2,"Less than 25% P.O.C.","Less than $44000"
"05103","Ouachita County, Arkansas",23830,35425,13137,9866,19,18,0,558,55.1,41.4,0.1,0.1,0,2.3,44.9,9658,6676,2982,69.12,30.88,418,6258,156,2826,574,9084,6.3,5.2,5.9,"25% - 50% P.O.C.","Less than $44000"
"05105","Perry County, Arkansas",10355,48667,9885,56,5,0,0,303,95.5,0.5,0,0,0,2.9,4.5,3668,2804,864,76.44,23.56,299,2505,117,747,416,3252,10.7,13.5,11.3,"Less than 25% P.O.C.","$44000 - $52000"
"05107","Phillips County, Arkansas",18606,29320,6420,11750,1,0,0,350,34.5,63.2,0,0,0,1.9,65.5,7485,3607,3878,48.19,51.81,132,3475,290,3588,422,7063,3.7,7.5,5.6,"50% - 75% P.O.C.","Less than $44000"
"05109","Pike County, Arkansas",10756,40401,9398,439,56,46,0,700,87.4,4.1,0.5,0.4,0,6.5,12.6,4280,3372,908,78.79,21.21,311,3061,90,818,401,3879,9.2,9.9,9.4,"Less than 25% P.O.C.","Less than $44000"
"05111","Poinsett County, Arkansas",23896,40921,20744,1093,22,12,0,727,86.8,4.6,0.1,0.1,0,3,13.2,9526,5994,3532,62.92,37.08,400,5594,356,3176,756,8770,6.7,10.1,7.9,"Less than 25% P.O.C.","Less than $44000"
"05113","Polk County, Arkansas",20094,37974,17603,95,272,57,0,1324,87.6,0.5,1.4,0.3,0,6.6,12.4,8243,6321,1922,76.68,23.32,635,5686,216,1706,851,7392,10,11.2,10.3,"Less than 25% P.O.C.","Less than $44000"
"05115","Pope County, Arkansas",63761,43462,53564,1866,386,658,0,5751,84,2.9,0.6,1,0,9,16,22579,15563,7016,68.93,31.07,1224,14339,600,6416,1824,20755,7.9,8.6,8.1,"Less than 25% P.O.C.","Less than $44000"
"05117","Prairie County, Arkansas",8189,42660,6932,1017,36,17,0,142,84.7,12.4,0.4,0.2,0,1.7,15.3,3776,2792,984,73.94,26.06,158,2634,157,827,315,3461,5.7,16,8.3,"Less than 25% P.O.C.","Less than $44000"
"05119","Pulaski County, Arkansas",392967,51749,205386,144099,931,8650,132,24171,52.3,36.7,0.2,2.2,0,6.2,47.7,158051,92938,65113,58.8,41.2,6999,85939,4495,60618,11494,146557,7.5,6.9,7.3,"25% - 50% P.O.C.","$44000 - $52000"
"05121","Randolph County, Arkansas",17695,37218,16616,192,113,21,57,367,93.9,1.1,0.6,0.1,0.3,2.1,6.1,7355,5275,2080,71.72,28.28,354,4921,337,1743,691,6664,6.7,16.2,9.4,"Less than 25% P.O.C.","Less than $44000"
"05123","St. Francis County, Arkansas",25900,35348,10353,13764,74,160,37,1343,40,53.1,0.3,0.6,0.1,5.2,60,9388,5139,4249,54.74,45.26,364,4775,455,3794,819,8569,7.1,10.7,8.7,"50% - 75% P.O.C.","Less than $44000"
"05125","Saline County, Arkansas",119415,64412,101010,8470,378,1512,143,5688,84.6,7.1,0.3,1.3,0.1,4.8,15.4,44075,34419,9656,78.09,21.91,3173,31246,840,8816,4013,40062,9.2,8.7,9.1,"Less than 25% P.O.C.","$60000 or more"
"05127","Scott County, Arkansas",10376,36092,8752,25,197,75,0,799,84.3,0.2,1.9,0.7,0,7.7,15.7,3944,2910,1034,73.78,26.22,351,2559,75,959,426,3518,12.1,7.3,10.8,"Less than 25% P.O.C.","Less than $44000"
"05129","Searcy County, Arkansas",7908,36438,7365,48,139,55,0,191,93.1,0.6,1.8,0.7,0,2.4,6.9,3327,2460,867,73.94,26.06,159,2301,44,823,203,3124,6.5,5.1,6.1,"Less than 25% P.O.C.","Less than $44000"
"05131","Sebastian County, Arkansas",127591,46228,88754,8555,1316,5719,16,18144,69.6,6.7,1,4.5,0,14.2,30.4,51228,30130,21098,58.82,41.18,2727,27403,1822,19276,4549,46679,9.1,8.6,8.9,"25% - 50% P.O.C.","$44000 - $52000"
"05133","Sevier County, Arkansas",17081,47704,9784,819,347,76,81,5711,57.3,4.8,2,0.4,0.5,33.4,42.7,5885,4201,1684,71.38,28.62,804,3397,294,1390,1098,4787,19.1,17.5,18.7,"25% - 50% P.O.C.","$44000 - $52000"
"05135","Sharp County, Arkansas",17139,34671,16014,123,57,14,0,391,93.4,0.7,0.3,0.1,0,2.3,6.6,7447,5746,1701,77.16,22.84,368,5378,197,1504,565,6882,6.4,11.6,7.6,"Less than 25% P.O.C.","Less than $44000"
"05137","Stone County, Arkansas",12475,38188,11808,11,58,63,0,243,94.7,0.1,0.5,0.5,0,1.9,5.3,4787,3573,1214,74.64,25.36,343,3230,81,1133,424,4363,9.6,6.7,8.9,"Less than 25% P.O.C.","Less than $44000"
"05139","Union County, Arkansas",39449,44663,23875,12883,290,258,0,1577,60.5,32.7,0.7,0.7,0,4,39.5,15726,11865,3861,75.45,24.55,698,11167,263,3598,961,14765,5.9,6.8,6.1,"25% - 50% P.O.C.","$44000 - $52000"
"05141","Van Buren County, Arkansas",16642,38499,15556,78,101,37,21,520,93.5,0.5,0.6,0.2,0.1,3.1,6.5,6813,5352,1461,78.56,21.44,393,4959,101,1360,494,6319,7.3,6.9,7.3,"Less than 25% P.O.C.","Less than $44000"
"05143","Washington County, Arkansas",232289,50451,164678,8306,1823,5592,5274,38979,70.9,3.6,0.8,2.4,2.3,16.8,29.1,87325,45928,41397,52.59,47.41,5518,40410,3472,37925,8990,78335,12,8.4,10.3,"25% - 50% P.O.C.","$44000 - $52000"
"05145","White County, Arkansas",78762,44029,69364,3333,456,583,0,3422,88.1,4.2,0.6,0.7,0,4.3,11.9,29055,19195,9860,66.06,33.94,2005,17190,712,9148,2717,26338,10.4,7.2,9.4,"Less than 25% P.O.C.","$44000 - $52000"
"05147","Woodruff County, Arkansas",6533,32845,4533,1839,0,59,0,30,69.4,28.1,0,0.9,0,0.5,30.6,2932,1917,1015,65.38,34.62,84,1833,139,876,223,2709,4.4,13.7,7.6,"25% - 50% P.O.C.","Less than $44000"
"05149","Yell County, Arkansas",21464,43923,16156,445,93,212,0,4326,75.3,2.1,0.4,1,0,20.2,24.7,7503,5363,2140,71.48,28.52,662,4701,365,1775,1027,6476,12.3,17.1,13.7,"Less than 25% P.O.C.","Less than $44000"
"06001","Alameda County, California",1656754,99406,520447,171168,5210,496006,13277,371019,31.4,10.3,0.3,29.9,0.8,22.4,68.6,577177,308891,268286,53.52,46.48,34619,274272,27968,240318,62587,514590,11.2,10.4,10.8,"50% - 75% P.O.C.","$60000 or more"
"06003","Alpine County, California",1039,63750,551,9,314,10,0,130,53,0.9,30.2,1,0,12.5,47,350,294,56,84,16,22,272,6,50,28,322,7.5,10.7,8,"25% - 50% P.O.C.","$60000 or more"
"06005","Amador County, California",38429,62772,30035,848,249,477,52,5340,78.2,2.2,0.6,1.2,0.1,13.9,21.8,14594,11165,3429,76.5,23.5,724,10441,282,3147,1006,13588,6.5,8.2,6.9,"Less than 25% P.O.C.","$60000 or more"
"06007","Butte County, California",225817,52537,162537,3342,1699,10057,476,36916,72,1.5,0.8,4.5,0.2,16.3,28,85320,50331,34989,58.99,41.01,3893,46438,2988,32001,6881,78439,7.7,8.5,8.1,"25% - 50% P.O.C.","$52000 - $60000"
"06009","Calaveras County, California",45514,63158,36837,315,184,684,19,5489,80.9,0.7,0.4,1.5,0,12.1,19.1,16942,13173,3769,77.75,22.25,740,12433,507,3262,1247,15695,5.6,13.5,7.4,"Less than 25% P.O.C.","$60000 or more"
"06011","Colusa County, California",21454,59401,7576,256,143,273,38,12738,35.3,1.2,0.7,1.3,0.2,59.4,64.7,7227,4410,2817,61.02,38.98,542,3868,728,2089,1270,5957,12.3,25.8,17.6,"50% - 75% P.O.C.","$52000 - $60000"
"06013","Contra Costa County, California",1142251,99716,500592,95892,2278,188237,5297,292298,43.8,8.4,0.2,16.5,0.5,25.6,56.2,394769,260244,134525,65.92,34.08,30318,229926,18515,116010,48833,345936,11.6,13.8,12.4,"50% - 75% P.O.C.","$60000 or more"
"06015","Del Norte County, California",27495,45283,17028,899,1943,862,44,5429,61.9,3.3,7.1,3.1,0.2,19.7,38.1,9945,6273,3672,63.08,36.92,532,5741,468,3204,1000,8945,8.5,12.7,10.1,"25% - 50% P.O.C.","$44000 - $52000"
"06017","El Dorado County, California",188563,83377,146747,1426,1031,8487,472,24199,77.8,0.8,0.5,4.5,0.3,12.8,22.2,70974,53750,17224,75.73,24.27,4038,49712,1659,15565,5697,65277,7.5,9.6,8,"Less than 25% P.O.C.","$60000 or more"
"06019","Fresno County, California",984521,53969,289650,44209,4651,99480,1207,522364,29.4,4.5,0.5,10.1,0.1,53.1,70.6,307906,164124,143782,53.3,46.7,28315,135809,27895,115887,56210,251696,17.3,19.4,18.3,"50% - 75% P.O.C.","$52000 - $60000"
"06021","Glenn County, California",27976,49633,14398,193,391,825,11,11680,51.5,0.7,1.4,2.9,0,41.8,48.5,10085,5988,4097,59.38,40.62,739,5249,549,3548,1288,8797,12.3,13.4,12.8,"25% - 50% P.O.C.","$44000 - $52000"
"06023","Humboldt County, California",135940,48041,101078,1336,6264,4073,432,15722,74.4,1,4.6,3,0.3,11.6,25.6,54679,31078,23601,56.84,43.16,2043,29035,2023,21578,4066,50613,6.6,8.6,7.4,"25% - 50% P.O.C.","$44000 - $52000"
"06025","Imperial County, California",180701,47622,19228,3882,1104,2367,240,152172,10.6,2.1,0.6,1.3,0.1,84.2,89.4,44829,26156,18673,58.35,41.65,4754,21402,3864,14809,8618,36211,18.2,20.7,19.2,"75% or more P.O.C.","$44000 - $52000"
"06027","Inyo County, California",17977,57316,11173,141,1828,325,34,4020,62.2,0.8,10.2,1.8,0.2,22.4,37.8,7950,5204,2746,65.46,34.54,235,4969,150,2596,385,7565,4.5,5.5,4.8,"25% - 50% P.O.C.","$52000 - $60000"
"06029","Kern County, California",887641,53350,303225,45761,4303,40730,1115,473374,34.2,5.2,0.5,4.6,0.1,53.3,65.8,270282,157554,112728,58.29,41.71,27347,130207,22700,90028,50047,220235,17.4,20.1,18.5,"50% - 75% P.O.C.","$52000 - $60000"
"06031","Kings County, California",150691,57848,48537,8779,1282,5565,241,82116,32.2,5.8,0.9,3.7,0.2,54.5,67.8,43452,22733,20719,52.32,47.68,3812,18921,4277,16442,8089,35363,16.8,20.6,18.6,"50% - 75% P.O.C.","$52000 - $60000"
"06033","Lake County, California",64195,47040,45258,1331,1926,684,42,13224,70.5,2.1,3,1.1,0.1,20.6,29.5,25660,17034,8626,66.38,33.62,1336,15698,1006,7620,2342,23318,7.8,11.7,9.1,"25% - 50% P.O.C.","$44000 - $52000"
"06035","Lassen County, California",30818,56352,20164,2612,844,427,247,5844,65.4,8.5,2.7,1.4,0.8,19,34.6,9280,6270,3010,67.56,32.44,386,5884,284,2726,670,8610,6.2,9.4,7.2,"25% - 50% P.O.C.","$52000 - $60000"
"06037","Los Angeles County, California",10081570,68044,2641770,790252,20831,1454769,24597,4888434,26.2,7.8,0.2,14.4,0.2,48.5,73.8,3316795,1519516,1797279,45.81,54.19,235641,1283875,238169,1559110,473810,2842985,15.5,13.3,14.3,"50% - 75% P.O.C.","$60000 or more"
"06039","Madera County, California",155433,57585,53053,4770,1546,3020,141,89798,34.1,3.1,1,1.9,0.1,57.8,65.9,44881,28772,16109,64.11,35.89,4729,24043,4592,11517,9321,35560,16.4,28.5,20.8,"50% - 75% P.O.C.","$52000 - $60000"
"06041","Marin County, California",259943,115246,184960,5527,438,15110,249,41527,71.2,2.1,0.2,5.8,0.1,16,28.8,105432,67115,38317,63.66,36.34,4150,62965,3411,34906,7561,97871,6.2,8.9,7.2,"25% - 50% P.O.C.","$60000 or more"
"06043","Mariposa County, California",17420,48820,13935,253,325,210,53,1963,80,1.5,1.9,1.2,0.3,11.3,20,7643,5230,2413,68.43,31.57,293,4937,249,2164,542,7101,5.6,10.3,7.1,"Less than 25% P.O.C.","$44000 - $52000"
"06045","Mendocino County, California",87224,51416,56857,626,2938,1773,165,21898,65.2,0.7,3.4,2,0.2,25.1,34.8,34408,20611,13797,59.9,40.1,1074,19537,1582,12215,2656,31752,5.2,11.5,7.7,"25% - 50% P.O.C.","$44000 - $52000"
"06047","Merced County, California",271382,53672,75037,7812,931,19650,607,161814,27.6,2.9,0.3,7.2,0.2,59.6,72.4,80008,41795,38213,52.24,47.76,8264,33531,9988,28225,18252,61756,19.8,26.1,22.8,"50% - 75% P.O.C.","$52000 - $60000"
"06049","Modoc County, California",8907,45507,6920,136,372,99,9,1291,77.7,1.5,4.2,1.1,0.1,14.5,22.3,3616,2708,908,74.89,25.11,131,2577,54,854,185,3431,4.8,5.9,5.1,"Less than 25% P.O.C.","$44000 - $52000"
"06051","Mono County, California",14310,62260,9308,59,242,363,0,3865,65,0.4,1.7,2.5,0,27,35,4765,3068,1697,64.39,35.61,127,2941,90,1607,217,4548,4.1,5.3,4.6,"25% - 50% P.O.C.","$60000 or more"
"06053","Monterey County, California",433410,71015,129738,10737,819,23348,1982,254294,29.9,2.5,0.2,5.4,0.5,58.7,70.1,127155,64900,62255,51.04,48.96,11123,53777,13722,48533,24845,102310,17.1,22,19.5,"50% - 75% P.O.C.","$60000 or more"
"06055","Napa County, California",139623,88596,73210,2780,407,11196,284,47544,52.4,2,0.3,8,0.2,34.1,47.6,48705,31276,17429,64.22,35.78,3231,28045,2644,14785,5875,42830,10.3,15.2,12.1,"25% - 50% P.O.C.","$60000 or more"
"06057","Nevada County, California",99244,66096,84513,478,413,1043,124,9373,85.2,0.5,0.4,1.1,0.1,9.4,14.8,40855,30316,10539,74.2,25.8,1435,28881,563,9976,1998,38857,4.7,5.3,4.9,"Less than 25% P.O.C.","$60000 or more"
"06059","Orange County, California",3168044,90234,1285855,51269,6116,642948,8928,1078726,40.6,1.6,0.2,20.3,0.3,34.1,59.4,1037492,595272,442220,57.38,42.62,76013,519259,69450,372770,145463,892029,12.8,15.7,14,"50% - 75% P.O.C.","$60000 or more"
"06061","Placer County, California",385512,89691,280105,6361,1373,28573,566,53969,72.7,1.7,0.4,7.4,0.1,14,27.3,142855,102650,40205,71.86,28.14,10120,92530,3416,36789,13536,129319,9.9,8.5,9.5,"25% - 50% P.O.C.","$60000 or more"
"06063","Plumas County, California",18660,55359,15514,141,268,212,86,1670,83.1,0.8,1.4,1.1,0.5,8.9,16.9,8450,6156,2294,72.85,27.15,424,5732,255,2039,679,7771,6.9,11.1,8,"Less than 25% P.O.C.","$52000 - $60000"
"06065","Riverside County, California",2411439,67005,851702,147160,10362,152347,6471,1179478,35.3,6.1,0.4,6.3,0.3,48.9,64.7,724893,480944,243949,66.35,33.65,83494,397450,46566,197383,130060,594833,17.4,19.1,17.9,"50% - 75% P.O.C.","$60000 or more"
"06067","Sacramento County, California",1524553,67151,681829,144695,5554,235434,17026,353318,44.7,9.5,0.4,15.4,1.1,23.2,55.3,543025,306324,236701,56.41,43.59,36983,269341,28105,208596,65088,477937,12.1,11.9,12,"50% - 75% P.O.C.","$60000 or more"
"06069","San Benito County, California",60376,86958,20703,454,186,1754,36,36081,34.3,0.8,0.3,2.9,0.1,59.8,65.7,18135,11554,6581,63.71,36.29,1715,9839,1795,4786,3510,14625,14.8,27.3,19.4,"50% - 75% P.O.C.","$60000 or more"
"06071","San Bernardino County, California",2149031,63362,613066,169340,7783,150165,6160,1145874,28.5,7.9,0.4,7,0.3,53.3,71.5,636041,380281,255760,59.79,40.21,72735,307546,53472,202288,126207,509834,19.1,20.9,19.8,"50% - 75% P.O.C.","$60000 or more"
"06073","San Diego County, California",3316073,78980,1510756,156084,12474,385657,12747,1117517,45.6,4.7,0.4,11.6,0.4,33.7,54.4,1125286,600104,525182,53.33,46.67,68296,531808,64440,460742,132736,992550,11.4,12.3,11.8,"50% - 75% P.O.C.","$60000 or more"
"06075","San Francisco County, California",874961,112449,354423,43782,1634,298108,2934,133314,40.5,5,0.2,34.1,0.3,15.2,59.5,362354,136239,226115,37.6,62.4,14015,122224,9776,216339,23791,338563,10.3,4.3,6.6,"50% - 75% P.O.C.","$60000 or more"
"06077","San Joaquin County, California",742603,64432,236509,50030,1697,112885,4055,307463,31.8,6.7,0.2,15.2,0.5,41.4,68.2,228567,129419,99148,56.62,43.38,23363,106056,20470,78678,43833,184734,18.1,20.6,19.2,"50% - 75% P.O.C.","$60000 or more"
"06079","San Luis Obispo County, California",282165,73518,194375,4909,1510,9969,265,63534,68.9,1.7,0.5,3.5,0.1,22.5,31.1,105981,65248,40733,61.57,38.43,4891,60357,3379,37354,8270,97711,7.5,8.3,7.8,"25% - 50% P.O.C.","$60000 or more"
"06081","San Mateo County, California",767423,122641,301123,16718,1158,217287,10092,187248,39.2,2.2,0.2,28.3,1.3,24.4,60.8,263543,158543,105000,60.16,39.84,16813,141730,12004,92996,28817,234726,10.6,11.4,10.9,"50% - 75% P.O.C.","$60000 or more"
"06083","Santa Barbara County, California",444829,74624,197993,8409,1601,23882,387,201837,44.5,1.9,0.4,5.4,0.1,45.4,55.5,145856,75945,69911,52.07,47.93,10099,65846,12586,57325,22685,123171,13.3,18,15.6,"50% - 75% P.O.C.","$60000 or more"
"06085","Santa Clara County, California",1927470,124055,607903,45259,3366,699290,6229,490978,31.5,2.3,0.2,36.3,0.3,25.5,68.5,640215,361105,279110,56.4,43.6,45892,315213,33662,245448,79554,560661,12.7,12.1,12.4,"50% - 75% P.O.C.","$60000 or more"
"06087","Santa Cruz County, California",273962,82234,156897,2491,401,12504,198,91980,57.3,0.9,0.1,4.6,0.1,33.6,42.7,95818,57561,38257,60.07,39.93,5411,52150,5034,33223,10445,85373,9.4,13.2,10.9,"25% - 50% P.O.C.","$60000 or more"
"06089","Shasta County, California",179212,54667,143013,2030,3912,5745,244,17975,79.8,1.1,2.2,3.2,0.1,10,20.2,71181,45548,25633,63.99,36.01,3393,42155,2965,22668,6358,64823,7.4,11.6,8.9,"Less than 25% P.O.C.","$52000 - $60000"
"06091","Sierra County, California",3040,52148,2662,2,29,0,0,324,87.6,0.1,1,0,0,10.7,12.4,1319,994,325,75.36,24.64,28,966,41,284,69,1250,2.8,12.6,5.2,"Less than 25% P.O.C.","$52000 - $60000"
"06093","Siskiyou County, California",43468,45241,33081,684,1389,696,124,5467,76.1,1.6,3.2,1.6,0.3,12.6,23.9,19240,12509,6731,65.02,34.98,588,11921,531,6200,1119,18121,4.7,7.9,5.8,"Less than 25% P.O.C.","$44000 - $52000"
"06095","Solano County, California",441829,81472,168060,59652,1254,66247,3911,116869,38,13.5,0.3,15,0.9,26.5,62,149865,92149,57716,61.49,38.51,11408,80741,8277,49439,19685,130180,12.4,14.3,13.1,"50% - 75% P.O.C.","$60000 or more"
"06097","Sonoma County, California",499772,81018,316022,7399,2343,20082,1483,133569,63.2,1.5,0.5,4,0.3,26.7,36.8,189374,116393,72981,61.46,38.54,8920,107473,8634,64347,17554,171820,7.7,11.8,9.3,"25% - 50% P.O.C.","$60000 or more"
"06099","Stanislaus County, California",543194,60704,227369,15311,2481,29284,3625,251259,41.9,2.8,0.5,5.4,0.7,46.3,58.1,173898,100576,73322,57.84,42.16,16209,84367,13819,59503,30028,143870,16.1,18.8,17.3,"50% - 75% P.O.C.","$60000 or more"
"06101","Sutter County, California",96109,59050,44412,1684,625,14914,376,29748,46.2,1.8,0.7,15.5,0.4,31,53.8,32636,18839,13797,57.72,42.28,2706,16133,2405,11392,5111,27525,14.4,17.4,15.7,"50% - 75% P.O.C.","$52000 - $60000"
"06103","Tehama County, California",63912,44514,43679,472,890,967,15,15958,68.3,0.7,1.4,1.5,0,25,31.7,24189,15813,8376,65.37,34.63,1562,14251,914,7462,2476,21713,9.9,10.9,10.2,"25% - 50% P.O.C.","$44000 - $52000"
"06105","Trinity County, California",12700,40846,10427,127,698,210,28,927,82.1,1,5.5,1.7,0.2,7.3,17.9,5939,4093,1846,68.92,31.08,138,3955,133,1713,271,5668,3.4,7.2,4.6,"Less than 25% P.O.C.","Less than $44000"
"06107","Tulare County, California",461898,49687,131716,5785,2784,14949,624,298245,28.5,1.3,0.6,3.2,0.1,64.6,71.5,138238,78866,59372,57.05,42.95,15253,63613,13837,45535,29090,109148,19.3,23.3,21,"50% - 75% P.O.C.","$44000 - $52000"
"06109","Tuolumne County, California",54045,60108,43341,948,763,732,123,6617,80.2,1.8,1.4,1.4,0.2,12.2,19.8,22502,16039,6463,71.28,28.72,1082,14957,544,5919,1626,20876,6.7,8.4,7.2,"Less than 25% P.O.C.","$60000 or more"
"06111","Ventura County, California",847263,88131,384818,14297,2017,60710,1421,361601,45.4,1.7,0.2,7.2,0.2,42.7,54.6,271040,171174,99866,63.15,36.85,21686,149488,16452,83414,38138,232902,12.7,16.5,14.1,"50% - 75% P.O.C.","$60000 or more"
"06113","Yolo County, California",217352,70228,101452,5279,663,30155,883,68704,46.7,2.4,0.3,13.9,0.4,31.6,53.3,74296,38315,35981,51.57,48.43,3957,34358,4233,31748,8190,66106,10.3,11.8,11,"50% - 75% P.O.C.","$60000 or more"
"06115","Yuba County, California",76360,58054,42145,2554,594,5075,296,21563,55.2,3.3,0.8,6.6,0.4,28.2,44.8,26354,15948,10406,60.51,39.49,2464,13484,1691,8715,4155,22199,15.5,16.3,15.8,"25% - 50% P.O.C.","$52000 - $60000"
"08001","Adams County, Colorado",504108,71202,252170,16139,2274,19493,536,201784,50,3.2,0.5,3.9,0.1,40,50,166450,110208,56242,66.21,33.79,16638,93570,7856,48386,24494,141956,15.1,14,14.7,"50% - 75% P.O.C.","$60000 or more"
"08003","Alamosa County, Colorado",16107,37515,7672,79,308,156,59,7533,47.6,0.5,1.9,1,0.4,46.8,52.4,6162,3562,2600,57.81,42.19,672,2890,83,2517,755,5407,18.9,3.2,12.3,"50% - 75% P.O.C.","Less than $44000"
"08005","Arapahoe County, Colorado",644560,77469,388556,67640,2473,38273,1411,123960,60.3,10.5,0.4,5.9,0.2,19.2,39.7,240304,152635,87669,63.52,36.48,15832,136803,7901,79768,23733,216571,10.4,9,9.9,"25% - 50% P.O.C.","$60000 or more"
"08007","Archuleta County, Colorado",13253,52221,10116,185,150,126,15,2435,76.3,1.4,1.1,1,0.1,18.4,23.7,5858,4230,1628,72.21,27.79,213,4017,48,1580,261,5597,5,2.9,4.5,"Less than 25% P.O.C.","$52000 - $60000"
"08009","Baca County, Colorado",3561,35878,3021,34,57,0,3,390,84.8,1,1.6,0,0.1,11,15.2,1662,1180,482,71,29,90,1090,44,438,134,1528,7.6,9.1,8.1,"Less than 25% P.O.C.","Less than $44000"
"08011","Bent County, Colorado",5787,30900,3667,211,24,12,0,1855,63.4,3.6,0.4,0.2,0,32.1,36.6,1767,1053,714,59.59,40.41,83,970,141,573,224,1543,7.9,19.7,12.7,"25% - 50% P.O.C.","Less than $44000"
"08013","Boulder County, Colorado",322510,83019,250174,2699,910,15184,183,44740,77.6,0.8,0.3,4.7,0.1,13.9,22.4,127415,79273,48142,62.22,37.78,5117,74156,2940,45202,8057,119358,6.5,6.1,6.3,"Less than 25% P.O.C.","$60000 or more"
"08014","Broomfield County, Colorado",67886,96416,52116,772,231,4411,0,8404,76.8,1.1,0.3,6.5,0,12.4,23.2,27470,17917,9553,65.22,34.78,1659,16258,530,9023,2189,25281,9.3,5.5,8,"Less than 25% P.O.C.","$60000 or more"
"08015","Chaffee County, Colorado",19557,55771,16609,330,79,278,0,1963,84.9,1.7,0.4,1.4,0,10,15.1,8231,6405,1826,77.82,22.18,257,6148,94,1732,351,7880,4,5.1,4.3,"Less than 25% P.O.C.","$52000 - $60000"
"08017","Cheyenne County, Colorado",2026,53977,1576,2,0,44,4,346,77.8,0.1,0,2.2,0.2,17.1,22.2,774,553,221,71.45,28.55,56,497,42,179,98,676,10.1,19,12.7,"Less than 25% P.O.C.","$52000 - $60000"
"08019","Clear Creek County, Colorado",9495,67060,8422,103,10,91,14,662,88.7,1.1,0.1,1,0.1,7,11.3,4395,3394,1001,77.22,22.78,99,3295,24,977,123,4272,2.9,2.4,2.8,"Less than 25% P.O.C.","$60000 or more"
"08021","Conejos County, Colorado",8128,36084,3622,40,72,13,27,4263,44.6,0.5,0.9,0.2,0.3,52.4,55.4,3183,2528,655,79.42,20.58,353,2175,61,594,414,2769,14,9.3,13,"50% - 75% P.O.C.","Less than $44000"
"08023","Costilla County, Colorado",3745,30965,1250,14,15,48,0,2317,33.4,0.4,0.4,1.3,0,61.9,66.6,1746,1205,541,69.01,30.99,92,1113,82,459,174,1572,7.6,15.2,10,"50% - 75% P.O.C.","Less than $44000"
"08025","Crowley County, Colorado",5754,42135,3540,203,66,31,0,1833,61.5,3.5,1.1,0.5,0,31.9,38.5,1301,943,358,72.48,27.52,113,830,38,320,151,1150,12,10.6,11.6,"25% - 50% P.O.C.","Less than $44000"
"08027","Custer County, Colorado",4776,53119,4067,138,44,0,0,440,85.2,2.9,0.9,0,0,9.2,14.8,2214,1930,284,87.17,12.83,133,1797,13,271,146,2068,6.9,4.6,6.6,"Less than 25% P.O.C.","$52000 - $60000"
"08029","Delta County, Colorado",30565,45269,24857,177,218,264,0,4649,81.3,0.6,0.7,0.9,0,15.2,18.7,11883,8751,3132,73.64,26.36,781,7970,283,2849,1064,10819,8.9,9,9,"Less than 25% P.O.C.","$44000 - $52000"
"08031","Denver County, Colorado",705576,68592,382228,62754,3186,25745,884,210937,54.2,8.9,0.5,3.6,0.1,29.9,45.8,301501,150382,151119,49.88,50.12,12362,138020,9320,141799,21682,279819,8.2,6.2,7.2,"25% - 50% P.O.C.","$60000 or more"
"08033","Dolores County, Colorado",1857,45972,1667,0,31,0,0,131,89.8,0,1.7,0,0,7.1,10.2,759,619,140,81.55,18.45,18,601,27,113,45,714,2.9,19.3,5.9,"Less than 25% P.O.C.","$44000 - $52000"
"08035","Douglas County, Colorado",336041,119730,276316,4478,855,15909,239,29211,82.2,1.3,0.3,4.7,0.1,8.7,17.8,120709,95344,25365,78.99,21.01,11170,84174,1719,23646,12889,107820,11.7,6.8,10.7,"Less than 25% P.O.C.","$60000 or more"
"08037","Eagle County, Colorado",54681,84790,36748,615,110,357,34,16179,67.2,1.1,0.2,0.7,0.1,29.6,32.8,18171,12680,5491,69.78,30.22,806,11874,538,4953,1344,16827,6.4,9.8,7.4,"25% - 50% P.O.C.","$60000 or more"
"08039","Elbert County, Colorado",25717,99199,22764,102,159,210,10,1799,88.5,0.4,0.6,0.8,0,7,11.5,9280,8354,926,90.02,9.98,1128,7226,133,793,1261,8019,13.5,14.4,13.6,"Less than 25% P.O.C.","$60000 or more"
"08041","El Paso County, Colorado",698974,68779,483009,41880,2426,19197,2453,119545,69.1,6,0.3,2.7,0.4,17.1,30.9,257507,164677,92830,63.95,36.05,17984,146693,9154,83676,27138,230369,10.9,9.9,10.5,"25% - 50% P.O.C.","$60000 or more"
"08043","Fremont County, Colorado",47321,49409,37428,2096,551,311,5,6288,79.1,4.4,1.2,0.7,0,13.3,20.9,17136,12858,4278,75.04,24.96,963,11895,368,3910,1331,15805,7.5,8.6,7.8,"Less than 25% P.O.C.","$44000 - $52000"
"08045","Garfield County, Colorado",59055,75937,40239,286,231,532,21,16789,68.1,0.5,0.4,0.9,0,28.4,31.9,21498,14374,7124,66.86,33.14,1317,13057,1043,6081,2360,19138,9.2,14.6,11,"25% - 50% P.O.C.","$60000 or more"
"08047","Gilpin County, Colorado",6018,76429,5133,20,122,0,0,503,85.3,0.3,2,0,0,8.4,14.7,2802,2230,572,79.59,20.41,81,2149,16,556,97,2705,3.6,2.8,3.5,"Less than 25% P.O.C.","$60000 or more"
"08049","Grand County, Colorado",15303,71198,13358,157,0,213,17,1350,87.3,1,0,1.4,0.1,8.8,12.7,5884,4028,1856,68.46,31.54,86,3942,193,1663,279,5605,2.1,10.4,4.7,"Less than 25% P.O.C.","$60000 or more"
"08051","Gunnison County, Colorado",16802,56577,14607,67,153,57,36,1583,86.9,0.4,0.9,0.3,0.2,9.4,13.1,6616,4065,2551,61.44,38.56,232,3833,41,2510,273,6343,5.7,1.6,4.1,"Less than 25% P.O.C.","$52000 - $60000"
"08053","Hinsdale County, Colorado",857,56339,771,0,15,4,0,49,90,0,1.8,0.5,0,5.7,10,377,270,107,71.62,28.38,6,264,4,103,10,367,2.2,3.7,2.7,"Less than 25% P.O.C.","$52000 - $60000"
"08055","Huerfano County, Colorado",6679,38137,4083,10,38,0,0,2290,61.1,0.1,0.6,0,0,34.3,38.9,3225,2314,911,71.75,28.25,78,2236,0,911,78,3147,3.4,0,2.4,"25% - 50% P.O.C.","Less than $44000"
"08057","Jackson County, Colorado",1261,53300,1036,0,0,0,0,220,82.2,0,0,0,0,17.4,17.8,558,446,112,79.93,20.07,14,432,0,112,14,544,3.1,0,2.5,"Less than 25% P.O.C.","$52000 - $60000"
"08059","Jefferson County, Colorado",574798,82986,449045,6132,2527,15995,297,88330,78.1,1.1,0.4,2.8,0.1,15.4,21.9,232284,164186,68098,70.68,29.32,11692,152494,4546,63552,16238,216046,7.1,6.7,7,"Less than 25% P.O.C.","$60000 or more"
"08061","Kiowa County, Colorado",1489,41731,1365,6,0,0,0,72,91.7,0.4,0,0,0,4.8,8.3,638,474,164,74.29,25.71,33,441,14,150,47,591,7,8.5,7.4,"Less than 25% P.O.C.","Less than $44000"
"08063","Kit Carson County, Colorado",7447,49349,5731,186,29,14,19,1421,77,2.5,0.4,0.2,0.3,19.1,23,3004,1995,1009,66.41,33.59,139,1856,114,895,253,2751,7,11.3,8.4,"Less than 25% P.O.C.","$44000 - $52000"
"08065","Lake County, Colorado",7751,50565,4948,9,100,65,3,2508,63.8,0.1,1.3,0.8,0,32.4,36.2,3392,2320,1072,68.4,31.6,82,2238,14,1058,96,3296,3.5,1.3,2.8,"25% - 50% P.O.C.","$44000 - $52000"
"08067","La Plata County, Colorado",55617,68685,43686,245,3082,392,4,7110,78.5,0.4,5.5,0.7,0,12.8,21.5,21794,15400,6394,70.66,29.34,939,14461,391,6003,1330,20464,6.1,6.1,6.1,"Less than 25% P.O.C.","$60000 or more"
"08069","Larimer County, Colorado",344786,71881,284755,3210,1727,7433,261,39686,82.6,0.9,0.5,2.2,0.1,11.5,17.4,137021,89118,47903,65.04,34.96,7474,81644,2492,45411,9966,127055,8.4,5.2,7.3,"Less than 25% P.O.C.","$60000 or more"
"08071","Las Animas County, Colorado",14266,41817,7546,107,239,137,0,5921,52.9,0.8,1.7,1,0,41.5,47.1,6670,4494,2176,67.38,32.62,276,4218,143,2033,419,6251,6.1,6.6,6.3,"25% - 50% P.O.C.","Less than $44000"
"08073","Lincoln County, Colorado",5585,47258,3748,452,44,23,13,1259,67.1,8.1,0.8,0.4,0.2,22.5,32.9,1518,1071,447,70.55,29.45,73,998,42,405,115,1403,6.8,9.4,7.6,"25% - 50% P.O.C.","$44000 - $52000"
"08075","Logan County, Colorado",22380,53318,17054,186,169,185,210,3749,76.2,0.8,0.8,0.8,0.9,16.8,23.8,8393,5476,2917,65.24,34.76,404,5072,190,2727,594,7799,7.4,6.5,7.1,"Less than 25% P.O.C.","$52000 - $60000"
"08077","Mesa County, Colorado",151218,55379,123063,890,1009,1403,162,21988,81.4,0.6,0.7,0.9,0.1,14.5,18.6,61742,42093,19649,68.18,31.82,3703,38390,1410,18239,5113,56629,8.8,7.2,8.3,"Less than 25% P.O.C.","$52000 - $60000"
"08079","Mineral County, Colorado",824,62188,712,8,0,4,0,79,86.4,1,0,0.5,0,9.6,13.6,367,318,49,86.65,13.35,0,318,5,44,5,362,0,10.2,1.4,"Less than 25% P.O.C.","$60000 or more"
"08081","Moffat County, Colorado",13127,57229,10543,130,71,18,0,2044,80.3,1,0.5,0.1,0,15.6,19.7,5366,3475,1891,64.76,35.24,282,3193,131,1760,413,4953,8.1,6.9,7.7,"Less than 25% P.O.C.","$52000 - $60000"
"08083","Montezuma County, Colorado",26031,49470,18854,63,3137,196,17,3260,72.4,0.2,12.1,0.8,0.1,12.5,27.6,10655,7683,2972,72.11,27.89,564,7119,182,2790,746,9909,7.3,6.1,7,"25% - 50% P.O.C.","$44000 - $52000"
"08085","Montrose County, Colorado",41686,50489,31704,116,325,344,112,8596,76.1,0.3,0.8,0.8,0.3,20.6,23.9,17140,12455,4685,72.67,27.33,1240,11215,243,4442,1483,15657,10,5.2,8.7,"Less than 25% P.O.C.","$44000 - $52000"
"08087","Morgan County, Colorado",28517,53682,16595,1038,53,152,50,10306,58.2,3.6,0.2,0.5,0.2,36.1,41.8,10928,6999,3929,64.05,35.95,1089,5910,398,3531,1487,9441,15.6,10.1,13.6,"25% - 50% P.O.C.","$52000 - $60000"
"08089","Otero County, Colorado",18282,38169,9711,113,69,159,13,7658,53.1,0.6,0.4,0.9,0.1,41.9,46.9,7722,4936,2786,63.92,36.08,376,4560,316,2470,692,7030,7.6,11.3,9,"25% - 50% P.O.C.","Less than $44000"
"08091","Ouray County, Colorado",4796,66417,4590,15,16,35,3,97,95.7,0.3,0.3,0.7,0.1,2,4.3,2163,1564,599,72.31,27.69,46,1518,38,561,84,2079,2.9,6.3,3.9,"Less than 25% P.O.C.","$60000 or more"
"08093","Park County, Colorado",17867,73622,15892,26,52,100,23,1091,88.9,0.1,0.3,0.6,0.1,6.1,11.1,6931,5988,943,86.39,13.61,202,5786,64,879,266,6665,3.4,6.8,3.8,"Less than 25% P.O.C.","$60000 or more"
"08095","Phillips County, Colorado",4290,51155,3178,5,0,22,0,1027,74.1,0.1,0,0.5,0,23.9,25.9,1689,1214,475,71.88,28.12,169,1045,49,426,218,1471,13.9,10.3,12.9,"25% - 50% P.O.C.","$44000 - $52000"
"08097","Pitkin County, Colorado",17926,78935,15296,165,0,397,0,1809,85.3,0.9,0,2.2,0,10.1,14.7,7467,4851,2616,64.97,35.03,166,4685,42,2574,208,7259,3.4,1.6,2.8,"Less than 25% P.O.C.","$60000 or more"
"08099","Prowers County, Colorado",12022,41929,7080,95,47,70,0,4573,58.9,0.8,0.4,0.6,0,38,41.1,4888,3198,1690,65.43,34.57,353,2845,252,1438,605,4283,11,14.9,12.4,"25% - 50% P.O.C.","Less than $44000"
"08101","Pueblo County, Colorado",165982,46783,86404,2631,1198,1038,124,71356,52.1,1.6,0.7,0.6,0.1,43,47.9,64314,41589,22725,64.67,35.33,3395,38194,2013,20712,5408,58906,8.2,8.9,8.4,"25% - 50% P.O.C.","$44000 - $52000"
"08103","Rio Blanco County, Colorado",6384,54357,5404,30,73,8,0,655,84.6,0.5,1.1,0.1,0,10.3,15.4,2301,1629,672,70.8,29.2,156,1473,38,634,194,2107,9.6,5.7,8.4,"Less than 25% P.O.C.","$52000 - $60000"
"08105","Rio Grande County, Colorado",11305,39123,5887,62,142,8,11,5020,52.1,0.5,1.3,0.1,0.1,44.4,47.9,4823,3049,1774,63.22,36.78,301,2748,78,1696,379,4444,9.9,4.4,7.9,"25% - 50% P.O.C.","Less than $44000"
"08107","Routt County, Colorado",25072,77443,22495,232,91,285,5,1743,89.7,0.9,0.4,1.1,0,7,10.3,9603,6837,2766,71.2,28.8,345,6492,206,2560,551,9052,5,7.4,5.7,"Less than 25% P.O.C.","$60000 or more"
"08109","Saguache County, Colorado",6592,38571,3862,33,106,0,0,2394,58.6,0.5,1.6,0,0,36.3,41.4,2860,2045,815,71.5,28.5,153,1892,108,707,261,2599,7.5,13.3,9.1,"25% - 50% P.O.C.","Less than $44000"
"08111","San Juan County, Colorado",589,54625,523,0,6,0,0,50,88.8,0,1,0,0,8.5,11.2,289,181,108,62.63,37.37,12,169,3,105,15,274,6.6,2.8,5.2,"Less than 25% P.O.C.","$52000 - $60000"
"08113","San Miguel County, Colorado",8049,67038,6909,1,50,135,0,859,85.8,0,0.6,1.7,0,10.7,14.2,3552,2166,1386,60.98,39.02,85,2081,71,1315,156,3396,3.9,5.1,4.4,"Less than 25% P.O.C.","$60000 or more"
"08115","Sedgwick County, Colorado",2322,43150,1961,19,3,22,0,312,84.5,0.8,0.1,0.9,0,13.4,15.5,967,690,277,71.35,28.65,48,642,14,263,62,905,7,5.1,6.4,"Less than 25% P.O.C.","Less than $44000"
"08117","Summit County, Colorado",30649,79277,25173,313,108,179,54,4382,82.1,1,0.4,0.6,0.2,14.3,17.9,10641,6970,3671,65.5,34.5,190,6780,480,3191,670,9971,2.7,13.1,6.3,"Less than 25% P.O.C.","$60000 or more"
"08119","Teller County, Colorado",24524,66592,21764,208,95,193,7,1614,88.7,0.8,0.4,0.8,0,6.6,11.3,10248,8451,1797,82.46,17.54,425,8026,127,1670,552,9696,5,7.1,5.4,"Less than 25% P.O.C.","$60000 or more"
"08121","Washington County, Colorado",4868,50094,4232,47,6,29,1,488,86.9,1,0.1,0.6,0,10,13.1,2087,1396,691,66.89,33.11,97,1299,77,614,174,1913,6.9,11.1,8.3,"Less than 25% P.O.C.","$44000 - $52000"
"08123","Weld County, Colorado",305345,74150,200316,3475,955,4660,278,89924,65.6,1.1,0.3,1.5,0.1,29.4,34.4,104671,76321,28350,72.92,27.08,10279,66042,3877,24473,14156,90515,13.5,13.7,13.5,"25% - 50% P.O.C.","$60000 or more"
"08125","Yuma County, Colorado",10003,52022,7473,47,56,0,0,2343,74.7,0.5,0.6,0,0,23.4,25.3,4028,2695,1333,66.91,33.09,296,2399,106,1227,402,3626,11,8,10,"25% - 50% P.O.C.","$52000 - $60000"
"09001","Fairfield County, Connecticut",943926,95645,582819,100262,1103,49846,333,185996,61.7,10.6,0.1,5.3,0,19.7,38.3,340189,228111,112078,67.05,32.95,23655,204456,11269,100809,34924,305265,10.4,10.1,10.3,"25% - 50% P.O.C.","$60000 or more"
"09003","Hartford County, Connecticut",893561,75148,545642,115637,1503,47563,180,161079,61.1,12.9,0.2,5.3,0,18,38.9,350408,224640,125768,64.11,35.89,17614,207026,7896,117872,25510,324898,7.8,6.3,7.3,"25% - 50% P.O.C.","$60000 or more"
"09005","Litchfield County, Connecticut",182002,79906,160930,2694,413,3438,9,11436,88.4,1.5,0.2,1.9,0,6.3,11.6,74143,56714,17429,76.49,23.51,3948,52766,994,16435,4942,69201,7,5.7,6.7,"Less than 25% P.O.C.","$60000 or more"
"09007","Middlesex County, Connecticut",163053,85898,136807,8055,126,4953,0,10095,83.9,4.9,0.1,3,0,6.2,16.1,66971,49235,17736,73.52,26.48,3321,45914,737,16999,4058,62913,6.7,4.2,6.1,"Less than 25% P.O.C.","$60000 or more"
"09009","New Haven County, Connecticut",857513,69905,539298,107111,826,34307,125,155335,62.9,12.5,0.1,4,0,18.1,37.1,330572,204451,126121,61.85,38.15,16266,188185,7762,118359,24028,306544,8,6.2,7.3,"25% - 50% P.O.C.","$60000 or more"
"09011","New London County, Connecticut",267390,73490,202296,13883,1452,10929,84,28213,75.7,5.2,0.5,4.1,0,10.6,24.3,107827,71566,36261,66.37,33.63,5204,66362,2138,34123,7342,100485,7.3,5.9,6.8,"Less than 25% P.O.C.","$60000 or more"
"09013","Tolland County, Connecticut",151063,87069,127817,4422,69,7360,3,8332,84.6,2.9,0,4.9,0,5.5,15.4,55683,39960,15723,71.76,28.24,2730,37230,393,15330,3123,52560,6.8,2.5,5.6,"Less than 25% P.O.C.","$60000 or more"
"09015","Windham County, Connecticut",116566,66550,96404,2056,104,1593,20,13754,82.7,1.8,0.1,1.4,0,11.8,17.3,44953,31004,13949,68.97,31.03,2532,28472,606,13343,3138,41815,8.2,4.3,7,"Less than 25% P.O.C.","$60000 or more"
"10001","Kent County, Delaware",176699,60910,108834,44351,916,3515,88,12485,61.6,25.1,0.5,2,0,7.1,38.4,65796,45436,20360,69.06,30.94,4440,40996,2187,18173,6627,59169,9.8,10.7,10.1,"25% - 50% P.O.C.","$60000 or more"
"10003","New Castle County, Delaware",556165,73892,319463,136551,1201,30398,167,55302,57.4,24.6,0.2,5.5,0,9.9,42.6,205829,139747,66082,67.89,32.11,11041,128706,4511,61571,15552,190277,7.9,6.8,7.6,"25% - 50% P.O.C.","$60000 or more"
"10005","Sussex County, Delaware",224384,63162,168200,26500,708,2743,75,20577,75,11.8,0.3,1.2,0,9.2,25,91697,73597,18100,80.26,19.74,4960,68637,2302,15798,7262,84435,6.7,12.7,7.9,"25% - 50% P.O.C.","$60000 or more"
"11001","District of Columbia, District of Columbia",692683,86420,253373,314774,1418,27188,307,76191,36.6,45.4,0.2,3.9,0,11,63.4,284386,118367,166019,41.62,58.38,7147,111220,7779,158240,14926,269460,6,4.7,5.2,"50% - 75% P.O.C.","$60000 or more"
"12001","Alachua County, Florida",265443,49689,162040,52644,850,16079,157,26242,61,19.8,0.3,6.1,0.1,9.9,39,97995,53913,44082,55.02,44.98,3357,50556,1696,42386,5053,92942,6.2,3.8,5.2,"25% - 50% P.O.C.","$44000 - $52000"
"12003","Baker County, Florida",28211,63275,22873,3758,144,173,10,721,81.1,13.3,0.5,0.6,0,2.6,18.9,8693,6544,2149,75.28,24.72,845,5699,165,1984,1010,7683,12.9,7.7,11.6,"Less than 25% P.O.C.","$60000 or more"
"12005","Bay County, Florida",182161,54316,138654,19737,519,4225,184,11815,76.1,10.8,0.3,2.3,0.1,6.5,23.9,71422,46488,24934,65.09,34.91,3121,43367,1943,22991,5064,66358,6.7,7.8,7.1,"Less than 25% P.O.C.","$52000 - $60000"
"12007","Bradford County, Florida",27317,45921,20089,5506,98,166,0,1137,73.5,20.2,0.4,0.6,0,4.2,26.5,9115,6316,2799,69.29,30.71,509,5807,287,2512,796,8319,8.1,10.3,8.7,"25% - 50% P.O.C.","$44000 - $52000"
"12009","Brevard County, Florida",585507,56775,435834,54358,1562,13616,524,60266,74.4,9.3,0.3,2.3,0.1,10.3,25.6,230417,171269,59148,74.33,25.67,9566,161703,4377,54771,13943,216474,5.6,7.4,6.1,"25% - 50% P.O.C.","$52000 - $60000"
"12011","Broward County, Florida",1926205,59547,698805,530990,3304,67677,942,574289,36.3,27.6,0.2,3.5,0,29.8,63.7,690050,428682,261368,62.12,37.88,36648,392034,23276,238092,59924,630126,8.5,8.9,8.7,"50% - 75% P.O.C.","$52000 - $60000"
"12013","Calhoun County, Florida",14362,38568,11080,1865,153,16,0,826,77.1,13,1.1,0.1,0,5.8,22.9,4501,3665,836,81.43,18.57,152,3513,89,747,241,4260,4.1,10.6,5.4,"Less than 25% P.O.C.","Less than $44000"
"12015","Charlotte County, Florida",181067,51499,151938,9690,506,2342,135,13189,83.9,5.4,0.3,1.3,0.1,7.3,16.1,76891,61262,15629,79.67,20.33,1594,59668,1084,14545,2678,74213,2.6,6.9,3.5,"Less than 25% P.O.C.","$44000 - $52000"
"12017","Citrus County, Florida",145169,44237,127751,4071,341,2477,40,8263,88,2.8,0.2,1.7,0,5.7,12,63681,52144,11537,81.88,18.12,1864,50280,1012,10525,2876,60805,3.6,8.8,4.5,"Less than 25% P.O.C.","$44000 - $52000"
"12019","Clay County, Florida",211405,65740,153772,21738,240,5841,102,21002,72.7,10.3,0.1,2.8,0,9.9,27.3,74333,55746,18587,74.99,25.01,6018,49728,2475,16112,8493,65840,10.8,13.3,11.4,"25% - 50% P.O.C.","$60000 or more"
"12021","Collier County, Florida",371453,69653,233370,24802,616,4793,0,103692,62.8,6.7,0.2,1.3,0,27.9,37.2,142979,104852,38127,73.33,26.67,6527,98325,3997,34130,10524,132455,6.2,10.5,7.4,"25% - 50% P.O.C.","$60000 or more"
"12023","Columbia County, Florida",69968,46494,50569,12449,148,744,0,4407,72.3,17.8,0.2,1.1,0,6.3,27.7,25133,17953,7180,71.43,28.57,1291,16662,708,6472,1999,23134,7.2,9.9,8,"25% - 50% P.O.C.","$44000 - $52000"
"12027","DeSoto County, Florida",36903,35438,20207,4617,31,83,41,11649,54.8,12.5,0.1,0.2,0.1,31.6,45.2,12072,8418,3654,69.73,30.27,876,7542,608,3046,1484,10588,10.4,16.6,12.3,"25% - 50% P.O.C.","Less than $44000"
"12029","Dixie County, Florida",16589,39828,13948,1453,2,38,6,674,84.1,8.8,0,0.2,0,4.1,15.9,6504,5111,1393,78.58,21.42,492,4619,64,1329,556,5948,9.6,4.6,8.5,"Less than 25% P.O.C.","Less than $44000"
"12031","Duval County, Florida",936186,55807,495030,272958,1968,42761,550,91153,52.9,29.2,0.2,4.6,0.1,9.7,47.1,359544,203977,155567,56.73,43.27,14462,189515,12304,143263,26766,332778,7.1,7.9,7.4,"25% - 50% P.O.C.","$52000 - $60000"
"12033","Escambia County, Florida",313491,50915,201691,68173,1199,9005,395,17808,64.3,21.7,0.4,2.9,0.1,5.7,35.7,120104,74504,45600,62.03,37.97,4262,70242,2670,42930,6932,113172,5.7,5.9,5.8,"25% - 50% P.O.C.","$44000 - $52000"
"12035","Flagler County, Florida",109801,54514,81979,10885,302,2817,104,11448,74.7,9.9,0.3,2.6,0.1,10.4,25.3,42121,32008,10113,75.99,24.01,1881,30127,889,9224,2770,39351,5.9,8.8,6.6,"25% - 50% P.O.C.","$52000 - $60000"
"12037","Franklin County, Florida",11811,46643,9107,1627,0,41,43,644,77.1,13.8,0,0.3,0.4,5.5,22.9,4444,3317,1127,74.64,25.36,197,3120,101,1026,298,4146,5.9,9,6.7,"Less than 25% P.O.C.","$44000 - $52000"
"12039","Gadsden County, Florida",45945,41401,14849,25626,48,81,17,4778,32.3,55.8,0.1,0.2,0,10.4,67.7,17149,12509,4640,72.94,27.06,1288,11221,332,4308,1620,15529,10.3,7.2,9.4,"50% - 75% P.O.C.","Less than $44000"
"12041","Gilchrist County, Florida",17953,43640,15479,1019,5,40,2,1049,86.2,5.7,0,0.2,0,5.8,13.8,6464,5368,1096,83.04,16.96,372,4996,247,849,619,5845,6.9,22.5,9.6,"Less than 25% P.O.C.","Less than $44000"
"12043","Glades County, Florida",13516,40977,8075,1751,519,108,0,2873,59.7,13,3.8,0.8,0,21.3,40.3,4700,3743,957,79.64,20.36,165,3578,140,817,305,4395,4.4,14.6,6.5,"25% - 50% P.O.C.","Less than $44000"
"12045","Gulf County, Florida",15576,47712,11886,2582,61,85,0,687,76.3,16.6,0.4,0.5,0,4.4,23.7,5757,4271,1486,74.19,25.81,231,4040,131,1355,362,5395,5.4,8.8,6.3,"Less than 25% P.O.C.","$44000 - $52000"
"12047","Hamilton County, Florida",14326,38569,7838,4820,86,20,0,1351,54.7,33.6,0.6,0.1,0,9.4,45.3,4381,2976,1405,67.93,32.07,214,2762,250,1155,464,3917,7.2,17.8,10.6,"25% - 50% P.O.C.","Less than $44000"
"12049","Hardee County, Florida",27131,38682,12767,2019,15,234,40,11828,47.1,7.4,0.1,0.9,0.1,43.6,52.9,7863,5105,2758,64.92,35.08,735,4370,478,2280,1213,6650,14.4,17.3,15.4,"50% - 75% P.O.C.","Less than $44000"
"12051","Hendry County, Florida",40732,40820,13050,4485,559,355,0,21888,32,11,1.4,0.9,0,53.7,68,12527,8185,4342,65.34,34.66,1396,6789,647,3695,2043,10484,17.1,14.9,16.3,"50% - 75% P.O.C.","Less than $44000"
"12053","Hernando County, Florida",186313,48812,144477,9112,557,2205,47,25178,77.5,4.9,0.3,1.2,0,13.5,22.5,75348,58814,16534,78.06,21.94,3896,54918,1783,14751,5679,69669,6.6,10.8,7.5,"Less than 25% P.O.C.","$44000 - $52000"
"12055","Highlands County, Florida",103437,40942,69397,9722,184,1451,0,20775,67.1,9.4,0.2,1.4,0,20.1,32.9,41740,31436,10304,75.31,24.69,1305,30131,1111,9193,2416,39324,4.2,10.8,5.8,"25% - 50% P.O.C.","Less than $44000"
"12057","Hillsborough County, Florida",1422278,58884,693874,221699,2354,56909,869,407736,48.8,15.6,0.2,4,0.1,28.7,51.2,526175,308217,217958,58.58,41.42,25493,282724,17660,200298,43153,483022,8.3,8.1,8.2,"50% - 75% P.O.C.","$52000 - $60000"
"12059","Holmes County, Florida",19432,39102,16841,1335,266,115,60,546,86.7,6.9,1.4,0.6,0.3,2.8,13.3,7092,5418,1674,76.4,23.6,412,5006,234,1440,646,6446,7.6,14,9.1,"Less than 25% P.O.C.","Less than $44000"
"12061","Indian River County, Florida",153989,54740,115945,13587,171,2005,57,19063,75.3,8.8,0.1,1.3,0,12.4,24.7,58612,46440,12172,79.23,20.77,1805,44635,717,11455,2522,56090,3.9,5.9,4.3,"Less than 25% P.O.C.","$52000 - $60000"
"12063","Jackson County, Florida",47945,39872,31317,12708,314,141,76,2328,65.3,26.5,0.7,0.3,0.2,4.9,34.7,17149,11975,5174,69.83,30.17,725,11250,425,4749,1150,15999,6.1,8.2,6.7,"25% - 50% P.O.C.","Less than $44000"
"12065","Jefferson County, Florida",14161,47240,8442,4865,71,39,0,584,59.6,34.4,0.5,0.3,0,4.1,40.4,5770,4443,1327,77,23,251,4192,70,1257,321,5449,5.6,5.3,5.6,"25% - 50% P.O.C.","$44000 - $52000"
"12067","Lafayette County, Florida",8637,50165,5718,1373,13,0,28,1360,66.2,15.9,0.2,0,0.3,15.7,33.8,2175,1835,340,84.37,15.63,317,1518,36,304,353,1822,17.3,10.6,16.2,"25% - 50% P.O.C.","$44000 - $52000"
"12069","Lake County, Florida",345867,54513,241079,35154,1353,6825,110,53938,69.7,10.2,0.4,2,0,15.6,30.3,134317,100010,34307,74.46,25.54,6526,93484,3673,30634,10199,124118,6.5,10.7,7.6,"25% - 50% P.O.C.","$52000 - $60000"
"12071","Lee County, Florida",737468,57832,495480,60077,1247,11801,278,157681,67.2,8.1,0.2,1.6,0,21.4,32.8,275965,199589,76376,72.32,27.68,10431,189158,7891,68485,18322,257643,5.2,10.3,6.6,"25% - 50% P.O.C.","$52000 - $60000"
"12073","Leon County, Florida",289770,53106,163785,88586,499,10127,65,18570,56.5,30.6,0.2,3.5,0,6.4,43.5,113658,60192,53466,52.96,47.04,3494,56698,2725,50741,6219,107439,5.8,5.1,5.5,"25% - 50% P.O.C.","$52000 - $60000"
"12075","Levy County, Florida",40403,37326,32222,3501,38,349,0,3388,79.8,8.7,0.1,0.9,0,8.4,20.2,16374,12717,3657,77.67,22.33,762,11955,350,3307,1112,15262,6,9.6,6.8,"Less than 25% P.O.C.","Less than $44000"
"12077","Liberty County, Florida",8345,38015,6363,1302,103,20,0,392,76.2,15.6,1.2,0.2,0,4.7,23.8,2459,1855,604,75.44,24.56,159,1696,56,548,215,2244,8.6,9.3,8.7,"Less than 25% P.O.C.","Less than $44000"
"12079","Madison County, Florida",18460,37037,10047,7053,63,163,5,1018,54.4,38.2,0.3,0.9,0,5.5,45.6,6778,4986,1792,73.56,26.44,308,4678,210,1582,518,6260,6.2,11.7,7.6,"25% - 50% P.O.C.","Less than $44000"
"12081","Manatee County, Florida",384213,59009,273486,32690,758,7874,121,63038,71.2,8.5,0.2,2,0,16.4,28.8,145356,105902,39454,72.86,27.14,5127,100775,3927,35527,9054,136302,4.8,10,6.2,"25% - 50% P.O.C.","$52000 - $60000"
"12083","Marion County, Florida",353526,45371,248645,44135,919,5058,129,46675,70.3,12.5,0.3,1.4,0,13.2,29.7,139172,104381,34791,75,25,6063,98318,3517,31274,9580,129592,5.8,10.1,6.9,"25% - 50% P.O.C.","$44000 - $52000"
"12085","Martin County, Florida",159065,61133,124491,8437,362,2176,119,21667,78.3,5.3,0.2,1.4,0.1,13.6,21.7,64528,50361,14167,78.05,21.95,2031,48330,1027,13140,3058,61470,4,7.2,4.7,"Less than 25% P.O.C.","$60000 or more"
"12086","Miami-Dade County, Florida",2699428,51347,356026,426336,2272,40851,605,1848925,13.2,15.8,0.1,1.5,0,68.5,86.8,883372,451932,431440,51.16,48.84,54680,397252,38567,392873,93247,790125,12.1,8.9,10.6,"75% or more P.O.C.","$44000 - $52000"
"12087","Monroe County, Florida",75798,70033,50226,5081,55,982,111,18439,66.3,6.7,0.1,1.3,0.1,24.3,33.7,32068,19078,12990,59.49,40.51,714,18364,953,12037,1667,30401,3.7,7.3,5.2,"25% - 50% P.O.C.","$60000 or more"
"12089","Nassau County, Florida",83098,69943,72351,4959,398,851,0,3579,87.1,6,0.5,1,0,4.3,12.9,32603,26081,6522,80,20,2138,23943,696,5826,2834,29769,8.2,10.7,8.7,"Less than 25% P.O.C.","$60000 or more"
"12091","Okaloosa County, Florida",203794,63412,150037,19338,389,6021,180,18873,73.6,9.5,0.2,3,0.1,9.3,26.4,77962,49459,28503,63.44,36.56,3856,45603,2118,26385,5974,71988,7.8,7.4,7.7,"25% - 50% P.O.C.","$60000 or more"
"12093","Okeechobee County, Florida",41144,41760,26004,3163,188,395,106,10497,63.2,7.7,0.5,1,0.3,25.5,36.8,13904,10033,3871,72.16,27.84,905,9128,390,3481,1295,12609,9,10.1,9.3,"25% - 50% P.O.C.","Less than $44000"
"12095","Orange County, Florida",1349746,58254,540187,267070,1687,68454,837,427125,40,19.8,0.1,5.1,0.1,31.6,60,461705,255793,205912,55.4,44.6,27001,228792,19501,186411,46502,415203,10.6,9.5,10.1,"50% - 75% P.O.C.","$52000 - $60000"
"12097","Osceola County, Florida",351955,52279,111501,32629,761,9274,244,190439,31.7,9.3,0.2,2.6,0.1,54.1,68.3,103141,63554,39587,61.62,38.38,7903,55651,5514,34073,13417,89724,12.4,13.9,13,"50% - 75% P.O.C.","$52000 - $60000"
"12099","Palm Beach County, Florida",1465027,63299,799422,266676,1201,38838,356,327940,54.6,18.2,0.1,2.7,0,22.4,45.4,554095,381611,172484,68.87,31.13,24058,357553,15495,156989,39553,514542,6.3,9,7.1,"25% - 50% P.O.C.","$60000 or more"
"12101","Pasco County, Florida",524602,52828,391110,28225,1591,13322,299,79843,74.6,5.4,0.3,2.5,0.1,15.2,25.4,204198,147225,56973,72.1,27.9,9768,137457,5402,51571,15170,189028,6.6,9.5,7.4,"25% - 50% P.O.C.","$52000 - $60000"
"12103","Pinellas County, Florida",964666,54090,713717,95936,2134,32166,829,93587,74,9.9,0.2,3.3,0.1,9.7,26,407546,273128,134418,67.02,32.98,11323,261805,6353,128065,17676,389870,4.1,4.7,4.3,"25% - 50% P.O.C.","$52000 - $60000"
"12105","Polk County, Florida",686218,50584,404039,100748,1911,11883,230,154628,58.9,14.7,0.3,1.7,0,22.5,41.1,235283,162088,73195,68.89,31.11,13792,148296,9576,63619,23368,211915,8.5,13.1,9.9,"25% - 50% P.O.C.","$44000 - $52000"
"12107","Putnam County, Florida",73252,37670,52366,11730,283,449,5,7319,71.5,16,0.4,0.6,0,10,28.5,28943,20472,8471,70.73,29.27,1373,19099,837,7634,2210,26733,6.7,9.9,7.6,"25% - 50% P.O.C.","Less than $44000"
"12109","St. Johns County, Florida",244674,82252,202180,12739,698,6461,192,17012,82.6,5.2,0.3,2.6,0.1,7,17.4,88773,71338,17435,80.36,19.64,5195,66143,1322,16113,6517,82256,7.3,7.6,7.3,"Less than 25% P.O.C.","$60000 or more"
"12111","St. Lucie County, Florida",312947,52322,179397,60482,952,6269,237,59355,57.3,19.3,0.3,2,0.1,19,42.7,114761,84050,30711,73.24,26.76,5732,78318,3491,27220,9223,105538,6.8,11.4,8,"25% - 50% P.O.C.","$52000 - $60000"
"12113","Santa Rosa County, Florida",174755,67949,143940,10595,748,3386,278,9730,82.4,6.1,0.4,1.9,0.2,5.6,17.6,63514,48252,15262,75.97,24.03,4182,44070,1698,13564,5880,57634,8.7,11.1,9.3,"Less than 25% P.O.C.","$60000 or more"
"12115","Sarasota County, Florida",419496,62236,348391,18124,467,6968,68,38526,83,4.3,0.1,1.7,0,9.2,17,182842,137028,45814,74.94,25.06,5218,131810,2492,43322,7710,175132,3.8,5.4,4.2,"Less than 25% P.O.C.","$60000 or more"
"12117","Seminole County, Florida",461402,66768,278310,50588,820,20689,195,98697,60.3,11,0.2,4.5,0,21.4,39.7,173668,112228,61440,64.62,35.38,8549,103679,3963,57477,12512,161156,7.6,6.5,7.2,"25% - 50% P.O.C.","$60000 or more"
"12119","Sumter County, Florida",125044,57226,106246,8443,408,1047,100,7178,85,6.8,0.3,0.8,0.1,5.7,15,56230,50446,5784,89.71,10.29,764,49682,253,5531,1017,55213,1.5,4.4,1.8,"Less than 25% P.O.C.","$52000 - $60000"
"12121","Suwannee County, Florida",44046,47839,33259,5605,41,47,0,4103,75.5,12.7,0.1,0.1,0,9.3,24.5,14888,11062,3826,74.3,25.7,921,10141,453,3373,1374,13514,8.3,11.8,9.2,"Less than 25% P.O.C.","$44000 - $52000"
"12123","Taylor County, Florida",21870,40306,15759,4345,69,74,0,1410,72.1,19.9,0.3,0.3,0,6.4,27.9,7405,5732,1673,77.41,22.59,515,5217,97,1576,612,6793,9,5.8,8.3,"25% - 50% P.O.C.","Less than $44000"
"12125","Union County, Florida",15303,44270,10637,3327,116,93,0,862,69.5,21.7,0.8,0.6,0,5.6,30.5,3960,2616,1344,66.06,33.94,333,2283,66,1278,399,3561,12.7,4.9,10.1,"25% - 50% P.O.C.","$44000 - $52000"
"12127","Volusia County, Florida",536487,49494,384521,55902,1554,9367,158,74629,71.7,10.4,0.3,1.7,0,13.9,28.3,216495,152225,64270,70.31,29.69,8564,143661,4508,59762,13072,203423,5.6,7,6,"25% - 50% P.O.C.","$44000 - $52000"
"12129","Wakulla County, Florida",32321,61410,25737,4833,66,167,0,1205,79.6,15,0.2,0.5,0,3.7,20.4,11200,9185,2015,82.01,17.99,597,8588,256,1759,853,10347,6.5,12.7,7.6,"Less than 25% P.O.C.","$60000 or more"
"12131","Walton County, Florida",68262,58093,57524,3148,298,692,0,4252,84.3,4.6,0.4,1,0,6.2,15.7,27420,20467,6953,74.64,25.36,1526,18941,723,6230,2249,25171,7.5,10.4,8.2,"Less than 25% P.O.C.","$52000 - $60000"
"12133","Washington County, Florida",24764,37022,19170,3706,334,167,103,915,77.4,15,1.3,0.7,0.4,3.7,22.6,8827,6861,1966,77.73,22.27,644,6217,177,1789,821,8006,9.4,9,9.3,"Less than 25% P.O.C.","Less than $44000"
"13001","Appling County, Georgia",18440,40304,12745,3555,94,74,0,1830,69.1,19.3,0.5,0.4,0,9.9,30.9,6656,5086,1570,76.41,23.59,361,4725,159,1411,520,6136,7.1,10.1,7.8,"25% - 50% P.O.C.","Less than $44000"
"13003","Atkinson County, Georgia",8239,37197,4657,1434,81,0,0,2050,56.5,17.4,1,0,0,24.9,43.5,2880,2112,768,73.33,26.67,249,1863,134,634,383,2497,11.8,17.4,13.3,"25% - 50% P.O.C.","Less than $44000"
"13005","Bacon County, Georgia",11201,37519,8234,1701,0,19,26,925,73.5,15.2,0,0.2,0.2,8.3,26.5,3874,2805,1069,72.41,27.59,261,2544,68,1001,329,3545,9.3,6.4,8.5,"25% - 50% P.O.C.","Less than $44000"
"13007","Baker County, Georgia",3132,32917,1586,1241,1,96,21,172,50.6,39.6,0,3.1,0.7,5.5,49.4,1425,930,495,65.26,34.74,26,904,27,468,53,1372,2.8,5.5,3.7,"25% - 50% P.O.C.","Less than $44000"
"13009","Baldwin County, Georgia",45111,43672,23631,18995,106,791,0,1019,52.4,42.1,0.2,1.8,0,2.3,47.6,16191,9468,6723,58.48,41.52,757,8711,406,6317,1163,15028,8,6,7.2,"25% - 50% P.O.C.","Less than $44000"
"13011","Banks County, Georgia",18708,47811,16425,486,100,210,0,1289,87.8,2.6,0.5,1.1,0,6.9,12.2,6740,5082,1658,75.4,24.6,566,4516,212,1446,778,5962,11.1,12.8,11.5,"Less than 25% P.O.C.","$44000 - $52000"
"13013","Barrow County, Georgia",78991,62345,56356,9238,121,2890,5,8613,71.3,11.7,0.2,3.7,0,10.9,28.7,26305,19895,6410,75.63,24.37,2654,17241,1161,5249,3815,22490,13.3,18.1,14.5,"25% - 50% P.O.C.","$60000 or more"
"13015","Bartow County, Georgia",104919,57423,81287,10825,196,933,1,9052,77.5,10.3,0.2,0.9,0,8.6,22.5,37627,24946,12681,66.3,33.7,2458,22488,1969,10712,4427,33200,9.9,15.5,11.8,"Less than 25% P.O.C.","$52000 - $60000"
"13017","Ben Hill County, Georgia",17033,32229,9511,6236,0,117,0,1041,55.8,36.6,0,0.7,0,6.1,44.2,6443,3791,2652,58.84,41.16,265,3526,86,2566,351,6092,7,3.2,5.4,"25% - 50% P.O.C.","Less than $44000"
"13019","Berrien County, Georgia",19152,40415,15671,2030,18,212,0,971,81.8,10.6,0.1,1.1,0,5.1,18.2,7367,4731,2636,64.22,35.78,425,4306,392,2244,817,6550,9,14.9,11.1,"Less than 25% P.O.C.","Less than $44000"
"13021","Bibb County, Georgia",153200,41334,58712,83170,252,3094,75,4986,38.3,54.3,0.2,2,0,3.3,61.7,58116,30409,27707,52.32,47.68,2127,28282,2316,25391,4443,53673,7,8.4,7.6,"50% - 75% P.O.C.","Less than $44000"
"13023","Bleckley County, Georgia",12807,48174,8781,3500,12,31,0,379,68.6,27.3,0.1,0.2,0,3,31.4,4176,3104,1072,74.33,25.67,216,2888,65,1007,281,3895,7,6.1,6.7,"25% - 50% P.O.C.","$44000 - $52000"
"13025","Brantley County, Georgia",18756,38857,17285,619,40,201,0,419,92.2,3.3,0.2,1.1,0,2.2,7.8,6823,5482,1341,80.35,19.65,549,4933,101,1240,650,6173,10,7.5,9.5,"Less than 25% P.O.C.","Less than $44000"
"13027","Brooks County, Georgia",15590,38285,8804,5587,0,66,8,920,56.5,35.8,0,0.4,0.1,5.9,43.5,6335,4685,1650,73.95,26.05,410,4275,213,1437,623,5712,8.8,12.9,9.8,"25% - 50% P.O.C.","Less than $44000"
"13029","Bryan County, Georgia",37063,72624,27076,5133,161,522,0,2624,73.1,13.8,0.4,1.4,0,7.1,26.9,13048,9151,3897,70.13,29.87,865,8286,611,3286,1476,11572,9.5,15.7,11.3,"25% - 50% P.O.C.","$60000 or more"
"13031","Bulloch County, Georgia",76120,45550,48323,21133,250,966,199,3034,63.5,27.8,0.3,1.3,0.3,4,36.5,27375,14758,12617,53.91,46.09,1639,13119,1152,11465,2791,24584,11.1,9.1,10.2,"25% - 50% P.O.C.","$44000 - $52000"
"13033","Burke County, Georgia",22520,44151,10645,10824,0,71,0,728,47.3,48.1,0,0.3,0,3.2,52.7,8193,5800,2393,70.79,29.21,561,5239,320,2073,881,7312,9.7,13.4,10.8,"50% - 75% P.O.C.","$44000 - $52000"
"13035","Butts County, Georgia",24090,43471,15907,6966,1,101,0,782,66,28.9,0,0.4,0,3.2,34,8279,5782,2497,69.84,30.16,493,5289,440,2057,933,7346,8.5,17.6,11.3,"25% - 50% P.O.C.","Less than $44000"
"13037","Calhoun County, Georgia",6365,34167,2076,3839,0,37,0,302,32.6,60.3,0,0.6,0,4.7,67.4,1736,1139,597,65.61,34.39,90,1049,102,495,192,1544,7.9,17.1,11.1,"50% - 75% P.O.C.","Less than $44000"
"13039","Camden County, Georgia",53231,56951,37155,9921,278,1020,59,3583,69.8,18.6,0.5,1.9,0.1,6.7,30.2,19338,12095,7243,62.55,37.45,788,11307,841,6402,1629,17709,6.5,11.6,8.4,"25% - 50% P.O.C.","$52000 - $60000"
"13043","Candler County, Georgia",10812,33736,6556,2717,0,21,0,1273,60.6,25.1,0,0.2,0,11.8,39.4,4013,2312,1701,57.61,42.39,347,1965,182,1519,529,3484,15,10.7,13.2,"25% - 50% P.O.C.","Less than $44000"
"13045","Carroll County, Georgia",117183,53737,82322,22305,507,897,102,8075,70.3,19,0.4,0.8,0.1,6.9,29.7,41903,28032,13871,66.9,33.1,3291,24741,1246,12625,4537,37366,11.7,9,10.8,"25% - 50% P.O.C.","$52000 - $60000"
"13047","Catoosa County, Georgia",66700,56235,60661,1369,240,878,32,2012,90.9,2.1,0.4,1.3,0,3,9.1,24778,18339,6439,74.01,25.99,1548,16791,596,5843,2144,22634,8.4,9.3,8.7,"Less than 25% P.O.C.","$52000 - $60000"
"13049","Charlton County, Georgia",13040,41961,7973,3375,232,96,0,1091,61.1,25.9,1.8,0.7,0,8.4,38.9,3675,2622,1053,71.35,28.65,245,2377,38,1015,283,3392,9.3,3.6,7.7,"25% - 50% P.O.C.","Less than $44000"
"13051","Chatham County, Georgia",288496,56842,139916,113750,672,7357,324,18472,48.5,39.4,0.2,2.6,0.1,6.4,51.5,108568,59401,49167,54.71,45.29,4110,55291,3226,45941,7336,101232,6.9,6.6,6.8,"50% - 75% P.O.C.","$52000 - $60000"
"13053","Chattahoochee County, Georgia",10560,47096,6080,2099,30,305,15,1675,57.6,19.9,0.3,2.9,0.1,15.9,42.4,2570,632,1938,24.59,75.41,46,586,313,1625,359,2211,7.3,16.2,14,"25% - 50% P.O.C.","$44000 - $52000"
"13055","Chattooga County, Georgia",24812,36807,20536,2556,35,42,0,1278,82.8,10.3,0.1,0.2,0,5.2,17.2,9260,6315,2945,68.2,31.8,565,5750,372,2573,937,8323,8.9,12.6,10.1,"Less than 25% P.O.C.","Less than $44000"
"13057","Cherokee County, Georgia",247515,82740,194846,16601,108,4465,80,26044,78.7,6.7,0,1.8,0,10.5,21.3,88137,67649,20488,76.75,23.25,6790,60859,2279,18209,9069,79068,10,11.1,10.3,"Less than 25% P.O.C.","$60000 or more"
"13059","Clarke County, Georgia",126176,38623,69418,34907,66,4880,51,13626,55,27.7,0.1,3.9,0,10.8,45,48844,19062,29782,39.03,60.97,1125,17937,1606,28176,2731,46113,5.9,5.4,5.6,"25% - 50% P.O.C.","Less than $44000"
"13061","Clay County, Georgia",2951,22325,1045,1841,0,30,0,11,35.4,62.4,0,1,0,0.4,64.6,1242,906,336,72.95,27.05,80,826,7,329,87,1155,8.8,2.1,7,"50% - 75% P.O.C.","Less than $44000"
"13063","Clayton County, Georgia",283538,47864,28559,193754,445,14517,183,37475,10.1,68.3,0.2,5.1,0.1,13.2,89.9,94279,46678,47601,49.51,50.49,6232,40446,6654,40947,12886,81393,13.4,14,13.7,"75% or more P.O.C.","$44000 - $52000"
"13065","Clinch County, Georgia",6686,27658,4354,1900,2,0,0,280,65.1,28.4,0,0,0,4.2,34.9,2477,1855,622,74.89,25.11,165,1690,89,533,254,2223,8.9,14.3,10.3,"25% - 50% P.O.C.","Less than $44000"
"13067","Cobb County, Georgia",751218,77932,389948,200733,1093,39700,264,97481,51.9,26.7,0.1,5.3,0,13,48.1,280374,180919,99455,64.53,35.47,17811,163108,8788,90667,26599,253775,9.8,8.8,9.5,"25% - 50% P.O.C.","$60000 or more"
"13069","Coffee County, Georgia",43021,40859,25010,12230,16,338,0,5034,58.1,28.4,0,0.8,0,11.7,41.9,14438,9112,5326,63.11,36.89,688,8424,559,4767,1247,13191,7.6,10.5,8.6,"25% - 50% P.O.C.","Less than $44000"
"13071","Colquitt County, Georgia",45486,36435,25418,10535,201,378,5,8737,55.9,23.2,0.4,0.8,0,19.2,44.1,15505,9763,5742,62.97,37.03,806,8957,704,5038,1510,13995,8.3,12.3,9.7,"25% - 50% P.O.C.","Less than $44000"
"13073","Columbia County, Georgia",150705,82339,103491,24995,208,5660,0,10094,68.7,16.6,0.1,3.8,0,6.7,31.3,47215,37541,9674,79.51,20.49,3926,33615,1153,8521,5079,42136,10.5,11.9,10.8,"25% - 50% P.O.C.","$60000 or more"
"13075","Cook County, Georgia",17177,41854,11116,4624,50,124,0,993,64.7,26.9,0.3,0.7,0,5.8,35.3,6217,4127,2090,66.38,33.62,251,3876,210,1880,461,5756,6.1,10,7.4,"25% - 50% P.O.C.","Less than $44000"
"13077","Coweta County, Georgia",143260,75913,101717,25318,343,2961,26,10040,71,17.7,0.2,2.1,0,7,29,52035,37896,14139,72.83,27.17,3526,34370,1575,12564,5101,46934,9.3,11.1,9.8,"25% - 50% P.O.C.","$60000 or more"
"13079","Crawford County, Georgia",12325,46283,9030,2708,12,19,0,407,73.3,22,0.1,0.2,0,3.3,26.7,4510,3515,995,77.94,22.06,215,3300,57,938,272,4238,6.1,5.7,6,"25% - 50% P.O.C.","$44000 - $52000"
"13081","Crisp County, Georgia",22713,36042,11330,10344,0,43,26,782,49.9,45.5,0,0.2,0.1,3.4,50.1,8585,4678,3907,54.49,45.51,429,4249,409,3498,838,7747,9.2,10.5,9.8,"50% - 75% P.O.C.","Less than $44000"
"13083","Dade County, Georgia",16197,42581,15116,106,0,173,6,370,93.3,0.7,0,1.1,0,2.3,6.7,6195,4429,1766,71.49,28.51,199,4230,137,1629,336,5859,4.5,7.8,5.4,"Less than 25% P.O.C.","Less than $44000"
"13085","Dawson County, Georgia",24536,66281,22598,258,23,144,0,1153,92.1,1.1,0.1,0.6,0,4.7,7.9,9041,7371,1670,81.53,18.47,663,6708,130,1540,793,8248,9,7.8,8.8,"Less than 25% P.O.C.","$60000 or more"
"13087","Decatur County, Georgia",26682,41481,13397,11219,30,66,0,1623,50.2,42,0.1,0.2,0,6.1,49.8,10084,5797,4287,57.49,42.51,428,5369,691,3596,1119,8965,7.4,16.1,11.1,"25% - 50% P.O.C.","Less than $44000"
"13089","DeKalb County, Georgia",749323,62399,218260,400411,1550,45232,315,63947,29.1,53.4,0.2,6,0,8.5,70.9,282436,154322,128114,54.64,45.36,11717,142605,11261,116853,22978,259458,7.6,8.8,8.1,"50% - 75% P.O.C.","$60000 or more"
"13091","Dodge County, Georgia",20829,39302,13484,5987,2,69,0,736,64.7,28.7,0,0.3,0,3.5,35.3,7628,5174,2454,67.83,32.17,349,4825,231,2223,580,7048,6.7,9.4,7.6,"25% - 50% P.O.C.","Less than $44000"
"13093","Dooly County, Georgia",13736,37340,5850,6741,6,2,0,953,42.6,49.1,0,0,0,6.9,57.4,5020,3493,1527,69.58,30.42,297,3196,269,1258,566,4454,8.5,17.6,11.3,"50% - 75% P.O.C.","Less than $44000"
"13095","Dougherty County, Georgia",89703,39584,22628,62245,175,862,6,2565,25.2,69.4,0.2,1,0,2.9,74.8,34087,15679,18408,46,54,806,14873,1465,16943,2271,31816,5.1,8,6.7,"50% - 75% P.O.C.","Less than $44000"
"13097","Douglas County, Georgia",143316,63835,58078,65820,97,2278,34,13848,40.5,45.9,0.1,1.6,0,9.7,59.5,49187,31638,17549,64.32,35.68,3910,27728,1704,15845,5614,43573,12.4,9.7,11.4,"50% - 75% P.O.C.","$60000 or more"
"13099","Early County, Georgia",10312,30640,4663,5383,30,57,0,84,45.2,52.2,0.3,0.6,0,0.8,54.8,4074,2606,1468,63.97,36.03,173,2433,153,1315,326,3748,6.6,10.4,8,"50% - 75% P.O.C.","Less than $44000"
"13101","Echols County, Georgia",3981,39494,2640,79,87,0,0,1086,66.3,2,2.2,0,0,27.3,33.7,1561,1058,503,67.78,32.22,74,984,70,433,144,1417,7,13.9,9.2,"25% - 50% P.O.C.","Less than $44000"
"13103","Effingham County, Georgia",60477,66822,47339,7956,106,534,29,2686,78.3,13.2,0.2,0.9,0,4.4,21.7,21172,16076,5096,75.93,24.07,1410,14666,575,4521,1985,19187,8.8,11.3,9.4,"Less than 25% P.O.C.","$60000 or more"
"13105","Elbert County, Georgia",19166,38678,12173,5674,0,83,0,1093,63.5,29.6,0,0.4,0,5.7,36.5,7559,5460,2099,72.23,27.77,476,4984,113,1986,589,6970,8.7,5.4,7.8,"25% - 50% P.O.C.","Less than $44000"
"13107","Emanuel County, Georgia",22533,37453,13355,7632,54,33,0,1015,59.3,33.9,0.2,0.1,0,4.5,40.7,8387,5354,3033,63.84,36.16,390,4964,219,2814,609,7778,7.3,7.2,7.3,"25% - 50% P.O.C.","Less than $44000"
"13109","Evans County, Georgia",10687,42607,6012,3168,15,97,0,1253,56.3,29.6,0.1,0.9,0,11.7,43.7,4020,2734,1286,68.01,31.99,187,2547,217,1069,404,3616,6.8,16.9,10,"25% - 50% P.O.C.","Less than $44000"
"13111","Fannin County, Georgia",25395,47997,24098,63,27,94,27,600,94.9,0.2,0.1,0.4,0.1,2.4,5.1,10408,8226,2182,79.04,20.96,637,7589,96,2086,733,9675,7.7,4.4,7,"Less than 25% P.O.C.","$44000 - $52000"
"13113","Fayette County, Georgia",112303,90145,69850,25282,99,4940,147,8115,62.2,22.5,0.1,4.4,0.1,7.2,37.8,40285,33015,7270,81.95,18.05,3764,29251,585,6685,4349,35936,11.4,8,10.8,"25% - 50% P.O.C.","$60000 or more"
"13115","Floyd County, Georgia",97369,48336,68902,13507,148,1233,0,10776,70.8,13.9,0.2,1.3,0,11.1,29.2,35679,21780,13899,61.04,38.96,2316,19464,1323,12576,3639,32040,10.6,9.5,10.2,"25% - 50% P.O.C.","$44000 - $52000"
"13117","Forsyth County, Georgia",228383,107218,163760,7577,388,29494,37,21686,71.7,3.3,0.2,12.9,0,9.5,28.3,76753,64504,12249,84.04,15.96,7674,56830,1871,10378,9545,67208,11.9,15.3,12.4,"25% - 50% P.O.C.","$60000 or more"
"13119","Franklin County, Georgia",22766,42488,19001,2119,19,213,0,1044,83.5,9.3,0.1,0.9,0,4.6,16.5,8460,5620,2840,66.43,33.57,480,5140,342,2498,822,7638,8.5,12,9.7,"Less than 25% P.O.C.","Less than $44000"
"13121","Fulton County, Georgia",1036200,69673,410771,451908,1666,72831,200,74764,39.6,43.6,0.2,7,0,7.2,60.4,410576,211868,198708,51.6,48.4,15442,196426,11413,187295,26855,383721,7.3,5.7,6.5,"50% - 75% P.O.C.","$60000 or more"
"13123","Gilmer County, Georgia",30414,52625,26116,126,81,137,3,3523,85.9,0.4,0.3,0.5,0,11.6,14.1,12021,8950,3071,74.45,25.55,734,8216,515,2556,1249,10772,8.2,16.8,10.4,"Less than 25% P.O.C.","$52000 - $60000"
"13125","Glascock County, Georgia",2996,45000,2618,306,9,0,1,37,87.4,10.2,0.3,0,0,1.2,12.6,1108,828,280,74.73,25.27,79,749,46,234,125,983,9.5,16.4,11.3,"Less than 25% P.O.C.","$44000 - $52000"
"13127","Glynn County, Georgia",84470,52977,53687,22022,293,1069,98,5589,63.6,26.1,0.3,1.3,0.1,6.6,36.4,34119,21340,12779,62.55,37.45,1716,19624,1072,11707,2788,31331,8,8.4,8.2,"25% - 50% P.O.C.","$52000 - $60000"
"13129","Gordon County, Georgia",57202,45865,44341,2137,5,584,38,9060,77.5,3.7,0,1,0.1,15.8,22.5,20561,13394,7167,65.14,34.86,970,12424,1276,5891,2246,18315,7.2,17.8,10.9,"Less than 25% P.O.C.","$44000 - $52000"
"13131","Grady County, Georgia",24828,43531,14393,7167,127,139,0,2846,58,28.9,0.5,0.6,0,11.5,42,9136,5872,3264,64.27,35.73,284,5588,499,2765,783,8353,4.8,15.3,8.6,"25% - 50% P.O.C.","Less than $44000"
"13133","Greene County, Georgia",17349,52129,9979,6073,0,198,4,1049,57.5,35,0,1.1,0,6,42.5,7132,5324,1808,74.65,25.35,242,5082,84,1724,326,6806,4.5,4.6,4.6,"25% - 50% P.O.C.","$52000 - $60000"
"13135","Gwinnett County, Georgia",915046,71026,341205,247238,1597,106156,216,193683,37.3,27,0.2,11.6,0,21.2,62.7,293330,194378,98952,66.27,33.73,28309,166069,13881,85071,42190,251140,14.6,14,14.4,"50% - 75% P.O.C.","$60000 or more"
"13137","Habersham County, Georgia",44626,50563,34493,1424,38,864,79,6599,77.3,3.2,0.1,1.9,0.2,14.8,22.7,15139,11848,3291,78.26,21.74,1200,10648,500,2791,1700,13439,10.1,15.2,11.2,"Less than 25% P.O.C.","$44000 - $52000"
"13139","Hall County, Georgia",198667,62984,120829,14059,304,3538,12,56409,60.8,7.1,0.2,1.8,0,28.4,39.2,64352,44697,19655,69.46,30.54,5741,38956,3806,15849,9547,54805,12.8,19.4,14.8,"25% - 50% P.O.C.","$60000 or more"
"13141","Hancock County, Georgia",8515,31860,2070,6227,0,31,12,142,24.3,73.1,0,0.4,0.1,1.7,75.7,2974,2099,875,70.58,29.42,52,2047,63,812,115,2859,2.5,7.2,3.9,"75% or more P.O.C.","Less than $44000"
"13143","Haralson County, Georgia",29227,48550,26560,1481,20,120,0,498,90.9,5.1,0.1,0.4,0,1.7,9.1,11259,7699,3560,68.38,31.62,797,6902,204,3356,1001,10258,10.4,5.7,8.9,"Less than 25% P.O.C.","$44000 - $52000"
"13145","Harris County, Georgia",34105,76319,26219,5486,24,350,4,1213,76.9,16.1,0.1,1,0,3.6,23.1,12156,10654,1502,87.64,12.36,1222,9432,256,1246,1478,10678,11.5,17,12.2,"Less than 25% P.O.C.","$60000 or more"
"13147","Hart County, Georgia",25773,43204,19280,4958,6,239,0,940,74.8,19.2,0,0.9,0,3.6,25.2,9853,7370,2483,74.8,25.2,592,6778,300,2183,892,8961,8,12.1,9.1,"25% - 50% P.O.C.","Less than $44000"
"13149","Heard County, Georgia",11736,51358,9948,1024,3,62,11,322,84.8,8.7,0,0.5,0.1,2.7,15.2,4502,3201,1301,71.1,28.9,353,2848,80,1221,433,4069,11,6.1,9.6,"Less than 25% P.O.C.","$44000 - $52000"
"13151","Henry County, Georgia",225356,71288,97850,97870,140,7420,0,15374,43.4,43.4,0.1,3.3,0,6.8,56.6,75984,53461,22523,70.36,29.64,6254,47207,2627,19896,8881,67103,11.7,11.7,11.7,"50% - 75% P.O.C.","$60000 or more"
"13153","Houston County, Georgia",153507,61723,86349,47122,480,4950,11,10026,56.3,30.7,0.3,3.2,0,6.5,43.7,57056,36289,20767,63.6,36.4,3165,33124,1938,18829,5103,51953,8.7,9.3,8.9,"25% - 50% P.O.C.","$60000 or more"
"13155","Irwin County, Georgia",9320,37736,6224,2637,11,38,0,357,66.8,28.3,0.1,0.4,0,3.8,33.2,3329,2450,879,73.6,26.4,109,2341,76,803,185,3144,4.4,8.6,5.6,"25% - 50% P.O.C.","Less than $44000"
"13157","Jackson County, Georgia",67885,65385,55223,4501,34,1205,41,5198,81.3,6.6,0.1,1.8,0.1,7.7,18.7,23166,18041,5125,77.88,22.12,2221,15820,515,4610,2736,20430,12.3,10,11.8,"Less than 25% P.O.C.","$60000 or more"
"13159","Jasper County, Georgia",13916,51250,10327,2838,8,41,0,546,74.2,20.4,0.1,0.3,0,3.9,25.8,5171,3973,1198,76.83,23.17,405,3568,170,1028,575,4596,10.2,14.2,11.1,"25% - 50% P.O.C.","$44000 - $52000"
"13161","Jeff Davis County, Georgia",15036,36669,10653,2467,0,34,0,1822,70.8,16.4,0,0.2,0,12.1,29.2,5279,3437,1842,65.11,34.89,409,3028,166,1676,575,4704,11.9,9,10.9,"25% - 50% P.O.C.","Less than $44000"
"13163","Jefferson County, Georgia",15618,33944,6561,8294,23,49,0,600,42,53.1,0.1,0.3,0,3.8,58,5664,3579,2085,63.19,36.81,182,3397,213,1872,395,5269,5.1,10.2,7,"50% - 75% P.O.C.","Less than $44000"
"13165","Jenkins County, Georgia",8793,27375,4807,3070,22,98,0,718,54.7,34.9,0.3,1.1,0,8.2,45.3,3443,2459,984,71.42,28.58,77,2382,102,882,179,3264,3.1,10.4,5.2,"25% - 50% P.O.C.","Less than $44000"
"13167","Johnson County, Georgia",9691,42446,6047,3213,0,21,0,239,62.4,33.2,0,0.2,0,2.5,37.6,3393,2282,1111,67.26,32.74,227,2055,97,1014,324,3069,9.9,8.7,9.5,"25% - 50% P.O.C.","Less than $44000"
"13169","Jones County, Georgia",28579,56020,20415,7019,50,213,0,476,71.4,24.6,0.2,0.7,0,1.7,28.6,10701,8587,2114,80.24,19.76,723,7864,322,1792,1045,9656,8.4,15.2,9.8,"25% - 50% P.O.C.","$52000 - $60000"
"13171","Lamar County, Georgia",18672,44846,12167,5489,26,90,0,458,65.2,29.4,0.1,0.5,0,2.5,34.8,6494,4497,1997,69.25,30.75,356,4141,153,1844,509,5985,7.9,7.7,7.8,"25% - 50% P.O.C.","$44000 - $52000"
"13173","Lanier County, Georgia",10380,40986,7122,2532,17,21,0,594,68.6,24.4,0.2,0.2,0,5.7,31.4,3714,2392,1322,64.4,35.6,318,2074,154,1168,472,3242,13.3,11.6,12.7,"25% - 50% P.O.C.","Less than $44000"
"13175","Laurens County, Georgia",47405,39120,27124,17646,37,538,8,1286,57.2,37.2,0.1,1.1,0,2.7,42.8,17142,11005,6137,64.2,35.8,792,10213,702,5435,1494,15648,7.2,11.4,8.7,"25% - 50% P.O.C.","Less than $44000"
"13177","Lee County, Georgia",29502,69280,21134,6108,20,723,35,878,71.6,20.7,0.1,2.5,0.1,3,28.4,10226,7440,2786,72.76,27.24,564,6876,366,2420,930,9296,7.6,13.1,9.1,"25% - 50% P.O.C.","$60000 or more"
"13179","Liberty County, Georgia",61349,48007,23847,24602,262,1205,307,7737,38.9,40.1,0.4,2,0.5,12.6,61.1,23485,10739,12746,45.73,54.27,964,9775,1553,11193,2517,20968,9,12.2,10.7,"50% - 75% P.O.C.","$44000 - $52000"
"13181","Lincoln County, Georgia",7856,39742,5199,2433,4,0,2,143,66.2,31,0.1,0,0,1.8,33.8,3475,2606,869,74.99,25.01,200,2406,52,817,252,3223,7.7,6,7.3,"25% - 50% P.O.C.","Less than $44000"
"13183","Long County, Georgia",18692,54605,10821,4639,31,182,82,2108,57.9,24.8,0.2,1,0.4,11.3,42.1,5695,3935,1760,69.1,30.9,452,3483,231,1529,683,5012,11.5,13.1,12,"25% - 50% P.O.C.","$52000 - $60000"
"13185","Lowndes County, Georgia",115364,42441,62042,41948,383,2011,77,6535,53.8,36.4,0.3,1.7,0.1,5.7,46.2,41282,21597,19685,52.32,47.68,1727,19870,1498,18187,3225,38057,8,7.6,7.8,"25% - 50% P.O.C.","Less than $44000"
"13187","Lumpkin County, Georgia",32402,51790,29344,660,71,267,46,1569,90.6,2,0.2,0.8,0.1,4.8,9.4,11570,8176,3394,70.67,29.33,624,7552,281,3113,905,10665,7.6,8.3,7.8,"Less than 25% P.O.C.","$44000 - $52000"
"13189","McDuffie County, Georgia",21455,43468,11483,8561,0,95,264,656,53.5,39.9,0,0.4,1.2,3.1,46.5,8153,4995,3158,61.27,38.73,206,4789,201,2957,407,7746,4.1,6.4,5,"25% - 50% P.O.C.","Less than $44000"
"13191","McIntosh County, Georgia",14174,49504,8802,5020,14,189,18,40,62.1,35.4,0.1,1.3,0.1,0.3,37.9,6042,4819,1223,79.76,20.24,308,4511,125,1098,433,5609,6.4,10.2,7.2,"25% - 50% P.O.C.","$44000 - $52000"
"13193","Macon County, Georgia",13305,32161,4302,8178,0,52,1,571,32.3,61.5,0,0.4,0,4.3,67.7,4696,3005,1691,63.99,36.01,105,2900,87,1604,192,4504,3.5,5.1,4.1,"50% - 75% P.O.C.","Less than $44000"
"13195","Madison County, Georgia",29218,52500,23914,3108,100,112,0,1595,81.8,10.6,0.3,0.4,0,5.5,18.2,10744,8027,2717,74.71,25.29,592,7435,340,2377,932,9812,7.4,12.5,8.7,"Less than 25% P.O.C.","$52000 - $60000"
"13197","Marion County, Georgia",8432,44643,4994,2568,14,77,52,614,59.2,30.5,0.2,0.9,0.6,7.3,40.8,3408,2672,736,78.4,21.6,238,2434,47,689,285,3123,8.9,6.4,8.4,"25% - 50% P.O.C.","$44000 - $52000"
"13199","Meriwether County, Georgia",21106,37121,11893,8388,19,52,0,464,56.3,39.7,0.1,0.2,0,2.2,43.7,8051,5514,2537,68.49,31.51,543,4971,180,2357,723,7328,9.8,7.1,9,"25% - 50% P.O.C.","Less than $44000"
"13201","Miller County, Georgia",5787,44542,3934,1754,33,0,17,25,68,30.3,0.6,0,0.3,0.4,32,2333,1528,805,65.5,34.5,101,1427,64,741,165,2168,6.6,8,7.1,"25% - 50% P.O.C.","$44000 - $52000"
"13205","Mitchell County, Georgia",22244,38116,10199,10312,63,44,12,1019,45.9,46.4,0.3,0.2,0.1,4.6,54.1,7982,4964,3018,62.19,37.81,233,4731,468,2550,701,7281,4.7,15.5,8.8,"50% - 75% P.O.C.","Less than $44000"
"13207","Monroe County, Georgia",27171,54754,19674,6304,41,247,0,631,72.4,23.2,0.2,0.9,0,2.3,27.6,9760,7725,2035,79.15,20.85,705,7020,196,1839,901,8859,9.1,9.6,9.2,"25% - 50% P.O.C.","$52000 - $60000"
"13209","Montgomery County, Georgia",9058,41996,5918,2332,0,16,0,597,65.3,25.7,0,0.2,0,6.6,34.7,3097,2142,955,69.16,30.84,133,2009,72,883,205,2892,6.2,7.5,6.6,"25% - 50% P.O.C.","Less than $44000"
"13211","Morgan County, Georgia",18507,66178,13316,4218,24,13,0,595,72,22.8,0.1,0.1,0,3.2,28,6942,5084,1858,73.24,26.76,354,4730,162,1696,516,6426,7,8.7,7.4,"25% - 50% P.O.C.","$60000 or more"
"13213","Murray County, Georgia",39724,48033,32789,413,53,135,0,5974,82.5,1,0.1,0.3,0,15,17.5,14385,10015,4370,69.62,30.38,943,9072,832,3538,1775,12610,9.4,19,12.3,"Less than 25% P.O.C.","$44000 - $52000"
"13215","Muscogee County, Georgia",195739,46408,78974,89275,790,4812,276,14903,40.3,45.6,0.4,2.5,0.1,7.6,59.7,72759,34936,37823,48.02,51.98,2401,32535,3302,34521,5703,67056,6.9,8.7,7.8,"50% - 75% P.O.C.","$44000 - $52000"
"13217","Newton County, Georgia",108079,56316,50197,47914,170,1147,88,6035,46.4,44.3,0.2,1.1,0.1,5.6,53.6,37018,25034,11984,67.63,32.37,3428,21606,1371,10613,4799,32219,13.7,11.4,13,"50% - 75% P.O.C.","$52000 - $60000"
"13219","Oconee County, Georgia",38132,90751,32083,1993,27,1403,25,2017,84.1,5.2,0.1,3.7,0.1,5.3,15.9,13423,11132,2291,82.93,17.07,1571,9561,190,2101,1761,11662,14.1,8.3,13.1,"Less than 25% P.O.C.","$60000 or more"
"13221","Oglethorpe County, Georgia",14931,47120,11294,2624,6,32,0,682,75.6,17.6,0,0.2,0,4.6,24.4,5651,4362,1289,77.19,22.81,302,4060,106,1183,408,5243,6.9,8.2,7.2,"Less than 25% P.O.C.","$44000 - $52000"
"13223","Paulding County, Georgia",159825,68370,113468,29547,381,1383,58,10125,71,18.5,0.2,0.9,0,6.3,29,53299,40386,12913,75.77,24.23,4889,35497,2258,10655,7147,46152,12.1,17.5,13.4,"25% - 50% P.O.C.","$60000 or more"
"13225","Peach County, Georgia",27145,46636,12424,12124,21,274,26,2092,45.8,44.7,0.1,1,0.1,7.7,54.2,10136,6628,3508,65.39,34.61,768,5860,160,3348,928,9208,11.6,4.6,9.2,"50% - 75% P.O.C.","$44000 - $52000"
"13227","Pickens County, Georgia",31387,67631,27188,324,288,134,16,970,86.6,1,0.9,0.4,0.1,3.1,13.4,11868,9008,2860,75.9,24.1,837,8171,329,2531,1166,10702,9.3,11.5,9.8,"Less than 25% P.O.C.","$60000 or more"
"13229","Pierce County, Georgia",19250,42804,16176,1799,79,0,0,973,84,9.3,0.4,0,0,5.1,16,7048,5461,1587,77.48,22.52,404,5057,218,1369,622,6426,7.4,13.7,8.8,"Less than 25% P.O.C.","Less than $44000"
"13231","Pike County, Georgia",18327,64878,15928,1639,0,93,0,298,86.9,8.9,0,0.5,0,1.6,13.1,6143,5158,985,83.97,16.03,487,4671,76,909,563,5580,9.4,7.7,9.2,"Less than 25% P.O.C.","$60000 or more"
"13233","Polk County, Georgia",41908,44891,30176,5002,0,154,7,5482,72,11.9,0,0.4,0,13.1,28,15038,9712,5326,64.58,35.42,1342,8370,623,4703,1965,13073,13.8,11.7,13.1,"25% - 50% P.O.C.","$44000 - $52000"
"13235","Pulaski County, Georgia",11216,45148,6437,4228,14,30,0,351,57.4,37.7,0.1,0.3,0,3.1,42.6,3687,2370,1317,64.28,35.72,117,2253,179,1138,296,3391,4.9,13.6,8,"25% - 50% P.O.C.","$44000 - $52000"
"13237","Putnam County, Georgia",21691,51606,14248,5684,0,109,0,1378,65.7,26.2,0,0.5,0,6.4,34.3,8937,6883,2054,77.02,22.98,332,6551,181,1873,513,8424,4.8,8.8,5.7,"25% - 50% P.O.C.","$44000 - $52000"
"13239","Quitman County, Georgia",2289,26667,848,1188,0,168,4,17,37,51.9,0,7.3,0.2,0.7,63,842,591,251,70.19,29.81,47,544,14,237,61,781,8,5.6,7.2,"50% - 75% P.O.C.","Less than $44000"
"13241","Rabun County, Georgia",16645,42500,14598,316,55,188,0,1334,87.7,1.9,0.3,1.1,0,8,12.3,6662,4947,1715,74.26,25.74,321,4626,148,1567,469,6193,6.5,8.6,7,"Less than 25% P.O.C.","Less than $44000"
"13243","Randolph County, Georgia",6973,31699,2416,4351,0,0,0,98,34.6,62.4,0,0,0,1.4,65.4,2553,1460,1093,57.19,42.81,82,1378,109,984,191,2362,5.6,10,7.5,"50% - 75% P.O.C.","Less than $44000"
"13245","Richmond County, Georgia",201852,42728,69706,112183,485,3602,426,9937,34.5,55.6,0.2,1.8,0.2,4.9,65.5,71400,37587,33813,52.64,47.36,2329,35258,3416,30397,5745,65655,6.2,10.1,8,"50% - 75% P.O.C.","Less than $44000"
"13247","Rockdale County, Georgia",89717,60189,28460,48243,81,1775,182,9173,31.7,53.8,0.1,2,0.2,10.2,68.3,31076,20622,10454,66.36,33.64,2739,17883,1512,8942,4251,26825,13.3,14.5,13.7,"50% - 75% P.O.C.","$60000 or more"
"13249","Schley County, Georgia",5221,44448,3550,1312,0,0,0,340,68,25.1,0,0,0,6.5,32,1864,1333,531,71.51,28.49,68,1265,56,475,124,1740,5.1,10.5,6.7,"25% - 50% P.O.C.","$44000 - $52000"
"13251","Screven County, Georgia",13989,39842,7618,5824,24,104,0,303,54.5,41.6,0.2,0.7,0,2.2,45.5,5098,3746,1352,73.48,26.52,348,3398,150,1202,498,4600,9.3,11.1,9.8,"25% - 50% P.O.C.","Less than $44000"
"13253","Seminole County, Georgia",8321,33357,5118,2737,0,65,0,267,61.5,32.9,0,0.8,0,3.2,38.5,3363,2195,1168,65.27,34.73,89,2106,120,1048,209,3154,4.1,10.3,6.2,"25% - 50% P.O.C.","Less than $44000"
"13255","Spalding County, Georgia",65306,47111,38215,22261,260,642,0,2978,58.5,34.1,0.4,1,0,4.6,41.5,24336,15204,9132,62.48,37.52,1299,13905,907,8225,2206,22130,8.5,9.9,9.1,"25% - 50% P.O.C.","$44000 - $52000"
"13257","Stephens County, Georgia",25750,47164,21205,3064,45,172,2,896,82.3,11.9,0.2,0.7,0,3.5,17.7,9543,6661,2882,69.8,30.2,705,5956,194,2688,899,8644,10.6,6.7,9.4,"Less than 25% P.O.C.","$44000 - $52000"
"13259","Stewart County, Georgia",6293,29732,1471,3299,9,203,0,1180,23.4,52.4,0.1,3.2,0,18.8,76.6,1816,1335,481,73.51,26.49,75,1260,19,462,94,1722,5.6,4,5.2,"75% or more P.O.C.","Less than $44000"
"13261","Sumter County, Georgia",30064,36681,11839,15670,0,410,0,1711,39.4,52.1,0,1.4,0,5.7,60.6,11510,6389,5121,55.51,44.49,510,5879,423,4698,933,10577,8,8.3,8.1,"50% - 75% P.O.C.","Less than $44000"
"13263","Talbot County, Georgia",6321,38549,2572,3649,2,35,0,38,40.7,57.7,0,0.6,0,0.6,59.3,2809,2219,590,79,21,136,2083,66,524,202,2607,6.1,11.2,7.2,"50% - 75% P.O.C.","Less than $44000"
"13265","Taliaferro County, Georgia",1611,37446,528,1000,0,12,0,64,32.8,62.1,0,0.7,0,4,67.2,593,409,184,68.97,31.03,33,376,10,174,43,550,8.1,5.4,7.3,"50% - 75% P.O.C.","Less than $44000"
"13267","Tattnall County, Georgia",25382,40730,14635,7404,56,48,5,2914,57.7,29.2,0.2,0.2,0,11.5,42.3,8241,5534,2707,67.15,32.85,686,4848,215,2492,901,7340,12.4,7.9,10.9,"25% - 50% P.O.C.","Less than $44000"
"13269","Taylor County, Georgia",8116,33832,4652,3081,0,149,0,213,57.3,38,0,1.8,0,2.6,42.7,3473,2449,1024,70.52,29.48,174,2275,106,918,280,3193,7.1,10.4,8.1,"25% - 50% P.O.C.","Less than $44000"
"13271","Telfair County, Georgia",16035,32405,7848,6173,5,4,0,1829,48.9,38.5,0,0,0,11.4,51.1,4668,3127,1541,66.99,33.01,132,2995,86,1455,218,4450,4.2,5.6,4.7,"50% - 75% P.O.C.","Less than $44000"
"13273","Terrell County, Georgia",8737,34768,3111,5077,0,271,0,246,35.6,58.1,0,3.1,0,2.8,64.4,3399,1870,1529,55.02,44.98,100,1770,309,1220,409,2990,5.3,20.2,12,"50% - 75% P.O.C.","Less than $44000"
"13275","Thomas County, Georgia",44630,43740,25712,16172,60,56,23,1657,57.6,36.2,0.1,0.1,0.1,3.7,42.4,17595,10774,6821,61.23,38.77,878,9896,608,6213,1486,16109,8.1,8.9,8.4,"25% - 50% P.O.C.","Less than $44000"
"13277","Tift County, Georgia",40541,45639,22644,11959,105,547,0,4776,55.9,29.5,0.3,1.3,0,11.8,44.1,15144,9087,6057,60,40,779,8308,649,5408,1428,13716,8.6,10.7,9.4,"25% - 50% P.O.C.","$44000 - $52000"
"13279","Toombs County, Georgia",26972,40175,16247,6891,3,245,0,3153,60.2,25.5,0,0.9,0,11.7,39.8,10030,6072,3958,60.54,39.46,591,5481,401,3557,992,9038,9.7,10.1,9.9,"25% - 50% P.O.C.","Less than $44000"
"13281","Towns County, Georgia",11617,48219,10930,147,41,60,0,318,94.1,1.3,0.4,0.5,0,2.7,5.9,4898,3833,1065,78.26,21.74,147,3686,92,973,239,4659,3.8,8.6,4.9,"Less than 25% P.O.C.","$44000 - $52000"
"13283","Treutlen County, Georgia",6795,32241,4896,1792,0,0,0,90,72.1,26.4,0,0,0,1.3,27.9,2490,1666,824,66.91,33.09,200,1466,73,751,273,2217,12,8.9,11,"25% - 50% P.O.C.","Less than $44000"
"13285","Troup County, Georgia",69919,45649,39347,25245,132,1514,0,2572,56.3,36.1,0.2,2.2,0,3.7,43.7,24928,14304,10624,57.38,42.62,1407,12897,799,9825,2206,22722,9.8,7.5,8.8,"25% - 50% P.O.C.","$44000 - $52000"
"13287","Turner County, Georgia",7943,37039,4269,3200,0,61,0,379,53.7,40.3,0,0.8,0,4.8,46.3,3169,2191,978,69.14,30.86,140,2051,279,699,419,2750,6.4,28.5,13.2,"25% - 50% P.O.C.","Less than $44000"
"13289","Twiggs County, Georgia",8229,34879,4530,3526,0,17,0,59,55,42.8,0,0.2,0,0.7,45,3044,2462,582,80.88,19.12,128,2334,42,540,170,2874,5.2,7.2,5.6,"25% - 50% P.O.C.","Less than $44000"
"13291","Union County, Georgia",23288,50021,21859,173,128,72,0,771,93.9,0.7,0.5,0.3,0,3.3,6.1,9743,7524,2219,77.22,22.78,326,7198,326,1893,652,9091,4.3,14.7,6.7,"Less than 25% P.O.C.","$44000 - $52000"
"13293","Upson County, Georgia",26236,37640,17634,7120,167,119,199,606,67.2,27.1,0.6,0.5,0.8,2.3,32.8,10154,6861,3293,67.57,32.43,406,6455,237,3056,643,9511,5.9,7.2,6.3,"25% - 50% P.O.C.","Less than $44000"
"13295","Walker County, Georgia",69039,46157,62742,2840,111,523,9,1531,90.9,4.1,0.2,0.8,0,2.2,9.1,25975,18660,7315,71.84,28.16,1725,16935,709,6606,2434,23541,9.2,9.7,9.4,"Less than 25% P.O.C.","$44000 - $52000"
"13297","Walton County, Georgia",91442,61599,68250,16120,107,1248,25,4014,74.6,17.6,0.1,1.4,0,4.4,25.4,31670,23517,8153,74.26,25.74,2649,20868,1106,7047,3755,27915,11.3,13.6,11.9,"25% - 50% P.O.C.","$60000 or more"
"13299","Ware County, Georgia",35593,36869,22547,10622,200,374,23,1461,63.3,29.8,0.6,1.1,0.1,4.1,36.7,13823,8791,5032,63.6,36.4,746,8045,494,4538,1240,12583,8.5,9.8,9,"25% - 50% P.O.C.","Less than $44000"
"13301","Warren County, Georgia",5297,37203,1986,3237,0,32,0,25,37.5,61.1,0,0.6,0,0.5,62.5,2244,1494,750,66.58,33.42,23,1471,145,605,168,2076,1.5,19.3,7.5,"50% - 75% P.O.C.","Less than $44000"
"13303","Washington County, Georgia",20436,38068,8691,10755,10,137,0,506,42.5,52.6,0,0.7,0,2.5,57.5,7503,4997,2506,66.6,33.4,357,4640,307,2199,664,6839,7.1,12.3,8.8,"50% - 75% P.O.C.","Less than $44000"
"13305","Wayne County, Georgia",29788,45483,21200,6030,21,182,0,1866,71.2,20.2,0.1,0.6,0,6.3,28.8,10400,6605,3795,63.51,36.49,733,5872,458,3337,1191,9209,11.1,12.1,11.5,"25% - 50% P.O.C.","$44000 - $52000"
"13307","Webster County, Georgia",2610,37297,1353,971,9,0,0,228,51.8,37.2,0.3,0,0,8.7,48.2,1140,957,183,83.95,16.05,96,861,0,183,96,1044,10,0,8.4,"25% - 50% P.O.C.","Less than $44000"
"13309","Wheeler County, Georgia",7928,30192,4454,3440,0,0,0,11,56.2,43.4,0,0,0,0.1,43.8,1862,1178,684,63.27,36.73,146,1032,55,629,201,1661,12.4,8,10.8,"25% - 50% P.O.C.","Less than $44000"
"13311","White County, Georgia",29489,52493,27218,430,127,171,1,958,92.3,1.5,0.4,0.6,0,3.2,7.7,11695,8872,2823,75.86,24.14,420,8452,210,2613,630,11065,4.7,7.4,5.4,"Less than 25% P.O.C.","$52000 - $60000"
"13313","Whitfield County, Georgia",104237,48623,60904,3918,261,1506,4,36599,58.4,3.8,0.3,1.4,0,35.1,41.6,35629,23006,12623,64.57,35.43,3215,19791,2187,10436,5402,30227,14,17.3,15.2,"25% - 50% P.O.C.","$44000 - $52000"
"13315","Wilcox County, Georgia",8824,36964,5163,3131,34,0,0,411,58.5,35.5,0.4,0,0,4.7,41.5,2575,1960,615,76.12,23.88,138,1822,74,541,212,2363,7,12,8.2,"25% - 50% P.O.C.","Less than $44000"
"13317","Wilkes County, Georgia",9844,37838,5014,4193,0,38,0,498,50.9,42.6,0,0.4,0,5.1,49.1,3979,2684,1295,67.45,32.55,92,2592,164,1131,256,3723,3.4,12.7,6.4,"25% - 50% P.O.C.","Less than $44000"
"13319","Wilkinson County, Georgia",9010,38996,5109,3509,11,0,5,259,56.7,38.9,0.1,0,0.1,2.9,43.3,3185,2396,789,75.23,24.77,149,2247,92,697,241,2944,6.2,11.7,7.6,"25% - 50% P.O.C.","Less than $44000"
"13321","Worth County, Georgia",20494,45398,13793,5741,77,162,6,451,67.3,28,0.4,0.8,0,2.2,32.7,8002,5236,2766,65.43,34.57,235,5001,316,2450,551,7451,4.5,11.4,6.9,"25% - 50% P.O.C.","$44000 - $52000"
"15001","Hawaii County, Hawaii",199459,62409,60447,1159,358,43561,22092,25386,30.3,0.6,0.2,21.8,11.1,12.7,69.7,69453,47047,22406,67.74,32.26,4823,42224,3396,19010,8219,61234,10.3,15.2,11.8,"50% - 75% P.O.C.","$60000 or more"
"15003","Honolulu County, Hawaii",984821,85857,180889,22158,1314,410954,87966,96985,18.4,2.2,0.1,41.7,8.9,9.8,81.6,312795,175751,137044,56.19,43.81,28825,146926,18332,118712,47157,265638,16.4,13.4,15.1,"75% or more P.O.C.","$60000 or more"
"15005","Kalawao County, Hawaii",66,69375,15,2,1,14,18,2,22.7,3,1.5,21.2,27.3,3,77.3,39,0,39,0,100,0,0,0,39,0,39,NA,0,0,"75% or more P.O.C.","$60000 or more"
"15007","Kauai County, Hawaii",71769,83554,21189,290,261,22298,5767,7933,29.5,0.4,0.4,31.1,8,11.1,70.5,22658,14320,8338,63.2,36.8,1942,12378,1181,7157,3123,19535,13.6,14.2,13.8,"50% - 75% P.O.C.","$60000 or more"
"15009","Maui County, Hawaii",165979,80948,50182,768,307,47782,17267,18812,30.2,0.5,0.2,28.8,10.4,11.3,69.8,54479,33259,21220,61.05,38.95,5033,28226,2752,18468,7785,46694,15.1,13,14.3,"50% - 75% P.O.C.","$60000 or more"
"16001","Ada County, Idaho",456849,66293,386787,5868,1769,11298,625,37469,84.7,1.3,0.4,2.5,0.1,8.2,15.3,173353,120145,53208,69.31,30.69,11724,108421,4107,49101,15831,157522,9.8,7.7,9.1,"Less than 25% P.O.C.","$60000 or more"
"16003","Adams County, Idaho",4097,48856,3774,16,72,0,8,147,92.1,0.4,1.8,0,0.2,3.6,7.9,1757,1411,346,80.31,19.69,81,1330,31,315,112,1645,5.7,9,6.4,"Less than 25% P.O.C.","$44000 - $52000"
"16005","Bannock County, Idaho",85765,51734,71764,595,2185,1500,134,7381,83.7,0.7,2.5,1.7,0.2,8.6,16.3,31155,21042,10113,67.54,32.46,3007,18035,900,9213,3907,27248,14.3,8.9,12.5,"Less than 25% P.O.C.","$44000 - $52000"
"16007","Bear Lake County, Idaho",6000,54167,5575,53,24,40,0,257,92.9,0.9,0.4,0.7,0,4.3,7.1,2424,1856,568,76.57,23.43,316,1540,51,517,367,2057,17,9,15.1,"Less than 25% P.O.C.","$52000 - $60000"
"16009","Benewah County, Idaho",9138,47556,7734,6,728,29,71,332,84.6,0.1,8,0.3,0.8,3.6,15.4,3418,2505,913,73.29,26.71,179,2326,116,797,295,3123,7.1,12.7,8.6,"Less than 25% P.O.C.","$44000 - $52000"
"16011","Bingham County, Idaho",45839,55472,33799,130,2350,263,24,8247,73.7,0.3,5.1,0.6,0.1,18,26.3,14989,11510,3479,76.79,23.21,2312,9198,589,2890,2901,12088,20.1,16.9,19.4,"25% - 50% P.O.C.","$52000 - $60000"
"16013","Blaine County, Idaho",22373,56694,16696,98,159,191,20,5062,74.6,0.4,0.7,0.9,0.1,22.6,25.4,7995,5601,2394,70.06,29.94,320,5281,293,2101,613,7382,5.7,12.2,7.7,"25% - 50% P.O.C.","$52000 - $60000"
"16015","Boise County, Idaho",7378,59646,6709,19,32,71,0,338,90.9,0.3,0.4,1,0,4.6,9.1,3205,2655,550,82.84,17.16,122,2533,24,526,146,3059,4.6,4.4,4.6,"Less than 25% P.O.C.","$52000 - $60000"
"16017","Bonner County, Idaho",43611,50256,40594,98,378,298,53,1354,93.1,0.2,0.9,0.7,0.1,3.1,6.9,17537,13269,4268,75.66,24.34,867,12402,362,3906,1229,16308,6.5,8.5,7,"Less than 25% P.O.C.","$44000 - $52000"
"16019","Bonneville County, Idaho",114392,60615,94977,508,411,1040,127,14916,83,0.4,0.4,0.9,0.1,13,17,39768,27689,12079,69.63,30.37,5344,22345,1480,10599,6824,32944,19.3,12.3,17.2,"Less than 25% P.O.C.","$60000 or more"
"16021","Boundary County, Idaho",11845,43423,10702,63,158,105,65,590,90.4,0.5,1.3,0.9,0.5,5,9.6,4653,3567,1086,76.66,23.34,531,3036,145,941,676,3977,14.9,13.4,14.5,"Less than 25% P.O.C.","Less than $44000"
"16023","Butte County, Idaho",2581,42132,2445,4,0,0,0,132,94.7,0.2,0,0,0,5.1,5.3,967,796,171,82.32,17.68,58,738,13,158,71,896,7.3,7.6,7.3,"Less than 25% P.O.C.","Less than $44000"
"16025","Camas County, Idaho",1048,39688,1028,0,0,0,0,17,98.1,0,0,0,0,1.6,1.9,394,298,96,75.63,24.37,22,276,13,83,35,359,7.4,13.5,8.9,"Less than 25% P.O.C.","Less than $44000"
"16027","Canyon County, Idaho",217633,52134,153011,887,1311,1787,536,55034,70.3,0.4,0.6,0.8,0.2,25.3,29.7,72807,50603,22204,69.5,30.5,8441,42162,3869,18335,12310,60497,16.7,17.4,16.9,"25% - 50% P.O.C.","$52000 - $60000"
"16029","Caribou County, Idaho",6953,59053,6377,0,4,4,0,405,91.7,0,0.1,0.1,0,5.8,8.3,2538,2013,525,79.31,20.69,311,1702,59,466,370,2168,15.4,11.2,14.6,"Less than 25% P.O.C.","$52000 - $60000"
"16031","Cassia County, Idaho",23690,52935,16546,52,257,139,4,6446,69.8,0.2,1.1,0.6,0,27.2,30.2,7711,5418,2293,70.26,29.74,956,4462,515,1778,1471,6240,17.6,22.5,19.1,"25% - 50% P.O.C.","$52000 - $60000"
"16033","Clark County, Idaho",913,46154,421,7,42,0,0,443,46.1,0.8,4.6,0,0,48.5,53.9,290,181,109,62.41,37.59,7,174,40,69,47,243,3.9,36.7,16.2,"50% - 75% P.O.C.","$44000 - $52000"
"16035","Clearwater County, Idaho",8673,43915,7827,46,191,35,20,367,90.2,0.5,2.2,0.4,0.2,4.2,9.8,3555,2775,780,78.06,21.94,131,2644,67,713,198,3357,4.7,8.6,5.6,"Less than 25% P.O.C.","Less than $44000"
"16037","Custer County, Idaho",4169,40875,3719,5,42,0,0,175,89.2,0.1,1,0,0,4.2,10.8,1774,1395,379,78.64,21.36,51,1344,35,344,86,1688,3.7,9.2,4.8,"Less than 25% P.O.C.","Less than $44000"
"16039","Elmore County, Idaho",26743,46855,19426,695,363,695,96,4564,72.6,2.6,1.4,2.6,0.4,17.1,27.4,10606,6343,4263,59.81,40.19,686,5657,327,3936,1013,9593,10.8,7.7,9.6,"25% - 50% P.O.C.","$44000 - $52000"
"16041","Franklin County, Idaho",13464,57215,12263,35,73,20,2,909,91.1,0.3,0.5,0.1,0,6.8,8.9,4397,3574,823,81.28,18.72,772,2802,108,715,880,3517,21.6,13.1,20,"Less than 25% P.O.C.","$52000 - $60000"
"16043","Fremont County, Idaho",13020,58065,11047,20,10,24,82,1629,84.8,0.2,0.1,0.2,0.6,12.5,15.2,4347,3530,817,81.21,18.79,773,2757,210,607,983,3364,21.9,25.7,22.6,"Less than 25% P.O.C.","$52000 - $60000"
"16045","Gem County, Idaho",17331,45492,15207,20,193,98,0,1451,87.7,0.1,1.1,0.6,0,8.4,12.3,6683,4999,1684,74.8,25.2,645,4354,133,1551,778,5905,12.9,7.9,11.6,"Less than 25% P.O.C.","$44000 - $52000"
"16047","Gooding County, Idaho",15148,47204,10279,13,47,139,34,4403,67.9,0.1,0.3,0.9,0.2,29.1,32.1,5469,3854,1615,70.47,29.53,460,3394,261,1354,721,4748,11.9,16.2,13.2,"25% - 50% P.O.C.","$44000 - $52000"
"16049","Idaho County, Idaho",16411,41516,14927,23,611,66,3,558,91,0.1,3.7,0.4,0,3.4,9,6407,4913,1494,76.68,23.32,443,4470,193,1301,636,5771,9,12.9,9.9,"Less than 25% P.O.C.","Less than $44000"
"16051","Jefferson County, Idaho",28534,63048,24750,0,346,127,14,3004,86.7,0,1.2,0.4,0,10.5,13.3,8791,7092,1699,80.67,19.33,1384,5708,341,1358,1725,7066,19.5,20.1,19.6,"Less than 25% P.O.C.","$60000 or more"
"16053","Jerome County, Idaho",23730,52921,14593,36,67,101,106,8565,61.5,0.2,0.3,0.4,0.4,36.1,38.5,8022,5208,2814,64.92,35.08,772,4436,578,2236,1350,6672,14.8,20.5,16.8,"25% - 50% P.O.C.","$52000 - $60000"
"16055","Kootenai County, Idaho",157322,57242,142577,465,1961,1317,159,7270,90.6,0.3,1.2,0.8,0.1,4.6,9.4,62304,43861,18443,70.4,29.6,3806,40055,1909,16534,5715,56589,8.7,10.4,9.2,"Less than 25% P.O.C.","$52000 - $60000"
"16057","Latah County, Idaho",39505,49158,35040,458,409,894,20,1726,88.7,1.2,1,2.3,0.1,4.4,11.3,15422,8378,7044,54.32,45.68,741,7637,307,6737,1048,14374,8.8,4.4,6.8,"Less than 25% P.O.C.","$44000 - $52000"
"16059","Lemhi County, Idaho",7847,39324,7320,3,21,0,8,268,93.3,0,0.3,0,0.1,3.4,6.7,3582,2781,801,77.64,22.36,196,2585,72,729,268,3314,7,9,7.5,"Less than 25% P.O.C.","Less than $44000"
"16061","Lewis County, Idaho",3838,41198,3217,5,297,53,1,175,83.8,0.1,7.7,1.4,0,4.6,16.2,1646,1143,503,69.44,30.56,89,1054,34,469,123,1523,7.8,6.8,7.5,"Less than 25% P.O.C.","Less than $44000"
"16063","Lincoln County, Idaho",5350,50053,3538,0,32,22,0,1644,66.1,0,0.6,0.4,0,30.7,33.9,1724,1176,548,68.21,31.79,165,1011,98,450,263,1461,14,17.9,15.3,"25% - 50% P.O.C.","$44000 - $52000"
"16065","Madison County, Idaho",39100,39160,34525,65,53,610,63,2964,88.3,0.2,0.1,1.6,0.2,7.6,11.7,11016,4913,6103,44.6,55.4,1468,3445,896,5207,2364,8652,29.9,14.7,21.5,"Less than 25% P.O.C.","Less than $44000"
"16067","Minidoka County, Idaho",20705,53370,12839,32,255,55,0,7302,62,0.2,1.2,0.3,0,35.3,38,7250,5322,1928,73.41,26.59,632,4690,419,1509,1051,6199,11.9,21.7,14.5,"25% - 50% P.O.C.","$52000 - $60000"
"16069","Nez Perce County, Idaho",40217,58107,34974,143,2350,308,5,1579,87,0.4,5.8,0.8,0,3.9,13,16384,11931,4453,72.82,27.18,1067,10864,208,4245,1275,15109,8.9,4.7,7.8,"Less than 25% P.O.C.","$52000 - $60000"
"16071","Oneida County, Idaho",4385,53841,4096,5,7,0,0,197,93.4,0.1,0.2,0,0,4.5,6.6,1615,1290,325,79.88,20.12,252,1038,35,290,287,1328,19.5,10.8,17.8,"Less than 25% P.O.C.","$52000 - $60000"
"16073","Owyhee County, Idaho",11552,43798,7913,61,318,13,0,3031,68.5,0.5,2.8,0.1,0,26.2,31.5,4321,3064,1257,70.91,29.09,471,2593,144,1113,615,3706,15.4,11.5,14.2,"25% - 50% P.O.C.","Less than $44000"
"16075","Payette County, Idaho",23260,50579,18241,19,138,199,13,4034,78.4,0.1,0.6,0.9,0.1,17.3,21.6,8876,6449,2427,72.66,27.34,833,5616,417,2010,1250,7626,12.9,17.2,14.1,"Less than 25% P.O.C.","$44000 - $52000"
"16077","Power County, Idaho",7671,48823,4704,6,329,0,3,2616,61.3,0.1,4.3,0,0,34.1,38.7,2633,1959,674,74.4,25.6,273,1686,128,546,401,2232,13.9,19,15.2,"25% - 50% P.O.C.","$44000 - $52000"
"16079","Shoshone County, Idaho",12609,39386,11500,43,377,9,0,449,91.2,0.3,3,0.1,0,3.6,8.8,5466,3824,1642,69.96,30.04,186,3638,133,1509,319,5147,4.9,8.1,5.8,"Less than 25% P.O.C.","Less than $44000"
"16081","Teton County, Idaho",11426,74216,9274,0,83,0,0,1928,81.2,0,0.7,0,0,16.9,18.8,3707,2882,825,77.74,22.26,436,2446,51,774,487,3220,15.1,6.2,13.1,"Less than 25% P.O.C.","$60000 or more"
"16083","Twin Falls County, Idaho",84869,52919,67080,689,452,1448,45,13890,79,0.8,0.5,1.7,0.1,16.4,21,31146,21447,9699,68.86,31.14,2894,18553,1302,8397,4196,26950,13.5,13.4,13.5,"Less than 25% P.O.C.","$52000 - $60000"
"16085","Valley County, Idaho",10709,64475,10130,6,22,26,0,495,94.6,0.1,0.2,0.2,0,4.6,5.4,3869,3127,742,80.82,19.18,187,2940,39,703,226,3643,6,5.3,5.8,"Less than 25% P.O.C.","$60000 or more"
"16087","Washington County, Idaho",10057,40992,7938,19,100,37,0,1713,78.9,0.2,1,0.4,0,17,21.1,4035,2927,1108,72.54,27.46,352,2575,142,966,494,3541,12,12.8,12.2,"Less than 25% P.O.C.","Less than $44000"
"17001","Adams County, Illinois",66085,52993,60589,2682,197,527,14,1059,91.7,4.1,0.3,0.8,0,1.6,8.3,27112,19478,7634,71.84,28.16,1761,17717,484,7150,2245,24867,9,6.3,8.3,"Less than 25% P.O.C.","$52000 - $60000"
"17003","Alexander County, Illinois",6260,36806,3929,2094,37,0,0,82,62.8,33.5,0.6,0,0,1.3,37.2,2154,1588,566,73.72,26.28,88,1500,34,532,122,2032,5.5,6,5.7,"25% - 50% P.O.C.","Less than $44000"
"17005","Bond County, Illinois",16589,57289,14565,1250,76,59,0,584,87.8,7.5,0.5,0.4,0,3.5,12.2,6299,4778,1521,75.85,24.15,350,4428,179,1342,529,5770,7.3,11.8,8.4,"Less than 25% P.O.C.","$52000 - $60000"
"17007","Boone County, Illinois",53537,69272,39083,1121,162,632,0,11673,73,2.1,0.3,1.2,0,21.8,27,18571,15042,3529,81,19,2021,13021,444,3085,2465,16106,13.4,12.6,13.3,"25% - 50% P.O.C.","$60000 or more"
"17009","Brown County, Illinois",6628,61655,4895,1252,18,0,0,440,73.9,18.9,0.3,0,0,6.6,26.1,2055,1537,518,74.79,25.21,91,1446,29,489,120,1935,5.9,5.6,5.8,"25% - 50% P.O.C.","$60000 or more"
"17011","Bureau County, Illinois",33122,57436,29047,338,63,288,3,3029,87.7,1,0.2,0.9,0,9.1,12.3,13698,10494,3204,76.61,23.39,910,9584,258,2946,1168,12530,8.7,8.1,8.5,"Less than 25% P.O.C.","$52000 - $60000"
"17013","Calhoun County, Illinois",4830,63009,4684,15,25,43,0,61,97,0.3,0.5,0.9,0,1.3,3,1664,1452,212,87.26,12.74,132,1320,9,203,141,1523,9.1,4.2,8.5,"Less than 25% P.O.C.","$60000 or more"
"17015","Carroll County, Illinois",14466,52410,13464,175,11,111,0,535,93.1,1.2,0.1,0.8,0,3.7,6.9,6508,4986,1522,76.61,23.39,347,4639,96,1426,443,6065,7,6.3,6.8,"Less than 25% P.O.C.","$52000 - $60000"
"17017","Cass County, Illinois",12493,52373,9430,538,22,45,1,2362,75.5,4.3,0.2,0.4,0,18.9,24.5,5043,3762,1281,74.6,25.4,289,3473,117,1164,406,4637,7.7,9.1,8.1,"Less than 25% P.O.C.","$52000 - $60000"
"17019","Champaign County, Illinois",209922,52797,140989,28016,288,22523,144,12518,67.2,13.3,0.1,10.7,0.1,6,32.8,82369,43636,38733,52.98,47.02,2921,40715,1691,37042,4612,77757,6.7,4.4,5.6,"25% - 50% P.O.C.","$52000 - $60000"
"17021","Christian County, Illinois",32931,52834,31291,430,100,199,29,535,95,1.3,0.3,0.6,0.1,1.6,5,13901,10435,3466,75.07,24.93,694,9741,242,3224,936,12965,6.7,7,6.7,"Less than 25% P.O.C.","$52000 - $60000"
"17023","Clark County, Illinois",15716,56531,15170,105,7,79,0,248,96.5,0.7,0,0.5,0,1.6,3.5,6720,5147,1573,76.59,23.41,429,4718,115,1458,544,6176,8.3,7.3,8.1,"Less than 25% P.O.C.","$52000 - $60000"
"17025","Clay County, Illinois",13287,48500,12766,107,32,42,0,17,96.1,0.8,0.2,0.3,0,0.1,3.9,5696,4245,1451,74.53,25.47,312,3933,212,1239,524,5172,7.3,14.6,9.2,"Less than 25% P.O.C.","$44000 - $52000"
"17027","Clinton County, Illinois",37634,66639,34412,1298,96,209,0,1175,91.4,3.4,0.3,0.6,0,3.1,8.6,14353,11432,2921,79.65,20.35,1049,10383,254,2667,1303,13050,9.2,8.7,9.1,"Less than 25% P.O.C.","$60000 or more"
"17029","Coles County, Illinois",51353,46202,46691,1986,93,625,14,1300,90.9,3.9,0.2,1.2,0,2.5,9.1,20926,12865,8061,61.48,38.52,906,11959,466,7595,1372,19554,7,5.8,6.6,"Less than 25% P.O.C.","$44000 - $52000"
"17031","Cook County, Illinois",5198275,64660,2198122,1199175,4980,375635,1224,1314796,42.3,23.1,0.1,7.2,0,25.3,57.7,1972108,1122584,849524,56.92,43.08,127041,995543,68055,781469,195096,1777012,11.3,8,9.9,"50% - 75% P.O.C.","$60000 or more"
"17033","Crawford County, Illinois",18972,49779,16632,1215,15,61,14,621,87.7,6.4,0.1,0.3,0.1,3.3,12.3,7666,5954,1712,77.67,22.33,411,5543,90,1622,501,7165,6.9,5.3,6.5,"Less than 25% P.O.C.","$44000 - $52000"
"17035","Cumberland County, Illinois",10836,56206,10475,8,4,46,6,116,96.7,0.1,0,0.4,0.1,1.1,3.3,4299,3382,917,78.67,21.33,380,3002,64,853,444,3855,11.2,7,10.3,"Less than 25% P.O.C.","$52000 - $60000"
"17037","DeKalb County, Illinois",104366,63317,80167,8094,56,2364,0,11637,76.8,7.8,0.1,2.3,0,11.2,23.2,38150,21757,16393,57.03,42.97,2224,19533,1075,15318,3299,34851,10.2,6.6,8.6,"Less than 25% P.O.C.","$60000 or more"
"17039","De Witt County, Illinois",15932,55587,15074,85,7,4,12,436,94.6,0.5,0,0,0.1,2.7,5.4,6694,5270,1424,78.73,21.27,378,4892,138,1286,516,6178,7.2,9.7,7.7,"Less than 25% P.O.C.","$52000 - $60000"
"17041","Douglas County, Illinois",19623,56714,17712,135,67,131,14,1425,90.3,0.7,0.3,0.7,0.1,7.3,9.7,7613,5633,1980,73.99,26.01,665,4968,160,1820,825,6788,11.8,8.1,10.8,"Less than 25% P.O.C.","$52000 - $60000"
"17043","DuPage County, Illinois",929060,92809,621563,43661,517,109752,207,132597,66.9,4.7,0.1,11.8,0,14.3,33.1,342791,251502,91289,73.37,26.63,27638,223864,7370,83919,35008,307783,11,8.1,10.2,"25% - 50% P.O.C.","$60000 or more"
"17045","Edgar County, Illinois",17407,53647,17087,31,12,31,0,210,98.2,0.2,0.1,0.2,0,1.2,1.8,7542,5770,1772,76.5,23.5,336,5434,99,1673,435,7107,5.8,5.6,5.8,"Less than 25% P.O.C.","$52000 - $60000"
"17047","Edwards County, Illinois",6455,51080,6228,51,4,18,0,89,96.5,0.8,0.1,0.3,0,1.4,3.5,2773,2224,549,80.2,19.8,158,2066,38,511,196,2577,7.1,6.9,7.1,"Less than 25% P.O.C.","$44000 - $52000"
"17049","Effingham County, Illinois",34137,56685,32720,171,30,180,0,719,95.8,0.5,0.1,0.5,0,2.1,4.2,13877,10462,3415,75.39,24.61,1214,9248,218,3197,1432,12445,11.6,6.4,10.3,"Less than 25% P.O.C.","$52000 - $60000"
"17051","Fayette County, Illinois",21565,46650,19868,1007,68,116,28,403,92.1,4.7,0.3,0.5,0.1,1.9,7.9,7737,6228,1509,80.5,19.5,508,5720,166,1343,674,7063,8.2,11,8.7,"Less than 25% P.O.C.","$44000 - $52000"
"17053","Ford County, Illinois",13270,52092,12406,150,69,87,4,443,93.5,1.1,0.5,0.7,0,3.3,6.5,5771,4167,1604,72.21,27.79,361,3806,137,1467,498,5273,8.7,8.5,8.6,"Less than 25% P.O.C.","$52000 - $60000"
"17055","Franklin County, Illinois",38923,42769,37309,284,87,167,27,655,95.9,0.7,0.2,0.4,0.1,1.7,4.1,16235,12050,4185,74.22,25.78,1042,11008,246,3939,1288,14947,8.6,5.9,7.9,"Less than 25% P.O.C.","Less than $44000"
"17057","Fulton County, Illinois",35092,51643,32209,1317,100,28,8,1061,91.8,3.8,0.3,0.1,0,3,8.2,13940,10913,3027,78.29,21.71,636,10277,219,2808,855,13085,5.8,7.2,6.1,"Less than 25% P.O.C.","$44000 - $52000"
"17059","Gallatin County, Illinois",5064,44076,4842,26,26,6,0,66,95.6,0.5,0.5,0.1,0,1.3,4.4,2293,1767,526,77.06,22.94,112,1655,44,482,156,2137,6.3,8.4,6.8,"Less than 25% P.O.C.","$44000 - $52000"
"17061","Greene County, Illinois",13132,49885,12635,183,0,27,7,159,96.2,1.4,0,0.2,0.1,1.2,3.8,4949,3838,1111,77.55,22.45,215,3623,45,1066,260,4689,5.6,4.1,5.3,"Less than 25% P.O.C.","$44000 - $52000"
"17063","Grundy County, Illinois",50666,77350,43718,589,22,405,19,5019,86.3,1.2,0,0.8,0,9.9,13.7,19676,14022,5654,71.26,28.74,1763,12259,427,5227,2190,17486,12.6,7.6,11.1,"Less than 25% P.O.C.","$60000 or more"
"17065","Hamilton County, Illinois",8176,54046,8070,33,0,12,0,61,98.7,0.4,0,0.1,0,0.7,1.3,3400,2721,679,80.03,19.97,212,2509,55,624,267,3133,7.8,8.1,7.9,"Less than 25% P.O.C.","$52000 - $60000"
"17067","Hancock County, Illinois",17983,52561,17291,109,4,66,0,269,96.2,0.6,0,0.4,0,1.5,3.8,7409,6030,1379,81.39,18.61,368,5662,94,1285,462,6947,6.1,6.8,6.2,"Less than 25% P.O.C.","$52000 - $60000"
"17069","Hardin County, Illinois",3939,51250,3727,107,7,4,0,37,94.6,2.7,0.2,0.1,0,0.9,5.4,1363,1117,246,81.95,18.05,64,1053,7,239,71,1292,5.7,2.8,5.2,"Less than 25% P.O.C.","$44000 - $52000"
"17071","Henderson County, Illinois",6809,53676,6533,9,0,39,0,123,95.9,0.1,0,0.6,0,1.8,4.1,2977,2447,530,82.2,17.8,135,2312,37,493,172,2805,5.5,7,5.8,"Less than 25% P.O.C.","$52000 - $60000"
"17073","Henry County, Illinois",49267,59933,44555,938,52,244,0,2808,90.4,1.9,0.1,0.5,0,5.7,9.6,19856,15616,4240,78.65,21.35,1375,14241,346,3894,1721,18135,8.8,8.2,8.7,"Less than 25% P.O.C.","$52000 - $60000"
"17075","Iroquois County, Illinois",27812,52700,24984,227,20,98,0,1941,89.8,0.8,0.1,0.4,0,7,10.2,11741,8939,2802,76.13,23.87,758,8181,285,2517,1043,10698,8.5,10.2,8.9,"Less than 25% P.O.C.","$52000 - $60000"
"17077","Jackson County, Illinois",57977,37241,42915,8663,146,1996,23,2567,74,14.9,0.3,3.4,0,4.4,26,23883,12292,11591,51.47,48.53,823,11469,432,11159,1255,22628,6.7,3.7,5.3,"25% - 50% P.O.C.","Less than $44000"
"17079","Jasper County, Illinois",9594,54256,9303,47,3,9,0,34,97,0.5,0,0.1,0,0.4,3,3711,2927,784,78.87,21.13,305,2622,82,702,387,3324,10.4,10.5,10.4,"Less than 25% P.O.C.","$52000 - $60000"
"17081","Jefferson County, Illinois",37985,49896,32496,3169,55,438,5,1016,85.5,8.3,0.1,1.2,0,2.7,14.5,14985,10976,4009,73.25,26.75,937,10039,231,3778,1168,13817,8.5,5.8,7.8,"Less than 25% P.O.C.","$44000 - $52000"
"17083","Jersey County, Illinois",21937,63028,20979,96,23,67,0,309,95.6,0.4,0.1,0.3,0,1.4,4.4,8499,6963,1536,81.93,18.07,478,6485,168,1368,646,7853,6.9,10.9,7.6,"Less than 25% P.O.C.","$60000 or more"
"17085","Jo Daviess County, Illinois",21588,57946,20436,123,74,130,8,654,94.7,0.6,0.3,0.6,0,3,5.3,9970,7814,2156,78.38,21.62,470,7344,289,1867,759,9211,6,13.4,7.6,"Less than 25% P.O.C.","$52000 - $60000"
"17087","Johnson County, Illinois",12494,52774,10618,1383,7,43,0,395,85,11.1,0.1,0.3,0,3.2,15,4303,3621,682,84.15,15.85,238,3383,5,677,243,4060,6.6,0.7,5.6,"Less than 25% P.O.C.","$52000 - $60000"
"17089","Kane County, Illinois",531376,79394,303165,28109,484,21320,190,169364,57.1,5.3,0.1,4,0,31.9,42.9,179637,132690,46947,73.87,26.13,18736,113954,7395,39552,26131,153506,14.1,15.8,14.5,"25% - 50% P.O.C.","$60000 or more"
"17091","Kankakee County, Illinois",110637,58902,79624,16714,200,933,0,11504,72,15.1,0.2,0.8,0,10.4,28,39796,27072,12724,68.03,31.97,2655,24417,1151,11573,3806,35990,9.8,9,9.6,"25% - 50% P.O.C.","$52000 - $60000"
"17093","Kendall County, Illinois",126054,96563,87604,8815,59,4016,0,23571,69.5,7,0,3.2,0,18.7,30.5,40721,34036,6685,83.58,16.42,5228,28808,1044,5641,6272,34449,15.4,15.6,15.4,"25% - 50% P.O.C.","$60000 or more"
"17095","Knox County, Illinois",50508,44129,41855,4281,85,554,0,2909,82.9,8.5,0.2,1.1,0,5.8,17.1,20680,13797,6883,66.72,33.28,1043,12754,498,6385,1541,19139,7.6,7.2,7.5,"Less than 25% P.O.C.","$44000 - $52000"
"17097","Lake County, Illinois",701473,89427,432361,45923,907,53654,196,152141,61.6,6.5,0.1,7.6,0,21.7,38.4,246122,179679,66443,73,27,21379,158300,7317,59126,28696,217426,11.9,11,11.7,"25% - 50% P.O.C.","$60000 or more"
"17099","LaSalle County, Illinois",109737,58142,93764,2833,74,782,19,10658,85.4,2.6,0.1,0.7,0,9.7,14.6,45095,32379,12716,71.8,28.2,2405,29974,1141,11575,3546,41549,7.4,9,7.9,"Less than 25% P.O.C.","$52000 - $60000"
"17101","Lawrence County, Illinois",16033,46636,13557,1323,155,87,0,615,84.6,8.3,1,0.5,0,3.8,15.4,6306,4677,1629,74.17,25.83,345,4332,168,1461,513,5793,7.4,10.3,8.1,"Less than 25% P.O.C.","$44000 - $52000"
"17103","Lee County, Illinois",34389,58194,29640,1875,92,193,31,2139,86.2,5.5,0.3,0.6,0.1,6.2,13.8,13788,9971,3817,72.32,27.68,669,9302,235,3582,904,12884,6.7,6.2,6.6,"Less than 25% P.O.C.","$52000 - $60000"
"17105","Livingston County, Illinois",36040,55160,32131,1488,0,308,0,1647,89.2,4.1,0,0.9,0,4.6,10.8,14307,10417,3890,72.81,27.19,976,9441,346,3544,1322,12985,9.4,8.9,9.2,"Less than 25% P.O.C.","$52000 - $60000"
"17107","Logan County, Illinois",29003,57308,25049,1984,35,218,2,985,86.4,6.8,0.1,0.8,0,3.4,13.6,10797,7854,2943,72.74,27.26,669,7185,164,2779,833,9964,8.5,5.6,7.7,"Less than 25% P.O.C.","$52000 - $60000"
"17109","McDonough County, Illinois",30479,44471,26782,1422,31,653,0,844,87.9,4.7,0.1,2.1,0,2.8,12.1,11408,7569,3839,66.35,33.65,527,7042,142,3697,669,10739,7,3.7,5.9,"Less than 25% P.O.C.","$44000 - $52000"
"17111","McHenry County, Illinois",307714,86799,249502,4231,219,8554,11,40266,81.1,1.4,0.1,2.8,0,13.1,18.9,112453,89278,23175,79.39,20.61,9482,79796,2697,20478,12179,100274,10.6,11.6,10.8,"Less than 25% P.O.C.","$60000 or more"
"17113","McLean County, Illinois",172578,67675,137144,14247,286,8762,33,8495,79.5,8.3,0.2,5.1,0,4.9,20.5,65845,42551,23294,64.62,35.38,3672,38879,1050,22244,4722,61123,8.6,4.5,7.2,"Less than 25% P.O.C.","$60000 or more"
"17115","Macon County, Illinois",105528,50480,80477,15490,230,1064,15,2405,76.3,14.7,0.2,1,0,2.3,23.7,43912,30039,13873,68.41,31.59,2054,27985,859,13014,2913,40999,6.8,6.2,6.6,"Less than 25% P.O.C.","$44000 - $52000"
"17117","Macoupin County, Illinois",45463,55159,43670,434,82,222,0,560,96.1,1,0.2,0.5,0,1.2,3.9,18875,14484,4391,76.74,23.26,1093,13391,311,4080,1404,17471,7.5,7.1,7.4,"Less than 25% P.O.C.","$52000 - $60000"
"17119","Madison County, Illinois",264776,60738,225251,22602,466,2744,27,8626,85.1,8.5,0.2,1,0,3.3,14.9,107659,76830,30829,71.36,28.64,6542,70288,1803,29026,8345,99314,8.5,5.8,7.8,"Less than 25% P.O.C.","$60000 or more"
"17121","Marion County, Illinois",37743,47519,34411,1368,81,243,0,765,91.2,3.6,0.2,0.6,0,2,8.8,15946,11730,4216,73.56,26.44,808,10922,382,3834,1190,14756,6.9,9.1,7.5,"Less than 25% P.O.C.","$44000 - $52000"
"17123","Marshall County, Illinois",11679,58465,11040,31,4,44,0,352,94.5,0.3,0,0.4,0,3,5.5,4884,3997,887,81.84,18.16,313,3684,79,808,392,4492,7.8,8.9,8,"Less than 25% P.O.C.","$52000 - $60000"
"17125","Mason County, Illinois",13621,48417,13138,103,22,24,0,153,96.5,0.8,0.2,0.2,0,1.1,3.5,5977,4653,1324,77.85,22.15,263,4390,153,1171,416,5561,5.7,11.6,7,"Less than 25% P.O.C.","$44000 - $52000"
"17127","Massac County, Illinois",14219,47481,12547,830,6,29,0,419,88.2,5.8,0,0.2,0,2.9,11.8,5822,4395,1427,75.49,24.51,350,4045,138,1289,488,5334,8,9.7,8.4,"Less than 25% P.O.C.","$44000 - $52000"
"17129","Menard County, Illinois",12306,74684,11763,54,33,43,0,188,95.6,0.4,0.3,0.3,0,1.5,4.4,5188,4051,1137,78.08,21.92,216,3835,121,1016,337,4851,5.3,10.6,6.5,"Less than 25% P.O.C.","$60000 or more"
"17131","Mercer County, Illinois",15589,59787,14856,98,15,57,0,380,95.3,0.6,0.1,0.4,0,2.4,4.7,6516,5150,1366,79.04,20.96,394,4756,99,1267,493,6023,7.7,7.2,7.6,"Less than 25% P.O.C.","$52000 - $60000"
"17133","Monroe County, Illinois",34168,85747,32900,60,0,444,0,525,96.3,0.2,0,1.3,0,1.5,3.7,13586,11334,2252,83.42,16.58,982,10352,32,2220,1014,12572,8.7,1.4,7.5,"Less than 25% P.O.C.","$60000 or more"
"17135","Montgomery County, Illinois",28828,52748,26883,1078,50,71,14,510,93.3,3.7,0.2,0.2,0,1.8,6.7,11522,8799,2723,76.37,23.63,671,8128,170,2553,841,10681,7.6,6.2,7.3,"Less than 25% P.O.C.","$52000 - $60000"
"17137","Morgan County, Illinois",34247,51437,30195,2319,80,210,2,849,88.2,6.8,0.2,0.6,0,2.5,11.8,13719,9400,4319,68.52,31.48,643,8757,217,4102,860,12859,6.8,5,6.3,"Less than 25% P.O.C.","$44000 - $52000"
"17139","Moultrie County, Illinois",14641,61456,14144,112,58,23,0,212,96.6,0.8,0.4,0.2,0,1.4,3.4,5959,4626,1333,77.63,22.37,512,4114,142,1191,654,5305,11.1,10.7,11,"Less than 25% P.O.C.","$60000 or more"
"17141","Ogle County, Illinois",51025,60986,44283,520,117,276,9,5166,86.8,1,0.2,0.5,0,10.1,13.2,21021,15390,5631,73.21,26.79,1575,13815,532,5099,2107,18914,10.2,9.4,10,"Less than 25% P.O.C.","$60000 or more"
"17143","Peoria County, Illinois",182770,55842,127756,32183,466,7424,11,8787,69.9,17.6,0.3,4.1,0,4.8,30.1,73253,47687,25566,65.1,34.9,4049,43638,1963,23603,6012,67241,8.5,7.7,8.2,"25% - 50% P.O.C.","$52000 - $60000"
"17145","Perry County, Illinois",21251,52428,18231,1925,27,146,0,662,85.8,9.1,0.1,0.7,0,3.1,14.2,8433,6360,2073,75.42,24.58,498,5862,97,1976,595,7838,7.8,4.7,7.1,"Less than 25% P.O.C.","$52000 - $60000"
"17147","Piatt County, Illinois",16401,70849,15779,91,9,88,0,222,96.2,0.6,0.1,0.5,0,1.4,3.8,6692,5520,1172,82.49,17.51,392,5128,54,1118,446,6246,7.1,4.6,6.7,"Less than 25% P.O.C.","$60000 or more"
"17149","Pike County, Illinois",15672,47492,15021,185,29,56,0,202,95.8,1.2,0.2,0.4,0,1.3,4.2,6309,4957,1352,78.57,21.43,384,4573,65,1287,449,5860,7.7,4.8,7.1,"Less than 25% P.O.C.","$44000 - $52000"
"17151","Pope County, Illinois",4203,38056,3823,177,0,24,0,116,91,4.2,0,0.6,0,2.8,9,1694,1398,296,82.53,17.47,70,1328,0,296,70,1624,5,0,4.1,"Less than 25% P.O.C.","Less than $44000"
"17153","Pulaski County, Illinois",5510,34640,3507,1665,6,7,0,128,63.6,30.2,0.1,0.1,0,2.3,36.4,2095,1600,495,76.37,23.63,105,1495,27,468,132,1963,6.6,5.5,6.3,"25% - 50% P.O.C.","Less than $44000"
"17155","Putnam County, Illinois",5721,63638,5262,30,0,46,0,320,92,0.5,0,0.8,0,5.6,8,2413,1943,470,80.52,19.48,126,1817,30,440,156,2257,6.5,6.4,6.5,"Less than 25% P.O.C.","$60000 or more"
"17157","Randolph County, Illinois",32295,53816,27402,3252,57,190,3,1014,84.8,10.1,0.2,0.6,0,3.1,15.2,11883,8792,3091,73.99,26.01,633,8159,151,2940,784,11099,7.2,4.9,6.6,"Less than 25% P.O.C.","$52000 - $60000"
"17159","Richland County, Illinois",15766,48894,15008,125,71,80,0,270,95.2,0.8,0.5,0.5,0,1.7,4.8,6452,4595,1857,71.22,28.78,399,4196,91,1766,490,5962,8.7,4.9,7.6,"Less than 25% P.O.C.","$44000 - $52000"
"17161","Rock Island County, Illinois",143873,54858,103282,14156,411,3630,61,18491,71.8,9.8,0.3,2.5,0,12.9,28.2,60546,41165,19381,67.99,32.01,3100,38065,1367,18014,4467,56079,7.5,7.1,7.4,"25% - 50% P.O.C.","$52000 - $60000"
"17163","St. Clair County, Illinois",262338,55179,161693,78281,439,3811,34,10748,61.6,29.8,0.2,1.5,0,4.1,38.4,104105,67869,36236,65.19,34.81,5140,62729,3022,33214,8162,95943,7.6,8.3,7.8,"25% - 50% P.O.C.","$52000 - $60000"
"17165","Saline County, Illinois",23994,44090,21957,632,53,173,54,428,91.5,2.6,0.2,0.7,0.2,1.8,8.5,9972,7432,2540,74.53,25.47,518,6914,308,2232,826,9146,7,12.1,8.3,"Less than 25% P.O.C.","$44000 - $52000"
"17167","Sangamon County, Illinois",196861,61912,158154,24955,158,3962,88,4532,80.3,12.7,0.1,2,0,2.3,19.7,83711,57673,26038,68.9,31.1,3815,53858,1751,24287,5566,78145,6.6,6.7,6.6,"Less than 25% P.O.C.","$60000 or more"
"17169","Schuyler County, Illinois",6953,52357,6166,611,9,0,0,67,88.7,8.8,0.1,0,0,1,11.3,2775,2102,673,75.75,24.25,183,1919,0,673,183,2592,8.7,0,6.6,"Less than 25% P.O.C.","$52000 - $60000"
"17171","Scott County, Illinois",5005,57118,4840,7,32,4,13,64,96.7,0.1,0.6,0.1,0.3,1.3,3.3,1939,1550,389,79.94,20.06,106,1444,24,365,130,1809,6.8,6.2,6.7,"Less than 25% P.O.C.","$52000 - $60000"
"17173","Shelby County, Illinois",21737,52953,21133,147,17,63,8,229,97.2,0.7,0.1,0.3,0,1.1,2.8,9189,7444,1745,81.01,18.99,567,6877,144,1601,711,8478,7.6,8.3,7.7,"Less than 25% P.O.C.","$52000 - $60000"
"17175","Stark County, Illinois",5447,54907,5198,53,0,51,0,95,95.4,1,0,0.9,0,1.7,4.6,2315,1817,498,78.49,21.51,175,1642,49,449,224,2091,9.6,9.8,9.7,"Less than 25% P.O.C.","$52000 - $60000"
"17177","Stephenson County, Illinois",45093,48805,37180,4334,79,382,0,1787,82.5,9.6,0.2,0.8,0,4,17.5,19739,13801,5938,69.92,30.08,944,12857,382,5556,1326,18413,6.8,6.4,6.7,"Less than 25% P.O.C.","$44000 - $52000"
"17179","Tazewell County, Illinois",133195,63454,125134,1645,187,1377,19,3116,93.9,1.2,0.1,1,0,2.3,6.1,54291,41480,12811,76.4,23.6,3731,37749,568,12243,4299,49992,9,4.4,7.9,"Less than 25% P.O.C.","$60000 or more"
"17181","Union County, Illinois",16968,50625,15452,273,18,56,0,880,91.1,1.6,0.1,0.3,0,5.2,8.9,6654,5141,1513,77.26,22.74,388,4753,127,1386,515,6139,7.5,8.4,7.7,"Less than 25% P.O.C.","$44000 - $52000"
"17183","Vermilion County, Illinois",77563,46515,60675,10837,202,759,12,3905,78.2,14,0.3,1,0,5,21.8,31151,21666,9485,69.55,30.45,1688,19978,834,8651,2522,28629,7.8,8.8,8.1,"Less than 25% P.O.C.","$44000 - $52000"
"17185","Wabash County, Illinois",11546,50770,10839,76,2,107,0,308,93.9,0.7,0,0.9,0,2.7,6.1,4839,3774,1065,77.99,22.01,325,3449,55,1010,380,4459,8.6,5.2,7.9,"Less than 25% P.O.C.","$44000 - $52000"
"17187","Warren County, Illinois",17146,50310,14268,498,38,426,0,1640,83.2,2.9,0.2,2.5,0,9.6,16.8,6862,5099,1763,74.31,25.69,467,4632,71,1692,538,6324,9.2,4,7.8,"Less than 25% P.O.C.","$44000 - $52000"
"17189","Washington County, Illinois",14058,61763,13495,121,18,41,7,203,96,0.9,0.1,0.3,0,1.4,4,6020,4665,1355,77.49,22.51,245,4420,93,1262,338,5682,5.3,6.9,5.6,"Less than 25% P.O.C.","$60000 or more"
"17191","Wayne County, Illinois",16402,50251,15777,248,26,42,0,102,96.2,1.5,0.2,0.3,0,0.6,3.8,7051,5401,1650,76.6,23.4,442,4959,196,1454,638,6413,8.2,11.9,9,"Less than 25% P.O.C.","$44000 - $52000"
"17193","White County, Illinois",13868,49290,13348,97,22,106,11,202,96.3,0.7,0.2,0.8,0.1,1.5,3.7,6041,4868,1173,80.58,19.42,416,4452,89,1084,505,5536,8.5,7.6,8.4,"Less than 25% P.O.C.","$44000 - $52000"
"17195","Whiteside County, Illinois",56016,54232,47374,861,81,289,56,6723,84.6,1.5,0.1,0.5,0.1,12,15.4,23084,17279,5805,74.85,25.15,1405,15874,442,5363,1847,21237,8.1,7.6,8,"Less than 25% P.O.C.","$52000 - $60000"
"17197","Will County, Illinois",689315,86961,438965,76586,446,37434,149,119765,63.7,11.1,0.1,5.4,0,17.4,36.3,229498,186528,42970,81.28,18.72,26259,160269,4825,38145,31084,198414,14.1,11.2,13.5,"25% - 50% P.O.C.","$60000 or more"
"17199","Williamson County, Illinois",67102,50734,60188,2749,135,785,0,1771,89.7,4.1,0.2,1.2,0,2.6,10.3,27029,18949,8080,70.11,29.89,1187,17762,401,7679,1588,25441,6.3,5,5.9,"Less than 25% P.O.C.","$44000 - $52000"
"17201","Winnebago County, Illinois",284819,54489,196571,35837,500,7497,22,36371,69,12.6,0.2,2.6,0,12.8,31,114779,75592,39187,65.86,34.14,6985,68607,3557,35630,10542,104237,9.2,9.1,9.2,"25% - 50% P.O.C.","$52000 - $60000"
"17203","Woodford County, Illinois",38700,72808,36957,234,17,200,0,707,95.5,0.6,0,0.5,0,1.8,4.5,14499,11857,2642,81.78,18.22,1451,10406,148,2494,1599,12900,12.2,5.6,11,"Less than 25% P.O.C.","$60000 or more"
"18001","Adams County, Indiana",35376,52504,33071,399,12,104,0,1601,93.5,1.1,0,0.3,0,4.5,6.5,12481,9623,2858,77.1,22.9,1845,7778,199,2659,2044,10437,19.2,7,16.4,"Less than 25% P.O.C.","$52000 - $60000"
"18003","Allen County, Indiana",372575,54857,275145,42030,582,14159,137,27818,73.8,11.3,0.2,3.8,0,7.5,26.2,145065,99264,45801,68.43,31.57,11602,87662,3211,42590,14813,130252,11.7,7,10.2,"25% - 50% P.O.C.","$52000 - $60000"
"18005","Bartholomew County, Indiana",82481,63431,67210,1267,179,6104,42,5572,81.5,1.5,0.2,7.4,0.1,6.8,18.5,31452,22470,8982,71.44,28.56,1706,20764,624,8358,2330,29122,7.6,6.9,7.4,"Less than 25% P.O.C.","$60000 or more"
"18007","Benton County, Indiana",8677,49488,8025,43,5,7,7,452,92.5,0.5,0.1,0.1,0.1,5.2,7.5,3432,2541,891,74.04,25.96,254,2287,82,809,336,3096,10,9.2,9.8,"Less than 25% P.O.C.","$44000 - $52000"
"18009","Blackford County, Indiana",12013,43505,11475,4,37,87,0,196,95.5,0,0.3,0.7,0,1.6,4.5,5235,3911,1324,74.71,25.29,321,3590,55,1269,376,4859,8.2,4.2,7.2,"Less than 25% P.O.C.","Less than $44000"
"18011","Boone County, Indiana",65544,83077,59387,1137,140,1943,0,1966,90.6,1.7,0.2,3,0,3,9.4,25485,19658,5827,77.14,22.86,2463,17195,271,5556,2734,22751,12.5,4.7,10.7,"Less than 25% P.O.C.","$60000 or more"
"18013","Brown County, Indiana",15064,61030,14410,98,0,110,0,259,95.7,0.7,0,0.7,0,1.7,4.3,6189,5224,965,84.41,15.59,363,4861,81,884,444,5745,6.9,8.4,7.2,"Less than 25% P.O.C.","$60000 or more"
"18015","Carroll County, Indiana",20074,54806,18853,233,27,30,2,814,93.9,1.2,0.1,0.1,0,4.1,6.1,8002,6457,1545,80.69,19.31,625,5832,145,1400,770,7232,9.7,9.4,9.6,"Less than 25% P.O.C.","$52000 - $60000"
"18017","Cass County, Indiana",37880,49415,30194,427,137,486,7,5817,79.7,1.1,0.4,1.3,0,15.4,20.3,14688,10863,3825,73.96,26.04,970,9893,366,3459,1336,13352,8.9,9.6,9.1,"Less than 25% P.O.C.","$44000 - $52000"
"18019","Clark County, Indiana",116507,55630,96942,7794,107,1213,13,6264,83.2,6.7,0.1,1,0,5.4,16.8,44200,31442,12758,71.14,28.86,2485,28957,980,11778,3465,40735,7.9,7.7,7.8,"Less than 25% P.O.C.","$52000 - $60000"
"18021","Clay County, Indiana",26234,55637,25221,220,4,73,10,142,96.1,0.8,0,0.3,0,0.5,3.9,10543,8177,2366,77.56,22.44,619,7558,154,2212,773,9770,7.6,6.5,7.3,"Less than 25% P.O.C.","$52000 - $60000"
"18023","Clinton County, Indiana",32273,54286,26509,216,53,113,33,5118,82.1,0.7,0.2,0.4,0.1,15.9,17.9,12033,8492,3541,70.57,29.43,985,7507,420,3121,1405,10628,11.6,11.9,11.7,"Less than 25% P.O.C.","$52000 - $60000"
"18025","Crawford County, Indiana",10569,41662,10151,41,9,0,0,158,96,0.4,0.1,0,0,1.5,4,3835,3168,667,82.61,17.39,151,3017,59,608,210,3625,4.8,8.8,5.5,"Less than 25% P.O.C.","Less than $44000"
"18027","Daviess County, Indiana",33120,53629,30324,638,13,89,15,1646,91.6,1.9,0,0.3,0,5,8.4,11227,8250,2977,73.48,26.52,1569,6681,304,2673,1873,9354,19,10.2,16.7,"Less than 25% P.O.C.","$52000 - $60000"
"18029","Dearborn County, Indiana",49479,68658,47567,411,50,279,14,646,96.1,0.8,0.1,0.6,0,1.3,3.9,18870,15027,3843,79.63,20.37,1349,13678,389,3454,1738,17132,9,10.1,9.2,"Less than 25% P.O.C.","$60000 or more"
"18031","Decatur County, Indiana",26562,57949,25241,173,53,387,0,533,95,0.7,0.2,1.5,0,2,5,10353,7230,3123,69.83,30.17,803,6427,315,2808,1118,9235,11.1,10.1,10.8,"Less than 25% P.O.C.","$52000 - $60000"
"18033","DeKalb County, Indiana",42927,56421,40787,243,20,141,0,1202,95,0.6,0,0.3,0,2.8,5,16801,12781,4020,76.07,23.93,1112,11669,405,3615,1517,15284,8.7,10.1,9,"Less than 25% P.O.C.","$52000 - $60000"
"18035","Delaware County, Indiana",115020,43512,99836,7885,108,1644,88,2847,86.8,6.9,0.1,1.4,0.1,2.5,13.2,46026,29215,16811,63.47,36.53,2136,27079,996,15815,3132,42894,7.3,5.9,6.8,"Less than 25% P.O.C.","Less than $44000"
"18037","Dubois County, Indiana",42543,60666,38378,276,0,300,0,3329,90.2,0.6,0,0.7,0,7.8,9.8,16893,13160,3733,77.9,22.1,1285,11875,273,3460,1558,15335,9.8,7.3,9.2,"Less than 25% P.O.C.","$60000 or more"
"18039","Elkhart County, Indiana",204558,57021,152973,11054,288,2147,109,32583,74.8,5.4,0.1,1,0.1,15.9,25.2,71718,50067,21651,69.81,30.19,6757,43310,2397,19254,9154,62564,13.5,11.1,12.8,"25% - 50% P.O.C.","$52000 - $60000"
"18041","Fayette County, Indiana",23194,46175,22152,550,57,8,0,289,95.5,2.4,0.2,0,0,1.2,4.5,9584,6662,2922,69.51,30.49,499,6163,176,2746,675,8909,7.5,6,7,"Less than 25% P.O.C.","$44000 - $52000"
"18043","Floyd County, Indiana",77320,64468,67904,3937,307,827,0,2535,87.8,5.1,0.4,1.1,0,3.3,12.2,29189,21295,7894,72.96,27.04,1565,19730,448,7446,2013,27176,7.3,5.7,6.9,"Less than 25% P.O.C.","$60000 or more"
"18045","Fountain County, Indiana",16430,52874,15660,37,11,72,0,414,95.3,0.2,0.1,0.4,0,2.5,4.7,6974,5312,1662,76.17,23.83,500,4812,197,1465,697,6277,9.4,11.9,10,"Less than 25% P.O.C.","$52000 - $60000"
"18047","Franklin County, Indiana",22774,62462,22053,33,0,205,0,183,96.8,0.1,0,0.9,0,0.8,3.2,8687,7293,1394,83.95,16.05,885,6408,123,1271,1008,7679,12.1,8.8,11.6,"Less than 25% P.O.C.","$60000 or more"
"18049","Fulton County, Indiana",20096,52034,18440,186,63,84,11,1045,91.8,0.9,0.3,0.4,0.1,5.2,8.2,7799,5822,1977,74.65,25.35,532,5290,150,1827,682,7117,9.1,7.6,8.7,"Less than 25% P.O.C.","$52000 - $60000"
"18051","Gibson County, Indiana",33656,55462,31492,738,16,143,0,545,93.6,2.2,0,0.4,0,1.6,6.4,13340,10068,3272,75.47,24.53,884,9184,222,3050,1106,12234,8.8,6.8,8.3,"Less than 25% P.O.C.","$52000 - $60000"
"18053","Grant County, Indiana",66452,44356,56430,4633,108,653,0,2846,84.9,7,0.2,1,0,4.3,15.1,26372,18046,8326,68.43,31.57,1632,16414,654,7672,2286,24086,9,7.9,8.7,"Less than 25% P.O.C.","$44000 - $52000"
"18055","Greene County, Indiana",32159,51613,31071,113,10,64,17,468,96.6,0.4,0,0.2,0.1,1.5,3.4,12781,10175,2606,79.61,20.39,830,9345,239,2367,1069,11712,8.2,9.2,8.4,"Less than 25% P.O.C.","$44000 - $52000"
"18057","Hamilton County, Indiana",323117,98173,270351,12585,603,19155,69,12928,83.7,3.9,0.2,5.9,0,4,16.3,119789,92174,27615,76.95,23.05,9849,82325,1572,26043,11421,108368,10.7,5.7,9.5,"Less than 25% P.O.C.","$60000 or more"
"18059","Hancock County, Indiana",75164,74072,69435,1780,0,603,0,1777,92.4,2.4,0,0.8,0,2.4,7.6,28740,22774,5966,79.24,20.76,1769,21005,347,5619,2116,26624,7.8,5.8,7.4,"Less than 25% P.O.C.","$60000 or more"
"18061","Harrison County, Indiana",39940,57712,38089,238,53,173,0,769,95.4,0.6,0.1,0.4,0,1.9,4.6,14403,11953,2450,82.99,17.01,891,11062,161,2289,1052,13351,7.5,6.6,7.3,"Less than 25% P.O.C.","$52000 - $60000"
"18063","Hendricks County, Indiana",163799,81933,138000,10993,253,4749,15,6394,84.2,6.7,0.2,2.9,0,3.9,15.8,59015,46306,12709,78.46,21.54,5205,41101,885,11824,6090,52925,11.2,7,10.3,"Less than 25% P.O.C.","$60000 or more"
"18065","Henry County, Indiana",48255,49832,45115,1204,101,193,21,878,93.5,2.5,0.2,0.4,0,1.8,6.5,18304,13451,4853,73.49,26.51,885,12566,511,4342,1396,16908,6.6,10.5,7.6,"Less than 25% P.O.C.","$44000 - $52000"
"18067","Howard County, Indiana",82331,52373,70047,6169,368,1029,16,2769,85.1,7.5,0.4,1.2,0,3.4,14.9,34701,24376,10325,70.25,29.75,1876,22500,645,9680,2521,32180,7.7,6.2,7.3,"Less than 25% P.O.C.","$52000 - $60000"
"18069","Huntington County, Indiana",36359,53632,34459,327,157,263,28,894,94.8,0.9,0.4,0.7,0.1,2.5,5.2,14742,11125,3617,75.46,24.54,899,10226,401,3216,1300,13442,8.1,11.1,8.8,"Less than 25% P.O.C.","$52000 - $60000"
"18071","Jackson County, Indiana",44025,51250,38802,473,61,983,14,3086,88.1,1.1,0.1,2.2,0,7,11.9,16753,12072,4681,72.06,27.94,1251,10821,363,4318,1614,15139,10.4,7.8,9.6,"Less than 25% P.O.C.","$44000 - $52000"
"18073","Jasper County, Indiana",33447,63892,30626,199,0,110,0,2012,91.6,0.6,0,0.3,0,6,8.4,12533,9601,2932,76.61,23.39,974,8627,179,2753,1153,11380,10.1,6.1,9.2,"Less than 25% P.O.C.","$60000 or more"
"18075","Jay County, Indiana",20840,47658,19773,76,0,157,1,647,94.9,0.4,0,0.8,0,3.1,5.1,8174,5968,2206,73.01,26.99,636,5332,224,1982,860,7314,10.7,10.2,10.5,"Less than 25% P.O.C.","$44000 - $52000"
"18077","Jefferson County, Indiana",32201,52718,29814,667,62,286,0,901,92.6,2.1,0.2,0.9,0,2.8,7.4,12632,9078,3554,71.87,28.13,712,8366,195,3359,907,11725,7.8,5.5,7.2,"Less than 25% P.O.C.","$52000 - $60000"
"18079","Jennings County, Indiana",27710,54191,26332,395,129,63,0,683,95,1.4,0.5,0.2,0,2.5,5,10792,8390,2402,77.74,22.26,900,7490,257,2145,1157,9635,10.7,10.7,10.7,"Less than 25% P.O.C.","$52000 - $60000"
"18081","Johnson County, Indiana",153716,72440,136803,3664,178,5192,27,5498,89,2.4,0.1,3.4,0,3.6,11,56628,41141,15487,72.65,27.35,4481,36660,1239,14248,5720,50908,10.9,8,10.1,"Less than 25% P.O.C.","$60000 or more"
"18083","Knox County, Indiana",37065,47380,34360,1023,47,336,26,752,92.7,2.8,0.1,0.9,0.1,2,7.3,15038,9708,5330,64.56,35.44,930,8778,316,5014,1246,13792,9.6,5.9,8.3,"Less than 25% P.O.C.","$44000 - $52000"
"18085","Kosciusko County, Indiana",79035,61366,69428,589,180,995,23,6293,87.8,0.7,0.2,1.3,0,8,12.2,30997,23179,7818,74.78,25.22,2521,20658,685,7133,3206,27791,10.9,8.8,10.3,"Less than 25% P.O.C.","$60000 or more"
"18087","LaGrange County, Indiana",39193,64498,36890,75,23,21,3,1587,94.1,0.2,0.1,0.1,0,4,5.9,12325,10124,2201,82.14,17.86,2480,7644,209,1992,2689,9636,24.5,9.5,21.8,"Less than 25% P.O.C.","$60000 or more"
"18089","Lake County, Indiana",485707,56128,262879,113562,942,6736,99,92189,54.1,23.4,0.2,1.4,0,19,45.9,186731,130138,56593,69.69,30.31,12525,117613,6032,50561,18557,168174,9.6,10.7,9.9,"25% - 50% P.O.C.","$52000 - $60000"
"18091","LaPorte County, Indiana",110154,53658,87323,12027,314,627,5,7269,79.3,10.9,0.3,0.6,0,6.6,20.7,43039,31135,11904,72.34,27.66,2555,28580,1334,10570,3889,39150,8.2,11.2,9,"Less than 25% P.O.C.","$52000 - $60000"
"18093","Lawrence County, Indiana",45548,53610,43582,180,226,223,27,761,95.7,0.4,0.5,0.5,0.1,1.7,4.3,18781,14457,4324,76.98,23.02,1346,13111,343,3981,1689,17092,9.3,7.9,9,"Less than 25% P.O.C.","$52000 - $60000"
"18095","Madison County, Indiana",129455,49522,109837,10037,205,660,12,5301,84.8,7.8,0.2,0.5,0,4.1,15.2,51003,35519,15484,69.64,30.36,2565,32954,1166,14318,3731,47272,7.2,7.5,7.3,"Less than 25% P.O.C.","$44000 - $52000"
"18097","Marion County, Indiana",951869,48316,525866,263127,1885,31122,177,98928,55.2,27.6,0.2,3.3,0,10.4,44.8,372358,200544,171814,53.86,46.14,17588,182956,11833,159981,29421,342937,8.8,6.9,7.9,"25% - 50% P.O.C.","$44000 - $52000"
"18099","Marshall County, Indiana",46461,52658,40543,266,7,217,0,4688,87.3,0.6,0,0.5,0,10.1,12.7,17304,12929,4375,74.72,25.28,1711,11218,569,3806,2280,15024,13.2,13,13.2,"Less than 25% P.O.C.","$52000 - $60000"
"18101","Martin County, Indiana",10212,52726,9910,77,33,18,0,117,97,0.8,0.3,0.2,0,1.1,3,4187,3274,913,78.19,21.81,326,2948,32,881,358,3829,10,3.5,8.6,"Less than 25% P.O.C.","$52000 - $60000"
"18103","Miami County, Indiana",35815,50657,31775,1926,297,208,6,1151,88.7,5.4,0.8,0.6,0,3.2,11.3,13611,9730,3881,71.49,28.51,697,9033,484,3397,1181,12430,7.2,12.5,8.7,"Less than 25% P.O.C.","$44000 - $52000"
"18105","Monroe County, Indiana",146461,49839,122315,4431,266,9771,23,4998,83.5,3,0.2,6.7,0,3.4,16.5,55624,31106,24518,55.92,44.08,2191,28915,1172,23346,3363,52261,7,4.8,6,"Less than 25% P.O.C.","$44000 - $52000"
"18107","Montgomery County, Indiana",38287,55522,35177,277,66,314,11,1836,91.9,0.7,0.2,0.8,0,4.8,8.1,15382,11005,4377,71.54,28.46,1126,9879,495,3882,1621,13761,10.2,11.3,10.5,"Less than 25% P.O.C.","$52000 - $60000"
"18109","Morgan County, Indiana",69922,64335,67126,285,26,558,0,1102,96,0.4,0,0.8,0,1.6,4,26034,20084,5950,77.15,22.85,1909,18175,630,5320,2539,23495,9.5,10.6,9.8,"Less than 25% P.O.C.","$60000 or more"
"18111","Newton County, Indiana",13992,55356,13006,33,19,0,0,898,93,0.2,0.1,0,0,6.4,7,5573,4342,1231,77.91,22.09,346,3996,246,985,592,4981,8,20,10.6,"Less than 25% P.O.C.","$52000 - $60000"
"18113","Noble County, Indiana",47506,56789,41360,228,63,310,10,4888,87.1,0.5,0.1,0.7,0,10.3,12.9,18276,14002,4274,76.61,23.39,1763,12239,511,3763,2274,16002,12.6,12,12.4,"Less than 25% P.O.C.","$52000 - $60000"
"18115","Ohio County, Indiana",5874,60128,5663,23,6,26,0,74,96.4,0.4,0.1,0.4,0,1.3,3.6,2555,1948,607,76.24,23.76,138,1810,50,557,188,2367,7.1,8.2,7.4,"Less than 25% P.O.C.","$60000 or more"
"18117","Orange County, Indiana",19545,47917,18586,500,17,96,0,125,95.1,2.6,0.1,0.5,0,0.6,4.9,7898,5874,2024,74.37,25.63,527,5347,161,1863,688,7210,9,8,8.7,"Less than 25% P.O.C.","$44000 - $52000"
"18119","Owen County, Indiana",20835,49543,20032,47,80,103,0,262,96.1,0.2,0.4,0.5,0,1.3,3.9,8776,6950,1826,79.19,20.81,505,6445,260,1566,765,8011,7.3,14.2,8.7,"Less than 25% P.O.C.","$44000 - $52000"
"18121","Parke County, Indiana",16946,52618,16013,99,125,0,0,274,94.5,0.6,0.7,0,0,1.6,5.5,6057,4770,1287,78.75,21.25,468,4302,113,1174,581,5476,9.8,8.8,9.6,"Less than 25% P.O.C.","$52000 - $60000"
"18123","Perry County, Indiana",19102,52348,17976,552,41,97,0,266,94.1,2.9,0.2,0.5,0,1.4,5.9,7615,5920,1695,77.74,22.26,527,5393,134,1561,661,6954,8.9,7.9,8.7,"Less than 25% P.O.C.","$52000 - $60000"
"18125","Pike County, Indiana",12378,50194,11923,109,0,111,0,115,96.3,0.9,0,0.9,0,0.9,3.7,5129,4224,905,82.36,17.64,254,3970,58,847,312,4817,6,6.4,6.1,"Less than 25% P.O.C.","$44000 - $52000"
"18127","Porter County, Indiana",168636,71152,140304,5841,268,2326,132,16813,83.2,3.5,0.2,1.4,0.1,10,16.8,64517,48434,16083,75.07,24.93,4549,43885,1021,15062,5570,58947,9.4,6.3,8.6,"Less than 25% P.O.C.","$60000 or more"
"18129","Posey County, Indiana",25560,64196,24522,373,19,77,0,305,95.9,1.5,0.1,0.3,0,1.2,4.1,10155,8299,1856,81.72,18.28,653,7646,90,1766,743,9412,7.9,4.8,7.3,"Less than 25% P.O.C.","$60000 or more"
"18131","Pulaski County, Indiana",12559,49580,11821,24,20,81,19,378,94.1,0.2,0.2,0.6,0.2,3,5.9,5151,3911,1240,75.93,24.07,275,3636,65,1175,340,4811,7,5.2,6.6,"Less than 25% P.O.C.","$44000 - $52000"
"18133","Putnam County, Indiana",37384,61047,34304,951,56,926,8,721,91.8,2.5,0.1,2.5,0,1.9,8.2,13543,9697,3846,71.6,28.4,832,8865,387,3459,1219,12324,8.6,10.1,9,"Less than 25% P.O.C.","$60000 or more"
"18135","Randolph County, Indiana",24926,48036,23125,147,24,27,0,863,92.8,0.6,0.1,0.1,0,3.5,7.2,10229,7803,2426,76.28,23.72,658,7145,158,2268,816,9413,8.4,6.5,8,"Less than 25% P.O.C.","$44000 - $52000"
"18137","Ripley County, Indiana",28391,56332,27126,111,68,275,0,520,95.5,0.4,0.2,1,0,1.8,4.5,10992,8342,2650,75.89,24.11,810,7532,254,2396,1064,9928,9.7,9.6,9.7,"Less than 25% P.O.C.","$52000 - $60000"
"18139","Rush County, Indiana",16641,54346,15923,271,0,19,0,275,95.7,1.6,0,0.1,0,1.7,4.3,6667,4758,1909,71.37,28.63,398,4360,253,1656,651,6016,8.4,13.3,9.8,"Less than 25% P.O.C.","$52000 - $60000"
"18141","St. Joseph County, Indiana",270216,52769,196069,34235,769,6458,217,23501,72.6,12.7,0.3,2.4,0.1,8.7,27.4,101872,69452,32420,68.18,31.82,6500,62952,2487,29933,8987,92885,9.4,7.7,8.8,"25% - 50% P.O.C.","$52000 - $60000"
"18143","Scott County, Indiana",23759,48700,22658,48,81,117,0,541,95.4,0.2,0.3,0.5,0,2.3,4.6,8971,6456,2515,71.97,28.03,678,5778,267,2248,945,8026,10.5,10.6,10.5,"Less than 25% P.O.C.","$44000 - $52000"
"18145","Shelby County, Indiana",44438,60404,41006,519,21,250,0,1873,92.3,1.2,0,0.6,0,4.2,7.7,17823,13064,4759,73.3,26.7,1047,12017,503,4256,1550,16273,8,10.6,8.7,"Less than 25% P.O.C.","$60000 or more"
"18147","Spencer County, Indiana",20447,57305,19397,143,30,69,0,593,94.9,0.7,0.1,0.3,0,2.9,5.1,8127,6652,1475,81.85,18.15,497,6155,178,1297,675,7452,7.5,12.1,8.3,"Less than 25% P.O.C.","$52000 - $60000"
"18149","Starke County, Indiana",22952,51190,21628,198,0,60,0,869,94.2,0.9,0,0.3,0,3.8,5.8,8549,6852,1697,80.15,19.85,698,6154,238,1459,936,7613,10.2,14,10.9,"Less than 25% P.O.C.","$44000 - $52000"
"18151","Steuben County, Indiana",34453,58279,32317,114,32,152,18,1220,93.8,0.3,0.1,0.4,0.1,3.5,6.2,14261,11091,3170,77.77,22.23,826,10265,263,2907,1089,13172,7.4,8.3,7.6,"Less than 25% P.O.C.","$52000 - $60000"
"18153","Sullivan County, Indiana",20730,50245,19056,804,14,106,0,360,91.9,3.9,0.1,0.5,0,1.7,8.1,7644,5685,1959,74.37,25.63,715,4970,133,1826,848,6796,12.6,6.8,11.1,"Less than 25% P.O.C.","$44000 - $52000"
"18155","Switzerland County, Indiana",10685,49383,10191,102,0,41,0,211,95.4,1,0,0.4,0,2,4.6,4349,3255,1094,74.84,25.16,471,2784,106,988,577,3772,14.5,9.7,13.3,"Less than 25% P.O.C.","$44000 - $52000"
"18157","Tippecanoe County, Indiana",191553,53130,145252,9951,483,15510,66,15948,75.8,5.2,0.3,8.1,0,8.3,24.2,70526,38848,31678,55.08,44.92,4189,34659,1505,30173,5694,64832,10.8,4.8,8.1,"Less than 25% P.O.C.","$52000 - $60000"
"18159","Tipton County, Indiana",15162,58118,14387,16,0,38,0,425,94.9,0.1,0,0.3,0,2.8,5.1,6376,5210,1166,81.71,18.29,480,4730,59,1107,539,5837,9.2,5.1,8.5,"Less than 25% P.O.C.","$52000 - $60000"
"18161","Union County, Indiana",7113,50375,6787,4,0,145,0,126,95.4,0.1,0,2,0,1.8,4.6,2823,2032,791,71.98,28.02,121,1911,177,614,298,2525,6,22.4,10.6,"Less than 25% P.O.C.","$44000 - $52000"
"18163","Vanderburgh County, Indiana",181291,49708,151571,17223,193,2238,313,4814,83.6,9.5,0.1,1.2,0.2,2.7,16.4,75607,48981,26626,64.78,35.22,3576,45405,1860,24766,5436,70171,7.3,7,7.2,"Less than 25% P.O.C.","$44000 - $52000"
"18165","Vermillion County, Indiana",15539,50243,14984,178,44,35,6,137,96.4,1.1,0.3,0.2,0,0.9,3.6,6664,4874,1790,73.14,26.86,344,4530,131,1659,475,6189,7.1,7.3,7.1,"Less than 25% P.O.C.","$44000 - $52000"
"18167","Vigo County, Indiana",107459,45230,91866,7163,178,1983,71,2886,85.5,6.7,0.2,1.8,0.1,2.7,14.5,41994,25956,16038,61.81,38.19,2047,23909,865,15173,2912,39082,7.9,5.4,6.9,"Less than 25% P.O.C.","$44000 - $52000"
"18169","Wabash County, Indiana",31389,54259,29611,331,243,121,10,819,94.3,1.1,0.8,0.4,0,2.6,5.7,12862,9516,3346,73.99,26.01,815,8701,222,3124,1037,11825,8.6,6.6,8.1,"Less than 25% P.O.C.","$52000 - $60000"
"18171","Warren County, Indiana",8237,60553,7901,47,0,23,0,149,95.9,0.6,0,0.3,0,1.8,4.1,3357,2815,542,83.85,16.15,241,2574,59,483,300,3057,8.6,10.9,8.9,"Less than 25% P.O.C.","$60000 or more"
"18173","Warrick County, Indiana",62280,73482,57543,1028,113,1660,3,1165,92.4,1.7,0.2,2.7,0,1.9,7.6,24514,19245,5269,78.51,21.49,1781,17464,470,4799,2251,22263,9.3,8.9,9.2,"Less than 25% P.O.C.","$60000 or more"
"18175","Washington County, Indiana",27848,47983,26947,26,106,95,0,374,96.8,0.1,0.4,0.3,0,1.3,3.2,10940,8513,2427,77.82,22.18,873,7640,132,2295,1005,9935,10.3,5.4,9.2,"Less than 25% P.O.C.","$44000 - $52000"
"18177","Wayne County, Indiana",66342,46516,58470,3163,97,737,0,1990,88.1,4.8,0.1,1.1,0,3,11.9,26644,17837,8807,66.95,33.05,1464,16373,537,8270,2001,24643,8.2,6.1,7.5,"Less than 25% P.O.C.","$44000 - $52000"
"18179","Wells County, Indiana",28011,59237,26429,224,63,115,0,861,94.4,0.8,0.2,0.4,0,3.1,5.6,10888,8586,2302,78.86,21.14,920,7666,179,2123,1099,9789,10.7,7.8,10.1,"Less than 25% P.O.C.","$52000 - $60000"
"18181","White County, Indiana",24149,54576,21572,114,80,55,0,2021,89.3,0.5,0.3,0.2,0,8.4,10.7,9879,7661,2218,77.55,22.45,763,6898,197,2021,960,8919,10,8.9,9.7,"Less than 25% P.O.C.","$52000 - $60000"
"18183","Whitley County, Indiana",33730,61741,32187,137,117,124,0,694,95.4,0.4,0.3,0.4,0,2.1,4.6,13742,11293,2449,82.18,17.82,886,10407,207,2242,1093,12649,7.8,8.5,8,"Less than 25% P.O.C.","$60000 or more"
"19001","Adair County, Iowa",7085,53363,6801,39,0,39,0,146,96,0.6,0,0.6,0,2.1,4,3200,2378,822,74.31,25.69,155,2223,67,755,222,2978,6.5,8.2,6.9,"Less than 25% P.O.C.","$52000 - $60000"
"19003","Adams County, Iowa",3670,49255,3598,2,4,9,0,49,98,0.1,0.1,0.2,0,1.3,2,1598,1306,292,81.73,18.27,116,1190,32,260,148,1450,8.9,11,9.3,"Less than 25% P.O.C.","$44000 - $52000"
"19005","Allamakee County, Iowa",13813,52216,12496,176,36,77,0,914,90.5,1.3,0.3,0.6,0,6.6,9.5,5953,4723,1230,79.34,20.66,492,4231,94,1136,586,5367,10.4,7.6,9.8,"Less than 25% P.O.C.","$52000 - $60000"
"19007","Appanoose County, Iowa",12452,40167,11850,89,24,58,0,250,95.2,0.7,0.2,0.5,0,2,4.8,5353,3801,1552,71.01,28.99,207,3594,151,1401,358,4995,5.4,9.7,6.7,"Less than 25% P.O.C.","Less than $44000"
"19009","Audubon County, Iowa",5571,52055,5380,2,2,15,0,32,96.6,0,0,0.3,0,0.6,3.4,2649,2034,615,76.78,23.22,152,1882,56,559,208,2441,7.5,9.1,7.9,"Less than 25% P.O.C.","$52000 - $60000"
"19011","Benton County, Iowa",25636,67729,24618,133,41,85,0,386,96,0.5,0.2,0.3,0,1.5,4,10306,8538,1768,82.84,17.16,786,7752,144,1624,930,9376,9.2,8.1,9,"Less than 25% P.O.C.","$60000 or more"
"19013","Black Hawk County, Iowa",132393,53539,107356,12444,416,3136,312,5827,81.1,9.4,0.3,2.4,0.2,4.4,18.9,52905,34645,18260,65.49,34.51,2834,31811,1158,17102,3992,48913,8.2,6.3,7.5,"Less than 25% P.O.C.","$52000 - $60000"
"19015","Boone County, Iowa",26370,64000,24878,168,14,82,112,695,94.3,0.6,0.1,0.3,0.4,2.6,5.7,10954,8558,2396,78.13,21.87,704,7854,219,2177,923,10031,8.2,9.1,8.4,"Less than 25% P.O.C.","$60000 or more"
"19017","Bremer County, Iowa",24864,70395,23634,219,51,286,13,392,95.1,0.9,0.2,1.2,0.1,1.6,4.9,9676,8000,1676,82.68,17.32,659,7341,95,1581,754,8922,8.2,5.7,7.8,"Less than 25% P.O.C.","$60000 or more"
"19019","Buchanan County, Iowa",21118,64837,20295,36,75,54,0,333,96.1,0.2,0.4,0.3,0,1.6,3.9,8029,6368,1661,79.31,20.69,616,5752,138,1523,754,7275,9.7,8.3,9.4,"Less than 25% P.O.C.","$60000 or more"
"19021","Buena Vista County, Iowa",20058,57125,11948,505,2,1987,299,5112,59.6,2.5,0,9.9,1.5,25.5,40.4,7524,4861,2663,64.61,35.39,752,4109,482,2181,1234,6290,15.5,18.1,16.4,"25% - 50% P.O.C.","$52000 - $60000"
"19023","Butler County, Iowa",14628,57115,14124,150,25,31,15,202,96.6,1,0.2,0.2,0.1,1.4,3.4,6254,4872,1382,77.9,22.1,414,4458,82,1300,496,5758,8.5,5.9,7.9,"Less than 25% P.O.C.","$52000 - $60000"
"19025","Calhoun County, Iowa",9744,52323,9183,150,30,35,0,190,94.2,1.5,0.3,0.4,0,1.9,5.8,4146,3268,878,78.82,21.18,275,2993,68,810,343,3803,8.4,7.7,8.3,"Less than 25% P.O.C.","$52000 - $60000"
"19027","Carroll County, Iowa",20281,59212,19661,19,3,41,0,506,96.9,0.1,0,0.2,0,2.5,3.1,8726,6617,2109,75.83,24.17,712,5905,135,1974,847,7879,10.8,6.4,9.7,"Less than 25% P.O.C.","$52000 - $60000"
"19029","Cass County, Iowa",13091,50187,12475,26,32,37,18,354,95.3,0.2,0.2,0.3,0.1,2.7,4.7,5921,4099,1822,69.23,30.77,273,3826,176,1646,449,5472,6.7,9.7,7.6,"Less than 25% P.O.C.","$44000 - $52000"
"19031","Cedar County, Iowa",18457,67795,17635,260,39,67,0,377,95.5,1.4,0.2,0.4,0,2,4.5,7391,6003,1388,81.22,18.78,478,5525,66,1322,544,6847,8,4.8,7.4,"Less than 25% P.O.C.","$60000 or more"
"19033","Cerro Gordo County, Iowa",42834,53963,38805,743,127,491,51,2086,90.6,1.7,0.3,1.1,0.1,4.9,9.4,19241,13297,5944,69.11,30.89,867,12430,404,5540,1271,17970,6.5,6.8,6.6,"Less than 25% P.O.C.","$52000 - $60000"
"19035","Cherokee County, Iowa",11343,56550,10593,228,39,90,0,182,93.4,2,0.3,0.8,0,1.6,6.6,5319,3969,1350,74.62,25.38,237,3732,163,1187,400,4919,6,12.1,7.5,"Less than 25% P.O.C.","$52000 - $60000"
"19037","Chickasaw County, Iowa",12026,60034,11516,119,20,15,5,304,95.8,1,0.2,0.1,0,2.5,4.2,5173,4173,1000,80.67,19.33,454,3719,109,891,563,4610,10.9,10.9,10.9,"Less than 25% P.O.C.","$60000 or more"
"19039","Clarke County, Iowa",9360,54427,7736,6,31,69,0,1337,82.6,0.1,0.3,0.7,0,14.3,17.4,3895,2743,1152,70.42,29.58,378,2365,132,1020,510,3385,13.8,11.5,13.1,"Less than 25% P.O.C.","$52000 - $60000"
"19041","Clay County, Iowa",16211,50521,15113,47,7,105,2,598,93.2,0.3,0,0.6,0,3.7,6.8,7212,4884,2328,67.72,32.28,456,4428,128,2200,584,6628,9.3,5.5,8.1,"Less than 25% P.O.C.","$44000 - $52000"
"19043","Clayton County, Iowa",17625,53152,16907,170,33,79,0,339,95.9,1,0.2,0.4,0,1.9,4.1,7510,5597,1913,74.53,25.47,497,5100,146,1767,643,6867,8.9,7.6,8.6,"Less than 25% P.O.C.","$52000 - $60000"
"19045","Clinton County, Iowa",46909,51688,42753,1290,141,326,2,1472,91.1,2.8,0.3,0.7,0,3.1,8.9,19635,14385,5250,73.26,26.74,1294,13091,287,4963,1581,18054,9,5.5,8.1,"Less than 25% P.O.C.","$44000 - $52000"
"19047","Crawford County, Iowa",17034,55755,11212,464,47,353,27,4782,65.8,2.7,0.3,2.1,0.2,28.1,34.2,6437,4451,1986,69.15,30.85,610,3841,271,1715,881,5556,13.7,13.6,13.7,"25% - 50% P.O.C.","$52000 - $60000"
"19049","Dallas County, Iowa",87099,88479,74403,1654,98,3925,0,5334,85.4,1.9,0.1,4.5,0,6.1,14.6,34399,25363,9036,73.73,26.27,2941,22422,560,8476,3501,30898,11.6,6.2,10.2,"Less than 25% P.O.C.","$60000 or more"
"19051","Davis County, Iowa",8920,63404,8636,4,0,57,0,131,96.8,0,0,0.6,0,1.5,3.2,3176,2706,470,85.2,14.8,441,2265,17,453,458,2718,16.3,3.6,14.4,"Less than 25% P.O.C.","$60000 or more"
"19053","Decatur County, Iowa",7979,44462,7395,141,24,55,0,239,92.7,1.8,0.3,0.7,0,3,7.3,3200,2145,1055,67.03,32.97,317,1828,52,1003,369,2831,14.8,4.9,11.5,"Less than 25% P.O.C.","$44000 - $52000"
"19055","Delaware County, Iowa",17183,63750,16594,36,55,52,0,267,96.6,0.2,0.3,0.3,0,1.6,3.4,6907,5827,1080,84.36,15.64,610,5217,74,1006,684,6223,10.5,6.9,9.9,"Less than 25% P.O.C.","$60000 or more"
"19057","Des Moines County, Iowa",39386,51267,34397,2235,76,302,0,1266,87.3,5.7,0.2,0.8,0,3.2,12.7,16891,11877,5014,70.32,29.68,875,11002,258,4756,1133,15758,7.4,5.1,6.7,"Less than 25% P.O.C.","$44000 - $52000"
"19059","Dickinson County, Iowa",17127,59969,16390,77,48,152,0,344,95.7,0.4,0.3,0.9,0,2,4.3,8174,6489,1685,79.39,20.61,357,6132,117,1568,474,7700,5.5,6.9,5.8,"Less than 25% P.O.C.","$52000 - $60000"
"19061","Dubuque County, Iowa",96982,63031,88010,3404,154,1042,493,2395,90.7,3.5,0.2,1.1,0.5,2.5,9.3,38210,28023,10187,73.34,26.66,2597,25426,675,9512,3272,34938,9.3,6.6,8.6,"Less than 25% P.O.C.","$60000 or more"
"19063","Emmet County, Iowa",9438,51563,8218,187,16,24,0,920,87.1,2,0.2,0.3,0,9.7,12.9,4036,3152,884,78.1,21.9,251,2901,98,786,349,3687,8,11.1,8.6,"Less than 25% P.O.C.","$44000 - $52000"
"19065","Fayette County, Iowa",19803,51128,18546,428,16,50,0,484,93.7,2.2,0.1,0.3,0,2.4,6.3,8200,6279,1921,76.57,23.43,552,5727,137,1784,689,7511,8.8,7.1,8.4,"Less than 25% P.O.C.","$44000 - $52000"
"19067","Floyd County, Iowa",15786,50406,14449,271,97,237,24,511,91.5,1.7,0.6,1.5,0.2,3.2,8.5,6903,4916,1987,71.22,28.78,447,4469,147,1840,594,6309,9.1,7.4,8.6,"Less than 25% P.O.C.","$44000 - $52000"
"19069","Franklin County, Iowa",10162,56419,8817,25,0,0,0,1296,86.8,0.2,0,0,0,12.8,13.2,4192,3130,1062,74.67,25.33,228,2902,119,943,347,3845,7.3,11.2,8.3,"Less than 25% P.O.C.","$52000 - $60000"
"19071","Fremont County, Iowa",6946,56750,6578,53,42,0,0,193,94.7,0.8,0.6,0,0,2.8,5.3,2945,2248,697,76.33,23.67,199,2049,68,629,267,2678,8.9,9.8,9.1,"Less than 25% P.O.C.","$52000 - $60000"
"19073","Greene County, Iowa",8950,53050,8467,38,13,66,0,260,94.6,0.4,0.1,0.7,0,2.9,5.4,3971,2915,1056,73.41,26.59,262,2653,114,942,376,3595,9,10.8,9.5,"Less than 25% P.O.C.","$52000 - $60000"
"19075","Grundy County, Iowa",12299,68038,11922,74,13,34,0,158,96.9,0.6,0.1,0.3,0,1.3,3.1,5155,4204,951,81.55,18.45,414,3790,52,899,466,4689,9.8,5.5,9,"Less than 25% P.O.C.","$60000 or more"
"19077","Guthrie County, Iowa",10669,61161,10139,34,15,26,0,290,95,0.3,0.1,0.2,0,2.7,5,4452,3546,906,79.65,20.35,273,3273,86,820,359,4093,7.7,9.5,8.1,"Less than 25% P.O.C.","$60000 or more"
"19079","Hamilton County, Iowa",14997,60910,13375,202,7,455,32,904,89.2,1.3,0,3,0.2,6,10.8,6259,4530,1729,72.38,27.62,345,4185,147,1582,492,5767,7.6,8.5,7.9,"Less than 25% P.O.C.","$60000 or more"
"19081","Hancock County, Iowa",10802,61761,10064,172,19,33,0,476,93.2,1.6,0.2,0.3,0,4.4,6.8,4790,3692,1098,77.08,22.92,336,3356,119,979,455,4335,9.1,10.8,9.5,"Less than 25% P.O.C.","$60000 or more"
"19083","Hardin County, Iowa",17061,54196,15670,210,240,13,5,743,91.8,1.2,1.4,0.1,0,4.4,8.2,7148,5353,1795,74.89,25.11,441,4912,166,1629,607,6541,8.2,9.2,8.5,"Less than 25% P.O.C.","$52000 - $60000"
"19085","Harrison County, Iowa",14089,63854,13554,27,5,69,6,245,96.2,0.2,0,0.5,0,1.7,3.8,6019,4558,1461,75.73,24.27,364,4194,109,1352,473,5546,8,7.5,7.9,"Less than 25% P.O.C.","$60000 or more"
"19087","Henry County, Iowa",19941,53501,17557,444,35,517,9,974,88,2.2,0.2,2.6,0,4.9,12,7743,5511,2232,71.17,28.83,420,5091,135,2097,555,7188,7.6,6,7.2,"Less than 25% P.O.C.","$52000 - $60000"
"19089","Howard County, Iowa",9226,55060,8904,29,0,40,1,148,96.5,0.3,0,0.4,0,1.6,3.5,3810,3035,775,79.66,20.34,253,2782,48,727,301,3509,8.3,6.2,7.9,"Less than 25% P.O.C.","$52000 - $60000"
"19091","Humboldt County, Iowa",9554,54575,8926,38,28,30,0,420,93.4,0.4,0.3,0.3,0,4.4,6.6,4174,3099,1075,74.25,25.75,271,2828,61,1014,332,3842,8.7,5.7,8,"Less than 25% P.O.C.","$52000 - $60000"
"19093","Ida County, Iowa",6901,58427,6580,42,42,16,0,169,95.3,0.6,0.6,0.2,0,2.4,4.7,3011,2275,736,75.56,24.44,270,2005,25,711,295,2716,11.9,3.4,9.8,"Less than 25% P.O.C.","$52000 - $60000"
"19095","Iowa County, Iowa",16189,61443,15377,122,8,80,0,464,95,0.8,0,0.5,0,2.9,5,6780,5452,1328,80.41,19.59,509,4943,32,1296,541,6239,9.3,2.4,8,"Less than 25% P.O.C.","$60000 or more"
"19097","Jackson County, Iowa",19401,55967,18523,92,2,79,179,285,95.5,0.5,0,0.4,0.9,1.5,4.5,8239,6510,1729,79.01,20.99,477,6033,176,1553,653,7586,7.3,10.2,7.9,"Less than 25% P.O.C.","$52000 - $60000"
"19099","Jasper County, Iowa",36971,58952,34552,737,76,172,0,867,93.5,2,0.2,0.5,0,2.3,6.5,14574,10858,3716,74.5,25.5,829,10029,261,3455,1090,13484,7.6,7,7.5,"Less than 25% P.O.C.","$52000 - $60000"
"19101","Jefferson County, Iowa",18148,47708,14614,1293,3,790,0,552,80.5,7.1,0,4.4,0,3,19.5,6754,4477,2277,66.29,33.71,137,4340,209,2068,346,6408,3.1,9.2,5.1,"Less than 25% P.O.C.","$44000 - $52000"
"19103","Johnson County, Iowa",148577,62542,116441,10701,279,9246,102,8345,78.4,7.2,0.2,6.2,0.1,5.6,21.6,59134,34589,24545,58.49,41.51,2704,31885,1610,22935,4314,54820,7.8,6.6,7.3,"Less than 25% P.O.C.","$60000 or more"
"19105","Jones County, Iowa",20559,57549,19299,435,18,196,0,418,93.9,2.1,0.1,1,0,2,6.1,8130,6367,1763,78.31,21.69,401,5966,243,1520,644,7486,6.3,13.8,7.9,"Less than 25% P.O.C.","$52000 - $60000"
"19107","Keokuk County, Iowa",10188,52881,9818,46,22,29,2,178,96.4,0.5,0.2,0.3,0,1.7,3.6,4394,3445,949,78.4,21.6,328,3117,124,825,452,3942,9.5,13.1,10.3,"Less than 25% P.O.C.","$52000 - $60000"
"19109","Kossuth County, Iowa",14978,56073,14194,106,52,84,0,402,94.8,0.7,0.3,0.6,0,2.7,5.2,6646,5031,1615,75.7,24.3,438,4593,61,1554,499,6147,8.7,3.8,7.5,"Less than 25% P.O.C.","$52000 - $60000"
"19111","Lee County, Iowa",34227,49564,31082,946,77,213,0,1237,90.8,2.8,0.2,0.6,0,3.6,9.2,14233,10591,3642,74.41,25.59,991,9600,191,3451,1182,13051,9.4,5.2,8.3,"Less than 25% P.O.C.","$44000 - $52000"
"19113","Linn County, Iowa",223861,64903,192090,12076,452,5080,291,7273,85.8,5.4,0.2,2.3,0.1,3.2,14.2,90877,67095,23782,73.83,26.17,5702,61393,1412,22370,7114,83763,8.5,5.9,7.8,"Less than 25% P.O.C.","$60000 or more"
"19115","Louisa County, Iowa",11178,56673,8735,120,94,377,0,1764,78.1,1.1,0.8,3.4,0,15.8,21.9,4335,3334,1001,76.91,23.09,356,2978,131,870,487,3848,10.7,13.1,11.2,"Less than 25% P.O.C.","$52000 - $60000"
"19117","Lucas County, Iowa",8583,55205,8368,7,2,0,0,172,97.5,0.1,0,0,0,2,2.5,3701,2892,809,78.14,21.86,279,2613,30,779,309,3392,9.6,3.7,8.3,"Less than 25% P.O.C.","$52000 - $60000"
"19119","Lyon County, Iowa",11776,64982,11239,10,20,30,34,312,95.4,0.1,0.2,0.3,0.3,2.6,4.6,4548,3882,666,85.36,14.64,545,3337,104,562,649,3899,14,15.6,14.3,"Less than 25% P.O.C.","$60000 or more"
"19121","Madison County, Iowa",16012,66316,15263,38,11,201,0,327,95.3,0.2,0.1,1.3,0,2,4.7,6462,5069,1393,78.44,21.56,659,4410,77,1316,736,5726,13,5.5,11.4,"Less than 25% P.O.C.","$60000 or more"
"19123","Mahaska County, Iowa",22164,54825,20654,295,57,342,50,496,93.2,1.3,0.3,1.5,0.2,2.2,6.8,8927,6161,2766,69.02,30.98,447,5714,338,2428,785,8142,7.3,12.2,8.8,"Less than 25% P.O.C.","$52000 - $60000"
"19125","Marion County, Iowa",33172,61038,31380,349,65,371,7,639,94.6,1.1,0.2,1.1,0,1.9,5.4,13365,9463,3902,70.8,29.2,958,8505,244,3658,1202,12163,10.1,6.3,9,"Less than 25% P.O.C.","$60000 or more"
"19127","Marshall County, Iowa",39964,56437,28335,477,43,1467,15,8771,70.9,1.2,0.1,3.7,0,21.9,29.1,15419,10868,4551,70.48,29.52,1295,9573,354,4197,1649,13770,11.9,7.8,10.7,"25% - 50% P.O.C.","$52000 - $60000"
"19129","Mills County, Iowa",15034,72079,14142,103,115,70,0,480,94.1,0.7,0.8,0.5,0,3.2,5.9,5554,4324,1230,77.85,22.15,419,3905,163,1067,582,4972,9.7,13.3,10.5,"Less than 25% P.O.C.","$60000 or more"
"19131","Mitchell County, Iowa",10608,58302,10230,32,47,49,0,157,96.4,0.3,0.4,0.5,0,1.5,3.6,4355,3517,838,80.76,19.24,376,3141,24,814,400,3955,10.7,2.9,9.2,"Less than 25% P.O.C.","$52000 - $60000"
"19133","Monona County, Iowa",8730,47605,8261,27,151,0,36,175,94.6,0.3,1.7,0,0.4,2,5.4,4000,2894,1106,72.35,27.65,248,2646,33,1073,281,3719,8.6,3,7,"Less than 25% P.O.C.","$44000 - $52000"
"19135","Monroe County, Iowa",7807,58269,7515,2,0,8,0,77,96.3,0,0,0.1,0,1,3.7,3294,2632,662,79.9,20.1,259,2373,31,631,290,3004,9.8,4.7,8.8,"Less than 25% P.O.C.","$52000 - $60000"
"19137","Montgomery County, Iowa",10053,51696,9423,11,51,17,0,383,93.7,0.1,0.5,0.2,0,3.8,6.3,4554,3198,1356,70.22,29.78,292,2906,147,1209,439,4115,9.1,10.8,9.6,"Less than 25% P.O.C.","$44000 - $52000"
"19139","Muscatine County, Iowa",42889,58453,32910,1059,87,373,11,7677,76.7,2.5,0.2,0.9,0,17.9,23.3,16660,12234,4426,73.43,26.57,1079,11155,504,3922,1583,15077,8.8,11.4,9.5,"Less than 25% P.O.C.","$52000 - $60000"
"19141","O'Brien County, Iowa",13835,53703,12791,156,20,132,4,681,92.5,1.1,0.1,1,0,4.9,7.5,6169,4422,1747,71.68,28.32,345,4077,117,1630,462,5707,7.8,6.7,7.5,"Less than 25% P.O.C.","$52000 - $60000"
"19143","Osceola County, Iowa",6052,59725,5392,76,15,8,3,490,89.1,1.3,0.2,0.1,0,8.1,10.9,2633,2064,569,78.39,21.61,189,1875,43,526,232,2401,9.2,7.6,8.8,"Less than 25% P.O.C.","$52000 - $60000"
"19145","Page County, Iowa",15268,51867,13900,300,58,152,0,532,91,2,0.4,1,0,3.5,9,6280,4493,1787,71.54,28.46,299,4194,152,1635,451,5829,6.7,8.5,7.2,"Less than 25% P.O.C.","$44000 - $52000"
"19147","Palo Alto County, Iowa",9003,52932,8404,208,20,30,0,253,93.3,2.3,0.2,0.3,0,2.8,6.7,3702,2678,1024,72.34,27.66,208,2470,81,943,289,3413,7.8,7.9,7.8,"Less than 25% P.O.C.","$52000 - $60000"
"19149","Plymouth County, Iowa",25068,67297,22989,232,113,163,0,1311,91.7,0.9,0.5,0.7,0,5.2,8.3,10250,7945,2305,77.51,22.49,869,7076,196,2109,1065,9185,10.9,8.5,10.4,"Less than 25% P.O.C.","$60000 or more"
"19151","Pocahontas County, Iowa",6797,52448,6312,40,21,91,45,260,92.9,0.6,0.3,1.3,0.7,3.8,7.1,3215,2484,731,77.26,22.74,174,2310,60,671,234,2981,7,8.2,7.3,"Less than 25% P.O.C.","$52000 - $60000"
"19153","Polk County, Iowa",479612,67637,372714,31432,840,21795,382,40165,77.7,6.6,0.2,4.5,0.1,8.4,22.3,187798,126008,61790,67.1,32.9,11859,114149,5348,56442,17207,170591,9.4,8.7,9.2,"Less than 25% P.O.C.","$60000 or more"
"19155","Pottawattamie County, Iowa",93393,60065,81966,1583,311,715,10,7196,87.8,1.7,0.3,0.8,0,7.7,12.2,36799,25183,11616,68.43,31.57,2170,23013,841,10775,3011,33788,8.6,7.2,8.2,"Less than 25% P.O.C.","$60000 or more"
"19157","Poweshiek County, Iowa",18388,53852,16852,354,2,391,0,589,91.6,1.9,0,2.1,0,3.2,8.4,7767,5327,2440,68.59,31.41,407,4920,180,2260,587,7180,7.6,7.4,7.6,"Less than 25% P.O.C.","$52000 - $60000"
"19159","Ringgold County, Iowa",4964,55271,4735,4,18,49,0,125,95.4,0.1,0.4,1,0,2.5,4.6,1971,1522,449,77.22,22.78,83,1439,61,388,144,1827,5.5,13.6,7.3,"Less than 25% P.O.C.","$52000 - $60000"
"19161","Sac County, Iowa",9802,58232,9300,71,0,43,0,308,94.9,0.7,0,0.4,0,3.1,5.1,4313,3424,889,79.39,20.61,255,3169,112,777,367,3946,7.4,12.6,8.5,"Less than 25% P.O.C.","$52000 - $60000"
"19163","Scott County, Iowa",172446,61183,137911,12852,402,4675,39,11590,80,7.5,0.2,2.7,0,6.7,20,67021,46259,20762,69.02,30.98,4202,42057,1402,19360,5604,61417,9.1,6.8,8.4,"Less than 25% P.O.C.","$60000 or more"
"19165","Shelby County, Iowa",11606,58000,10974,88,30,22,0,345,94.6,0.8,0.3,0.2,0,3,5.4,5030,3896,1134,77.46,22.54,344,3552,98,1036,442,4588,8.8,8.6,8.8,"Less than 25% P.O.C.","$52000 - $60000"
"19167","Sioux County, Iowa",34827,69844,30265,122,26,257,16,3743,86.9,0.4,0.1,0.7,0,10.7,13.1,12248,9840,2408,80.34,19.66,1655,8185,437,1971,2092,10156,16.8,18.1,17.1,"Less than 25% P.O.C.","$60000 or more"
"19169","Story County, Iowa",96941,56756,81274,2149,200,7765,0,3348,83.8,2.2,0.2,8,0,3.5,16.2,37811,20235,17576,53.52,46.48,1503,18732,431,17145,1934,35877,7.4,2.5,5.1,"Less than 25% P.O.C.","$52000 - $60000"
"19171","Tama County, Iowa",17032,56037,13753,157,1231,78,0,1666,80.7,0.9,7.2,0.5,0,9.8,19.3,6767,5129,1638,75.79,24.21,499,4630,216,1422,715,6052,9.7,13.2,10.6,"Less than 25% P.O.C.","$52000 - $60000"
"19173","Taylor County, Iowa",6167,50431,5574,1,3,63,0,475,90.4,0,0,1,0,7.7,9.6,2616,2047,569,78.25,21.75,160,1887,94,475,254,2362,7.8,16.5,9.7,"Less than 25% P.O.C.","$44000 - $52000"
"19175","Union County, Iowa",12358,49900,11617,62,0,180,8,369,94,0.5,0,1.5,0.1,3,6,5176,3644,1532,70.4,29.6,427,3217,120,1412,547,4629,11.7,7.8,10.6,"Less than 25% P.O.C.","$44000 - $52000"
"19177","Van Buren County, Iowa",7150,48591,6888,31,0,37,0,113,96.3,0.4,0,0.5,0,1.6,3.7,2894,2353,541,81.31,18.69,243,2110,44,497,287,2607,10.3,8.1,9.9,"Less than 25% P.O.C.","$44000 - $52000"
"19179","Wapello County, Iowa",35141,46246,28891,1165,29,432,234,3787,82.2,3.3,0.1,1.2,0.7,10.8,17.8,14481,10357,4124,71.52,28.48,1005,9352,313,3811,1318,13163,9.7,7.6,9.1,"Less than 25% P.O.C.","$44000 - $52000"
"19181","Warren County, Iowa",50076,77048,47171,233,40,330,173,1423,94.2,0.5,0.1,0.7,0.3,2.8,5.8,19258,15215,4043,79.01,20.99,1580,13635,340,3703,1920,17338,10.4,8.4,10,"Less than 25% P.O.C.","$60000 or more"
"19183","Washington County, Iowa",22100,62556,20116,172,54,132,4,1363,91,0.8,0.2,0.6,0,6.2,9,8832,6267,2565,70.96,29.04,589,5678,289,2276,878,7954,9.4,11.3,9.9,"Less than 25% P.O.C.","$60000 or more"
"19185","Wayne County, Iowa",6429,44768,6177,19,24,6,0,102,96.1,0.3,0.4,0.1,0,1.6,3.9,2689,2181,508,81.11,18.89,248,1933,77,431,325,2364,11.4,15.2,12.1,"Less than 25% P.O.C.","$44000 - $52000"
"19187","Webster County, Iowa",36545,47466,31849,1707,115,501,5,1838,87.2,4.7,0.3,1.4,0,5,12.8,15306,10408,4898,68,32,778,9630,344,4554,1122,14184,7.5,7,7.3,"Less than 25% P.O.C.","$44000 - $52000"
"19189","Winnebago County, Iowa",10534,49870,9635,169,33,134,0,489,91.5,1.6,0.3,1.3,0,4.6,8.5,4577,3480,1097,76.03,23.97,327,3153,52,1045,379,4198,9.4,4.7,8.3,"Less than 25% P.O.C.","$44000 - $52000"
"19191","Winneshiek County, Iowa",20262,65263,19251,308,12,132,0,455,95,1.5,0.1,0.7,0,2.2,5,8257,6551,1706,79.34,20.66,534,6017,46,1660,580,7677,8.2,2.7,7,"Less than 25% P.O.C.","$60000 or more"
"19193","Woodbury County, Iowa",102586,59224,74850,3311,1617,2885,282,17049,73,3.2,1.6,2.8,0.3,16.6,27,39016,25924,13092,66.44,33.56,2921,23003,1165,11927,4086,34930,11.3,8.9,10.5,"25% - 50% P.O.C.","$52000 - $60000"
"19195","Worth County, Iowa",7445,57130,7018,115,0,25,1,222,94.3,1.5,0,0.3,0,3,5.7,3172,2461,711,77.59,22.41,193,2268,38,673,231,2941,7.8,5.3,7.3,"Less than 25% P.O.C.","$52000 - $60000"
"19197","Wright County, Iowa",12739,53333,10880,49,3,67,0,1541,85.4,0.4,0,0.5,0,12.1,14.6,5718,4100,1618,71.7,28.3,420,3680,76,1542,496,5222,10.2,4.7,8.7,"Less than 25% P.O.C.","$52000 - $60000"
"20001","Allen County, Kansas",12556,45333,11311,125,37,94,28,446,90.1,1,0.3,0.7,0.2,3.6,9.9,5372,3801,1571,70.76,29.24,284,3517,106,1465,390,4982,7.5,6.7,7.3,"Less than 25% P.O.C.","$44000 - $52000"
"20003","Anderson County, Kansas",7835,50213,7431,39,164,1,0,148,94.8,0.5,2.1,0,0,1.9,5.2,3101,2306,795,74.36,25.64,238,2068,112,683,350,2751,10.3,14.1,11.3,"Less than 25% P.O.C.","$44000 - $52000"
"20005","Atchison County, Kansas",16268,50439,14336,471,46,78,0,495,88.1,2.9,0.3,0.5,0,3,11.9,5958,4133,1825,69.37,30.63,272,3861,133,1692,405,5553,6.6,7.3,6.8,"Less than 25% P.O.C.","$44000 - $52000"
"20007","Barber County, Kansas",4624,50174,4137,37,36,75,0,254,89.5,0.8,0.8,1.6,0,5.5,10.5,1923,1380,543,71.76,28.24,139,1241,44,499,183,1740,10.1,8.1,9.5,"Less than 25% P.O.C.","$44000 - $52000"
"20009","Barton County, Kansas",26453,49723,21572,279,189,67,61,3918,81.5,1.1,0.7,0.3,0.2,14.8,18.5,10624,7464,3160,70.26,29.74,544,6920,136,3024,680,9944,7.3,4.3,6.4,"Less than 25% P.O.C.","$44000 - $52000"
"20011","Bourbon County, Kansas",14608,43917,13159,412,38,111,0,390,90.1,2.8,0.3,0.8,0,2.7,9.9,5636,4024,1612,71.4,28.6,495,3529,125,1487,620,5016,12.3,7.8,11,"Less than 25% P.O.C.","Less than $44000"
"20013","Brown County, Kansas",9626,48333,7991,64,718,60,3,446,83,0.7,7.5,0.6,0,4.6,17,3872,2719,1153,70.22,29.78,227,2492,110,1043,337,3535,8.3,9.5,8.7,"Less than 25% P.O.C.","$44000 - $52000"
"20015","Butler County, Kansas",66698,64782,59238,1567,480,813,34,3256,88.8,2.3,0.7,1.2,0.1,4.9,11.2,24870,18523,6347,74.48,25.52,2358,16165,751,5596,3109,21761,12.7,11.8,12.5,"Less than 25% P.O.C.","$60000 or more"
"20017","Chase County, Kansas",2637,45353,2405,44,16,0,0,125,91.2,1.7,0.6,0,0,4.7,8.8,1051,848,203,80.69,19.31,74,774,11,192,85,966,8.7,5.4,8.1,"Less than 25% P.O.C.","$44000 - $52000"
"20019","Chautauqua County, Kansas",3323,40298,2858,18,131,10,0,128,86,0.5,3.9,0.3,0,3.9,14,1456,1131,325,77.68,22.32,77,1054,63,262,140,1316,6.8,19.4,9.6,"Less than 25% P.O.C.","Less than $44000"
"20021","Cherokee County, Kansas",20179,43175,17760,120,353,90,74,516,88,0.6,1.7,0.4,0.4,2.6,12,7929,5765,2164,72.71,27.29,605,5160,174,1990,779,7150,10.5,8,9.8,"Less than 25% P.O.C.","Less than $44000"
"20023","Cheyenne County, Kansas",2665,47639,2481,0,0,0,0,181,93.1,0,0,0,0,6.8,6.9,1221,977,244,80.02,19.98,58,919,30,214,88,1133,5.9,12.3,7.2,"Less than 25% P.O.C.","$44000 - $52000"
"20025","Clark County, Kansas",2026,53348,1818,7,21,23,0,112,89.7,0.3,1,1.1,0,5.5,10.3,873,649,224,74.34,25.66,49,600,10,214,59,814,7.6,4.5,6.8,"Less than 25% P.O.C.","$52000 - $60000"
"20027","Clay County, Kansas",8082,53929,7595,72,53,48,0,205,94,0.9,0.7,0.6,0,2.5,6,3514,2497,1017,71.06,28.94,362,2135,20,997,382,3132,14.5,2,10.9,"Less than 25% P.O.C.","$52000 - $60000"
"20029","Cloud County, Kansas",8938,45373,8314,168,19,8,0,283,93,1.9,0.2,0.1,0,3.2,7,3689,2690,999,72.92,27.08,281,2409,105,894,386,3303,10.4,10.5,10.5,"Less than 25% P.O.C.","$44000 - $52000"
"20031","Coffey County, Kansas",8254,59583,7700,66,19,8,0,222,93.3,0.8,0.2,0.1,0,2.7,6.7,3585,2720,865,75.87,24.13,183,2537,77,788,260,3325,6.7,8.9,7.3,"Less than 25% P.O.C.","$52000 - $60000"
"20033","Comanche County, Kansas",1740,54821,1671,0,0,0,0,66,96,0,0,0,0,3.8,4,751,598,153,79.63,20.37,62,536,10,143,72,679,10.4,6.5,9.6,"Less than 25% P.O.C.","$52000 - $60000"
"20035","Cowley County, Kansas",35351,50102,28155,1019,472,569,3,3839,79.6,2.9,1.3,1.6,0,10.9,20.4,13499,9102,4397,67.43,32.57,670,8432,519,3878,1189,12310,7.4,11.8,8.8,"Less than 25% P.O.C.","$44000 - $52000"
"20037","Crawford County, Kansas",38968,41004,33737,830,140,724,0,2225,86.6,2.1,0.4,1.9,0,5.7,13.4,15284,9076,6208,59.38,40.62,788,8288,350,5858,1138,14146,8.7,5.6,7.4,"Less than 25% P.O.C.","Less than $44000"
"20039","Decatur County, Kansas",2860,48125,2725,15,13,11,0,85,95.3,0.5,0.5,0.4,0,3,4.7,1442,1063,379,73.72,26.28,56,1007,9,370,65,1377,5.3,2.4,4.5,"Less than 25% P.O.C.","$44000 - $52000"
"20041","Dickinson County, Kansas",18828,49991,17102,256,166,100,0,881,90.8,1.4,0.9,0.5,0,4.7,9.2,7911,5586,2325,70.61,29.39,633,4953,145,2180,778,7133,11.3,6.2,9.8,"Less than 25% P.O.C.","$44000 - $52000"
"20043","Doniphan County, Kansas",7684,49703,6938,452,12,5,0,214,90.3,5.9,0.2,0.1,0,2.8,9.7,3046,2194,852,72.03,27.97,247,1947,45,807,292,2754,11.3,5.3,9.6,"Less than 25% P.O.C.","$44000 - $52000"
"20045","Douglas County, Kansas",120290,59435,94306,4959,2636,6283,10,7555,78.4,4.1,2.2,5.2,0,6.3,21.6,46936,24082,22854,51.31,48.69,1930,22152,833,22021,2763,44173,8,3.6,5.9,"Less than 25% P.O.C.","$52000 - $60000"
"20047","Edwards County, Kansas",2869,50902,2185,10,0,22,0,594,76.2,0.3,0,0.8,0,20.7,23.8,1308,1020,288,77.98,22.02,60,960,19,269,79,1229,5.9,6.6,6,"Less than 25% P.O.C.","$44000 - $52000"
"20049","Elk County, Kansas",2523,38750,2272,10,43,12,0,115,90.1,0.4,1.7,0.5,0,4.6,9.9,1128,897,231,79.52,20.48,79,818,12,219,91,1037,8.8,5.2,8.1,"Less than 25% P.O.C.","Less than $44000"
"20051","Ellis County, Kansas",28775,52883,25729,312,69,324,96,1648,89.4,1.1,0.2,1.1,0.3,5.7,10.6,11544,7061,4483,61.17,38.83,624,6437,223,4260,847,10697,8.8,5,7.3,"Less than 25% P.O.C.","$52000 - $60000"
"20053","Ellsworth County, Kansas",6231,54902,5341,199,48,80,0,384,85.7,3.2,0.8,1.3,0,6.2,14.3,2388,1835,553,76.84,23.16,165,1670,30,523,195,2193,9,5.4,8.2,"Less than 25% P.O.C.","$52000 - $60000"
"20055","Finney County, Kansas",36750,60798,15190,1007,125,1446,0,18340,41.3,2.7,0.3,3.9,0,49.9,58.7,12519,8058,4461,64.37,35.63,1256,6802,926,3535,2182,10337,15.6,20.8,17.4,"50% - 75% P.O.C.","$60000 or more"
"20057","Ford County, Kansas",34179,51711,13577,652,158,469,14,18817,39.7,1.9,0.5,1.4,0,55.1,60.3,11344,6978,4366,61.51,38.49,1204,5774,524,3842,1728,9616,17.3,12,15.2,"50% - 75% P.O.C.","$44000 - $52000"
"20059","Franklin County, Kansas",25558,56582,23256,204,102,98,0,1065,91,0.8,0.4,0.4,0,4.2,9,10118,7317,2801,72.32,27.68,650,6667,271,2530,921,9197,8.9,9.7,9.1,"Less than 25% P.O.C.","$52000 - $60000"
"20061","Geary County, Kansas",34025,53133,19259,6017,336,1006,352,5506,56.6,17.7,1,3,1,16.2,43.4,12684,4809,7875,37.91,62.09,508,4301,794,7081,1302,11382,10.6,10.1,10.3,"25% - 50% P.O.C.","$52000 - $60000"
"20063","Gove County, Kansas",2644,48317,2457,3,9,14,0,90,92.9,0.1,0.3,0.5,0,3.4,7.1,1217,922,295,75.76,24.24,101,821,24,271,125,1092,11,8.1,10.3,"Less than 25% P.O.C.","$44000 - $52000"
"20065","Graham County, Kansas",2519,46375,2230,105,0,44,0,50,88.5,4.2,0,1.7,0,2,11.5,1196,984,212,82.27,17.73,70,914,9,203,79,1117,7.1,4.2,6.6,"Less than 25% P.O.C.","$44000 - $52000"
"20067","Grant County, Kansas",7467,53413,3857,3,0,32,0,3554,51.7,0,0,0.4,0,47.6,48.3,2551,1900,651,74.48,25.52,220,1680,42,609,262,2289,11.6,6.5,10.3,"25% - 50% P.O.C.","$52000 - $60000"
"20069","Gray County, Kansas",6039,64930,4941,0,11,7,22,964,81.8,0,0.2,0.1,0.4,16,18.2,2151,1681,470,78.15,21.85,318,1363,57,413,375,1776,18.9,12.1,17.4,"Less than 25% P.O.C.","$60000 or more"
"20071","Greeley County, Kansas",1185,54112,883,0,7,0,0,293,74.5,0,0.6,0,0,24.7,25.5,519,327,192,63.01,36.99,15,312,28,164,43,476,4.6,14.6,8.3,"25% - 50% P.O.C.","$52000 - $60000"
"20073","Greenwood County, Kansas",6081,41982,5588,13,6,11,0,236,91.9,0.2,0.1,0.2,0,3.9,8.1,2769,2043,726,73.78,26.22,192,1851,93,633,285,2484,9.4,12.8,10.3,"Less than 25% P.O.C.","Less than $44000"
"20075","Hamilton County, Kansas",2591,46944,1671,48,0,0,0,854,64.5,1.9,0,0,0,33,35.5,890,638,252,71.69,28.31,20,618,53,199,73,817,3.1,21,8.2,"25% - 50% P.O.C.","$44000 - $52000"
"20077","Harper County, Kansas",5594,49865,5043,7,74,22,11,343,90.2,0.1,1.3,0.4,0.2,6.1,9.8,2265,1577,688,69.62,30.38,116,1461,42,646,158,2107,7.4,6.1,7,"Less than 25% P.O.C.","$44000 - $52000"
"20079","Harvey County, Kansas",34503,57982,28557,522,64,218,62,4101,82.8,1.5,0.2,0.6,0.2,11.9,17.2,13290,9513,3777,71.58,28.42,1046,8467,340,3437,1386,11904,11,9,10.4,"Less than 25% P.O.C.","$52000 - $60000"
"20081","Haskell County, Kansas",4018,55064,2684,1,56,5,0,1230,66.8,0,1.4,0.1,0,30.6,33.2,1320,1006,314,76.21,23.79,106,900,69,245,175,1145,10.5,22,13.3,"25% - 50% P.O.C.","$52000 - $60000"
"20083","Hodgeman County, Kansas",1876,61211,1653,1,2,36,0,149,88.1,0.1,0.1,1.9,0,7.9,11.9,767,625,142,81.49,18.51,49,576,13,129,62,705,7.8,9.2,8.1,"Less than 25% P.O.C.","$60000 or more"
"20085","Jackson County, Kansas",13266,57914,11127,28,999,72,18,613,83.9,0.2,7.5,0.5,0.1,4.6,16.1,5465,4130,1335,75.57,24.43,349,3781,219,1116,568,4897,8.5,16.4,10.4,"Less than 25% P.O.C.","$52000 - $60000"
"20087","Jefferson County, Kansas",18890,64864,17677,137,144,3,0,517,93.6,0.7,0.8,0,0,2.7,6.4,7575,6368,1207,84.07,15.93,504,5864,152,1055,656,6919,7.9,12.6,8.7,"Less than 25% P.O.C.","$60000 or more"
"20089","Jewell County, Kansas",2885,40676,2745,10,18,5,4,69,95.1,0.3,0.6,0.2,0.1,2.4,4.9,1380,1122,258,81.3,18.7,55,1067,17,241,72,1308,4.9,6.6,5.2,"Less than 25% P.O.C.","Less than $44000"
"20091","Johnson County, Kansas",591506,89087,472754,27116,1207,29891,170,45285,79.9,4.6,0.2,5.1,0,7.7,20.1,228592,158251,70341,69.23,30.77,15761,142490,3858,66483,19619,208973,10,5.5,8.6,"Less than 25% P.O.C.","$60000 or more"
"20093","Kearny County, Kansas",3907,52599,2612,15,0,15,0,1239,66.9,0.4,0,0.4,0,31.7,33.1,1201,914,287,76.1,23.9,116,798,38,249,154,1047,12.7,13.2,12.8,"25% - 50% P.O.C.","$52000 - $60000"
"20095","Kingman County, Kansas",7340,60469,6836,34,26,2,0,263,93.1,0.5,0.4,0,0,3.6,6.9,3133,2461,672,78.55,21.45,194,2267,62,610,256,2877,7.9,9.2,8.2,"Less than 25% P.O.C.","$60000 or more"
"20097","Kiowa County, Kansas",2505,53274,2221,16,17,19,0,160,88.7,0.6,0.7,0.8,0,6.4,11.3,985,695,290,70.56,29.44,57,638,33,257,90,895,8.2,11.4,9.1,"Less than 25% P.O.C.","$52000 - $60000"
"20099","Labette County, Kansas",20119,47643,17186,949,150,31,0,911,85.4,4.7,0.7,0.2,0,4.5,14.6,8176,5683,2493,69.51,30.49,612,5071,317,2176,929,7247,10.8,12.7,11.4,"Less than 25% P.O.C.","$44000 - $52000"
"20101","Lane County, Kansas",1564,52125,1424,0,12,19,4,105,91,0,0.8,1.2,0.3,6.7,9,757,572,185,75.56,24.44,33,539,13,172,46,711,5.8,7,6.1,"Less than 25% P.O.C.","$52000 - $60000"
"20103","Leavenworth County, Kansas",80745,73013,63710,6611,461,1170,81,5661,78.9,8.2,0.6,1.4,0.1,7,21.1,27253,18374,8879,67.42,32.58,2087,16287,1002,7877,3089,24164,11.4,11.3,11.3,"Less than 25% P.O.C.","$60000 or more"
"20105","Lincoln County, Kansas",3044,45076,2884,5,0,0,0,102,94.7,0.2,0,0,0,3.4,5.3,1248,972,276,77.88,22.12,73,899,32,244,105,1143,7.5,11.6,8.4,"Less than 25% P.O.C.","$44000 - $52000"
"20107","Linn County, Kansas",9671,48778,9047,53,64,50,0,261,93.5,0.5,0.7,0.5,0,2.7,6.5,4497,3485,1012,77.5,22.5,360,3125,113,899,473,4024,10.3,11.2,10.5,"Less than 25% P.O.C.","$44000 - $52000"
"20109","Logan County, Kansas",2805,51740,2526,2,23,0,0,172,90.1,0.1,0.8,0,0,6.1,9.9,1153,798,355,69.21,30.79,55,743,27,328,82,1071,6.9,7.6,7.1,"Less than 25% P.O.C.","$44000 - $52000"
"20111","Lyon County, Kansas",33251,46338,23642,741,172,688,0,7059,71.1,2.2,0.5,2.1,0,21.2,28.9,13569,8143,5426,60.01,39.99,678,7465,427,4999,1105,12464,8.3,7.9,8.1,"25% - 50% P.O.C.","$44000 - $52000"
"20113","McPherson County, Kansas",28567,59089,26163,309,142,193,0,1205,91.6,1.1,0.5,0.7,0,4.2,8.4,12334,8573,3761,69.51,30.49,1015,7558,105,3656,1120,11214,11.8,2.8,9.1,"Less than 25% P.O.C.","$52000 - $60000"
"20115","Marion County, Kansas",11964,52123,11073,86,18,34,0,447,92.6,0.7,0.2,0.3,0,3.7,7.4,4846,3806,1040,78.54,21.46,345,3461,92,948,437,4409,9.1,8.8,9,"Less than 25% P.O.C.","$52000 - $60000"
"20117","Marshall County, Kansas",9749,51895,9224,30,5,38,25,246,94.6,0.3,0.1,0.4,0.3,2.5,5.4,4085,3215,870,78.7,21.3,246,2969,79,791,325,3760,7.7,9.1,8,"Less than 25% P.O.C.","$44000 - $52000"
"20119","Meade County, Kansas",4180,59316,3154,26,9,30,0,856,75.5,0.6,0.2,0.7,0,20.5,24.5,1689,1169,520,69.21,30.79,145,1024,23,497,168,1521,12.4,4.4,9.9,"Less than 25% P.O.C.","$52000 - $60000"
"20121","Miami County, Kansas",33417,71995,30976,497,270,191,0,1078,92.7,1.5,0.8,0.6,0,3.2,7.3,12835,10169,2666,79.23,20.77,1046,9123,200,2466,1246,11589,10.3,7.5,9.7,"Less than 25% P.O.C.","$60000 or more"
"20123","Mitchell County, Kansas",6145,46203,5833,44,44,17,0,150,94.9,0.7,0.7,0.3,0,2.4,5.1,2570,1832,738,71.28,28.72,157,1675,12,726,169,2401,8.6,1.6,6.6,"Less than 25% P.O.C.","$44000 - $52000"
"20125","Montgomery County, Kansas",32521,45157,25832,1608,1054,317,59,2197,79.4,4.9,3.2,1,0.2,6.8,20.6,13576,9337,4239,68.78,31.22,764,8573,529,3710,1293,12283,8.2,12.5,9.5,"Less than 25% P.O.C.","$44000 - $52000"
"20127","Morris County, Kansas",5566,55658,5097,11,6,24,0,279,91.6,0.2,0.1,0.4,0,5,8.4,2280,1832,448,80.35,19.65,131,1701,20,428,151,2129,7.2,4.5,6.6,"Less than 25% P.O.C.","$52000 - $60000"
"20129","Morton County, Kansas",2754,47750,1961,22,0,17,0,644,71.2,0.8,0,0.6,0,23.4,28.8,1038,721,317,69.46,30.54,53,668,47,270,100,938,7.4,14.8,9.6,"25% - 50% P.O.C.","$44000 - $52000"
"20131","Nemaha County, Kansas",10121,63216,9629,73,61,12,0,213,95.1,0.7,0.6,0.1,0,2.1,4.9,4007,3002,1005,74.92,25.08,337,2665,90,915,427,3580,11.2,9,10.7,"Less than 25% P.O.C.","$60000 or more"
"20133","Neosho County, Kansas",16108,46291,14461,195,63,11,0,897,89.8,1.2,0.4,0.1,0,5.6,10.2,6601,4644,1957,70.35,29.65,421,4223,195,1762,616,5985,9.1,10,9.3,"Less than 25% P.O.C.","$44000 - $52000"
"20135","Ness County, Kansas",2876,56492,2512,15,9,10,0,294,87.3,0.5,0.3,0.3,0,10.2,12.7,1269,1058,211,83.37,16.63,104,954,10,201,114,1155,9.8,4.7,9,"Less than 25% P.O.C.","$52000 - $60000"
"20137","Norton County, Kansas",5446,49038,4847,151,31,27,0,283,89,2.8,0.6,0.5,0,5.2,11,1830,1467,363,80.16,19.84,199,1268,8,355,207,1623,13.6,2.2,11.3,"Less than 25% P.O.C.","$44000 - $52000"
"20139","Osage County, Kansas",15881,54090,14807,94,24,30,1,516,93.2,0.6,0.2,0.2,0,3.2,6.8,6607,4935,1672,74.69,25.31,488,4447,175,1497,663,5944,9.9,10.5,10,"Less than 25% P.O.C.","$52000 - $60000"
"20141","Osborne County, Kansas",3530,51286,3334,17,14,3,0,76,94.4,0.5,0.4,0.1,0,2.2,5.6,1648,1232,416,74.76,25.24,106,1126,26,390,132,1516,8.6,6.2,8,"Less than 25% P.O.C.","$44000 - $52000"
"20143","Ottawa County, Kansas",5822,54784,5478,57,33,36,0,158,94.1,1,0.6,0.6,0,2.7,5.9,2446,1947,499,79.6,20.4,144,1803,51,448,195,2251,7.4,10.2,8,"Less than 25% P.O.C.","$52000 - $60000"
"20145","Pawnee County, Kansas",6629,49917,5577,292,57,4,0,511,84.1,4.4,0.9,0.1,0,7.7,15.9,2448,1617,831,66.05,33.95,92,1525,45,786,137,2311,5.7,5.4,5.6,"Less than 25% P.O.C.","$44000 - $52000"
"20147","Phillips County, Kansas",5340,50093,5001,33,20,29,5,180,93.7,0.6,0.4,0.5,0.1,3.4,6.3,2316,1754,562,75.73,24.27,180,1574,29,533,209,2107,10.3,5.2,9,"Less than 25% P.O.C.","$44000 - $52000"
"20149","Pottawatomie County, Kansas",23847,66835,21433,311,203,186,0,1236,89.9,1.3,0.9,0.8,0,5.2,10.1,8698,6841,1857,78.65,21.35,952,5889,137,1720,1089,7609,13.9,7.4,12.5,"Less than 25% P.O.C.","$60000 or more"
"20151","Pratt County, Kansas",9452,52327,8350,239,28,10,0,676,88.3,2.5,0.3,0.1,0,7.2,11.7,3652,2474,1178,67.74,32.26,309,2165,125,1053,434,3218,12.5,10.6,11.9,"Less than 25% P.O.C.","$52000 - $60000"
"20153","Rawlins County, Kansas",2502,53207,2247,16,18,3,0,180,89.8,0.6,0.7,0.1,0,7.2,10.2,1176,871,305,74.06,25.94,61,810,42,263,103,1073,7,13.8,8.8,"Less than 25% P.O.C.","$52000 - $60000"
"20155","Reno County, Kansas",62765,49936,52751,1704,479,354,4,5951,84,2.7,0.8,0.6,0,9.5,16,25014,17331,7683,69.29,30.71,1615,15716,431,7252,2046,22968,9.3,5.6,8.2,"Less than 25% P.O.C.","$44000 - $52000"
"20157","Republic County, Kansas",4658,47976,4444,53,11,11,0,95,95.4,1.1,0.2,0.2,0,2,4.6,2218,1617,601,72.9,27.1,112,1505,69,532,181,2037,6.9,11.5,8.2,"Less than 25% P.O.C.","$44000 - $52000"
"20159","Rice County, Kansas",9658,53012,8029,163,67,74,14,1100,83.1,1.7,0.7,0.8,0.1,11.4,16.9,3917,2918,999,74.5,25.5,326,2592,77,922,403,3514,11.2,7.7,10.3,"Less than 25% P.O.C.","$52000 - $60000"
"20161","Riley County, Kansas",75056,51208,57436,4571,254,3684,143,6250,76.5,6.1,0.3,4.9,0.2,8.3,23.5,26490,11441,15049,43.19,56.81,769,10672,757,14292,1526,24964,6.7,5,5.8,"Less than 25% P.O.C.","$44000 - $52000"
"20163","Rooks County, Kansas",5053,49415,4756,88,8,4,11,127,94.1,1.7,0.2,0.1,0.2,2.5,5.9,2176,1675,501,76.98,23.02,141,1534,18,483,159,2017,8.4,3.6,7.3,"Less than 25% P.O.C.","$44000 - $52000"
"20165","Rush County, Kansas",3022,47981,2793,6,0,17,0,98,92.4,0.2,0,0.6,0,3.2,7.6,1421,1077,344,75.79,24.21,78,999,7,337,85,1336,7.2,2,6,"Less than 25% P.O.C.","$44000 - $52000"
"20167","Russell County, Kansas",6948,44792,6414,160,62,0,23,237,92.3,2.3,0.9,0,0.3,3.4,7.7,3015,2352,663,78.01,21.99,131,2221,39,624,170,2845,5.6,5.9,5.6,"Less than 25% P.O.C.","$44000 - $52000"
"20169","Saline County, Kansas",54701,52200,43855,1521,254,1233,15,6170,80.2,2.8,0.5,2.3,0,11.3,19.8,21959,14646,7313,66.7,33.3,1126,13520,553,6760,1679,20280,7.7,7.6,7.6,"Less than 25% P.O.C.","$52000 - $60000"
"20171","Scott County, Kansas",4917,65417,4004,0,4,61,3,766,81.4,0,0.1,1.2,0.1,15.6,18.6,1967,1376,591,69.95,30.05,185,1191,57,534,242,1725,13.4,9.6,12.3,"Less than 25% P.O.C.","$60000 or more"
"20173","Sedgwick County, Kansas",513375,56524,349470,44037,3207,21982,192,74791,68.1,8.6,0.6,4.3,0,14.6,31.9,197229,124155,73074,62.95,37.05,14743,109412,7536,65538,22279,174950,11.9,10.3,11.3,"25% - 50% P.O.C.","$52000 - $60000"
"20175","Seward County, Kansas",22349,49291,6725,1007,124,592,0,13685,30.1,4.5,0.6,2.6,0,61.2,69.9,7321,4884,2437,66.71,33.29,908,3976,298,2139,1206,6115,18.6,12.2,16.5,"50% - 75% P.O.C.","$44000 - $52000"
"20177","Shawnee County, Kansas",177852,56762,131504,14783,1425,2631,37,21961,73.9,8.3,0.8,1.5,0,12.3,26.1,72267,46560,25707,64.43,35.57,3881,42679,1658,24049,5539,66728,8.3,6.4,7.7,"25% - 50% P.O.C.","$52000 - $60000"
"20179","Sheridan County, Kansas",2506,62885,2330,25,8,0,0,128,93,1,0.3,0,0,5.1,7,1134,870,264,76.72,23.28,58,812,39,225,97,1037,6.7,14.8,8.6,"Less than 25% P.O.C.","$60000 or more"
"20181","Sherman County, Kansas",5938,54754,4965,42,49,55,0,722,83.6,0.7,0.8,0.9,0,12.2,16.4,2544,1702,842,66.9,33.1,122,1580,93,749,215,2329,7.2,11,8.5,"Less than 25% P.O.C.","$52000 - $60000"
"20183","Smith County, Kansas",3627,43429,3434,12,19,27,0,81,94.7,0.3,0.5,0.7,0,2.2,5.3,1701,1311,390,77.07,22.93,115,1196,15,375,130,1571,8.8,3.8,7.6,"Less than 25% P.O.C.","Less than $44000"
"20185","Stafford County, Kansas",4181,49375,3486,12,47,4,0,558,83.4,0.3,1.1,0.1,0,13.3,16.6,1771,1438,333,81.2,18.8,157,1281,14,319,171,1600,10.9,4.2,9.7,"Less than 25% P.O.C.","$44000 - $52000"
"20187","Stanton County, Kansas",2052,52054,1183,0,3,0,0,833,57.7,0,0.1,0,0,40.6,42.3,733,545,188,74.35,25.65,5,540,23,165,28,705,0.9,12.2,3.8,"25% - 50% P.O.C.","$52000 - $60000"
"20189","Stevens County, Kansas",5603,57806,3393,43,22,18,0,2040,60.6,0.8,0.4,0.3,0,36.4,39.4,1814,1274,540,70.23,29.77,207,1067,59,481,266,1548,16.2,10.9,14.7,"25% - 50% P.O.C.","$52000 - $60000"
"20191","Sumner County, Kansas",23114,55000,20704,221,298,146,0,1252,89.6,1,1.3,0.6,0,5.4,10.4,9416,6979,2437,74.12,25.88,732,6247,275,2162,1007,8409,10.5,11.3,10.7,"Less than 25% P.O.C.","$52000 - $60000"
"20193","Thomas County, Kansas",7810,60124,7032,167,0,72,0,510,90,2.1,0,0.9,0,6.5,10,3375,2282,1093,67.61,32.39,187,2095,183,910,370,3005,8.2,16.7,11,"Less than 25% P.O.C.","$60000 or more"
"20195","Trego County, Kansas",2840,57966,2700,3,2,48,0,61,95.1,0.1,0.1,1.7,0,2.1,4.9,1379,1033,346,74.91,25.09,78,955,10,336,88,1291,7.6,2.9,6.4,"Less than 25% P.O.C.","$52000 - $60000"
"20197","Wabaunsee County, Kansas",6889,61178,6349,37,22,88,3,265,92.2,0.5,0.3,1.3,0,3.8,7.8,2744,2345,399,85.46,14.54,252,2093,58,341,310,2434,10.7,14.5,11.3,"Less than 25% P.O.C.","$60000 or more"
"20199","Wallace County, Kansas",1574,63269,1441,3,0,6,0,74,91.6,0.2,0,0.4,0,4.7,8.4,636,483,153,75.94,24.06,61,422,2,151,63,573,12.6,1.3,9.9,"Less than 25% P.O.C.","$60000 or more"
"20201","Washington County, Kansas",5493,50588,5259,6,3,8,0,197,95.7,0.1,0.1,0.1,0,3.6,4.3,2332,1817,515,77.92,22.08,206,1611,13,502,219,2113,11.3,2.5,9.4,"Less than 25% P.O.C.","$44000 - $52000"
"20203","Wichita County, Kansas",2130,57978,1315,20,2,14,0,750,61.7,0.9,0.1,0.7,0,35.2,38.3,934,685,249,73.34,26.66,63,622,7,242,70,864,9.2,2.8,7.5,"25% - 50% P.O.C.","$52000 - $60000"
"20205","Wilson County, Kansas",8688,48341,7995,40,43,1,3,279,92,0.5,0.5,0,0,3.2,8,3712,2721,991,73.3,26.7,294,2427,132,859,426,3286,10.8,13.3,11.5,"Less than 25% P.O.C.","$44000 - $52000"
"20207","Woodson County, Kansas",3157,39643,2926,14,34,0,0,12,92.7,0.4,1.1,0,0,0.4,7.3,1434,1105,329,77.06,22.94,87,1018,38,291,125,1309,7.9,11.6,8.7,"Less than 25% P.O.C.","Less than $44000"
"20209","Wyandotte County, Kansas",164861,46881,67390,35794,518,7509,354,47625,40.9,21.7,0.3,4.6,0.2,28.9,59.1,60128,34518,25610,57.41,42.59,4414,30104,2664,22946,7078,53050,12.8,10.4,11.8,"50% - 75% P.O.C.","$44000 - $52000"
"21001","Adair County, Kentucky",19222,38021,17930,595,45,98,0,376,93.3,3.1,0.2,0.5,0,2,6.7,6977,5311,1666,76.12,23.88,420,4891,93,1573,513,6464,7.9,5.6,7.4,"Less than 25% P.O.C.","Less than $44000"
"21003","Allen County, Kentucky",20944,44036,19901,208,0,130,0,452,95,1,0,0.6,0,2.2,5,7605,5698,1907,74.92,25.08,479,5219,209,1698,688,6917,8.4,11,9,"Less than 25% P.O.C.","$44000 - $52000"
"21005","Anderson County, Kentucky",22409,55334,21018,627,0,61,9,403,93.8,2.8,0,0.3,0,1.8,6.2,8694,6612,2082,76.05,23.95,542,6070,227,1855,769,7925,8.2,10.9,8.8,"Less than 25% P.O.C.","$52000 - $60000"
"21007","Ballard County, Kentucky",8032,45048,7428,328,19,18,0,109,92.5,4.1,0.2,0.2,0,1.4,7.5,3065,2473,592,80.69,19.31,236,2237,44,548,280,2785,9.5,7.4,9.1,"Less than 25% P.O.C.","$44000 - $52000"
"21009","Barren County, Kentucky",43884,41459,39665,1521,54,148,0,1415,90.4,3.5,0.1,0.3,0,3.2,9.6,16931,11290,5641,66.68,33.32,687,10603,558,5083,1245,15686,6.1,9.9,7.4,"Less than 25% P.O.C.","Less than $44000"
"21011","Bath County, Kentucky",12355,44898,11745,188,14,58,0,206,95.1,1.5,0.1,0.5,0,1.7,4.9,4827,3479,1348,72.07,27.93,309,3170,97,1251,406,4421,8.9,7.2,8.4,"Less than 25% P.O.C.","$44000 - $52000"
"21013","Bell County, Kentucky",26791,26272,25249,739,60,45,0,285,94.2,2.8,0.2,0.2,0,1.1,5.8,10624,7017,3607,66.05,33.95,532,6485,346,3261,878,9746,7.6,9.6,8.3,"Less than 25% P.O.C.","Less than $44000"
"21015","Boone County, Kentucky",130820,78327,114783,3775,126,3137,0,5546,87.7,2.9,0.1,2.4,0,4.2,12.3,46997,35015,11982,74.5,25.5,4632,30383,1082,10900,5714,41283,13.2,9,12.2,"Less than 25% P.O.C.","$60000 or more"
"21017","Bourbon County, Kentucky",20058,49637,17073,1389,0,162,0,1364,85.1,6.9,0,0.8,0,6.8,14.9,8106,5119,2987,63.15,36.85,267,4852,174,2813,441,7665,5.2,5.8,5.4,"Less than 25% P.O.C.","$44000 - $52000"
"21019","Boyd County, Kentucky",47682,48308,44393,1094,30,142,14,866,93.1,2.3,0.1,0.3,0,1.8,6.9,18210,12521,5689,68.76,31.24,784,11737,479,5210,1263,16947,6.3,8.4,6.9,"Less than 25% P.O.C.","$44000 - $52000"
"21021","Boyle County, Kentucky",29972,46382,25597,2375,91,252,0,996,85.4,7.9,0.3,0.8,0,3.3,14.6,11023,7404,3619,67.17,32.83,332,7072,290,3329,622,10401,4.5,8,5.6,"Less than 25% P.O.C.","$44000 - $52000"
"21023","Bracken County, Kentucky",8305,49158,7979,30,24,91,0,68,96.1,0.4,0.3,1.1,0,0.8,3.9,3318,2456,862,74.02,25.98,181,2275,127,735,308,3010,7.4,14.7,9.3,"Less than 25% P.O.C.","$44000 - $52000"
"21025","Breathitt County, Kentucky",12977,27344,12530,171,30,43,0,123,96.6,1.3,0.2,0.3,0,0.9,3.4,5358,3805,1553,71.02,28.98,199,3606,141,1412,340,5018,5.2,9.1,6.3,"Less than 25% P.O.C.","Less than $44000"
"21027","Breckinridge County, Kentucky",20176,47190,19028,358,53,71,0,314,94.3,1.8,0.3,0.4,0,1.6,5.7,7598,6123,1475,80.59,19.41,600,5523,116,1359,716,6882,9.8,7.9,9.4,"Less than 25% P.O.C.","$44000 - $52000"
"21029","Bullitt County, Kentucky",80171,63348,75689,805,199,555,17,1608,94.4,1,0.2,0.7,0,2,5.6,29690,23843,5847,80.31,19.69,2107,21736,539,5308,2646,27044,8.8,9.2,8.9,"Less than 25% P.O.C.","$60000 or more"
"21031","Butler County, Kentucky",12764,41763,12089,70,20,40,5,419,94.7,0.5,0.2,0.3,0,3.3,5.3,4958,3572,1386,72.05,27.95,270,3302,133,1253,403,4555,7.6,9.6,8.1,"Less than 25% P.O.C.","Less than $44000"
"21033","Caldwell County, Kentucky",12702,44775,11544,796,0,0,0,318,90.9,6.3,0,0,0,2.5,9.1,5163,3943,1220,76.37,23.63,152,3791,127,1093,279,4884,3.9,10.4,5.4,"Less than 25% P.O.C.","$44000 - $52000"
"21035","Calloway County, Kentucky",38837,42273,34816,1356,122,426,89,1055,89.6,3.5,0.3,1.1,0.2,2.7,10.4,14996,9364,5632,62.44,37.56,434,8930,301,5331,735,14261,4.6,5.3,4.9,"Less than 25% P.O.C.","Less than $44000"
"21037","Campbell County, Kentucky",92861,63050,85709,2967,74,904,13,1903,92.3,3.2,0.1,1,0,2,7.7,36746,25624,11122,69.73,30.27,2484,23140,555,10567,3039,33707,9.7,5,8.3,"Less than 25% P.O.C.","$60000 or more"
"21039","Carlisle County, Kentucky",4784,45109,4482,38,31,38,0,112,93.7,0.8,0.6,0.8,0,2.3,6.3,1980,1618,362,81.72,18.28,175,1443,37,325,212,1768,10.8,10.2,10.7,"Less than 25% P.O.C.","$44000 - $52000"
"21041","Carroll County, Kentucky",10671,43524,9460,299,34,35,0,723,88.7,2.8,0.3,0.3,0,6.8,11.3,4101,2638,1463,64.33,35.67,207,2431,78,1385,285,3816,7.8,5.3,6.9,"Less than 25% P.O.C.","Less than $44000"
"21043","Carter County, Kentucky",27159,34736,26248,148,125,29,3,369,96.6,0.5,0.5,0.1,0,1.4,3.4,9606,7432,2174,77.37,22.63,546,6886,217,1957,763,8843,7.3,10,7.9,"Less than 25% P.O.C.","Less than $44000"
"21045","Casey County, Kentucky",15885,34819,15034,126,51,24,0,466,94.6,0.8,0.3,0.2,0,2.9,5.4,6099,4714,1385,77.29,22.71,399,4315,87,1298,486,5613,8.5,6.3,8,"Less than 25% P.O.C.","Less than $44000"
"21047","Christian County, Kentucky",71414,43919,46815,15392,387,1133,260,5621,65.6,21.6,0.5,1.6,0.4,7.9,34.4,25721,12375,13346,48.11,51.89,930,11445,1657,11689,2587,23134,7.5,12.4,10.1,"25% - 50% P.O.C.","Less than $44000"
"21049","Clark County, Kentucky",35971,54953,32429,1647,54,221,0,1045,90.2,4.6,0.2,0.6,0,2.9,9.8,14509,9773,4736,67.36,32.64,622,9151,342,4394,964,13545,6.4,7.2,6.6,"Less than 25% P.O.C.","$52000 - $60000"
"21051","Clay County, Kentucky",20368,26840,18856,730,25,0,8,522,92.6,3.6,0.1,0,0,2.6,7.4,7622,5172,2450,67.86,32.14,403,4769,285,2165,688,6934,7.8,11.6,9,"Less than 25% P.O.C.","Less than $44000"
"21053","Clinton County, Kentucky",10193,32184,9686,37,0,30,0,289,95,0.4,0,0.3,0,2.8,5,3985,2770,1215,69.51,30.49,162,2608,162,1053,324,3661,5.8,13.3,8.1,"Less than 25% P.O.C.","Less than $44000"
"21055","Crittenden County, Kentucky",9000,45244,8645,71,20,0,0,111,96.1,0.8,0.2,0,0,1.2,3.9,3567,2921,646,81.89,18.11,197,2724,57,589,254,3313,6.7,8.8,7.1,"Less than 25% P.O.C.","$44000 - $52000"
"21057","Cumberland County, Kentucky",6697,35344,6189,140,0,51,0,91,92.4,2.1,0,0.8,0,1.4,7.6,2616,1907,709,72.9,27.1,124,1783,7,702,131,2485,6.5,1,5,"Less than 25% P.O.C.","Less than $44000"
"21059","Daviess County, Kentucky",100474,51673,88435,4325,169,1735,15,3146,88,4.3,0.2,1.7,0,3.1,12,40179,27297,12882,67.94,32.06,2384,24913,861,12021,3245,36934,8.7,6.7,8.1,"Less than 25% P.O.C.","$44000 - $52000"
"21061","Edmonson County, Kentucky",12138,43401,11542,181,49,10,0,91,95.1,1.5,0.4,0.1,0,0.7,4.9,4885,3927,958,80.39,19.61,180,3747,202,756,382,4503,4.6,21.1,7.8,"Less than 25% P.O.C.","Less than $44000"
"21063","Elliott County, Kentucky",7510,32306,7182,268,6,0,0,36,95.6,3.6,0.1,0,0,0.5,4.4,2523,1901,622,75.35,24.65,192,1709,6,616,198,2325,10.1,1,7.8,"Less than 25% P.O.C.","Less than $44000"
"21065","Estill County, Kentucky",14224,31688,14085,16,21,2,3,15,99,0.1,0.1,0,0,0.1,1,5499,3967,1532,72.14,27.86,265,3702,159,1373,424,5075,6.7,10.4,7.7,"Less than 25% P.O.C.","Less than $44000"
"21067","Fayette County, Kentucky",320601,57291,227629,46338,326,12004,65,23063,71,14.5,0.1,3.7,0,7.2,29,129784,70648,59136,54.44,45.56,5072,65576,3922,55214,8994,120790,7.2,6.6,6.9,"25% - 50% P.O.C.","$52000 - $60000"
"21069","Fleming County, Kentucky",14513,44612,13902,318,9,13,0,157,95.8,2.2,0.1,0.1,0,1.1,4.2,5841,4277,1564,73.22,26.78,277,4000,235,1329,512,5329,6.5,15,8.8,"Less than 25% P.O.C.","$44000 - $52000"
"21071","Floyd County, Kentucky",36456,32730,35374,312,3,121,0,306,97,0.9,0,0.3,0,0.8,3,15000,10486,4514,69.91,30.09,574,9912,274,4240,848,14152,5.5,6.1,5.7,"Less than 25% P.O.C.","Less than $44000"
"21073","Franklin County, Kentucky",50529,56274,41219,4705,40,908,36,1702,81.6,9.3,0.1,1.8,0.1,3.4,18.4,21076,13236,7840,62.8,37.2,820,12416,347,7493,1167,19909,6.2,4.4,5.5,"Less than 25% P.O.C.","$52000 - $60000"
"21075","Fulton County, Kentucky",6130,30114,4341,1472,42,9,0,120,70.8,24,0.7,0.1,0,2,29.2,2441,1497,944,61.33,38.67,37,1460,58,886,95,2346,2.5,6.1,3.9,"25% - 50% P.O.C.","Less than $44000"
"21077","Gallatin County, Kentucky",8737,52167,7955,176,0,6,0,460,91,2,0,0.1,0,5.3,9,3105,2236,869,72.01,27.99,264,1972,94,775,358,2747,11.8,10.8,11.5,"Less than 25% P.O.C.","$52000 - $60000"
"21079","Garrard County, Kentucky",17445,52631,16431,338,27,45,0,387,94.2,1.9,0.2,0.3,0,2.2,5.8,6706,5526,1180,82.4,17.6,378,5148,107,1073,485,6221,6.8,9.1,7.2,"Less than 25% P.O.C.","$52000 - $60000"
"21081","Grant County, Kentucky",24951,48714,23561,199,33,31,0,694,94.4,0.8,0.1,0.1,0,2.8,5.6,9141,6263,2878,68.52,31.48,696,5567,471,2407,1167,7974,11.1,16.4,12.8,"Less than 25% P.O.C.","$44000 - $52000"
"21083","Graves County, Kentucky",37248,44043,32232,1521,52,169,111,2491,86.5,4.1,0.1,0.5,0.3,6.7,13.5,14316,10805,3511,75.47,24.53,845,9960,369,3142,1214,13102,7.8,10.5,8.5,"Less than 25% P.O.C.","$44000 - $52000"
"21085","Grayson County, Kentucky",26247,38612,24993,303,113,16,0,362,95.2,1.2,0.4,0.1,0,1.4,4.8,9758,7084,2674,72.6,27.4,582,6502,195,2479,777,8981,8.2,7.3,8,"Less than 25% P.O.C.","Less than $44000"
"21087","Green County, Kentucky",10979,35899,10353,285,77,9,0,94,94.3,2.6,0.7,0.1,0,0.9,5.7,4413,3258,1155,73.83,26.17,212,3046,48,1107,260,4153,6.5,4.2,5.9,"Less than 25% P.O.C.","Less than $44000"
"21089","Greenup County, Kentucky",35555,51655,34198,338,8,173,0,387,96.2,1,0,0.5,0,1.1,3.8,14056,10906,3150,77.59,22.41,835,10071,366,2784,1201,12855,7.7,11.6,8.5,"Less than 25% P.O.C.","$44000 - $52000"
"21091","Hancock County, Kentucky",8720,57217,8327,78,8,50,0,134,95.5,0.9,0.1,0.6,0,1.5,4.5,3311,2622,689,79.19,20.81,247,2375,66,623,313,2998,9.4,9.6,9.5,"Less than 25% P.O.C.","$52000 - $60000"
"21093","Hardin County, Kentucky",108527,54367,82502,12188,141,2301,336,6150,76,11.2,0.1,2.1,0.3,5.7,24,41646,25605,16041,61.48,38.52,2307,23298,1443,14598,3750,37896,9,9,9,"Less than 25% P.O.C.","$52000 - $60000"
"21095","Harlan County, Kentucky",26699,26478,25367,587,0,78,0,260,95,2.2,0,0.3,0,1,5,11134,7663,3471,68.83,31.17,763,6900,274,3197,1037,10097,10,7.9,9.3,"Less than 25% P.O.C.","Less than $44000"
"21097","Harrison County, Kentucky",18722,48438,17534,322,0,0,3,452,93.7,1.7,0,0,0,2.4,6.3,7283,5022,2261,68.96,31.04,466,4556,122,2139,588,6695,9.3,5.4,8.1,"Less than 25% P.O.C.","$44000 - $52000"
"21099","Hart County, Kentucky",18729,38396,17142,766,102,91,0,346,91.5,4.1,0.5,0.5,0,1.8,8.5,7351,5449,1902,74.13,25.87,505,4944,180,1722,685,6666,9.3,9.5,9.3,"Less than 25% P.O.C.","Less than $44000"
"21101","Henderson County, Kentucky",45829,48926,39674,3341,93,194,12,1170,86.6,7.3,0.2,0.4,0,2.6,13.4,18643,11431,7212,61.32,38.68,715,10716,526,6686,1241,17402,6.3,7.3,6.7,"Less than 25% P.O.C.","$44000 - $52000"
"21103","Henry County, Kentucky",15911,53926,14548,472,0,100,19,518,91.4,3,0,0.6,0.1,3.3,8.6,6044,4359,1685,72.12,27.88,375,3984,260,1425,635,5409,8.6,15.4,10.5,"Less than 25% P.O.C.","$52000 - $60000"
"21105","Hickman County, Kentucky",4510,42929,3899,377,18,32,0,83,86.5,8.4,0.4,0.7,0,1.8,13.5,1798,1489,309,82.81,17.19,123,1366,7,302,130,1668,8.3,2.3,7.2,"Less than 25% P.O.C.","Less than $44000"
"21107","Hopkins County, Kentucky",45331,47170,40115,2911,90,269,3,949,88.5,6.4,0.2,0.6,0,2.1,11.5,18588,12912,5676,69.46,30.54,885,12027,488,5188,1373,17215,6.9,8.6,7.4,"Less than 25% P.O.C.","$44000 - $52000"
"21109","Jackson County, Kentucky",13369,32138,13087,42,0,0,0,33,97.9,0.3,0,0,0,0.2,2.1,5484,4123,1361,75.18,24.82,371,3752,20,1341,391,5093,9,1.5,7.1,"Less than 25% P.O.C.","Less than $44000"
"21111","Jefferson County, Kentucky",767419,56586,517604,164679,1126,21932,362,41742,67.4,21.5,0.1,2.9,0,5.4,32.6,312679,193084,119595,61.75,38.25,14975,178109,7986,111609,22961,289718,7.8,6.7,7.3,"25% - 50% P.O.C.","$52000 - $60000"
"21113","Jessamine County, Kentucky",53032,58245,47112,2401,156,766,0,1837,88.8,4.5,0.3,1.4,0,3.5,11.2,18821,12155,6666,64.58,35.42,1154,11001,770,5896,1924,16897,9.5,11.6,10.2,"Less than 25% P.O.C.","$52000 - $60000"
"21115","Johnson County, Kentucky",22634,37055,22008,111,17,341,0,74,97.2,0.5,0.1,1.5,0,0.3,2.8,8488,6103,2385,71.9,28.1,414,5689,157,2228,571,7917,6.8,6.6,6.7,"Less than 25% P.O.C.","Less than $44000"
"21117","Kenton County, Kentucky",165668,64339,146656,7546,189,2108,4,5352,88.5,4.6,0.1,1.3,0,3.2,11.5,63966,42303,21663,66.13,33.87,4005,38298,1548,20115,5553,58413,9.5,7.1,8.7,"Less than 25% P.O.C.","$60000 or more"
"21119","Knott County, Kentucky",15260,31198,14779,79,20,32,14,149,96.8,0.5,0.1,0.2,0.1,1,3.2,6388,4776,1612,74.77,25.23,456,4320,159,1453,615,5773,9.5,9.9,9.6,"Less than 25% P.O.C.","Less than $44000"
"21121","Knox County, Kentucky",31365,30181,30037,255,225,118,47,379,95.8,0.8,0.7,0.4,0.1,1.2,4.2,11961,7834,4127,65.5,34.5,496,7338,498,3629,994,10967,6.3,12.1,8.3,"Less than 25% P.O.C.","Less than $44000"
"21123","Larue County, Kentucky",14204,47643,12979,482,10,53,0,461,91.4,3.4,0.1,0.4,0,3.2,8.6,5741,4253,1488,74.08,25.92,465,3788,68,1420,533,5208,10.9,4.6,9.3,"Less than 25% P.O.C.","$44000 - $52000"
"21125","Laurel County, Kentucky",60357,41526,57796,444,234,237,0,940,95.8,0.7,0.4,0.4,0,1.6,4.2,22573,15788,6785,69.94,30.06,1444,14344,659,6126,2103,20470,9.1,9.7,9.3,"Less than 25% P.O.C.","Less than $44000"
"21127","Lawrence County, Kentucky",15671,32798,15361,29,6,32,0,185,98,0.2,0,0.2,0,1.2,2,5784,4334,1450,74.93,25.07,282,4052,93,1357,375,5409,6.5,6.4,6.5,"Less than 25% P.O.C.","Less than $44000"
"21129","Lee County, Kentucky",6881,25275,6582,52,47,15,0,30,95.7,0.8,0.7,0.2,0,0.4,4.3,2839,1956,883,68.9,31.1,189,1767,22,861,211,2628,9.7,2.5,7.4,"Less than 25% P.O.C.","Less than $44000"
"21131","Leslie County, Kentucky",10283,31627,10030,15,0,39,0,51,97.5,0.1,0,0.4,0,0.5,2.5,4076,3317,759,81.38,18.62,271,3046,126,633,397,3679,8.2,16.6,9.7,"Less than 25% P.O.C.","Less than $44000"
"21133","Letcher County, Kentucky",22295,29886,21728,83,41,59,0,179,97.5,0.4,0.2,0.3,0,0.8,2.5,9721,7210,2511,74.17,25.83,523,6687,247,2264,770,8951,7.3,9.8,7.9,"Less than 25% P.O.C.","Less than $44000"
"21135","Lewis County, Kentucky",13417,31147,13117,90,29,19,0,0,97.8,0.7,0.2,0.1,0,0,2.2,5268,3897,1371,73.97,26.03,275,3622,49,1322,324,4944,7.1,3.6,6.2,"Less than 25% P.O.C.","Less than $44000"
"21137","Lincoln County, Kentucky",24476,42919,23068,466,5,40,15,403,94.2,1.9,0,0.2,0.1,1.6,5.8,9697,7596,2101,78.33,21.67,644,6952,448,1653,1092,8605,8.5,21.3,11.3,"Less than 25% P.O.C.","Less than $44000"
"21139","Livingston County, Kentucky",9235,50839,8806,42,13,13,3,183,95.4,0.5,0.1,0.1,0,2,4.6,3857,3058,799,79.28,20.72,123,2935,57,742,180,3677,4,7.1,4.7,"Less than 25% P.O.C.","$44000 - $52000"
"21141","Logan County, Kentucky",26902,48014,23828,1802,17,69,2,767,88.6,6.7,0.1,0.3,0,2.9,11.4,10418,7261,3157,69.7,30.3,550,6711,228,2929,778,9640,7.6,7.2,7.5,"Less than 25% P.O.C.","$44000 - $52000"
"21143","Lyon County, Kentucky",8271,52528,7454,470,50,31,12,154,90.1,5.7,0.6,0.4,0.1,1.9,9.9,3333,2645,688,79.36,20.64,75,2570,55,633,130,3203,2.8,8,3.9,"Less than 25% P.O.C.","$52000 - $60000"
"21145","McCracken County, Kentucky",65268,46080,54368,6843,228,573,46,1648,83.3,10.5,0.3,0.9,0.1,2.5,16.7,27854,18124,9730,65.07,34.93,1176,16948,613,9117,1789,26065,6.5,6.3,6.4,"Less than 25% P.O.C.","$44000 - $52000"
"21147","McCreary County, Kentucky",17465,28105,15619,989,45,79,5,432,89.4,5.7,0.3,0.5,0,2.5,10.6,6052,4245,1807,70.14,29.86,253,3992,145,1662,398,5654,6,8,6.6,"Less than 25% P.O.C.","Less than $44000"
"21149","McLean County, Kentucky",9283,51861,8918,116,48,21,0,80,96.1,1.2,0.5,0.2,0,0.9,3.9,3809,2987,822,78.42,21.58,129,2858,65,757,194,3615,4.3,7.9,5.1,"Less than 25% P.O.C.","$44000 - $52000"
"21151","Madison County, Kentucky",90802,50060,81234,3710,315,802,251,2247,89.5,4.1,0.3,0.9,0.3,2.5,10.5,33359,19700,13659,59.05,40.95,1615,18085,880,12779,2495,30864,8.2,6.4,7.5,"Less than 25% P.O.C.","$44000 - $52000"
"21153","Magoffin County, Kentucky",12491,28147,12337,4,4,13,0,133,98.8,0,0,0.1,0,1.1,1.2,5020,3641,1379,72.53,27.47,188,3453,180,1199,368,4652,5.2,13.1,7.3,"Less than 25% P.O.C.","Less than $44000"
"21155","Marion County, Kentucky",19244,40107,16893,1401,36,41,28,515,87.8,7.3,0.2,0.2,0.1,2.7,12.2,7405,5434,1971,73.38,26.62,388,5046,152,1819,540,6865,7.1,7.7,7.3,"Less than 25% P.O.C.","Less than $44000"
"21157","Marshall County, Kentucky",31192,55113,30053,293,46,62,0,514,96.3,0.9,0.1,0.2,0,1.6,3.7,13121,10623,2498,80.96,19.04,536,10087,211,2287,747,12374,5,8.4,5.7,"Less than 25% P.O.C.","$52000 - $60000"
"21159","Martin County, Kentucky",11648,41013,10749,590,29,11,12,231,92.3,5.1,0.2,0.1,0.1,2,7.7,4153,2926,1227,70.46,29.54,369,2557,93,1134,462,3691,12.6,7.6,11.1,"Less than 25% P.O.C.","Less than $44000"
"21161","Mason County, Kentucky",17112,45377,15223,1082,8,155,7,328,89,6.3,0,0.9,0,1.9,11,6700,4531,2169,67.63,32.37,295,4236,213,1956,508,6192,6.5,9.8,7.6,"Less than 25% P.O.C.","$44000 - $52000"
"21163","Meade County, Kentucky",28182,56603,25206,1004,211,185,0,1040,89.4,3.6,0.7,0.7,0,3.7,10.6,10685,7759,2926,72.62,27.38,824,6935,239,2687,1063,9622,10.6,8.2,9.9,"Less than 25% P.O.C.","$52000 - $60000"
"21165","Menifee County, Kentucky",6443,39325,6258,10,0,20,0,73,97.1,0.2,0,0.3,0,1.1,2.9,2651,2116,535,79.82,20.18,166,1950,59,476,225,2426,7.8,11,8.5,"Less than 25% P.O.C.","Less than $44000"
"21167","Mercer County, Kentucky",21592,55093,19610,900,8,98,12,636,90.8,4.2,0,0.5,0.1,2.9,9.2,8556,6183,2373,72.27,27.73,496,5687,133,2240,629,7927,8,5.6,7.4,"Less than 25% P.O.C.","$52000 - $60000"
"21169","Metcalfe County, Kentucky",10036,37386,9526,156,27,40,0,82,94.9,1.6,0.3,0.4,0,0.8,5.1,4074,3192,882,78.35,21.65,330,2862,57,825,387,3687,10.3,6.5,9.5,"Less than 25% P.O.C.","Less than $44000"
"21171","Monroe County, Kentucky",10627,34879,9920,259,9,31,3,328,93.3,2.4,0.1,0.3,0,3.1,6.7,4491,3131,1360,69.72,30.28,182,2949,136,1224,318,4173,5.8,10,7.1,"Less than 25% P.O.C.","Less than $44000"
"21173","Montgomery County, Kentucky",27884,45516,25872,770,93,21,35,768,92.8,2.8,0.3,0.1,0.1,2.8,7.2,10481,7112,3369,67.86,32.14,570,6542,377,2992,947,9534,8,11.2,9,"Less than 25% P.O.C.","$44000 - $52000"
"21175","Morgan County, Kentucky",13288,36134,12313,452,72,78,46,179,92.7,3.4,0.5,0.6,0.3,1.3,7.3,4865,3632,1233,74.66,25.34,310,3322,109,1124,419,4446,8.5,8.8,8.6,"Less than 25% P.O.C.","Less than $44000"
"21177","Muhlenberg County, Kentucky",30951,43590,28489,1305,54,243,22,472,92,4.2,0.2,0.8,0.1,1.5,8,11351,9039,2312,79.63,20.37,617,8422,107,2205,724,10627,6.8,4.6,6.4,"Less than 25% P.O.C.","Less than $44000"
"21179","Nelson County, Kentucky",45650,60127,41252,2325,20,247,0,985,90.4,5.1,0,0.5,0,2.2,9.6,17853,13561,4292,75.96,24.04,1284,12277,447,3845,1731,16122,9.5,10.4,9.7,"Less than 25% P.O.C.","$60000 or more"
"21181","Nicholas County, Kentucky",7153,38149,6848,90,18,0,0,103,95.7,1.3,0.3,0,0,1.4,4.3,2804,1931,873,68.87,31.13,167,1764,138,735,305,2499,8.6,15.8,10.9,"Less than 25% P.O.C.","Less than $44000"
"21183","Ohio County, Kentucky",24071,45564,22689,208,9,67,0,835,94.3,0.9,0,0.3,0,3.5,5.7,9122,6940,2182,76.08,23.92,685,6255,193,1989,878,8244,9.9,8.8,9.6,"Less than 25% P.O.C.","$44000 - $52000"
"21185","Oldham County, Kentucky",65967,99128,58252,2349,134,1010,29,2613,88.3,3.6,0.2,1.5,0,4,11.7,20911,17712,3199,84.7,15.3,2388,15324,398,2801,2786,18125,13.5,12.4,13.3,"Less than 25% P.O.C.","$60000 or more"
"21187","Owen County, Kentucky",10796,48801,10627,62,17,0,13,41,98.4,0.6,0.2,0,0.1,0.4,1.6,3995,2987,1008,74.77,25.23,286,2701,177,831,463,3532,9.6,17.6,11.6,"Less than 25% P.O.C.","$44000 - $52000"
"21189","Owsley County, Kentucky",4442,30284,4150,243,0,7,0,0,93.4,5.5,0,0.2,0,0,6.6,1704,1166,538,68.43,31.57,95,1071,18,520,113,1591,8.1,3.3,6.6,"Less than 25% P.O.C.","Less than $44000"
"21191","Pendleton County, Kentucky",14572,54375,14000,157,7,83,0,198,96.1,1.1,0,0.6,0,1.4,3.9,5253,3956,1297,75.31,24.69,328,3628,110,1187,438,4815,8.3,8.5,8.3,"Less than 25% P.O.C.","$52000 - $60000"
"21193","Perry County, Kentucky",26624,33640,25342,495,10,229,59,278,95.2,1.9,0,0.9,0.2,1,4.8,11226,8515,2711,75.85,24.15,591,7924,212,2499,803,10423,6.9,7.8,7.2,"Less than 25% P.O.C.","Less than $44000"
"21195","Pike County, Kentucky",59497,34856,57651,524,68,331,24,571,96.9,0.9,0.1,0.6,0,1,3.1,25702,18749,6953,72.95,27.05,1355,17394,373,6580,1728,23974,7.2,5.4,6.7,"Less than 25% P.O.C.","Less than $44000"
"21197","Powell County, Kentucky",12304,37469,11780,44,39,74,6,206,95.7,0.4,0.3,0.6,0,1.7,4.3,4770,3293,1477,69.04,30.96,238,3055,166,1311,404,4366,7.2,11.2,8.5,"Less than 25% P.O.C.","Less than $44000"
"21199","Pulaski County, Kentucky",64350,39998,60638,561,204,529,0,1603,94.2,0.9,0.3,0.8,0,2.5,5.8,25301,17453,7848,68.98,31.02,1270,16183,728,7120,1998,23303,7.3,9.3,7.9,"Less than 25% P.O.C.","Less than $44000"
"21201","Robertson County, Kentucky",2123,41902,1994,38,0,0,0,91,93.9,1.8,0,0,0,4.3,6.1,861,645,216,74.91,25.09,54,591,34,182,88,773,8.4,15.7,10.2,"Less than 25% P.O.C.","Less than $44000"
"21203","Rockcastle County, Kentucky",16820,35720,16346,26,202,23,0,156,97.2,0.2,1.2,0.1,0,0.9,2.8,6544,4984,1560,76.16,23.84,366,4618,139,1421,505,6039,7.3,8.9,7.7,"Less than 25% P.O.C.","Less than $44000"
"21205","Rowan County, Kentucky",24507,38230,23163,375,53,196,0,421,94.5,1.5,0.2,0.8,0,1.7,5.5,8623,5160,3463,59.84,40.16,379,4781,205,3258,584,8039,7.3,5.9,6.8,"Less than 25% P.O.C.","Less than $44000"
"21207","Russell County, Kentucky",17778,38390,16619,54,4,142,0,672,93.5,0.3,0,0.8,0,3.8,6.5,6922,5131,1791,74.13,25.87,363,4768,177,1614,540,6382,7.1,9.9,7.8,"Less than 25% P.O.C.","Less than $44000"
"21209","Scott County, Kentucky",54667,70817,47541,2528,79,620,0,2366,87,4.6,0.1,1.1,0,4.3,13,20551,14391,6160,70.03,29.97,1618,12773,586,5574,2204,18347,11.2,9.5,10.7,"Less than 25% P.O.C.","$60000 or more"
"21211","Shelby County, Kentucky",47325,67056,37940,3155,0,439,37,4541,80.2,6.7,0,0.9,0.1,9.6,19.8,16624,11672,4952,70.21,29.79,1167,10505,723,4229,1890,14734,10,14.6,11.4,"Less than 25% P.O.C.","$60000 or more"
"21213","Simpson County, Kentucky",18183,48623,15486,1788,74,121,0,444,85.2,9.8,0.4,0.7,0,2.4,14.8,7028,4566,2462,64.97,35.03,425,4141,415,2047,840,6188,9.3,16.9,12,"Less than 25% P.O.C.","$44000 - $52000"
"21215","Spencer County, Kentucky",18680,80166,17572,347,34,63,0,445,94.1,1.9,0.2,0.3,0,2.4,5.9,6763,5758,1005,85.14,14.86,573,5185,167,838,740,6023,10,16.6,10.9,"Less than 25% P.O.C.","$60000 or more"
"21217","Taylor County, Kentucky",25571,44522,22894,1095,9,259,0,618,89.5,4.3,0,1,0,2.4,10.5,9857,5940,3917,60.26,39.74,444,5496,193,3724,637,9220,7.5,4.9,6.5,"Less than 25% P.O.C.","$44000 - $52000"
"21219","Todd County, Kentucky",12316,44005,10559,1006,0,8,0,491,85.7,8.2,0,0.1,0,4,14.3,4644,3133,1511,67.46,32.54,341,2792,161,1350,502,4142,10.9,10.7,10.8,"Less than 25% P.O.C.","$44000 - $52000"
"21221","Trigg County, Kentucky",14449,50536,12737,1076,0,68,0,325,88.2,7.4,0,0.5,0,2.2,11.8,5892,4770,1122,80.96,19.04,428,4342,31,1091,459,5433,9,2.8,7.8,"Less than 25% P.O.C.","$44000 - $52000"
"21223","Trimble County, Kentucky",8558,53056,8044,14,40,0,66,263,94,0.2,0.5,0,0.8,3.1,6,3498,2697,801,77.1,22.9,270,2427,78,723,348,3150,10,9.7,9.9,"Less than 25% P.O.C.","$52000 - $60000"
"21225","Union County, Kentucky",14638,46673,12062,1927,0,68,0,288,82.4,13.2,0,0.5,0,2,17.6,5374,3804,1570,70.79,29.21,421,3383,214,1356,635,4739,11.1,13.6,11.8,"Less than 25% P.O.C.","$44000 - $52000"
"21227","Warren County, Kentucky",128652,52270,100823,11382,438,5151,477,6898,78.4,8.8,0.3,4,0.4,5.4,21.6,48224,28312,19912,58.71,41.29,2802,25510,1601,18311,4403,43821,9.9,8,9.1,"Less than 25% P.O.C.","$52000 - $60000"
"21229","Washington County, Kentucky",12023,53743,10544,644,0,106,0,511,87.7,5.4,0,0.9,0,4.3,12.3,4581,3434,1147,74.96,25.04,215,3219,165,982,380,4201,6.3,14.4,8.3,"Less than 25% P.O.C.","$52000 - $60000"
"21231","Wayne County, Kentucky",20546,34914,19141,407,5,32,0,685,93.2,2,0,0.2,0,3.3,6.8,8231,6051,2180,73.51,26.49,458,5593,235,1945,693,7538,7.6,10.8,8.4,"Less than 25% P.O.C.","Less than $44000"
"21233","Webster County, Kentucky",13068,42119,11547,438,12,7,9,715,88.4,3.4,0.1,0.1,0.1,5.5,11.6,4953,3557,1396,71.82,28.18,324,3233,134,1262,458,4495,9.1,9.6,9.2,"Less than 25% P.O.C.","Less than $44000"
"21235","Whitley County, Kentucky",36131,39005,34682,319,124,87,0,465,96,0.9,0.3,0.2,0,1.3,4,12620,8682,3938,68.8,31.2,779,7903,341,3597,1120,11500,9,8.7,8.9,"Less than 25% P.O.C.","Less than $44000"
"21237","Wolfe County, Kentucky",7207,24623,7074,4,23,5,0,26,98.2,0.1,0.3,0.1,0,0.4,1.8,2898,1837,1061,63.39,36.61,267,1570,46,1015,313,2585,14.5,4.3,10.8,"Less than 25% P.O.C.","Less than $44000"
"21239","Woodford County, Kentucky",26318,63820,22688,1187,0,107,0,1767,86.2,4.5,0,0.4,0,6.7,13.8,10355,7321,3034,70.7,29.3,419,6902,282,2752,701,9654,5.7,9.3,6.8,"Less than 25% P.O.C.","$60000 or more"
"22001","Acadia Parish, Louisiana",62457,43396,48329,10813,9,55,0,1595,77.4,17.3,0,0.1,0,2.6,22.6,22236,15806,6430,71.08,28.92,1680,14126,1009,5421,2689,19547,10.6,15.7,12.1,"Less than 25% P.O.C.","Less than $44000"
"22003","Allen Parish, Louisiana",25618,46446,18178,4723,511,152,0,1592,71,18.4,2,0.6,0,6.2,29,7925,5906,2019,74.52,25.48,578,5328,336,1683,914,7011,9.8,16.6,11.5,"25% - 50% P.O.C.","$44000 - $52000"
"22005","Ascension Parish, Louisiana",123114,80527,84233,26751,87,1297,43,6900,68.4,21.7,0.1,1.1,0,5.6,31.6,43032,35079,7953,81.52,18.48,3826,31253,955,6998,4781,38251,10.9,12,11.1,"25% - 50% P.O.C.","$60000 or more"
"22007","Assumption Parish, Louisiana",22478,43759,14737,6724,93,17,0,684,65.6,29.9,0.4,0.1,0,3,34.4,8552,6683,1869,78.15,21.85,460,6223,148,1721,608,7944,6.9,7.9,7.1,"25% - 50% P.O.C.","Less than $44000"
"22009","Avoyelles Parish, Louisiana",40669,38565,26450,10892,350,214,81,786,65,26.8,0.9,0.5,0.2,1.9,35,15163,10537,4626,69.49,30.51,697,9840,401,4225,1098,14065,6.6,8.7,7.2,"25% - 50% P.O.C.","Less than $44000"
"22011","Beauregard Parish, Louisiana",37043,53209,29722,4577,165,164,4,1387,80.2,12.4,0.4,0.4,0,3.7,19.8,13520,10474,3046,77.47,22.53,1173,9301,377,2669,1550,11970,11.2,12.4,11.5,"Less than 25% P.O.C.","$52000 - $60000"
"22013","Bienville Parish, Louisiana",13564,30272,7366,5858,6,5,0,83,54.3,43.2,0,0,0,0.6,45.7,5812,4248,1564,73.09,26.91,242,4006,163,1401,405,5407,5.7,10.4,7,"25% - 50% P.O.C.","Less than $44000"
"22015","Bossier Parish, Louisiana",126499,54268,84427,28602,589,2365,12,8392,66.7,22.6,0.5,1.9,0,6.6,33.3,49377,31315,18062,63.42,36.58,2400,28915,1498,16564,3898,45479,7.7,8.3,7.9,"25% - 50% P.O.C.","$52000 - $60000"
"22017","Caddo Parish, Louisiana",245831,41797,110269,120330,857,3148,112,6942,44.9,48.9,0.3,1.3,0,2.8,55.1,95864,57358,38506,59.83,40.17,3390,53968,3324,35182,6714,89150,5.9,8.6,7,"50% - 75% P.O.C.","Less than $44000"
"22019","Calcasieu Parish, Louisiana",201619,51148,135937,50012,630,2821,9,7279,67.4,24.8,0.3,1.4,0,3.6,32.6,77780,52468,25312,67.46,32.54,5250,47218,2022,23290,7272,70508,10,8,9.3,"25% - 50% P.O.C.","$44000 - $52000"
"22021","Caldwell Parish, Louisiana",9992,37691,7912,1638,33,31,0,320,79.2,16.4,0.3,0.3,0,3.2,20.8,3665,2804,861,76.51,23.49,205,2599,81,780,286,3379,7.3,9.4,7.8,"Less than 25% P.O.C.","Less than $44000"
"22023","Cameron Parish, Louisiana",6930,53423,6118,234,35,36,0,408,88.3,3.4,0.5,0.5,0,5.9,11.7,2734,2308,426,84.42,15.58,265,2043,15,411,280,2454,11.5,3.5,10.2,"Less than 25% P.O.C.","$52000 - $60000"
"22025","Catahoula Parish, Louisiana",9766,40129,6457,3084,10,16,0,184,66.1,31.6,0.1,0.2,0,1.9,33.9,3364,2699,665,80.23,19.77,306,2393,72,593,378,2986,11.3,10.8,11.2,"25% - 50% P.O.C.","Less than $44000"
"22027","Claiborne Parish, Louisiana",15985,26776,7219,8304,46,22,0,242,45.2,51.9,0.3,0.1,0,1.5,54.8,5917,3901,2016,65.93,34.07,281,3620,237,1779,518,5399,7.2,11.8,8.8,"50% - 75% P.O.C.","Less than $44000"
"22029","Concordia Parish, Louisiana",19778,32500,11260,8127,1,29,0,307,56.9,41.1,0,0.1,0,1.6,43.1,7162,4737,2425,66.14,33.86,324,4413,203,2222,527,6635,6.8,8.4,7.4,"25% - 50% P.O.C.","Less than $44000"
"22031","De Soto Parish, Louisiana",27289,46006,16039,9643,245,27,11,785,58.8,35.3,0.9,0.1,0,2.9,41.2,10821,7716,3105,71.31,28.69,480,7236,384,2721,864,9957,6.2,12.4,8,"25% - 50% P.O.C.","$44000 - $52000"
"22033","East Baton Rouge Parish, Louisiana",443763,54948,198071,203920,586,14101,205,18565,44.6,46,0.1,3.2,0,4.2,55.4,164346,98234,66112,59.77,40.23,7920,90314,4476,61636,12396,151950,8.1,6.8,7.5,"50% - 75% P.O.C.","$52000 - $60000"
"22035","East Carroll Parish, Louisiana",7096,22346,2056,4945,0,0,0,39,29,69.7,0,0,0,0.5,71,2037,1051,986,51.6,48.4,53,998,92,894,145,1892,5,9.3,7.1,"50% - 75% P.O.C.","Less than $44000"
"22037","East Feliciana Parish, Louisiana",19371,51803,10336,8385,98,66,0,323,53.4,43.3,0.5,0.3,0,1.7,46.6,6959,5605,1354,80.54,19.46,594,5011,29,1325,623,6336,10.6,2.1,9,"25% - 50% P.O.C.","$44000 - $52000"
"22039","Evangeline Parish, Louisiana",33589,31965,22277,9109,89,158,21,1254,66.3,27.1,0.3,0.5,0.1,3.7,33.7,12172,7975,4197,65.52,34.48,697,7278,427,3770,1124,11048,8.7,10.2,9.2,"25% - 50% P.O.C.","Less than $44000"
"22041","Franklin Parish, Louisiana",20238,35282,13180,6850,12,0,9,74,65.1,33.8,0.1,0,0,0.4,34.9,7423,5400,2023,72.75,27.25,632,4768,243,1780,875,6548,11.7,12,11.8,"25% - 50% P.O.C.","Less than $44000"
"22043","Grant Parish, Louisiana",22340,42505,17095,3548,32,26,0,1125,76.5,15.9,0.1,0.1,0,5,23.5,6989,4803,2186,68.72,31.28,285,4518,211,1975,496,6493,5.9,9.7,7.1,"Less than 25% P.O.C.","Less than $44000"
"22045","Iberia Parish, Louisiana",71887,46861,42240,22677,70,1967,0,3027,58.8,31.5,0.1,2.7,0,4.2,41.2,26184,17775,8409,67.88,32.12,1541,16234,892,7517,2433,23751,8.7,10.6,9.3,"25% - 50% P.O.C.","$44000 - $52000"
"22047","Iberville Parish, Louisiana",32822,50161,15648,15786,26,14,0,855,47.7,48.1,0.1,0,0,2.6,52.3,10903,8007,2896,73.44,26.56,654,7353,262,2634,916,9987,8.2,9,8.4,"50% - 75% P.O.C.","$44000 - $52000"
"22049","Jackson Parish, Louisiana",15879,39139,10686,4719,16,92,0,263,67.3,29.7,0.1,0.6,0,1.7,32.7,5971,4238,1733,70.98,29.02,257,3981,168,1565,425,5546,6.1,9.7,7.1,"25% - 50% P.O.C.","Less than $44000"
"22051","Jefferson Parish, Louisiana",434850,54032,228933,114781,1301,18131,32,63104,52.6,26.4,0.3,4.2,0,14.5,47.4,169452,103702,65750,61.2,38.8,7094,96608,5699,60051,12793,156659,6.8,8.7,7.5,"25% - 50% P.O.C.","$52000 - $60000"
"22053","Jefferson Davis Parish, Louisiana",31441,42105,24567,5149,260,154,0,772,78.1,16.4,0.8,0.5,0,2.5,21.9,11726,8550,3176,72.91,27.09,942,7608,262,2914,1204,10522,11,8.2,10.3,"Less than 25% P.O.C.","Less than $44000"
"22055","Lafayette Parish, Louisiana",241973,56999,158910,62564,577,4529,0,11132,65.7,25.9,0.2,1.9,0,4.6,34.3,91543,59362,32181,64.85,35.15,4904,54458,2626,29555,7530,84013,8.3,8.2,8.2,"25% - 50% P.O.C.","$52000 - $60000"
"22057","Lafourche Parish, Louisiana",98108,55506,75378,13303,2078,575,15,4280,76.8,13.6,2.1,0.6,0,4.4,23.2,36895,28219,8676,76.48,23.52,2676,25543,687,7989,3363,33532,9.5,7.9,9.1,"Less than 25% P.O.C.","$52000 - $60000"
"22059","LaSalle Parish, Louisiana",14936,42104,12357,1656,154,179,14,422,82.7,11.1,1,1.2,0.1,2.8,17.3,4814,3687,1127,76.59,23.41,467,3220,148,979,615,4199,12.7,13.1,12.8,"Less than 25% P.O.C.","Less than $44000"
"22061","Lincoln Parish, Louisiana",47246,35467,25181,19177,117,782,1,1447,53.3,40.6,0.2,1.7,0,3.1,46.7,17712,9120,8592,51.49,48.51,631,8489,505,8087,1136,16576,6.9,5.9,6.4,"25% - 50% P.O.C.","Less than $44000"
"22063","Livingston Parish, Louisiana",138928,63389,121824,8189,318,867,19,5195,87.7,5.9,0.2,0.6,0,3.7,12.3,48410,39618,8792,81.84,18.16,3675,35943,1168,7624,4843,43567,9.3,13.3,10,"Less than 25% P.O.C.","$60000 or more"
"22065","Madison Parish, Louisiana",11306,30350,3826,7184,17,0,0,239,33.8,63.5,0.2,0,0,2.1,66.2,3832,2038,1794,53.18,46.82,165,1873,189,1605,354,3478,8.1,10.5,9.2,"50% - 75% P.O.C.","Less than $44000"
"22067","Morehouse Parish, Louisiana",25610,32929,12633,12570,29,129,0,146,49.3,49.1,0.1,0.5,0,0.6,50.7,9732,6498,3234,66.77,33.23,330,6168,355,2879,685,9047,5.1,11,7,"50% - 75% P.O.C.","Less than $44000"
"22069","Natchitoches Parish, Louisiana",38769,28567,20180,15912,275,285,0,918,52.1,41,0.7,0.7,0,2.4,47.9,14659,6424,8235,43.82,56.18,319,6105,175,8060,494,14165,5,2.1,3.4,"25% - 50% P.O.C.","Less than $44000"
"22071","Orleans Parish, Louisiana",390845,41604,119866,230066,564,11287,26,21413,30.7,58.9,0.1,2.9,0,5.5,69.3,153819,74240,79579,48.26,51.74,3731,70509,2917,76662,6648,147171,5,3.7,4.3,"50% - 75% P.O.C.","Less than $44000"
"22073","Ouachita Parish, Louisiana",155494,41121,89942,58037,246,1558,0,3446,57.8,37.3,0.2,1,0,2.2,42.2,56556,33023,23533,58.39,41.61,2135,30888,2318,21215,4453,52103,6.5,9.8,7.9,"25% - 50% P.O.C.","Less than $44000"
"22075","Plaquemines Parish, Louisiana",23338,57204,14918,4648,247,901,8,1711,63.9,19.9,1.1,3.9,0,7.3,36.1,8919,6135,2784,68.79,31.21,466,5669,484,2300,950,7969,7.6,17.4,10.7,"25% - 50% P.O.C.","$52000 - $60000"
"22077","Pointe Coupee Parish, Louisiana",22016,41480,13281,7873,0,56,0,573,60.3,35.8,0,0.3,0,2.6,39.7,8960,6837,2123,76.31,23.69,402,6435,165,1958,567,8393,5.9,7.8,6.3,"25% - 50% P.O.C.","Less than $44000"
"22079","Rapides Parish, Louisiana",130970,47269,80178,41147,947,1685,10,4123,61.2,31.4,0.7,1.3,0,3.1,38.8,48488,29922,18566,61.71,38.29,2040,27882,1352,17214,3392,45096,6.8,7.3,7,"25% - 50% P.O.C.","$44000 - $52000"
"22081","Red River Parish, Louisiana",8565,33816,4856,3350,0,0,0,204,56.7,39.1,0,0,0,2.4,43.3,3372,2483,889,73.64,26.36,150,2333,30,859,180,3192,6,3.4,5.3,"25% - 50% P.O.C.","Less than $44000"
"22083","Richland Parish, Louisiana",20350,34029,12326,7284,3,78,0,451,60.6,35.8,0,0.4,0,2.2,39.4,7459,4977,2482,66.72,33.28,442,4535,188,2294,630,6829,8.9,7.6,8.4,"25% - 50% P.O.C.","Less than $44000"
"22085","Sabine Parish, Louisiana",23991,40336,16213,3827,1499,86,8,931,67.6,16,6.2,0.4,0,3.9,32.4,9158,6242,2916,68.16,31.84,414,5828,217,2699,631,8527,6.6,7.4,6.9,"25% - 50% P.O.C.","Less than $44000"
"22087","St. Bernard Parish, Louisiana",46266,44661,28844,10521,75,1152,18,4655,62.3,22.7,0.2,2.5,0,10.1,37.7,15005,10160,4845,67.71,32.29,992,9168,675,4170,1667,13338,9.8,13.9,11.1,"25% - 50% P.O.C.","$44000 - $52000"
"22089","St. Charles Parish, Louisiana",52773,69019,34366,13893,191,528,0,3233,65.1,26.3,0.4,1,0,6.1,34.9,19212,15510,3702,80.73,19.27,1422,14088,281,3421,1703,17509,9.2,7.6,8.9,"25% - 50% P.O.C.","$60000 or more"
"22091","St. Helena Parish, Louisiana",10297,43886,4546,5409,114,26,0,184,44.1,52.5,1.1,0.3,0,1.8,55.9,3857,3045,812,78.95,21.05,131,2914,17,795,148,3709,4.3,2.1,3.8,"50% - 75% P.O.C.","Less than $44000"
"22093","St. James Parish, Louisiana",21308,51603,10266,10565,0,35,0,355,48.2,49.6,0,0.2,0,1.7,51.8,7719,6098,1621,79,21,483,5615,136,1485,619,7100,7.9,8.4,8,"50% - 75% P.O.C.","$44000 - $52000"
"22095","St. John the Baptist Parish, Louisiana",43242,57429,14840,24278,0,476,0,2634,34.3,56.1,0,1.1,0,6.1,65.7,15270,11990,3280,78.52,21.48,1137,10853,415,2865,1552,13718,9.5,12.7,10.2,"50% - 75% P.O.C.","$52000 - $60000"
"22097","St. Landry Parish, Louisiana",83172,36403,45215,34494,151,60,0,1837,54.4,41.5,0.2,0.1,0,2.2,45.6,30485,20808,9677,68.26,31.74,2006,18802,1189,8488,3195,27290,9.6,12.3,10.5,"25% - 50% P.O.C.","Less than $44000"
"22099","St. Martin Parish, Louisiana",53732,48656,34562,15610,212,536,0,1611,64.3,29.1,0.4,1,0,3,35.7,19749,15569,4180,78.83,21.17,1778,13791,460,3720,2238,17511,11.4,11,11.3,"25% - 50% P.O.C.","$44000 - $52000"
"22101","St. Mary Parish, Louisiana",50968,40485,28581,15432,787,734,11,3585,56.1,30.3,1.5,1.4,0,7,43.9,19856,12056,7800,60.72,39.28,813,11243,246,7554,1059,18797,6.7,3.2,5.3,"25% - 50% P.O.C.","Less than $44000"
"22103","St. Tammany Parish, Louisiana",255155,68905,200457,30529,1221,3858,38,14329,78.6,12,0.5,1.5,0,5.6,21.4,92962,72853,20109,78.37,21.63,7102,65751,1865,18244,8967,83995,9.7,9.3,9.6,"Less than 25% P.O.C.","$60000 or more"
"22105","Tangipahoa Parish, Louisiana",132057,47832,83496,38794,341,989,0,5642,63.2,29.4,0.3,0.7,0,4.3,36.8,47597,32840,14757,69,31,3155,29685,1369,13388,4524,43073,9.6,9.3,9.5,"25% - 50% P.O.C.","$44000 - $52000"
"22107","Tensas Parish, Louisiana",4561,27500,1927,2525,0,5,0,94,42.2,55.4,0,0.1,0,2.1,57.8,1792,1210,582,67.52,32.48,85,1125,65,517,150,1642,7,11.2,8.4,"50% - 75% P.O.C.","Less than $44000"
"22109","Terrebonne Parish, Louisiana",112054,48747,74703,21222,6234,1111,64,5773,66.7,18.9,5.6,1,0.1,5.2,33.3,39972,28586,11386,71.52,28.48,3224,25362,951,10435,4175,35797,11.3,8.4,10.4,"25% - 50% P.O.C.","$44000 - $52000"
"22111","Union Parish, Louisiana",22353,44100,15406,5533,62,33,6,1049,68.9,24.8,0.3,0.1,0,4.7,31.1,7582,6196,1386,81.72,18.28,303,5893,100,1286,403,7179,4.9,7.2,5.3,"25% - 50% P.O.C.","$44000 - $52000"
"22113","Vermilion Parish, Louisiana",59865,51945,46883,8658,279,1177,49,2102,78.3,14.5,0.5,2,0.1,3.5,21.7,22086,17045,5041,77.18,22.82,1680,15365,421,4620,2101,19985,9.9,8.4,9.5,"Less than 25% P.O.C.","$44000 - $52000"
"22115","Vernon Parish, Louisiana",49646,49141,34780,7125,598,927,204,4617,70.1,14.4,1.2,1.9,0.4,9.3,29.9,17696,9383,8313,53.02,46.98,816,8567,838,7475,1654,16042,8.7,10.1,9.3,"25% - 50% P.O.C.","$44000 - $52000"
"22117","Washington Parish, Louisiana",46435,37570,30434,13986,107,46,0,1058,65.5,30.1,0.2,0.1,0,2.3,34.5,17613,11875,5738,67.42,32.58,1166,10709,434,5304,1600,16013,9.8,7.6,9.1,"25% - 50% P.O.C.","Less than $44000"
"22119","Webster Parish, Louisiana",39242,28951,24312,13331,146,106,51,761,62,34,0.4,0.3,0.1,1.9,38,16551,11074,5477,66.91,33.09,668,10406,681,4796,1349,15202,6,12.4,8.2,"25% - 50% P.O.C.","Less than $44000"
"22121","West Baton Rouge Parish, Louisiana",26101,65385,14579,10365,21,16,0,818,55.9,39.7,0.1,0.1,0,3.1,44.1,9643,7045,2598,73.06,26.94,606,6439,144,2454,750,8893,8.6,5.5,7.8,"25% - 50% P.O.C.","$60000 or more"
"22123","West Carroll Parish, Louisiana",11041,38500,8697,1778,19,0,7,425,78.8,16.1,0.2,0,0.1,3.8,21.2,4084,3140,944,76.89,23.11,285,2855,75,869,360,3724,9.1,7.9,8.8,"Less than 25% P.O.C.","Less than $44000"
"22125","West Feliciana Parish, Louisiana",15428,59637,8079,6854,30,94,0,191,52.4,44.4,0.2,0.6,0,1.2,47.6,3869,2832,1037,73.2,26.8,236,2596,115,922,351,3518,8.3,11.1,9.1,"25% - 50% P.O.C.","$52000 - $60000"
"22127","Winn Parish, Louisiana",14313,38353,9303,4516,76,0,0,293,65,31.6,0.5,0,0,2,35,5483,3686,1797,67.23,32.77,277,3409,87,1710,364,5119,7.5,4.8,6.6,"25% - 50% P.O.C.","Less than $44000"
"23001","Androscoggin County, Maine",107602,53509,97498,2325,142,839,0,1998,90.6,2.2,0.1,0.8,0,1.9,9.4,45630,29359,16271,64.34,35.66,2186,27173,838,15433,3024,42606,7.4,5.2,6.6,"Less than 25% P.O.C.","$52000 - $60000"
"23003","Aroostook County, Maine",67809,41123,63825,637,1263,306,9,834,94.1,0.9,1.9,0.5,0,1.2,5.9,29516,21246,8270,71.98,28.02,1547,19699,338,7932,1885,27631,7.3,4.1,6.4,"Less than 25% P.O.C.","Less than $44000"
"23005","Cumberland County, Maine",292307,73072,263921,8571,375,6269,31,6061,90.3,2.9,0.1,2.1,0,2.1,9.7,120644,83578,37066,69.28,30.72,5206,78372,1697,35369,6903,113741,6.2,4.6,5.7,"Less than 25% P.O.C.","$60000 or more"
"23007","Franklin County, Maine",29982,51422,28670,73,39,113,61,389,95.6,0.2,0.1,0.4,0.2,1.3,4.4,11848,9410,2438,79.42,20.58,569,8841,120,2318,689,11159,6,4.9,5.8,"Less than 25% P.O.C.","$44000 - $52000"
"23009","Hancock County, Maine",54601,57178,51722,466,254,624,75,794,94.7,0.9,0.5,1.1,0.1,1.5,5.3,23661,18056,5605,76.31,23.69,820,17236,178,5427,998,22663,4.5,3.2,4.2,"Less than 25% P.O.C.","$52000 - $60000"
"23011","Kennebec County, Maine",121753,55365,115148,922,622,1108,48,1900,94.6,0.8,0.5,0.9,0,1.6,5.4,52105,36752,15353,70.53,29.47,2155,34597,577,14776,2732,49373,5.9,3.8,5.2,"Less than 25% P.O.C.","$52000 - $60000"
"23013","Knox County, Maine",39759,57751,37833,186,193,201,2,600,95.2,0.5,0.5,0.5,0,1.5,4.8,17020,13146,3874,77.24,22.76,634,12512,174,3700,808,16212,4.8,4.5,4.7,"Less than 25% P.O.C.","$52000 - $60000"
"23015","Lincoln County, Maine",34201,57720,32798,128,148,338,0,426,95.9,0.4,0.4,1,0,1.2,4.1,15336,12148,3188,79.21,20.79,624,11524,186,3002,810,14526,5.1,5.8,5.3,"Less than 25% P.O.C.","$52000 - $60000"
"23017","Oxford County, Maine",57550,49204,54829,206,171,210,7,793,95.3,0.4,0.3,0.4,0,1.4,4.7,21338,17242,4096,80.8,19.2,842,16400,403,3693,1245,20093,4.9,9.8,5.8,"Less than 25% P.O.C.","$44000 - $52000"
"23019","Penobscot County, Maine",151774,50808,142101,1247,1683,1472,58,2061,93.6,0.8,1.1,1,0,1.4,6.4,62156,43123,19033,69.38,30.62,2764,40359,606,18427,3370,58786,6.4,3.2,5.4,"Less than 25% P.O.C.","$44000 - $52000"
"23021","Piscataquis County, Maine",16836,40890,15979,82,135,131,0,245,94.9,0.5,0.8,0.8,0,1.5,5.1,7025,5332,1693,75.9,24.1,276,5056,108,1585,384,6641,5.2,6.4,5.5,"Less than 25% P.O.C.","Less than $44000"
"23023","Sagadahoc County, Maine",35452,63694,33521,278,72,271,0,609,94.6,0.8,0.2,0.8,0,1.7,5.4,15980,11909,4071,74.52,25.48,507,11402,129,3942,636,15344,4.3,3.2,4,"Less than 25% P.O.C.","$60000 or more"
"23025","Somerset County, Maine",50520,44256,48349,294,244,186,0,554,95.7,0.6,0.5,0.4,0,1.1,4.3,21321,16230,5091,76.12,23.88,955,15275,437,4654,1392,19929,5.9,8.6,6.5,"Less than 25% P.O.C.","$44000 - $52000"
"23027","Waldo County, Maine",39539,51931,37630,196,173,182,0,586,95.2,0.5,0.4,0.5,0,1.5,4.8,17236,13649,3587,79.19,20.81,851,12798,130,3457,981,16255,6.2,3.6,5.7,"Less than 25% P.O.C.","$44000 - $52000"
"23029","Washington County, Maine",31491,41347,28165,133,1611,145,9,743,89.4,0.4,5.1,0.5,0,2.4,10.6,13791,10553,3238,76.52,23.48,492,10061,183,3055,675,13116,4.7,5.7,4.9,"Less than 25% P.O.C.","Less than $44000"
"23031","York County, Maine",204316,67830,192542,1624,892,2551,53,3507,94.2,0.8,0.4,1.2,0,1.7,5.8,85314,63026,22288,73.88,26.12,4210,58816,1048,21240,5258,80056,6.7,4.7,6.2,"Less than 25% P.O.C.","$60000 or more"
"24001","Allegany County, Maryland",71445,45893,62135,5692,90,663,15,1277,87,8,0.1,0.9,0,1.8,13,27399,18859,8540,68.83,31.17,1009,17850,736,7804,1745,25654,5.4,8.6,6.4,"Less than 25% P.O.C.","$44000 - $52000"
"24003","Anne Arundel County, Maryland",571275,100798,389750,93175,835,21377,356,44621,68.2,16.3,0.1,3.7,0.1,7.8,31.8,209814,155617,54197,74.17,25.83,15432,140185,5379,48818,20811,189003,9.9,9.9,9.9,"25% - 50% P.O.C.","$60000 or more"
"24005","Baltimore County, Maryland",828018,76866,474239,235778,1946,49687,345,44807,57.3,28.5,0.2,6,0,5.4,42.7,313519,207123,106396,66.06,33.94,18847,188276,8754,97642,27601,285918,9.1,8.2,8.8,"25% - 50% P.O.C.","$60000 or more"
"24009","Calvert County, Maryland",91511,109313,71522,10524,128,1650,38,3641,78.2,11.5,0.1,1.8,0,4,21.8,31973,27070,4903,84.67,15.33,3115,23955,566,4337,3681,28292,11.5,11.5,11.5,"Less than 25% P.O.C.","$60000 or more"
"24011","Caroline County, Maryland",33049,58638,24967,4475,54,229,0,2417,75.5,13.5,0.2,0.7,0,7.3,24.5,12024,8759,3265,72.85,27.15,914,7845,420,2845,1334,10690,10.4,12.9,11.1,"Less than 25% P.O.C.","$52000 - $60000"
"24013","Carroll County, Maryland",167699,96769,149333,5790,410,3176,11,5921,89,3.5,0.2,1.9,0,3.5,11,60758,49823,10935,82,18,5394,44429,947,9988,6341,54417,10.8,8.7,10.4,"Less than 25% P.O.C.","$60000 or more"
"24015","Cecil County, Maryland",102552,76887,87291,6546,92,1446,7,4525,85.1,6.4,0.1,1.4,0,4.4,14.9,37058,27065,9993,73.03,26.97,2518,24547,1143,8850,3661,33397,9.3,11.4,9.9,"Less than 25% P.O.C.","$60000 or more"
"24017","Charles County, Maryland",159428,100003,64027,72431,843,5062,16,9212,40.2,45.4,0.5,3.2,0,5.8,59.8,56520,43436,13084,76.85,23.15,5263,38173,1833,11251,7096,49424,12.1,14,12.6,"50% - 75% P.O.C.","$60000 or more"
"24019","Dorchester County, Maryland",32138,52917,20206,8287,20,354,0,1815,62.9,25.8,0.1,1.1,0,5.6,37.1,13183,8969,4214,68.03,31.97,676,8293,372,3842,1048,12135,7.5,8.8,7.9,"25% - 50% P.O.C.","$52000 - $60000"
"24021","Frederick County, Maryland",251422,97730,184756,23557,665,11151,170,24101,73.5,9.4,0.3,4.4,0.1,9.6,26.5,92526,69614,22912,75.24,24.76,7937,61677,2240,20672,10177,82349,11.4,9.8,11,"25% - 50% P.O.C.","$60000 or more"
"24023","Garrett County, Maryland",29235,52617,28193,250,20,125,9,330,96.4,0.9,0.1,0.4,0,1.1,3.6,12425,9771,2654,78.64,21.36,739,9032,132,2522,871,11554,7.6,5,7,"Less than 25% P.O.C.","$52000 - $60000"
"24025","Harford County, Maryland",252222,89147,191893,33969,397,6472,5,11489,76.1,13.5,0.2,2.6,0,4.6,23.9,93955,73899,20056,78.65,21.35,7719,66180,1873,18183,9592,84363,10.4,9.3,10.2,"Less than 25% P.O.C.","$60000 or more"
"24027","Howard County, Maryland",318855,121160,165862,58978,670,57531,68,22012,52,18.5,0.2,18,0,6.9,48,114170,83520,30650,73.15,26.85,8563,74957,2679,27971,11242,102928,10.3,8.7,9.8,"25% - 50% P.O.C.","$60000 or more"
"24029","Kent County, Maryland",19536,58598,15187,2770,26,228,0,859,77.7,14.2,0.1,1.2,0,4.4,22.3,8025,5557,2468,69.25,30.75,260,5297,163,2305,423,7602,4.7,6.6,5.3,"Less than 25% P.O.C.","$52000 - $60000"
"24031","Montgomery County, Maryland",1043530,108820,457265,186964,1505,153306,438,203754,43.8,17.9,0.1,14.7,0,19.5,56.2,370950,242632,128318,65.41,34.59,27227,215405,12763,115555,39990,330960,11.2,9.9,10.8,"50% - 75% P.O.C.","$60000 or more"
"24033","Prince George's County, Maryland",908670,84920,115436,560785,2116,37170,404,167498,12.7,61.7,0.2,4.1,0,18.4,87.3,311343,193263,118080,62.07,37.93,24893,168370,14463,103617,39356,271987,12.9,12.2,12.6,"75% or more P.O.C.","$60000 or more"
"24035","Queen Anne's County, Maryland",49632,97034,42945,3289,17,504,0,1955,86.5,6.6,0,1,0,3.9,13.5,18577,15046,3531,80.99,19.01,1277,13769,382,3149,1659,16918,8.5,10.8,8.9,"Less than 25% P.O.C.","$60000 or more"
"24037","St. Mary's County, Maryland",112290,89845,83197,16275,94,2865,20,5819,74.1,14.5,0.1,2.6,0,5.2,25.9,40552,28811,11741,71.05,28.95,3377,25434,1032,10709,4409,36143,11.7,8.8,10.9,"25% - 50% P.O.C.","$60000 or more"
"24039","Somerset County, Maryland",25729,37803,13260,10668,87,253,6,930,51.5,41.5,0.3,1,0,3.6,48.5,8574,5575,2999,65.02,34.98,340,5235,276,2723,616,7958,6.1,9.2,7.2,"25% - 50% P.O.C.","Less than $44000"
"24041","Talbot County, Maryland",37167,73547,28926,3738,48,503,0,2513,77.8,10.1,0.1,1.4,0,6.8,22.2,16826,11828,4998,70.3,29.7,542,11286,236,4762,778,16048,4.6,4.7,4.6,"Less than 25% P.O.C.","$60000 or more"
"24043","Washington County, Maryland",150109,60860,118474,15578,186,2731,113,7616,78.9,10.4,0.1,1.8,0.1,5.1,21.1,56035,36952,19083,65.94,34.06,3423,33529,1641,17442,5064,50971,9.3,8.6,9,"Less than 25% P.O.C.","$60000 or more"
"24045","Wicomico County, Maryland",102539,56956,64575,26301,249,3202,28,5376,63,25.6,0.2,3.1,0,5.2,37,37793,21791,16002,57.66,42.34,1619,20172,1093,14909,2712,35081,7.4,6.8,7.2,"25% - 50% P.O.C.","$52000 - $60000"
"24047","Worcester County, Maryland",51765,63499,41494,6573,62,617,41,1811,80.2,12.7,0.1,1.2,0.1,3.5,19.8,22089,16582,5507,75.07,24.93,838,15744,444,5063,1282,20807,5.1,8.1,5.8,"Less than 25% P.O.C.","$60000 or more"
"24510","Baltimore city, Maryland",609032,50379,167430,376203,1442,15649,204,32183,27.5,61.8,0.2,2.6,0,5.3,72.5,239116,113587,125529,47.5,52.5,8948,104639,8924,116605,17872,221244,7.9,7.1,7.5,"50% - 75% P.O.C.","$44000 - $52000"
"25001","Barnstable County, Massachusetts",213496,74336,190593,6093,1217,3124,75,6616,89.3,2.9,0.6,1.5,0,3.1,10.7,94323,75287,19036,79.82,20.18,4417,70870,1073,17963,5490,88833,5.9,5.6,5.8,"Less than 25% P.O.C.","$60000 or more"
"25003","Berkshire County, Massachusetts",126425,59230,111388,3315,193,2238,78,5999,88.1,2.6,0.2,1.8,0.1,4.7,11.9,54813,37928,16885,69.2,30.8,1768,36160,752,16133,2520,52293,4.7,4.5,4.6,"Less than 25% P.O.C.","$52000 - $60000"
"25005","Bristol County, Massachusetts",561037,69095,455995,22101,285,12664,206,44846,81.3,3.9,0.1,2.3,0,8,18.7,217912,136508,81404,62.64,37.36,12009,124499,4912,76492,16921,200991,8.8,6,7.8,"Less than 25% P.O.C.","$60000 or more"
"25007","Dukes County, Massachusetts",17312,71811,14811,727,116,59,0,630,85.6,4.2,0.7,0.3,0,3.6,14.4,6765,4893,1872,72.33,27.67,250,4643,78,1794,328,6437,5.1,4.2,4.8,"Less than 25% P.O.C.","$60000 or more"
"25009","Essex County, Massachusetts",783676,79263,550875,25199,784,26696,140,164027,70.3,3.2,0.1,3.4,0,20.9,29.7,294202,188804,105398,64.17,35.83,17990,170814,7825,97573,25815,268387,9.5,7.4,8.8,"25% - 50% P.O.C.","$60000 or more"
"25011","Franklin County, Massachusetts",70577,60950,64012,969,200,890,106,2835,90.7,1.4,0.3,1.3,0.2,4,9.3,30569,20979,9590,68.63,31.37,1190,19789,323,9267,1513,29056,5.7,3.4,4.9,"Less than 25% P.O.C.","$60000 or more"
"25013","Hampden County, Massachusetts",467871,55429,293556,36142,694,10767,11,117760,62.7,7.7,0.1,2.3,0,25.2,37.3,179423,109668,69755,61.12,38.88,8919,100749,5427,64328,14346,165077,8.1,7.8,8,"25% - 50% P.O.C.","$52000 - $60000"
"25015","Hampshire County, Massachusetts",161032,70876,134786,4027,182,8430,128,9047,83.7,2.5,0.1,5.2,0.1,5.6,16.3,58838,39341,19497,66.86,33.14,2530,36811,638,18859,3168,55670,6.4,3.3,5.4,"Less than 25% P.O.C.","$60000 or more"
"25017","Middlesex County, Massachusetts",1600842,102603,1150282,79953,1867,190409,542,127980,71.9,5,0.1,11.9,0,8,28.1,604384,376888,227496,62.36,37.64,34468,342420,11290,216206,45758,558626,9.1,5,7.6,"25% - 50% P.O.C.","$60000 or more"
"25019","Nantucket County, Massachusetts",11168,107717,9513,736,32,71,7,465,85.2,6.6,0.3,0.6,0.1,4.2,14.8,3713,2619,1094,70.54,29.46,206,2413,125,969,331,3382,7.9,11.4,8.9,"Less than 25% P.O.C.","$60000 or more"
"25021","Norfolk County, Massachusetts",700437,103291,524697,47098,765,77181,253,31734,74.9,6.7,0.1,11,0,4.5,25.1,265300,182847,82453,68.92,31.08,20411,162436,3726,78727,24137,241163,11.2,4.5,9.1,"25% - 50% P.O.C.","$60000 or more"
"25023","Plymouth County, Massachusetts",515303,89489,415590,49456,519,7093,50,20102,80.6,9.6,0.1,1.4,0,3.9,19.4,187460,143386,44074,76.49,23.51,16509,126877,3199,40875,19708,167752,11.5,7.3,10.5,"Less than 25% P.O.C.","$60000 or more"
"25025","Suffolk County, Massachusetts",796605,69669,357453,160215,1408,69875,365,182360,44.9,20.1,0.2,8.8,0,22.9,55.1,309844,111811,198033,36.09,63.91,10135,101676,12343,185690,22478,287366,9.1,6.2,7.3,"50% - 75% P.O.C.","$60000 or more"
"25027","Worcester County, Massachusetts",824772,74679,629988,37150,1405,40296,249,94778,76.4,4.5,0.2,4.9,0,11.5,23.6,309951,201806,108145,65.11,34.89,19019,182787,6342,101803,25361,284590,9.4,5.9,8.2,"Less than 25% P.O.C.","$60000 or more"
"26001","Alcona County, Michigan",10353,40484,9916,41,60,20,7,155,95.8,0.4,0.6,0.2,0.1,1.5,4.2,4988,4430,558,88.81,11.19,79,4351,67,491,146,4842,1.8,12,2.9,"Less than 25% P.O.C.","Less than $44000"
"26003","Alger County, Michigan",9151,45570,7650,702,334,13,0,144,83.6,7.7,3.6,0.1,0,1.6,16.4,3007,2527,480,84.04,15.96,150,2377,9,471,159,2848,5.9,1.9,5.3,"Less than 25% P.O.C.","$44000 - $52000"
"26005","Allegan County, Michigan",116143,62965,102709,1426,364,802,0,8532,88.4,1.2,0.3,0.7,0,7.3,11.6,43416,35849,7567,82.57,17.43,4304,31545,779,6788,5083,38333,12,10.3,11.7,"Less than 25% P.O.C.","$60000 or more"
"26007","Alpena County, Michigan",28520,43363,27297,164,103,176,37,393,95.7,0.6,0.4,0.6,0.1,1.4,4.3,12752,9940,2812,77.95,22.05,523,9417,93,2719,616,12136,5.3,3.3,4.8,"Less than 25% P.O.C.","Less than $44000"
"26009","Antrim County, Michigan",23206,56165,21970,100,159,78,0,543,94.7,0.4,0.7,0.3,0,2.3,5.3,9899,8621,1278,87.09,12.91,739,7882,119,1159,858,9041,8.6,9.3,8.7,"Less than 25% P.O.C.","$52000 - $60000"
"26011","Arenac County, Michigan",15070,42290,14263,62,192,55,0,304,94.6,0.4,1.3,0.4,0,2,5.4,6571,5506,1065,83.79,16.21,329,5177,80,985,409,6162,6,7.5,6.2,"Less than 25% P.O.C.","Less than $44000"
"26013","Baraga County, Michigan",8421,46065,6116,783,824,34,5,134,72.6,9.3,9.8,0.4,0.1,1.6,27.4,3107,2494,613,80.27,19.73,196,2298,46,567,242,2865,7.9,7.5,7.8,"25% - 50% P.O.C.","$44000 - $52000"
"26015","Barry County, Michigan",60540,64490,56987,306,222,364,4,1786,94.1,0.5,0.4,0.6,0,3,5.9,24296,20299,3997,83.55,16.45,1998,18301,494,3503,2492,21804,9.8,12.4,10.3,"Less than 25% P.O.C.","$60000 or more"
"26017","Bay County, Michigan",104104,48819,93760,1743,286,606,0,5548,90.1,1.7,0.3,0.6,0,5.3,9.9,44339,34037,10302,76.77,23.23,2323,31714,623,9679,2946,41393,6.8,6,6.6,"Less than 25% P.O.C.","$44000 - $52000"
"26019","Benzie County, Michigan",17615,57974,16516,32,269,76,0,441,93.8,0.2,1.5,0.4,0,2.5,6.2,6792,6093,699,89.71,10.29,388,5705,63,636,451,6341,6.4,9,6.6,"Less than 25% P.O.C.","$52000 - $60000"
"26021","Berrien County, Michigan",154133,50795,115449,22368,608,2893,27,8449,74.9,14.5,0.4,1.9,0,5.5,25.1,63665,45014,18651,70.7,29.3,3526,41488,1632,17019,5158,58507,7.8,8.8,8.1,"25% - 50% P.O.C.","$44000 - $52000"
"26023","Branch County, Michigan",43513,51947,39338,1002,173,342,15,2071,90.4,2.3,0.4,0.8,0,4.8,9.6,16650,12358,4292,74.22,25.78,1318,11040,443,3849,1761,14889,10.7,10.3,10.6,"Less than 25% P.O.C.","$44000 - $52000"
"26025","Calhoun County, Michigan",134212,48607,104044,13919,592,3233,16,7031,77.5,10.4,0.4,2.4,0,5.2,22.5,53991,37743,16248,69.91,30.09,3106,34637,1059,15189,4165,49826,8.2,6.5,7.7,"Less than 25% P.O.C.","$44000 - $52000"
"26027","Cass County, Michigan",51523,55107,44376,2654,535,431,0,2002,86.1,5.2,1,0.8,0,3.9,13.9,21019,16819,4200,80.02,19.98,1578,15241,509,3691,2087,18932,9.4,12.1,9.9,"Less than 25% P.O.C.","$52000 - $60000"
"26029","Charlevoix County, Michigan",26188,55760,24549,111,397,129,14,523,93.7,0.4,1.5,0.5,0.1,2,6.3,11503,9303,2200,80.87,19.13,630,8673,131,2069,761,10742,6.8,6,6.6,"Less than 25% P.O.C.","$52000 - $60000"
"26031","Cheboygan County, Michigan",25418,48044,23399,200,521,109,0,366,92.1,0.8,2,0.4,0,1.4,7.9,11195,9222,1973,82.38,17.62,435,8787,177,1796,612,10583,4.7,9,5.5,"Less than 25% P.O.C.","$44000 - $52000"
"26033","Chippewa County, Michigan",37629,46486,26196,2231,5234,372,35,709,69.6,5.9,13.9,1,0.1,1.9,30.4,13999,9442,4557,67.45,32.55,676,8766,338,4219,1014,12985,7.2,7.4,7.2,"25% - 50% P.O.C.","$44000 - $52000"
"26035","Clare County, Michigan",30651,39565,29061,190,171,36,0,617,94.8,0.6,0.6,0.1,0,2,5.2,12199,10114,2085,82.91,17.09,741,9373,282,1803,1023,11176,7.3,13.5,8.4,"Less than 25% P.O.C.","Less than $44000"
"26037","Clinton County, Michigan",78389,70390,70467,1419,119,1165,0,3554,89.9,1.8,0.2,1.5,0,4.5,10.1,29728,23779,5949,79.99,20.01,2478,21301,504,5445,2982,26746,10.4,8.5,10,"Less than 25% P.O.C.","$60000 or more"
"26039","Crawford County, Michigan",13892,47977,13131,103,42,129,0,279,94.5,0.7,0.3,0.9,0,2,5.5,6141,4986,1155,81.19,18.81,318,4668,65,1090,383,5758,6.4,5.6,6.2,"Less than 25% P.O.C.","$44000 - $52000"
"26041","Delta County, Michigan",36026,47434,33456,121,706,156,4,493,92.9,0.3,2,0.4,0,1.4,7.1,16234,12565,3669,77.4,22.6,1005,11560,285,3384,1290,14944,8,7.8,7.9,"Less than 25% P.O.C.","$44000 - $52000"
"26043","Dickinson County, Michigan",25439,51645,24150,158,228,166,0,399,94.9,0.6,0.9,0.7,0,1.6,5.1,11231,8688,2543,77.36,22.64,593,8095,91,2452,684,10547,6.8,3.6,6.1,"Less than 25% P.O.C.","$44000 - $52000"
"26045","Eaton County, Michigan",109456,64348,90672,7202,546,2517,32,5901,82.8,6.6,0.5,2.3,0,5.4,17.2,44480,32148,12332,72.28,27.72,2860,29288,847,11485,3707,40773,8.9,6.9,8.3,"Less than 25% P.O.C.","$60000 or more"
"26047","Emmet County, Michigan",33104,55829,30177,243,959,187,30,549,91.2,0.7,2.9,0.6,0.1,1.7,8.8,14463,10534,3929,72.83,27.17,553,9981,110,3819,663,13800,5.2,2.8,4.6,"Less than 25% P.O.C.","$52000 - $60000"
"26049","Genesee County, Michigan",407875,48588,295468,79700,1313,4182,33,14027,72.4,19.5,0.3,1,0,3.4,27.6,167902,117587,50315,70.03,29.97,8837,108750,4127,46188,12964,154938,7.5,8.2,7.7,"25% - 50% P.O.C.","$44000 - $52000"
"26051","Gladwin County, Michigan",25279,44619,24213,72,100,131,0,428,95.8,0.3,0.4,0.5,0,1.7,4.2,11047,9379,1668,84.9,15.1,638,8741,171,1497,809,10238,6.8,10.3,7.3,"Less than 25% P.O.C.","$44000 - $52000"
"26053","Gogebic County, Michigan",15061,38839,13570,582,383,81,12,220,90.1,3.9,2.5,0.5,0.1,1.5,9.9,6744,5224,1520,77.46,22.54,195,5029,56,1464,251,6493,3.7,3.7,3.7,"Less than 25% P.O.C.","Less than $44000"
"26055","Grand Traverse County, Michigan",92181,63575,85354,797,828,537,25,2639,92.6,0.9,0.9,0.6,0,2.9,7.4,37319,28480,8839,76.32,23.68,2086,26394,487,8352,2573,34746,7.3,5.5,6.9,"Less than 25% P.O.C.","$60000 or more"
"26057","Gratiot County, Michigan",40916,47848,35199,2238,106,183,30,2498,86,5.5,0.3,0.4,0.1,6.1,14,15035,11172,3863,74.31,25.69,912,10260,288,3575,1200,13835,8.2,7.5,8,"Less than 25% P.O.C.","$44000 - $52000"
"26059","Hillsdale County, Michigan",45757,49622,43312,311,171,180,0,1061,94.7,0.7,0.4,0.4,0,2.3,5.3,18107,13847,4260,76.47,23.53,1432,12415,463,3797,1895,16212,10.3,10.9,10.5,"Less than 25% P.O.C.","$44000 - $52000"
"26061","Houghton County, Michigan",36070,43183,33211,265,143,1000,19,589,92.1,0.7,0.4,2.8,0.1,1.6,7.9,13386,8954,4432,66.89,33.11,826,8128,242,4190,1068,12318,9.2,5.5,8,"Less than 25% P.O.C.","Less than $44000"
"26063","Huron County, Michigan",31349,48289,29842,150,67,199,0,754,95.2,0.5,0.2,0.6,0,2.4,4.8,13847,11199,2648,80.88,19.12,675,10524,182,2466,857,12990,6,6.9,6.2,"Less than 25% P.O.C.","$44000 - $52000"
"26065","Ingham County, Michigan",290587,52872,202303,32279,856,19566,62,22675,69.6,11.1,0.3,6.7,0,7.8,30.4,112840,65979,46861,58.47,41.53,5145,60834,2419,44442,7564,105276,7.8,5.2,6.7,"25% - 50% P.O.C.","$52000 - $60000"
"26067","Ionia County, Michigan",64300,57043,56769,2919,111,265,9,3067,88.3,4.5,0.2,0.4,0,4.8,11.7,22964,17592,5372,76.61,23.39,2061,15531,556,4816,2617,20347,11.7,10.3,11.4,"Less than 25% P.O.C.","$52000 - $60000"
"26069","Iosco County, Michigan",25197,43678,23634,184,235,190,2,570,93.8,0.7,0.9,0.8,0,2.3,6.2,11669,9329,2340,79.95,20.05,448,8881,125,2215,573,11096,4.8,5.3,4.9,"Less than 25% P.O.C.","Less than $44000"
"26071","Iron County, Michigan",11152,41599,10526,61,187,65,0,234,94.4,0.5,1.7,0.6,0,2.1,5.6,5225,4220,1005,80.77,19.23,153,4067,38,967,191,5034,3.6,3.8,3.7,"Less than 25% P.O.C.","Less than $44000"
"26073","Isabella County, Michigan",70688,45116,60355,1868,2024,1243,10,2799,85.4,2.6,2.9,1.8,0,4,14.6,24739,15372,9367,62.14,37.86,1393,13979,413,8954,1806,22933,9.1,4.4,7.3,"Less than 25% P.O.C.","$44000 - $52000"
"26075","Jackson County, Michigan",158636,53658,134275,12204,543,1296,35,5605,84.6,7.7,0.3,0.8,0,3.5,15.4,61805,45409,16396,73.47,26.53,3881,41528,1141,15255,5022,56783,8.5,7,8.1,"Less than 25% P.O.C.","$52000 - $60000"
"26077","Kalamazoo County, Michigan",262745,56511,203326,27827,519,6210,108,12975,77.4,10.6,0.2,2.4,0,4.9,22.6,103445,66214,37231,64.01,35.99,6113,60101,2282,34949,8395,95050,9.2,6.1,8.1,"Less than 25% P.O.C.","$52000 - $60000"
"26079","Kalkaska County, Michigan",17585,46898,16553,146,158,95,0,354,94.1,0.8,0.9,0.5,0,2,5.9,7145,5901,1244,82.59,17.41,489,5412,135,1109,624,6521,8.3,10.9,8.7,"Less than 25% P.O.C.","$44000 - $52000"
"26081","Kent County, Michigan",648121,63053,477967,59796,1375,19363,127,68519,73.7,9.2,0.2,3,0,10.6,26.3,241746,168688,73058,69.78,30.22,20122,148566,6430,66628,26552,215194,11.9,8.8,11,"25% - 50% P.O.C.","$60000 or more"
"26083","Keweenaw County, Michigan",2111,50292,2043,19,7,4,0,17,96.8,0.9,0.3,0.2,0,0.8,3.2,1081,951,130,87.97,12.03,56,895,0,130,56,1025,5.9,0,5.2,"Less than 25% P.O.C.","$44000 - $52000"
"26085","Lake County, Michigan",11852,37320,10072,940,106,25,2,309,85,7.9,0.9,0.2,0,2.6,15,4631,3897,734,84.15,15.85,226,3671,75,659,301,4330,5.8,10.2,6.5,"Less than 25% P.O.C.","Less than $44000"
"26087","Lapeer County, Michigan",88038,62641,80793,1108,263,492,26,4114,91.8,1.3,0.3,0.6,0,4.7,8.2,33700,28290,5410,83.95,16.05,2926,25364,480,4930,3406,30294,10.3,8.9,10.1,"Less than 25% P.O.C.","$60000 or more"
"26089","Leelanau County, Michigan",21652,65249,19488,94,645,134,17,945,90,0.4,3,0.6,0.1,4.4,10,9139,8071,1068,88.31,11.69,510,7561,69,999,579,8560,6.3,6.5,6.3,"Less than 25% P.O.C.","$60000 or more"
"26091","Lenawee County, Michigan",98381,55450,85263,2236,306,305,20,7842,86.7,2.3,0.3,0.3,0,8,13.3,38345,29728,8617,77.53,22.47,2535,27193,677,7940,3212,35133,8.5,7.9,8.4,"Less than 25% P.O.C.","$52000 - $60000"
"26093","Livingston County, Michigan",189754,84221,179018,1108,443,1729,122,4630,94.3,0.6,0.2,0.9,0.1,2.4,5.7,72000,61489,10511,85.4,14.6,5490,55999,676,9835,6166,65834,8.9,6.4,8.6,"Less than 25% P.O.C.","$60000 or more"
"26095","Luce County, Michigan",6338,45469,4923,413,370,32,8,221,77.7,6.5,5.8,0.5,0.1,3.5,22.3,2231,1773,458,79.47,20.53,98,1675,52,406,150,2081,5.5,11.4,6.7,"Less than 25% P.O.C.","$44000 - $52000"
"26097","Mackinac County, Michigan",10780,47938,7883,349,1710,74,17,191,73.1,3.2,15.9,0.7,0.2,1.8,26.9,5269,3786,1483,71.85,28.15,158,3628,83,1400,241,5028,4.2,5.6,4.6,"25% - 50% P.O.C.","$44000 - $52000"
"26099","Macomb County, Michigan",870325,62855,687817,101209,2176,34954,539,22781,79,11.6,0.3,4,0.1,2.6,21,346402,254008,92394,73.33,26.67,24472,229536,6748,85646,31220,315182,9.6,7.3,9,"Less than 25% P.O.C.","$60000 or more"
"26101","Manistee County, Michigan",24457,50055,21763,687,421,81,16,772,89,2.8,1.7,0.3,0.1,3.2,11,9426,7865,1561,83.44,16.56,482,7383,65,1496,547,8879,6.1,4.2,5.8,"Less than 25% P.O.C.","$44000 - $52000"
"26103","Marquette County, Michigan",66686,53970,61408,1105,532,627,32,1016,92.1,1.7,0.8,0.9,0,1.5,7.9,26552,18791,7761,70.77,29.23,1306,17485,281,7480,1587,24965,7,3.6,6,"Less than 25% P.O.C.","$52000 - $60000"
"26105","Mason County, Michigan",28954,51725,26481,261,282,167,0,1322,91.5,0.9,1,0.6,0,4.6,8.5,12186,9366,2820,76.86,23.14,742,8624,188,2632,930,11256,7.9,6.7,7.6,"Less than 25% P.O.C.","$44000 - $52000"
"26107","Mecosta County, Michigan",43251,45018,39451,1275,271,346,9,992,91.2,2.9,0.6,0.8,0,2.3,8.8,15808,11594,4214,73.34,26.66,833,10761,265,3949,1098,14710,7.2,6.3,6.9,"Less than 25% P.O.C.","$44000 - $52000"
"26109","Menominee County, Michigan",23074,46828,21434,73,510,94,0,419,92.9,0.3,2.2,0.4,0,1.8,7.1,10627,8259,2368,77.72,22.28,514,7745,128,2240,642,9985,6.2,5.4,6,"Less than 25% P.O.C.","$44000 - $52000"
"26111","Midland County, Michigan",83355,62625,76250,1110,326,1916,38,2289,91.5,1.3,0.4,2.3,0,2.7,8.5,34199,26197,8002,76.6,23.4,2230,23967,568,7434,2798,31401,8.5,7.1,8.2,"Less than 25% P.O.C.","$60000 or more"
"26113","Missaukee County, Michigan",15028,47194,14121,89,63,29,0,437,94,0.6,0.4,0.2,0,2.9,6,6055,4851,1204,80.12,19.88,502,4349,174,1030,676,5379,10.3,14.5,11.2,"Less than 25% P.O.C.","$44000 - $52000"
"26115","Monroe County, Michigan",149727,62203,136707,3514,361,862,8,5359,91.3,2.3,0.2,0.6,0,3.6,8.7,59929,47778,12151,79.72,20.28,4560,43218,958,11193,5518,54411,9.5,7.9,9.2,"Less than 25% P.O.C.","$60000 or more"
"26117","Montcalm County, Michigan",63413,49448,58184,1321,326,224,58,2222,91.8,2.1,0.5,0.4,0.1,3.5,8.2,23913,18675,5238,78.1,21.9,1938,16737,369,4869,2307,21606,10.4,7,9.6,"Less than 25% P.O.C.","$44000 - $52000"
"26119","Montmorency County, Michigan",9265,41772,8881,22,109,14,3,122,95.9,0.2,1.2,0.2,0,1.3,4.1,4452,3742,710,84.05,15.95,186,3556,26,684,212,4240,5,3.7,4.8,"Less than 25% P.O.C.","Less than $44000"
"26121","Muskegon County, Michigan",173297,50854,132344,23397,1247,949,15,9809,76.4,13.5,0.7,0.5,0,5.7,23.6,65939,49270,16669,74.72,25.28,4967,44303,1590,15079,6557,59382,10.1,9.5,9.9,"Less than 25% P.O.C.","$44000 - $52000"
"26123","Newaygo County, Michigan",48366,50326,43792,543,316,186,0,2803,90.5,1.1,0.7,0.4,0,5.8,9.5,19161,16074,3087,83.89,16.11,1639,14435,380,2707,2019,17142,10.2,12.3,10.5,"Less than 25% P.O.C.","$44000 - $52000"
"26125","Oakland County, Michigan",1253185,79698,902331,169294,2725,93327,241,51653,72,13.5,0.2,7.4,0,4.1,28,504585,358384,146201,71.03,28.97,29138,329246,5897,140304,35035,469550,8.1,4,6.9,"25% - 50% P.O.C.","$60000 or more"
"26127","Oceana County, Michigan",26416,50104,21583,280,206,57,0,3934,81.7,1.1,0.8,0.2,0,14.9,18.3,10156,8386,1770,82.57,17.43,853,7533,287,1483,1140,9016,10.2,16.2,11.2,"Less than 25% P.O.C.","$44000 - $52000"
"26129","Ogemaw County, Michigan",20898,40373,19779,68,208,136,0,449,94.6,0.3,1,0.7,0,2.1,5.4,9184,7476,1708,81.4,18.6,600,6876,124,1584,724,8460,8,7.3,7.9,"Less than 25% P.O.C.","Less than $44000"
"26131","Ontonagon County, Michigan",5877,41546,5578,29,45,25,6,89,94.9,0.5,0.8,0.4,0.1,1.5,5.1,2793,2464,329,88.22,11.78,92,2372,13,316,105,2688,3.7,4,3.8,"Less than 25% P.O.C.","Less than $44000"
"26133","Osceola County, Michigan",23290,44032,22013,257,169,64,0,454,94.5,1.1,0.7,0.3,0,1.9,5.5,9181,7406,1775,80.67,19.33,697,6709,175,1600,872,8309,9.4,9.9,9.5,"Less than 25% P.O.C.","$44000 - $52000"
"26135","Oscoda County, Michigan",8248,42335,7878,41,49,12,4,135,95.5,0.5,0.6,0.1,0,1.6,4.5,3806,3245,561,85.26,14.74,235,3010,40,521,275,3531,7.2,7.1,7.2,"Less than 25% P.O.C.","Less than $44000"
"26137","Otsego County, Michigan",24490,54332,23149,124,75,139,3,423,94.5,0.5,0.3,0.6,0,1.7,5.5,9944,7846,2098,78.9,21.1,686,7160,215,1883,901,9043,8.7,10.2,9.1,"Less than 25% P.O.C.","$52000 - $60000"
"26139","Ottawa County, Michigan",286558,69314,240269,4089,661,7549,56,28112,83.8,1.4,0.2,2.6,0,9.8,16.2,102610,79724,22886,77.7,22.3,10673,69051,1624,21262,12297,90313,13.4,7.1,12,"Less than 25% P.O.C.","$60000 or more"
"26141","Presque Isle County, Michigan",12714,47948,12147,74,60,72,0,177,95.5,0.6,0.5,0.6,0,1.4,4.5,5797,5147,650,88.79,11.21,260,4887,27,623,287,5510,5.1,4.2,5,"Less than 25% P.O.C.","$44000 - $52000"
"26143","Roscommon County, Michigan",23851,42054,22632,38,174,69,0,449,94.9,0.2,0.7,0.3,0,1.9,5.1,11139,9137,2002,82.03,17.97,361,8776,75,1927,436,10703,4,3.7,3.9,"Less than 25% P.O.C.","Less than $44000"
"26145","Saginaw County, Michigan",191821,48000,133043,35005,379,2284,17,16218,69.4,18.2,0.2,1.2,0,8.5,30.6,78933,56249,22684,71.26,28.74,4216,52033,1651,21033,5867,73066,7.5,7.3,7.4,"25% - 50% P.O.C.","$44000 - $52000"
"26147","St. Clair County, Michigan",159247,56951,145070,3478,232,1010,57,5373,91.1,2.2,0.1,0.6,0,3.4,8.9,64850,50144,14706,77.32,22.68,4254,45890,1389,13317,5643,59207,8.5,9.4,8.7,"Less than 25% P.O.C.","$52000 - $60000"
"26149","St. Joseph County, Michigan",60836,52086,52623,1347,45,305,36,4822,86.5,2.2,0.1,0.5,0.1,7.9,13.5,24150,18018,6132,74.61,25.39,2174,15844,742,5390,2916,21234,12.1,12.1,12.1,"Less than 25% P.O.C.","$52000 - $60000"
"26151","Sanilac County, Michigan",41295,47672,38807,222,118,106,0,1522,94,0.5,0.3,0.3,0,3.7,6,17499,13775,3724,78.72,21.28,1115,12660,341,3383,1456,16043,8.1,9.2,8.3,"Less than 25% P.O.C.","$44000 - $52000"
"26153","Schoolcraft County, Michigan",8048,45500,6895,36,565,30,0,89,85.7,0.4,7,0.4,0,1.1,14.3,3468,2903,565,83.71,16.29,132,2771,47,518,179,3289,4.5,8.3,5.2,"Less than 25% P.O.C.","$44000 - $52000"
"26155","Shiawassee County, Michigan",68340,56032,64313,467,170,200,6,2011,94.1,0.7,0.2,0.3,0,2.9,5.9,27593,20858,6735,75.59,24.41,1745,19113,484,6251,2229,25364,8.4,7.2,8.1,"Less than 25% P.O.C.","$52000 - $60000"
"26157","Tuscola County, Michigan",52939,49988,49413,495,145,170,0,1808,93.3,0.9,0.3,0.3,0,3.4,6.7,21777,17950,3827,82.43,17.57,1483,16467,320,3507,1803,19974,8.3,8.4,8.3,"Less than 25% P.O.C.","$44000 - $52000"
"26159","Van Buren County, Michigan",75358,54485,61194,2394,285,513,18,8685,81.2,3.2,0.4,0.7,0,11.5,18.8,29411,22638,6773,76.97,23.03,2506,20132,782,5991,3288,26123,11.1,11.5,11.2,"Less than 25% P.O.C.","$52000 - $60000"
"26161","Washtenaw County, Michigan",367000,72586,257368,43225,883,33349,123,17329,70.1,11.8,0.2,9.1,0,4.7,29.9,141245,86332,54913,61.12,38.88,7114,79218,3313,51600,10427,130818,8.2,6,7.4,"25% - 50% P.O.C.","$60000 or more"
"26163","Wayne County, Michigan",1757299,47301,870241,677346,4673,58726,426,104419,49.5,38.5,0.3,3.3,0,5.9,50.5,682282,423147,259135,62.02,37.98,41865,381282,23087,236048,64952,617330,9.9,8.9,9.5,"50% - 75% P.O.C.","$44000 - $52000"
"26165","Wexford County, Michigan",33256,47193,31432,173,149,158,28,653,94.5,0.5,0.4,0.5,0.1,2,5.5,12963,9958,3005,76.82,23.18,973,8985,245,2760,1218,11745,9.8,8.2,9.4,"Less than 25% P.O.C.","$44000 - $52000"
"27001","Aitkin County, Minnesota",15834,49351,14873,71,318,54,14,221,93.9,0.4,2,0.3,0.1,1.4,6.1,7681,6310,1371,82.15,17.85,270,6040,169,1202,439,7242,4.3,12.3,5.7,"Less than 25% P.O.C.","$44000 - $52000"
"27003","Anoka County, Minnesota",350253,82175,284641,21506,2065,15582,92,15996,81.3,6.1,0.6,4.4,0,4.6,18.7,128198,102689,25509,80.1,19.9,11306,91383,2735,22774,14041,114157,11,10.7,11,"Less than 25% P.O.C.","$60000 or more"
"27005","Becker County, Minnesota",34011,60284,29332,167,2454,219,10,716,86.2,0.5,7.2,0.6,0,2.1,13.8,13617,10691,2926,78.51,21.49,1075,9616,239,2687,1314,12303,10.1,8.2,9.6,"Less than 25% P.O.C.","$60000 or more"
"27007","Beltrami County, Minnesota",46403,49160,33360,472,9117,348,32,1130,71.9,1,19.6,0.7,0.1,2.4,28.1,17372,11650,5722,67.06,32.94,1071,10579,453,5269,1524,15848,9.2,7.9,8.8,"25% - 50% P.O.C.","$44000 - $52000"
"27009","Benton County, Minnesota",40129,57715,36074,1601,50,408,0,981,89.9,4,0.1,1,0,2.4,10.1,16452,11085,5367,67.38,32.62,1152,9933,434,4933,1586,14866,10.4,8.1,9.6,"Less than 25% P.O.C.","$52000 - $60000"
"27011","Big Stone County, Minnesota",4996,53900,4799,3,14,0,0,91,96.1,0.1,0.3,0,0,1.8,3.9,2298,1676,622,72.93,27.07,119,1557,24,598,143,2155,7.1,3.9,6.2,"Less than 25% P.O.C.","$52000 - $60000"
"27013","Blue Earth County, Minnesota",66795,57429,58714,2578,177,1443,11,2438,87.9,3.9,0.3,2.2,0,3.6,12.1,26091,16179,9912,62.01,37.99,1435,14744,806,9106,2241,23850,8.9,8.1,8.6,"Less than 25% P.O.C.","$52000 - $60000"
"27015","Brown County, Minnesota",25163,61120,23499,171,57,166,0,1107,93.4,0.7,0.2,0.7,0,4.4,6.6,10764,8522,2242,79.17,20.83,729,7793,110,2132,839,9925,8.6,4.9,7.8,"Less than 25% P.O.C.","$60000 or more"
"27017","Carlton County, Minnesota",35633,63098,31399,667,1768,202,0,634,88.1,1.9,5,0.6,0,1.8,11.9,13613,10865,2748,79.81,20.19,1116,9749,165,2583,1281,12332,10.3,6,9.4,"Less than 25% P.O.C.","$60000 or more"
"27019","Carver County, Minnesota",101949,101496,90564,1780,215,2813,7,4272,88.8,1.7,0.2,2.8,0,4.2,11.2,36754,30105,6649,81.91,18.09,3543,26562,495,6154,4038,32716,11.8,7.4,11,"Less than 25% P.O.C.","$60000 or more"
"27021","Cass County, Minnesota",29268,52204,24264,122,3359,182,4,658,82.9,0.4,11.5,0.6,0,2.2,17.1,13164,10728,2436,81.49,18.51,885,9843,318,2118,1203,11961,8.2,13.1,9.1,"Less than 25% P.O.C.","$52000 - $60000"
"27023","Chippewa County, Minnesota",11953,55269,10413,99,206,105,137,872,87.1,0.8,1.7,0.9,1.1,7.3,12.9,5209,3475,1734,66.71,33.29,339,3136,137,1597,476,4733,9.8,7.9,9.1,"Less than 25% P.O.C.","$52000 - $60000"
"27025","Chisago County, Minnesota",55315,83464,51660,723,270,624,17,1205,93.4,1.3,0.5,1.1,0,2.2,6.6,20242,17480,2762,86.36,13.64,1792,15688,294,2468,2086,18156,10.3,10.6,10.3,"Less than 25% P.O.C.","$60000 or more"
"27027","Clay County, Minnesota",63446,65269,55305,2306,1022,803,74,2872,87.2,3.6,1.6,1.3,0.1,4.5,12.8,24364,16444,7920,67.49,32.51,1822,14622,528,7392,2350,22014,11.1,6.7,9.6,"Less than 25% P.O.C.","$60000 or more"
"27029","Clearwater County, Minnesota",8821,50386,7469,16,702,42,2,191,84.7,0.2,8,0.5,0,2.2,15.3,3405,2769,636,81.32,18.68,242,2527,79,557,321,3084,8.7,12.4,9.4,"Less than 25% P.O.C.","$44000 - $52000"
"27031","Cook County, Minnesota",5376,57432,4597,4,467,50,0,124,85.5,0.1,8.7,0.9,0,2.3,14.5,2691,2069,622,76.89,23.11,170,1899,89,533,259,2432,8.2,14.3,9.6,"Less than 25% P.O.C.","$52000 - $60000"
"27033","Cottonwood County, Minnesota",11299,52087,9722,99,9,429,18,870,86,0.9,0.1,3.8,0.2,7.7,14,4846,3784,1062,78.09,21.91,401,3383,72,990,473,4373,10.6,6.8,9.8,"Less than 25% P.O.C.","$52000 - $60000"
"27035","Crow Wing County, Minnesota",64217,56549,60939,512,532,272,0,958,94.9,0.8,0.8,0.4,0,1.5,5.1,26820,20528,6292,76.54,23.46,1509,19019,366,5926,1875,24945,7.4,5.8,7,"Less than 25% P.O.C.","$52000 - $60000"
"27037","Dakota County, Minnesota",421453,86036,330303,25657,1111,20222,169,30100,78.4,6.1,0.3,4.8,0,7.1,21.6,161488,119521,41967,74.01,25.99,11185,108336,3637,38330,14822,146666,9.4,8.7,9.2,"Less than 25% P.O.C.","$60000 or more"
"27039","Dodge County, Minnesota",20669,74575,19048,69,74,191,1,1028,92.2,0.3,0.4,0.9,0,5,7.8,7756,6510,1246,83.94,16.06,696,5814,99,1147,795,6961,10.7,7.9,10.3,"Less than 25% P.O.C.","$60000 or more"
"27041","Douglas County, Minnesota",37513,63819,35982,143,101,118,0,620,95.9,0.4,0.3,0.3,0,1.7,4.1,16663,12380,4283,74.3,25.7,1109,11271,224,4059,1333,15330,9,5.2,8,"Less than 25% P.O.C.","$60000 or more"
"27043","Faribault County, Minnesota",13801,53156,12530,35,41,51,0,954,90.8,0.3,0.3,0.4,0,6.9,9.2,6137,4756,1381,77.5,22.5,376,4380,121,1260,497,5640,7.9,8.8,8.1,"Less than 25% P.O.C.","$52000 - $60000"
"27045","Fillmore County, Minnesota",20949,61207,20169,107,7,105,1,344,96.3,0.5,0,0.5,0,1.6,3.7,8616,6963,1653,80.81,19.19,743,6220,156,1497,899,7717,10.7,9.4,10.4,"Less than 25% P.O.C.","$60000 or more"
"27047","Freeborn County, Minnesota",30463,53631,25909,303,59,752,0,2967,85.1,1,0.2,2.5,0,9.7,14.9,13009,9975,3034,76.68,23.32,772,9203,251,2783,1023,11986,7.7,8.3,7.9,"Less than 25% P.O.C.","$52000 - $60000"
"27049","Goodhue County, Minnesota",46246,66800,42567,604,373,383,0,1547,92,1.3,0.8,0.8,0,3.3,8,19452,14644,4808,75.28,24.72,1488,13156,251,4557,1739,17713,10.2,5.2,8.9,"Less than 25% P.O.C.","$60000 or more"
"27051","Grant County, Minnesota",5935,55466,5646,17,17,2,0,137,95.1,0.3,0.3,0,0,2.3,4.9,2612,2022,590,77.41,22.59,189,1833,25,565,214,2398,9.3,4.2,8.2,"Less than 25% P.O.C.","$52000 - $60000"
"27053","Hennepin County, Minnesota",1245837,78167,857475,162381,7067,88360,390,86179,68.8,13,0.6,7.1,0,6.9,31.2,508030,316847,191183,62.37,37.63,26759,290088,12521,178662,39280,468750,8.4,6.5,7.7,"25% - 50% P.O.C.","$60000 or more"
"27055","Houston County, Minnesota",18648,60382,17901,242,45,72,4,211,96,1.3,0.2,0.4,0,1.1,4,8253,6613,1640,80.13,19.87,513,6100,73,1567,586,7667,7.8,4.5,7.1,"Less than 25% P.O.C.","$60000 or more"
"27057","Hubbard County, Minnesota",21019,56709,19509,118,447,136,0,448,92.8,0.6,2.1,0.6,0,2.1,7.2,8688,7054,1634,81.19,18.81,555,6499,187,1447,742,7946,7.9,11.4,8.5,"Less than 25% P.O.C.","$52000 - $60000"
"27059","Isanti County, Minnesota",39430,74616,36959,178,85,576,6,801,93.7,0.5,0.2,1.5,0,2,6.3,14903,12299,2604,82.53,17.47,1319,10980,124,2480,1443,13460,10.7,4.8,9.7,"Less than 25% P.O.C.","$60000 or more"
"27061","Itasca County, Minnesota",45141,55139,41415,220,1621,192,3,674,91.7,0.5,3.6,0.4,0,1.5,8.3,19506,15853,3653,81.27,18.73,1411,14442,331,3322,1742,17764,8.9,9.1,8.9,"Less than 25% P.O.C.","$52000 - $60000"
"27063","Jackson County, Minnesota",9954,58727,9196,39,3,208,0,362,92.4,0.4,0,2.1,0,3.6,7.6,4419,3581,838,81.04,18.96,335,3246,84,754,419,4000,9.4,10,9.5,"Less than 25% P.O.C.","$52000 - $60000"
"27065","Kanabec County, Minnesota",16089,57163,15256,35,78,85,0,256,94.8,0.2,0.5,0.5,0,1.6,5.2,6439,5461,978,84.81,15.19,563,4898,70,908,633,5806,10.3,7.2,9.8,"Less than 25% P.O.C.","$52000 - $60000"
"27067","Kandiyohi County, Minnesota",42841,60294,34274,2285,92,420,0,5190,80,5.3,0.2,1,0,12.1,20,16889,12500,4389,74.01,25.99,1332,11168,503,3886,1835,15054,10.7,11.5,10.9,"Less than 25% P.O.C.","$60000 or more"
"27069","Kittson County, Minnesota",4311,59643,4110,64,22,29,0,40,95.3,1.5,0.5,0.7,0,0.9,4.7,1860,1498,362,80.54,19.46,134,1364,9,353,143,1717,8.9,2.5,7.7,"Less than 25% P.O.C.","$52000 - $60000"
"27071","Koochiching County, Minnesota",12515,50870,11665,73,389,40,0,168,93.2,0.6,3.1,0.3,0,1.3,6.8,5538,4363,1175,78.78,21.22,180,4183,27,1148,207,5331,4.1,2.3,3.7,"Less than 25% P.O.C.","$44000 - $52000"
"27073","Lac qui Parle County, Minnesota",6719,53071,6380,53,11,57,0,152,95,0.8,0.2,0.8,0,2.3,5,3090,2501,589,80.94,19.06,217,2284,24,565,241,2849,8.7,4.1,7.8,"Less than 25% P.O.C.","$52000 - $60000"
"27075","Lake County, Minnesota",10560,61452,10084,68,92,14,19,151,95.5,0.6,0.9,0.1,0.2,1.4,4.5,5192,4259,933,82.03,17.97,240,4019,51,882,291,4901,5.6,5.5,5.6,"Less than 25% P.O.C.","$60000 or more"
"27077","Lake of the Woods County, Minnesota",3771,49967,3506,2,49,3,0,3,93,0.1,1.3,0.1,0,0.1,7,1470,1189,281,80.88,19.12,74,1115,0,281,74,1396,6.2,0,5,"Less than 25% P.O.C.","$44000 - $52000"
"27079","Le Sueur County, Minnesota",28242,71080,25716,238,50,115,3,1755,91.1,0.8,0.2,0.4,0,6.2,8.9,10939,8925,2014,81.59,18.41,830,8095,222,1792,1052,9887,9.3,11,9.6,"Less than 25% P.O.C.","$60000 or more"
"27081","Lincoln County, Minnesota",5677,53077,5453,25,16,9,0,118,96.1,0.4,0.3,0.2,0,2.1,3.9,2468,1945,523,78.81,21.19,206,1739,47,476,253,2215,10.6,9,10.3,"Less than 25% P.O.C.","$52000 - $60000"
"27083","Lyon County, Minnesota",25758,57730,21581,862,50,1117,2,1770,83.8,3.3,0.2,4.3,0,6.9,16.2,10018,6851,3167,68.39,31.61,770,6081,254,2913,1024,8994,11.2,8,10.2,"Less than 25% P.O.C.","$52000 - $60000"
"27085","McLeod County, Minnesota",35832,62121,32575,209,80,210,0,2222,90.9,0.6,0.2,0.6,0,6.2,9.1,14714,11426,3288,77.65,22.35,1081,10345,170,3118,1251,13463,9.5,5.2,8.5,"Less than 25% P.O.C.","$60000 or more"
"27087","Mahnomen County, Minnesota",5501,44688,2495,29,2110,19,11,239,45.4,0.5,38.4,0.3,0.2,4.3,54.6,1946,1324,622,68.04,31.96,151,1173,108,514,259,1687,11.4,17.4,13.3,"50% - 75% P.O.C.","$44000 - $52000"
"27089","Marshall County, Minnesota",9372,60118,8736,33,28,33,8,424,93.2,0.4,0.3,0.4,0.1,4.5,6.8,3971,3279,692,82.57,17.43,337,2942,26,666,363,3608,10.3,3.8,9.1,"Less than 25% P.O.C.","$60000 or more"
"27091","Martin County, Minnesota",19852,52798,18446,92,28,102,16,888,92.9,0.5,0.1,0.5,0.1,4.5,7.1,8759,6466,2293,73.82,26.18,622,5844,100,2193,722,8037,9.6,4.4,8.2,"Less than 25% P.O.C.","$52000 - $60000"
"27093","Meeker County, Minnesota",23105,63452,21701,98,25,71,8,924,93.9,0.4,0.1,0.3,0,4,6.1,9209,7403,1806,80.39,19.61,852,6551,143,1663,995,8214,11.5,7.9,10.8,"Less than 25% P.O.C.","$60000 or more"
"27095","Mille Lacs County, Minnesota",25865,56135,22977,120,1238,134,9,640,88.8,0.5,4.8,0.5,0,2.5,11.2,10249,7696,2553,75.09,24.91,890,6806,226,2327,1116,9133,11.6,8.9,10.9,"Less than 25% P.O.C.","$52000 - $60000"
"27097","Morrison County, Minnesota",33064,57815,31634,185,64,144,0,577,95.7,0.6,0.2,0.4,0,1.7,4.3,13371,10326,3045,77.23,22.77,1047,9279,323,2722,1370,12001,10.1,10.6,10.2,"Less than 25% P.O.C.","$52000 - $60000"
"27099","Mower County, Minnesota",39807,54295,31277,1566,48,1468,248,4611,78.6,3.9,0.1,3.7,0.6,11.6,21.4,15565,11359,4206,72.98,27.02,1142,10217,614,3592,1756,13809,10.1,14.6,11.3,"Less than 25% P.O.C.","$52000 - $60000"
"27101","Murray County, Minnesota",8296,60231,7719,31,17,129,0,335,93,0.4,0.2,1.6,0,4,7,3645,2958,687,81.15,18.85,264,2694,26,661,290,3355,8.9,3.8,8,"Less than 25% P.O.C.","$60000 or more"
"27103","Nicollet County, Minnesota",33954,67399,30099,937,13,579,0,1548,88.6,2.8,0,1.7,0,4.6,11.4,12885,9519,3366,73.88,26.12,899,8620,110,3256,1009,11876,9.4,3.3,7.8,"Less than 25% P.O.C.","$60000 or more"
"27105","Nobles County, Minnesota",21734,55304,12922,866,84,1450,0,6047,59.5,4,0.4,6.7,0,27.8,40.5,8033,5677,2356,70.67,29.33,762,4915,326,2030,1088,6945,13.4,13.8,13.5,"25% - 50% P.O.C.","$52000 - $60000"
"27107","Norman County, Minnesota",6520,55085,5832,59,142,26,0,332,89.4,0.9,2.2,0.4,0,5.1,10.6,2746,2250,496,81.94,18.06,229,2021,41,455,270,2476,10.2,8.3,9.8,"Less than 25% P.O.C.","$52000 - $60000"
"27109","Olmsted County, Minnesota",154809,76951,123957,9280,370,8967,128,7626,80.1,6,0.2,5.8,0.1,4.9,19.9,62108,45178,16930,72.74,27.26,4366,40812,919,16011,5285,56823,9.7,5.4,8.5,"Less than 25% P.O.C.","$60000 or more"
"27111","Otter Tail County, Minnesota",58195,58682,53870,806,280,348,2,2017,92.6,1.4,0.5,0.6,0,3.5,7.4,24687,19324,5363,78.28,21.72,1689,17635,316,5047,2005,22682,8.7,5.9,8.1,"Less than 25% P.O.C.","$52000 - $60000"
"27113","Pennington County, Minnesota",14183,60122,12859,143,233,165,0,537,90.7,1,1.6,1.2,0,3.8,9.3,5995,4366,1629,72.83,27.17,354,4012,86,1543,440,5555,8.1,5.3,7.3,"Less than 25% P.O.C.","$60000 or more"
"27115","Pine County, Minnesota",29223,53422,26054,609,710,164,6,853,89.2,2.1,2.4,0.6,0,2.9,10.8,10760,8707,2053,80.92,19.08,747,7960,127,1926,874,9886,8.6,6.2,8.1,"Less than 25% P.O.C.","$52000 - $60000"
"27117","Pipestone County, Minnesota",9191,52917,8088,43,147,15,0,636,88,0.5,1.6,0.2,0,6.9,12,3973,2976,997,74.91,25.09,324,2652,46,951,370,3603,10.9,4.6,9.3,"Less than 25% P.O.C.","$52000 - $60000"
"27119","Polk County, Minnesota",31521,59343,27394,665,497,312,10,2046,86.9,2.1,1.6,1,0,6.5,13.1,12584,9179,3405,72.94,27.06,1048,8131,255,3150,1303,11281,11.4,7.5,10.4,"Less than 25% P.O.C.","$52000 - $60000"
"27121","Pope County, Minnesota",11048,61275,10601,46,32,63,0,173,96,0.4,0.3,0.6,0,1.6,4,4981,3862,1119,77.53,22.47,300,3562,47,1072,347,4634,7.8,4.2,7,"Less than 25% P.O.C.","$60000 or more"
"27123","Ramsey County, Minnesota",544442,64660,337039,64535,2606,78233,160,40748,61.9,11.9,0.5,14.4,0,7.5,38.1,209043,124254,84789,59.44,40.56,12317,111937,7956,76833,20273,188770,9.9,9.4,9.7,"25% - 50% P.O.C.","$60000 or more"
"27125","Red Lake County, Minnesota",4015,58576,3696,18,63,0,0,155,92.1,0.4,1.6,0,0,3.9,7.9,1669,1395,274,83.58,16.42,136,1259,8,266,144,1525,9.7,2.9,8.6,"Less than 25% P.O.C.","$52000 - $60000"
"27127","Redwood County, Minnesota",15261,55404,13278,119,682,409,0,534,87,0.8,4.5,2.7,0,3.5,13,6261,4914,1347,78.49,21.51,546,4368,98,1249,644,5617,11.1,7.3,10.3,"Less than 25% P.O.C.","$52000 - $60000"
"27129","Renville County, Minnesota",14652,59028,12875,51,208,100,0,1253,87.9,0.3,1.4,0.7,0,8.6,12.1,6085,4744,1341,77.96,22.04,390,4354,140,1201,530,5555,8.2,10.4,8.7,"Less than 25% P.O.C.","$52000 - $60000"
"27131","Rice County, Minnesota",66185,68584,54429,3756,231,1399,30,5380,82.2,5.7,0.3,2.1,0,8.1,17.8,23005,17018,5987,73.98,26.02,1506,15512,509,5478,2015,20990,8.8,8.5,8.8,"Less than 25% P.O.C.","$60000 or more"
"27133","Rock County, Minnesota",9402,63005,8793,87,29,100,0,299,93.5,0.9,0.3,1.1,0,3.2,6.5,3914,2954,960,75.47,24.53,376,2578,87,873,463,3451,12.7,9.1,11.8,"Less than 25% P.O.C.","$60000 or more"
"27135","Roseau County, Minnesota",15361,62202,14121,136,269,407,9,202,91.9,0.9,1.8,2.6,0.1,1.3,8.1,5980,4877,1103,81.56,18.44,504,4373,60,1043,564,5416,10.3,5.4,9.4,"Less than 25% P.O.C.","$60000 or more"
"27137","St. Louis County, Minnesota",199759,55646,182012,3107,3549,2060,88,3394,91.1,1.6,1.8,1,0,1.7,8.9,85807,61177,24630,71.3,28.7,4161,57016,1515,23115,5676,80131,6.8,6.2,6.6,"Less than 25% P.O.C.","$52000 - $60000"
"27139","Scott County, Minnesota",145275,102152,117891,6180,708,8845,3,7466,81.2,4.3,0.5,6.1,0,5.1,18.8,49479,40993,8486,82.85,17.15,5207,35786,1080,7406,6287,43192,12.7,12.7,12.7,"Less than 25% P.O.C.","$60000 or more"
"27141","Sherburne County, Minnesota",94463,89250,86124,2327,500,1213,0,2451,91.2,2.5,0.5,1.3,0,2.6,8.8,32206,26938,5268,83.64,16.36,3528,23410,291,4977,3819,28387,13.1,5.5,11.9,"Less than 25% P.O.C.","$60000 or more"
"27143","Sibley County, Minnesota",14892,63439,13160,157,34,107,0,1335,88.4,1.1,0.2,0.7,0,9,11.6,6031,4771,1260,79.11,20.89,516,4255,98,1162,614,5417,10.8,7.8,10.2,"Less than 25% P.O.C.","$60000 or more"
"27145","Stearns County, Minnesota",158452,62789,136299,10167,317,3298,0,5342,86,6.4,0.2,2.1,0,3.4,14,59479,40493,18986,68.08,31.92,4102,36391,1687,17299,5789,53690,10.1,8.9,9.7,"Less than 25% P.O.C.","$60000 or more"
"27147","Steele County, Minnesota",36683,64903,31753,1153,122,433,8,2860,86.6,3.1,0.3,1.2,0,7.8,13.4,14692,11043,3649,75.16,24.84,1069,9974,216,3433,1285,13407,9.7,5.9,8.7,"Less than 25% P.O.C.","$60000 or more"
"27149","Stevens County, Minnesota",9789,60559,8541,132,156,232,0,631,87.3,1.3,1.6,2.4,0,6.4,12.7,3624,2481,1143,68.46,31.54,263,2218,74,1069,337,3287,10.6,6.5,9.3,"Less than 25% P.O.C.","$60000 or more"
"27151","Swift County, Minnesota",9359,51620,8534,194,1,27,57,467,91.2,2.1,0,0.3,0.6,5,8.8,4263,2995,1268,70.26,29.74,194,2801,66,1202,260,4003,6.5,5.2,6.1,"Less than 25% P.O.C.","$44000 - $52000"
"27153","Todd County, Minnesota",24494,53585,22323,170,82,157,5,1478,91.1,0.7,0.3,0.6,0,6,8.9,9819,8108,1711,82.57,17.43,963,7145,173,1538,1136,8683,11.9,10.1,11.6,"Less than 25% P.O.C.","$52000 - $60000"
"27155","Traverse County, Minnesota",3311,51957,2937,17,164,6,0,103,88.7,0.5,5,0.2,0,3.1,11.3,1608,1280,328,79.6,20.4,105,1175,27,301,132,1476,8.2,8.2,8.2,"Less than 25% P.O.C.","$44000 - $52000"
"27157","Wabasha County, Minnesota",21537,65226,20387,119,45,102,0,630,94.7,0.6,0.2,0.5,0,2.9,5.3,9020,7092,1928,78.63,21.37,644,6448,95,1833,739,8281,9.1,4.9,8.2,"Less than 25% P.O.C.","$60000 or more"
"27159","Wadena County, Minnesota",13654,46605,12857,82,100,57,0,267,94.2,0.6,0.7,0.4,0,2,5.8,5666,4335,1331,76.51,23.49,395,3940,133,1198,528,5138,9.1,10,9.3,"Less than 25% P.O.C.","$44000 - $52000"
"27161","Waseca County, Minnesota",18740,56762,16720,444,131,113,0,1124,89.2,2.4,0.7,0.6,0,6,10.8,7425,5755,1670,77.51,22.49,646,5109,150,1520,796,6629,11.2,9,10.7,"Less than 25% P.O.C.","$52000 - $60000"
"27163","Washington County, Minnesota",255938,96671,211647,11593,800,14726,110,10716,82.7,4.5,0.3,5.8,0,4.2,17.3,94431,76614,17817,81.13,18.87,8386,68228,1209,16608,9595,84836,10.9,6.8,10.2,"Less than 25% P.O.C.","$60000 or more"
"27165","Watonwan County, Minnesota",10972,54065,7876,89,3,129,0,2797,71.8,0.8,0,1.2,0,25.5,28.2,4310,3314,996,76.89,23.11,331,2983,116,880,447,3863,10,11.6,10.4,"25% - 50% P.O.C.","$52000 - $60000"
"27167","Wilkin County, Minnesota",6291,60595,6176,25,13,1,0,22,98.2,0.4,0.2,0,0,0.3,1.8,2818,2201,617,78.11,21.89,187,2014,47,570,234,2584,8.5,7.6,8.3,"Less than 25% P.O.C.","$60000 or more"
"27169","Winona County, Minnesota",50725,59329,46224,651,159,1331,0,1502,91.1,1.3,0.3,2.6,0,3,8.9,19442,13693,5749,70.43,29.57,1109,12584,312,5437,1421,18021,8.1,5.4,7.3,"Less than 25% P.O.C.","$52000 - $60000"
"27171","Wright County, Minnesota",134438,84974,124159,1899,336,1493,20,3953,92.4,1.4,0.2,1.1,0,2.9,7.6,48242,39350,8892,81.57,18.43,4993,34357,686,8206,5679,42563,12.7,7.7,11.8,"Less than 25% P.O.C.","$60000 or more"
"27173","Yellow Medicine County, Minnesota",9814,59210,8781,68,249,60,0,461,89.5,0.7,2.5,0.6,0,4.7,10.5,4087,3247,840,79.45,20.55,339,2908,45,795,384,3703,10.4,5.4,9.4,"Less than 25% P.O.C.","$52000 - $60000"
"28001","Adams County, Mississippi",31266,29936,11321,17561,95,187,0,1829,36.2,56.2,0.3,0.6,0,5.8,63.8,11237,7014,4223,62.42,37.58,481,6533,328,3895,809,10428,6.9,7.8,7.2,"50% - 75% P.O.C.","Less than $44000"
"28003","Alcorn County, Mississippi",37090,42086,30735,4426,1,110,0,1179,82.9,11.9,0,0.3,0,3.2,17.1,14649,10064,4585,68.7,31.3,699,9365,288,4297,987,13662,6.9,6.3,6.7,"Less than 25% P.O.C.","Less than $44000"
"28005","Amite County, Mississippi",12412,33981,7119,5202,3,23,0,0,57.4,41.9,0,0.2,0,0,42.6,5218,4430,788,84.9,15.1,245,4185,65,723,310,4908,5.5,8.2,5.9,"25% - 50% P.O.C.","Less than $44000"
"28007","Attala County, Mississippi",18437,33767,9883,7784,25,37,0,377,53.6,42.2,0.1,0.2,0,2,46.4,6941,5031,1910,72.48,27.52,573,4458,230,1680,803,6138,11.4,12,11.6,"25% - 50% P.O.C.","Less than $44000"
"28009","Benton County, Mississippi",8232,36258,4977,2804,0,0,15,214,60.5,34.1,0,0,0.2,2.6,39.5,3149,2538,611,80.6,19.4,145,2393,91,520,236,2913,5.7,14.9,7.5,"25% - 50% P.O.C.","Less than $44000"
"28011","Bolivar County, Mississippi",31848,29854,10340,20383,40,286,0,687,32.5,64,0.1,0.9,0,2.2,67.5,12111,6491,5620,53.6,46.4,510,5981,561,5059,1071,11040,7.9,10,8.8,"50% - 75% P.O.C.","Less than $44000"
"28013","Calhoun County, Mississippi",14499,37263,9350,3968,0,34,0,873,64.5,27.4,0,0.2,0,6,35.5,5846,4358,1488,74.55,25.45,280,4078,124,1364,404,5442,6.4,8.3,6.9,"25% - 50% P.O.C.","Less than $44000"
"28015","Carroll County, Mississippi",10070,46052,6481,3493,5,0,0,24,64.4,34.7,0,0,0,0.2,35.6,3827,3106,721,81.16,18.84,129,2977,33,688,162,3665,4.2,4.6,4.2,"25% - 50% P.O.C.","$44000 - $52000"
"28017","Chickasaw County, Mississippi",17193,36548,8525,7616,11,33,0,841,49.6,44.3,0.1,0.2,0,4.9,50.4,6476,4513,1963,69.69,30.31,397,4116,131,1832,528,5948,8.8,6.7,8.2,"50% - 75% P.O.C.","Less than $44000"
"28019","Choctaw County, Mississippi",8277,36777,5577,2564,34,2,8,49,67.4,31,0.4,0,0.1,0.6,32.6,3228,2536,692,78.56,21.44,135,2401,37,655,172,3056,5.3,5.3,5.3,"25% - 50% P.O.C.","Less than $44000"
"28021","Claiborne County, Mississippi",9089,29338,1025,7928,6,103,0,8,11.3,87.2,0.1,1.1,0,0.1,88.7,2908,2020,888,69.46,30.54,188,1832,69,819,257,2651,9.3,7.8,8.8,"75% or more P.O.C.","Less than $44000"
"28023","Clarke County, Mississippi",15770,43207,9974,5592,8,0,0,102,63.2,35.5,0.1,0,0,0.6,36.8,6237,5195,1042,83.29,16.71,419,4776,57,985,476,5761,8.1,5.5,7.6,"25% - 50% P.O.C.","Less than $44000"
"28025","Clay County, Mississippi",19640,31833,7622,11770,92,57,0,14,38.8,59.9,0.5,0.3,0,0.1,61.2,7618,5436,2182,71.36,28.64,329,5107,180,2002,509,7109,6.1,8.2,6.7,"50% - 75% P.O.C.","Less than $44000"
"28027","Coahoma County, Mississippi",23255,29121,4834,18030,39,115,0,86,20.8,77.5,0.2,0.5,0,0.4,79.2,8782,4442,4340,50.58,49.42,377,4065,464,3876,841,7941,8.5,10.7,9.6,"75% or more P.O.C.","Less than $44000"
"28029","Copiah County, Mississippi",28501,42151,12509,14698,6,103,0,902,43.9,51.6,0,0.4,0,3.2,56.1,9414,7271,2143,77.24,22.76,645,6626,271,1872,916,8498,8.9,12.6,9.7,"50% - 75% P.O.C.","Less than $44000"
"28031","Covington County, Mississippi",18978,38178,11470,6946,0,0,0,452,60.4,36.6,0,0,0,2.4,39.6,6759,5286,1473,78.21,21.79,498,4788,66,1407,564,6195,9.4,4.5,8.3,"25% - 50% P.O.C.","Less than $44000"
"28033","DeSoto County, Mississippi",178975,67038,115053,48654,325,2524,25,8836,64.3,27.2,0.2,1.4,0,4.9,35.7,62890,46531,16359,73.99,26.01,4633,41898,2097,14262,6730,56160,10,12.8,10.7,"25% - 50% P.O.C.","$60000 or more"
"28035","Forrest County, Mississippi",75224,39840,42808,27945,163,639,0,2203,56.9,37.1,0.2,0.8,0,2.9,43.1,28086,15308,12778,54.5,45.5,1160,14148,1034,11744,2194,25892,7.6,8.1,7.8,"25% - 50% P.O.C.","Less than $44000"
"28037","Franklin County, Mississippi",7733,40219,4884,2782,12,4,0,21,63.2,36,0.2,0.1,0,0.3,36.8,2928,2252,676,76.91,23.09,191,2061,52,624,243,2685,8.5,7.7,8.3,"25% - 50% P.O.C.","Less than $44000"
"28039","George County, Mississippi",23917,47292,20835,1920,125,107,0,683,87.1,8,0.5,0.4,0,2.9,12.9,7592,6210,1382,81.8,18.2,642,5568,151,1231,793,6799,10.3,10.9,10.4,"Less than 25% P.O.C.","$44000 - $52000"
"28041","Greene County, Mississippi",13645,49677,9861,3538,30,0,0,163,72.3,25.9,0.2,0,0,1.2,27.7,3925,3249,676,82.78,17.22,294,2955,58,618,352,3573,9,8.6,9,"25% - 50% P.O.C.","$44000 - $52000"
"28043","Grenada County, Mississippi",21088,40122,11528,9139,148,24,0,127,54.7,43.3,0.7,0.1,0,0.6,45.3,8391,5367,3024,63.96,36.04,428,4939,266,2758,694,7697,8,8.8,8.3,"25% - 50% P.O.C.","Less than $44000"
"28045","Hancock County, Mississippi",46961,48119,39769,3765,264,268,0,1794,84.7,8,0.6,0.6,0,3.8,15.3,20036,15131,4905,75.52,24.48,1553,13578,372,4533,1925,18111,10.3,7.6,9.6,"Less than 25% P.O.C.","$44000 - $52000"
"28047","Harrison County, Mississippi",204502,47894,130615,50506,1039,5813,64,11193,63.9,24.7,0.5,2.8,0,5.5,36.1,78104,44241,33863,56.64,43.36,3430,40811,3770,30093,7200,70904,7.8,11.1,9.2,"25% - 50% P.O.C.","$44000 - $52000"
"28049","Hinds County, Mississippi",238797,44625,58497,172749,314,1844,74,3676,24.5,72.3,0.1,0.8,0,1.5,75.5,88611,51408,37203,58.02,41.98,4225,47183,3521,33682,7746,80865,8.2,9.5,8.7,"75% or more P.O.C.","$44000 - $52000"
"28051","Holmes County, Mississippi",17737,21504,2736,14897,0,12,0,30,15.4,84,0,0.1,0,0.2,84.6,6188,3791,2397,61.26,38.74,332,3459,206,2191,538,5650,8.8,8.6,8.7,"75% or more P.O.C.","Less than $44000"
"28053","Humphreys County, Mississippi",8389,28962,1730,6346,24,7,4,278,20.6,75.6,0.3,0.1,0,3.3,79.4,3186,1971,1215,61.86,38.14,174,1797,102,1113,276,2910,8.8,8.4,8.7,"75% or more P.O.C.","Less than $44000"
"28055","Issaquena County, Mississippi",1361,24208,504,839,0,0,0,18,37,61.6,0,0,0,1.3,63,483,211,272,43.69,56.31,14,197,21,251,35,448,6.6,7.7,7.2,"50% - 75% P.O.C.","Less than $44000"
"28057","Itawamba County, Mississippi",23462,44567,21120,1678,84,6,6,376,90,7.2,0.4,0,0,1.6,10,8653,6606,2047,76.34,23.66,397,6209,93,1954,490,8163,6,4.5,5.7,"Less than 25% P.O.C.","$44000 - $52000"
"28059","Jackson County, Mississippi",142376,51657,96260,29882,499,3414,82,9242,67.6,21,0.4,2.4,0.1,6.5,32.4,52423,36586,15837,69.79,30.21,2883,33703,1378,14459,4261,48162,7.9,8.7,8.1,"25% - 50% P.O.C.","$44000 - $52000"
"28061","Jasper County, Mississippi",16505,35872,7379,8889,1,0,0,75,44.7,53.9,0,0,0,0.5,55.3,6629,5637,992,85.04,14.96,515,5122,54,938,569,6060,9.1,5.4,8.6,"50% - 75% P.O.C.","Less than $44000"
"28063","Jefferson County, Mississippi",7225,25019,938,5705,11,43,0,522,13,79,0.2,0.6,0,7.2,87,2448,1649,799,67.36,32.64,177,1472,53,746,230,2218,10.7,6.6,9.4,"75% or more P.O.C.","Less than $44000"
"28065","Jefferson Davis County, Mississippi",11339,32116,4275,6950,0,14,0,40,37.7,61.3,0,0.1,0,0.4,62.3,4713,3563,1150,75.6,24.4,260,3303,73,1077,333,4380,7.3,6.3,7.1,"50% - 75% P.O.C.","Less than $44000"
"28067","Jones County, Mississippi",68352,41775,44132,20041,146,225,47,3073,64.6,29.3,0.2,0.3,0.1,4.5,35.4,24858,18059,6799,72.65,27.35,1399,16660,795,6004,2194,22664,7.7,11.7,8.8,"25% - 50% P.O.C.","Less than $44000"
"28069","Kemper County, Mississippi",9943,31103,3375,6134,364,7,0,58,33.9,61.7,3.7,0.1,0,0.6,66.1,3611,2659,952,73.64,26.36,230,2429,44,908,274,3337,8.6,4.6,7.6,"50% - 75% P.O.C.","Less than $44000"
"28071","Lafayette County, Mississippi",53590,50272,37539,12591,132,1116,19,1407,70,23.5,0.2,2.1,0,2.6,30,18721,11616,7105,62.05,37.95,929,10687,291,6814,1220,17501,8,4.1,6.5,"25% - 50% P.O.C.","$44000 - $52000"
"28073","Lamar County, Mississippi",61969,60328,45921,12446,22,799,0,1682,74.1,20.1,0,1.3,0,2.7,25.9,22116,14920,7196,67.46,32.54,1370,13550,970,6226,2340,19776,9.2,13.5,10.6,"25% - 50% P.O.C.","$60000 or more"
"28075","Lauderdale County, Mississippi",76279,42534,40059,33271,137,505,0,1723,52.5,43.6,0.2,0.7,0,2.3,47.5,29736,19169,10567,64.46,35.54,1198,17971,859,9708,2057,27679,6.2,8.1,6.9,"25% - 50% P.O.C.","Less than $44000"
"28077","Lawrence County, Mississippi",12633,41914,8196,4109,19,28,0,116,64.9,32.5,0.2,0.2,0,0.9,35.1,4849,3646,1203,75.19,24.81,329,3317,135,1068,464,4385,9,11.2,9.6,"25% - 50% P.O.C.","Less than $44000"
"28079","Leake County, Mississippi",22792,37096,10716,9504,1293,117,0,1059,47,41.7,5.7,0.5,0,4.6,53,8105,5738,2367,70.8,29.2,593,5145,343,2024,936,7169,10.3,14.5,11.5,"50% - 75% P.O.C.","Less than $44000"
"28081","Lee County, Mississippi",85072,50559,55681,24991,225,833,7,2249,65.5,29.4,0.3,1,0,2.6,34.5,32099,21784,10315,67.87,32.13,1876,19908,780,9535,2656,29443,8.6,7.6,8.3,"25% - 50% P.O.C.","$44000 - $52000"
"28083","Leflore County, Mississippi",29222,26735,6484,21683,0,176,0,773,22.2,74.2,0,0.6,0,2.6,77.8,9962,5042,4920,50.61,49.39,415,4627,478,4442,893,9069,8.2,9.7,9,"75% or more P.O.C.","Less than $44000"
"28085","Lincoln County, Mississippi",34320,42606,23053,10945,5,165,0,152,67.2,31.9,0,0.5,0,0.4,32.8,12699,9568,3131,75.34,24.66,727,8841,329,2802,1056,11643,7.6,10.5,8.3,"25% - 50% P.O.C.","Less than $44000"
"28087","Lowndes County, Mississippi",59150,50441,30605,25868,83,602,10,1204,51.7,43.7,0.1,1,0,2,48.3,22436,14253,8183,63.53,36.47,973,13280,660,7523,1633,20803,6.8,8.1,7.3,"25% - 50% P.O.C.","$44000 - $52000"
"28089","Madison County, Mississippi",104562,71824,57866,39677,181,2699,9,3133,55.3,37.9,0.2,2.6,0,3,44.7,39635,28411,11224,71.68,28.32,2679,25732,752,10472,3431,36204,9.4,6.7,8.7,"25% - 50% P.O.C.","$60000 or more"
"28091","Marion County, Mississippi",24990,32090,16194,8140,0,104,21,402,64.8,32.6,0,0.4,0.1,1.6,35.2,9483,7800,1683,82.25,17.75,696,7104,138,1545,834,8649,8.9,8.2,8.8,"25% - 50% P.O.C.","Less than $44000"
"28093","Marshall County, Mississippi",35599,42233,16990,16992,26,0,0,1315,47.7,47.7,0.1,0,0,3.7,52.3,12772,9644,3128,75.51,24.49,811,8833,366,2762,1177,11595,8.4,11.7,9.2,"50% - 75% P.O.C.","Less than $44000"
"28095","Monroe County, Mississippi",35673,42354,23903,11098,8,31,0,450,67,31.1,0,0.1,0,1.3,33,13966,10377,3589,74.3,25.7,910,9467,506,3083,1416,12550,8.8,14.1,10.1,"25% - 50% P.O.C.","Less than $44000"
"28097","Montgomery County, Mississippi",10068,39840,5250,4435,0,29,0,140,52.1,44.1,0,0.3,0,1.4,47.9,4539,3143,1396,69.24,30.76,92,3051,226,1170,318,4221,2.9,16.2,7,"25% - 50% P.O.C.","Less than $44000"
"28099","Neshoba County, Mississippi",29332,37987,17093,6145,4824,159,8,626,58.3,20.9,16.4,0.5,0,2.1,41.7,10657,7625,3032,71.55,28.45,918,6707,366,2666,1284,9373,12,12.1,12,"25% - 50% P.O.C.","Less than $44000"
"28101","Newton County, Mississippi",21360,35958,12869,6498,1135,111,0,408,60.2,30.4,5.3,0.5,0,1.9,39.8,8037,6201,1836,77.16,22.84,710,5491,259,1577,969,7068,11.4,14.1,12.1,"25% - 50% P.O.C.","Less than $44000"
"28103","Noxubee County, Mississippi",10700,33784,2766,7721,0,5,0,150,25.9,72.2,0,0,0,1.4,74.1,3986,2907,1079,72.93,27.07,185,2722,142,937,327,3659,6.4,13.2,8.2,"50% - 75% P.O.C.","Less than $44000"
"28105","Oktibbeha County, Mississippi",49512,40453,27946,18277,43,1597,29,837,56.4,36.9,0.1,3.2,0.1,1.7,43.6,17798,9201,8597,51.7,48.3,640,8561,440,8157,1080,16718,7,5.1,6.1,"25% - 50% P.O.C.","Less than $44000"
"28107","Panola County, Mississippi",34190,38304,16042,16530,64,5,21,699,46.9,48.3,0.2,0,0.1,2,53.1,12488,8696,3792,69.63,30.37,691,8005,525,3267,1216,11272,7.9,13.8,9.7,"50% - 75% P.O.C.","Less than $44000"
"28109","Pearl River County, Mississippi",55219,46901,45177,7046,31,137,0,1709,81.8,12.8,0.1,0.2,0,3.1,18.2,21020,16354,4666,77.8,22.2,1449,14905,604,4062,2053,18967,8.9,12.9,9.8,"Less than 25% P.O.C.","$44000 - $52000"
"28111","Perry County, Mississippi",12006,42469,9312,2379,0,18,0,181,77.6,19.8,0,0.1,0,1.5,22.4,4623,3802,821,82.24,17.76,413,3389,93,728,506,4117,10.9,11.3,10.9,"Less than 25% P.O.C.","Less than $44000"
"28113","Pike County, Mississippi",39532,31784,17150,21357,198,125,0,628,43.4,54,0.5,0.3,0,1.6,56.6,14404,9940,4464,69.01,30.99,711,9229,440,4024,1151,13253,7.2,9.9,8,"50% - 75% P.O.C.","Less than $44000"
"28115","Pontotoc County, Mississippi",31618,44759,24171,4893,10,25,0,2171,76.4,15.5,0,0.1,0,6.9,23.6,10783,7685,3098,71.27,28.73,833,6852,437,2661,1270,9513,10.8,14.1,11.8,"Less than 25% P.O.C.","$44000 - $52000"
"28117","Prentiss County, Mississippi",25255,39256,20830,2533,17,554,0,380,82.5,10,0.1,2.2,0,1.5,17.5,9145,6651,2494,72.73,27.27,451,6200,425,2069,876,8269,6.8,17,9.6,"Less than 25% P.O.C.","Less than $44000"
"28119","Quitman County, Mississippi",7187,25283,1871,5176,0,16,0,88,26,72,0,0.2,0,1.2,74,3027,1776,1251,58.67,41.33,133,1643,130,1121,263,2764,7.5,10.4,8.7,"50% - 75% P.O.C.","Less than $44000"
"28121","Rankin County, Mississippi",152677,65996,112876,31635,221,1765,48,4201,73.9,20.7,0.1,1.2,0,2.8,26.1,55909,42778,13131,76.51,23.49,4289,38489,1167,11964,5456,50453,10,8.9,9.8,"25% - 50% P.O.C.","$60000 or more"
"28123","Scott County, Mississippi",28332,34943,13977,10745,123,73,0,3197,49.3,37.9,0.4,0.3,0,11.3,50.7,10180,7545,2635,74.12,25.88,544,7001,385,2250,929,9251,7.2,14.6,9.1,"50% - 75% P.O.C.","Less than $44000"
"28125","Sharkey County, Mississippi",4404,29394,1104,3284,5,0,0,5,25.1,74.6,0.1,0,0,0.1,74.9,1751,1122,629,64.08,35.92,88,1034,71,558,159,1592,7.8,11.3,9.1,"50% - 75% P.O.C.","Less than $44000"
"28127","Simpson County, Mississippi",26888,43850,16560,9851,4,149,0,68,61.6,36.6,0,0.6,0,0.3,38.4,9486,7564,1922,79.74,20.26,591,6973,361,1561,952,8534,7.8,18.8,10,"25% - 50% P.O.C.","Less than $44000"
"28129","Smith County, Mississippi",16009,43105,11852,3675,0,85,37,280,74,23,0,0.5,0.2,1.7,26,5820,4832,988,83.02,16.98,257,4575,88,900,345,5475,5.3,8.9,5.9,"25% - 50% P.O.C.","Less than $44000"
"28131","Stone County, Mississippi",18276,45483,13981,3323,34,0,17,369,76.5,18.2,0.2,0,0.1,2,23.5,6334,4720,1614,74.52,25.48,444,4276,282,1332,726,5608,9.4,17.5,11.5,"Less than 25% P.O.C.","$44000 - $52000"
"28133","Sunflower County, Mississippi",26168,30838,6220,19332,33,20,0,474,23.8,73.9,0.1,0.1,0,1.8,76.2,8322,4458,3864,53.57,46.43,369,4089,491,3373,860,7462,8.3,12.7,10.3,"75% or more P.O.C.","Less than $44000"
"28135","Tallahatchie County, Mississippi",14158,29864,4943,7587,22,198,11,1341,34.9,53.6,0.2,1.4,0.1,9.5,65.1,4369,3144,1225,71.96,28.04,283,2861,138,1087,421,3948,9,11.3,9.6,"50% - 75% P.O.C.","Less than $44000"
"28137","Tate County, Mississippi",28404,51030,18349,8483,34,41,34,747,64.6,29.9,0.1,0.1,0.1,2.6,35.4,10324,7725,2599,74.83,25.17,839,6886,462,2137,1301,9023,10.9,17.8,12.6,"25% - 50% P.O.C.","$44000 - $52000"
"28139","Tippah County, Mississippi",22018,39246,16953,3644,3,63,11,1051,77,16.6,0,0.3,0,4.8,23,7834,5664,2170,72.3,27.7,492,5172,280,1890,772,7062,8.7,12.9,9.9,"Less than 25% P.O.C.","Less than $44000"
"28141","Tishomingo County, Mississippi",19441,37681,18117,509,35,5,0,616,93.2,2.6,0.2,0,0,3.2,6.8,7635,5766,1869,75.52,24.48,395,5371,147,1722,542,7093,6.9,7.9,7.1,"Less than 25% P.O.C.","Less than $44000"
"28143","Tunica County, Mississippi",9988,39370,1897,7830,0,140,0,96,19,78.4,0,1.4,0,1,81,3930,1581,2349,40.23,59.77,146,1435,397,1952,543,3387,9.2,16.9,13.8,"75% or more P.O.C.","Less than $44000"
"28145","Union County, Mississippi",28507,45754,22292,4405,0,102,0,1248,78.2,15.5,0,0.4,0,4.4,21.8,9808,7174,2634,73.14,26.86,592,6582,349,2285,941,8867,8.3,13.2,9.6,"Less than 25% P.O.C.","$44000 - $52000"
"28147","Walthall County, Mississippi",14477,30961,7623,6706,0,15,0,119,52.7,46.3,0,0.1,0,0.8,47.3,5601,4922,679,87.88,12.12,496,4426,59,620,555,5046,10.1,8.7,9.9,"25% - 50% P.O.C.","Less than $44000"
"28149","Warren County, Mississippi",46519,45113,21897,22969,53,332,8,981,47.1,49.4,0.1,0.7,0,2.1,52.9,18235,12053,6182,66.1,33.9,976,11077,398,5784,1374,16861,8.1,6.4,7.5,"50% - 75% P.O.C.","$44000 - $52000"
"28151","Washington County, Mississippi",46057,29705,11577,33160,45,260,0,745,25.1,72,0.1,0.6,0,1.6,74.9,17988,9514,8474,52.89,47.11,763,8751,1006,7468,1769,16219,8,11.9,9.8,"50% - 75% P.O.C.","Less than $44000"
"28153","Wayne County, Mississippi",20373,37706,11695,8359,0,26,0,132,57.4,41,0,0.1,0,0.6,42.6,7683,6413,1270,83.47,16.53,412,6001,94,1176,506,7177,6.4,7.4,6.6,"25% - 50% P.O.C.","Less than $44000"
"28155","Webster County, Mississippi",9768,45730,7639,1995,23,34,0,68,78.2,20.4,0.2,0.3,0,0.7,21.8,3782,2886,896,76.31,23.69,194,2692,122,774,316,3466,6.7,13.6,8.4,"Less than 25% P.O.C.","$44000 - $52000"
"28157","Wilkinson County, Mississippi",8875,27313,2469,6294,0,10,0,19,27.8,70.9,0,0.1,0,0.2,72.2,3170,2534,636,79.94,20.06,106,2428,26,610,132,3038,4.2,4.1,4.2,"50% - 75% P.O.C.","Less than $44000"
"28159","Winston County, Mississippi",18229,34724,9103,8489,242,6,0,234,49.9,46.6,1.3,0,0,1.3,50.1,7269,5313,1956,73.09,26.91,367,4946,263,1693,630,6639,6.9,13.4,8.7,"50% - 75% P.O.C.","Less than $44000"
"28161","Yalobusha County, Mississippi",12367,41464,7175,4904,5,19,0,172,58,39.7,0,0.2,0,1.4,42,5181,3629,1552,70.04,29.96,143,3486,166,1386,309,4872,3.9,10.7,6,"25% - 50% P.O.C.","Less than $44000"
"28163","Yazoo County, Mississippi",28565,33279,9903,16908,92,126,0,1312,34.7,59.2,0.3,0.4,0,4.6,65.3,8542,5395,3147,63.16,36.84,475,4920,442,2705,917,7625,8.8,14,10.7,"50% - 75% P.O.C.","Less than $44000"
"29001","Adair County, Missouri",25369,41929,22788,680,29,608,56,622,89.8,2.7,0.1,2.4,0.2,2.5,10.2,9258,5561,3697,60.07,39.93,391,5170,103,3594,494,8764,7,2.8,5.3,"Less than 25% P.O.C.","Less than $44000"
"29003","Andrew County, Missouri",17503,58772,16536,240,45,34,0,438,94.5,1.4,0.3,0.2,0,2.5,5.5,6763,5406,1357,79.93,20.07,487,4919,218,1139,705,6058,9,16.1,10.4,"Less than 25% P.O.C.","$52000 - $60000"
"29005","Atchison County, Missouri",5229,50236,5049,24,41,25,0,69,96.6,0.5,0.8,0.5,0,1.3,3.4,2562,1786,776,69.71,30.29,79,1707,62,714,141,2421,4.4,8,5.5,"Less than 25% P.O.C.","$44000 - $52000"
"29007","Audrain County, Missouri",25644,44261,22223,1464,59,33,24,797,86.7,5.7,0.2,0.1,0.1,3.1,13.3,9286,6360,2926,68.49,31.51,621,5739,182,2744,803,8483,9.8,6.2,8.6,"Less than 25% P.O.C.","$44000 - $52000"
"29009","Barry County, Missouri",35530,44403,30426,80,211,454,0,3321,85.6,0.2,0.6,1.3,0,9.3,14.4,13645,10062,3583,73.74,26.26,758,9304,708,2875,1466,12179,7.5,19.8,10.7,"Less than 25% P.O.C.","$44000 - $52000"
"29011","Barton County, Missouri",11797,44125,10905,35,280,4,9,187,92.4,0.3,2.4,0,0.1,1.6,7.6,4895,3430,1465,70.07,29.93,298,3132,161,1304,459,4436,8.7,11,9.4,"Less than 25% P.O.C.","$44000 - $52000"
"29013","Bates County, Missouri",16296,47625,15341,246,96,47,31,360,94.1,1.5,0.6,0.3,0.2,2.2,5.9,6547,4761,1786,72.72,27.28,525,4236,237,1549,762,5785,11,13.3,11.6,"Less than 25% P.O.C.","$44000 - $52000"
"29015","Benton County, Missouri",19107,40249,18115,48,190,16,0,391,94.8,0.3,1,0.1,0,2,5.2,7872,6426,1446,81.63,18.37,301,6125,166,1280,467,7405,4.7,11.5,5.9,"Less than 25% P.O.C.","Less than $44000"
"29017","Bollinger County, Missouri",12225,44158,11735,50,105,44,0,137,96,0.4,0.9,0.4,0,1.1,4,4593,3712,881,80.82,19.18,308,3404,86,795,394,4199,8.3,9.8,8.6,"Less than 25% P.O.C.","$44000 - $52000"
"29019","Boone County, Missouri",177651,55328,140135,15935,503,7870,127,6086,78.9,9,0.3,4.4,0.1,3.4,21.1,70619,39269,31350,55.61,44.39,2956,36313,1756,29594,4712,65907,7.5,5.6,6.7,"Less than 25% P.O.C.","$52000 - $60000"
"29021","Buchanan County, Missouri",88460,51916,73664,4522,334,962,256,5776,83.3,5.1,0.4,1.1,0.3,6.5,16.7,33501,20888,12613,62.35,37.65,1864,19024,1087,11526,2951,30550,8.9,8.6,8.8,"Less than 25% P.O.C.","$44000 - $52000"
"29023","Butler County, Missouri",42656,39915,37775,2367,239,325,28,914,88.6,5.5,0.6,0.8,0.1,2.1,11.4,16390,10439,5951,63.69,36.31,760,9679,724,5227,1484,14906,7.3,12.2,9.1,"Less than 25% P.O.C.","Less than $44000"
"29025","Caldwell County, Missouri",9039,49839,8540,52,63,37,0,147,94.5,0.6,0.7,0.4,0,1.6,5.5,3639,2770,869,76.12,23.88,313,2457,89,780,402,3237,11.3,10.2,11,"Less than 25% P.O.C.","$44000 - $52000"
"29027","Callaway County, Missouri",44889,56938,40487,1941,229,346,148,940,90.2,4.3,0.5,0.8,0.3,2.1,9.8,15973,11582,4391,72.51,27.49,1114,10468,400,3991,1514,14459,9.6,9.1,9.5,"Less than 25% P.O.C.","$52000 - $60000"
"29029","Camden County, Missouri",45466,53478,42853,335,259,139,0,1242,94.3,0.7,0.6,0.3,0,2.7,5.7,16031,12938,3093,80.71,19.29,580,12358,286,2807,866,15165,4.5,9.2,5.4,"Less than 25% P.O.C.","$52000 - $60000"
"29031","Cape Girardeau County, Missouri",78491,53732,67460,5777,42,1340,32,1827,85.9,7.4,0.1,1.7,0,2.3,14.1,29594,19229,10365,64.98,35.02,1276,17953,890,9475,2166,27428,6.6,8.6,7.3,"Less than 25% P.O.C.","$52000 - $60000"
"29033","Carroll County, Missouri",8781,50830,8317,124,18,43,0,140,94.7,1.4,0.2,0.5,0,1.6,5.3,3503,2601,902,74.25,25.75,208,2393,51,851,259,3244,8,5.7,7.4,"Less than 25% P.O.C.","$44000 - $52000"
"29035","Carter County, Missouri",6147,39530,5913,4,7,0,0,158,96.2,0.1,0.1,0,0,2.6,3.8,2333,1806,527,77.41,22.59,139,1667,91,436,230,2103,7.7,17.3,9.9,"Less than 25% P.O.C.","Less than $44000"
"29037","Cass County, Missouri",103597,69433,91136,4122,517,796,135,4541,88,4,0.5,0.8,0.1,4.4,12,39770,30425,9345,76.5,23.5,3166,27259,818,8527,3984,35786,10.4,8.8,10,"Less than 25% P.O.C.","$60000 or more"
"29039","Cedar County, Missouri",14043,39365,13278,7,38,30,0,317,94.6,0,0.3,0.2,0,2.3,5.4,5842,4131,1711,70.71,29.29,442,3689,108,1603,550,5292,10.7,6.3,9.4,"Less than 25% P.O.C.","Less than $44000"
"29041","Chariton County, Missouri",7483,46738,7106,191,3,0,0,40,95,2.6,0,0,0,0.5,5,2686,2102,584,78.26,21.74,168,1934,21,563,189,2497,8,3.6,7,"Less than 25% P.O.C.","$44000 - $52000"
"29043","Christian County, Missouri",85658,60645,79950,593,253,484,0,2525,93.3,0.7,0.3,0.6,0,2.9,6.7,31645,23496,8149,74.25,25.75,2207,21289,994,7155,3201,28444,9.4,12.2,10.1,"Less than 25% P.O.C.","$60000 or more"
"29045","Clark County, Missouri",6779,48909,6570,21,18,69,0,41,96.9,0.3,0.3,1,0,0.6,3.1,2657,1989,668,74.86,25.14,111,1878,30,638,141,2516,5.6,4.5,5.3,"Less than 25% P.O.C.","$44000 - $52000"
"29047","Clay County, Missouri",242516,70510,196732,14447,850,5238,515,16479,81.1,6,0.4,2.2,0.2,6.8,18.9,91238,62636,28602,68.65,31.35,6420,56216,2156,26446,8576,82662,10.2,7.5,9.4,"Less than 25% P.O.C.","$60000 or more"
"29049","Clinton County, Missouri",20500,62701,19213,310,62,136,9,439,93.7,1.5,0.3,0.7,0,2.1,6.3,8177,6249,1928,76.42,23.58,594,5655,156,1772,750,7427,9.5,8.1,9.2,"Less than 25% P.O.C.","$60000 or more"
"29051","Cole County, Missouri",76723,60066,62605,8943,267,1174,11,2176,81.6,11.7,0.3,1.5,0,2.8,18.4,30154,19990,10164,66.29,33.71,1793,18197,720,9444,2513,27641,9,7.1,8.3,"Less than 25% P.O.C.","$60000 or more"
"29053","Cooper County, Missouri",17660,52735,15502,1006,73,70,33,352,87.8,5.7,0.4,0.4,0.2,2,12.2,6397,4642,1755,72.57,27.43,431,4211,125,1630,556,5841,9.3,7.1,8.7,"Less than 25% P.O.C.","$52000 - $60000"
"29055","Crawford County, Missouri",24154,44438,22986,90,9,51,0,485,95.2,0.4,0,0.2,0,2,4.8,9578,6842,2736,71.43,28.57,331,6511,256,2480,587,8991,4.8,9.4,6.1,"Less than 25% P.O.C.","$44000 - $52000"
"29057","Dade County, Missouri",7578,40399,7101,27,71,64,2,162,93.7,0.4,0.9,0.8,0,2.1,6.3,3068,2356,712,76.79,23.21,272,2084,65,647,337,2731,11.5,9.1,11,"Less than 25% P.O.C.","Less than $44000"
"29059","Dallas County, Missouri",16617,43542,15713,5,206,91,0,348,94.6,0,1.2,0.5,0,2.1,5.4,6209,4723,1486,76.07,23.93,517,4206,175,1311,692,5517,10.9,11.8,11.1,"Less than 25% P.O.C.","Less than $44000"
"29061","Daviess County, Missouri",8295,51679,7957,50,46,15,9,130,95.9,0.6,0.6,0.2,0.1,1.6,4.1,3035,2407,628,79.31,20.69,236,2171,124,504,360,2675,9.8,19.7,11.9,"Less than 25% P.O.C.","$44000 - $52000"
"29063","DeKalb County, Missouri",12526,55918,10498,1120,99,67,35,324,83.8,8.9,0.8,0.5,0.3,2.6,16.2,3807,2631,1176,69.11,30.89,257,2374,49,1127,306,3501,9.8,4.2,8,"Less than 25% P.O.C.","$52000 - $60000"
"29065","Dent County, Missouri",15545,42100,14661,64,99,39,0,274,94.3,0.4,0.6,0.3,0,1.8,5.7,6371,4683,1688,73.5,26.5,479,4204,188,1500,667,5704,10.2,11.1,10.5,"Less than 25% P.O.C.","Less than $44000"
"29067","Douglas County, Missouri",13306,37425,13040,30,67,11,0,115,98,0.2,0.5,0.1,0,0.9,2,5137,4097,1040,79.75,20.25,253,3844,88,952,341,4796,6.2,8.5,6.6,"Less than 25% P.O.C.","Less than $44000"
"29069","Dunklin County, Missouri",30027,36380,24134,3068,52,177,0,1991,80.4,10.2,0.2,0.6,0,6.6,19.6,12342,7657,4685,62.04,37.96,516,7141,355,4330,871,11471,6.7,7.6,7.1,"Less than 25% P.O.C.","Less than $44000"
"29071","Franklin County, Missouri",103191,57214,98056,743,196,511,13,1799,95,0.7,0.2,0.5,0,1.7,5,40943,30507,10436,74.51,25.49,3110,27397,644,9792,3754,37189,10.2,6.2,9.2,"Less than 25% P.O.C.","$52000 - $60000"
"29073","Gasconade County, Missouri",14711,54885,14109,60,71,50,0,210,95.9,0.4,0.5,0.3,0,1.4,4.1,6076,4761,1315,78.36,21.64,363,4398,132,1183,495,5581,7.6,10,8.1,"Less than 25% P.O.C.","$52000 - $60000"
"29075","Gentry County, Missouri",6616,47790,6348,39,19,36,4,107,95.9,0.6,0.3,0.5,0.1,1.6,4.1,2555,1880,675,73.58,26.42,241,1639,41,634,282,2273,12.8,6.1,11,"Less than 25% P.O.C.","$44000 - $52000"
"29077","Greene County, Missouri",289756,46086,253625,9377,1484,5881,103,10786,87.5,3.2,0.5,2,0,3.7,12.5,125201,70172,55029,56.05,43.95,4818,65354,3361,51668,8179,117022,6.9,6.1,6.5,"Less than 25% P.O.C.","$44000 - $52000"
"29079","Grundy County, Missouri",9992,45594,9399,28,56,64,5,244,94.1,0.3,0.6,0.6,0.1,2.4,5.9,3936,2686,1250,68.24,31.76,272,2414,64,1186,336,3600,10.1,5.1,8.5,"Less than 25% P.O.C.","$44000 - $52000"
"29081","Harrison County, Missouri",8491,42917,8078,44,57,17,3,195,95.1,0.5,0.7,0.2,0,2.3,4.9,3429,2493,936,72.7,27.3,238,2255,84,852,322,3107,9.5,9,9.4,"Less than 25% P.O.C.","Less than $44000"
"29083","Henry County, Missouri",21735,45795,20327,273,88,92,2,535,93.5,1.3,0.4,0.4,0,2.5,6.5,9328,6738,2590,72.23,27.77,568,6170,326,2264,894,8434,8.4,12.6,9.6,"Less than 25% P.O.C.","$44000 - $52000"
"29085","Hickory County, Missouri",9404,34182,8913,3,152,25,0,164,94.8,0,1.6,0.3,0,1.7,5.2,3976,3269,707,82.22,17.78,214,3055,40,667,254,3722,6.5,5.7,6.4,"Less than 25% P.O.C.","Less than $44000"
"29087","Holt County, Missouri",4432,49524,4247,47,44,29,2,47,95.8,1.1,1,0.7,0,1.1,4.2,2022,1541,481,76.21,23.79,140,1401,28,453,168,1854,9.1,5.8,8.3,"Less than 25% P.O.C.","$44000 - $52000"
"29089","Howard County, Missouri",10058,52700,9108,586,83,36,0,158,90.6,5.8,0.8,0.4,0,1.6,9.4,3471,2716,755,78.25,21.75,262,2454,83,672,345,3126,9.6,11,9.9,"Less than 25% P.O.C.","$52000 - $60000"
"29091","Howell County, Missouri",40104,38357,37809,90,469,262,0,855,94.3,0.2,1.2,0.7,0,2.1,5.7,15878,10861,5017,68.4,31.6,1019,9842,309,4708,1328,14550,9.4,6.2,8.4,"Less than 25% P.O.C.","Less than $44000"
"29093","Iron County, Missouri",10164,37435,9591,113,55,27,6,181,94.4,1.1,0.5,0.3,0.1,1.8,5.6,4074,2885,1189,70.81,29.19,269,2616,99,1090,368,3706,9.3,8.3,9,"Less than 25% P.O.C.","Less than $44000"
"29095","Jackson County, Missouri",696216,55134,433000,161124,2112,12582,2133,62514,62.2,23.1,0.3,1.8,0.3,9,37.8,286601,166927,119674,58.24,41.76,15260,151667,8662,111012,23922,262679,9.1,7.2,8.3,"25% - 50% P.O.C.","$52000 - $60000"
"29097","Jasper County, Missouri",119920,48357,100935,2189,1555,1357,150,9644,84.2,1.8,1.3,1.1,0.1,8,15.8,45759,29096,16663,63.59,36.41,2847,26249,1491,15172,4338,41421,9.8,8.9,9.5,"Less than 25% P.O.C.","$44000 - $52000"
"29099","Jefferson County, Missouri",223951,65454,211428,2105,562,1817,22,4398,94.4,0.9,0.3,0.8,0,2,5.6,84444,67019,17425,79.37,20.63,6463,60556,1907,15518,8370,76074,9.6,10.9,9.9,"Less than 25% P.O.C.","$60000 or more"
"29101","Johnson County, Missouri",53682,55273,46037,2300,214,902,154,2356,85.8,4.3,0.4,1.7,0.3,4.4,14.2,19864,12114,7750,60.98,39.02,1029,11085,592,7158,1621,18243,8.5,7.6,8.2,"Less than 25% P.O.C.","$52000 - $60000"
"29103","Knox County, Missouri",3947,40000,3797,18,0,24,2,43,96.2,0.5,0,0.6,0.1,1.1,3.8,1490,1231,259,82.62,17.38,58,1173,21,238,79,1411,4.7,8.1,5.3,"Less than 25% P.O.C.","Less than $44000"
"29105","Laclede County, Missouri",35531,47257,33083,205,265,131,4,872,93.1,0.6,0.7,0.4,0,2.5,6.9,14112,9807,4305,69.49,30.51,717,9090,659,3646,1376,12736,7.3,15.3,9.8,"Less than 25% P.O.C.","$44000 - $52000"
"29107","Lafayette County, Missouri",32597,58766,29981,717,79,174,75,942,92,2.2,0.2,0.5,0.2,2.9,8,13050,9238,3812,70.79,29.21,905,8333,314,3498,1219,11831,9.8,8.2,9.3,"Less than 25% P.O.C.","$52000 - $60000"
"29109","Lawrence County, Missouri",38204,44742,34040,184,313,14,60,2847,89.1,0.5,0.8,0,0.2,7.5,10.9,14787,10616,4171,71.79,28.21,1080,9536,510,3661,1590,13197,10.2,12.2,10.8,"Less than 25% P.O.C.","$44000 - $52000"
"29111","Lewis County, Missouri",9955,45988,9220,419,77,0,24,47,92.6,4.2,0.8,0,0.2,0.5,7.4,3752,2856,896,76.12,23.88,320,2536,71,825,391,3361,11.2,7.9,10.4,"Less than 25% P.O.C.","$44000 - $52000"
"29113","Lincoln County, Missouri",56477,64196,52543,1079,182,158,13,1401,93,1.9,0.3,0.3,0,2.5,7,19286,15137,4149,78.49,21.51,1534,13603,593,3556,2127,17159,10.1,14.3,11,"Less than 25% P.O.C.","$60000 or more"
"29115","Linn County, Missouri",12113,45930,11485,57,32,43,9,293,94.8,0.5,0.3,0.4,0.1,2.4,5.2,5106,3721,1385,72.88,27.12,349,3372,183,1202,532,4574,9.4,13.2,10.4,"Less than 25% P.O.C.","$44000 - $52000"
"29117","Livingston County, Missouri",15126,46992,13971,382,85,94,16,278,92.4,2.5,0.6,0.6,0.1,1.8,7.6,5915,3940,1975,66.61,33.39,377,3563,119,1856,496,5419,9.6,6,8.4,"Less than 25% P.O.C.","$44000 - $52000"
"29119","McDonald County, Missouri",22782,41643,17604,415,601,343,506,2639,77.3,1.8,2.6,1.5,2.2,11.6,22.7,8259,5666,2593,68.6,31.4,737,4929,484,2109,1221,7038,13,18.7,14.8,"Less than 25% P.O.C.","Less than $44000"
"29121","Macon County, Missouri",15199,42746,14226,297,101,94,3,228,93.6,2,0.7,0.6,0,1.5,6.4,5845,4362,1483,74.63,25.37,398,3964,83,1400,481,5364,9.1,5.6,8.2,"Less than 25% P.O.C.","Less than $44000"
"29123","Madison County, Missouri",12179,43636,11526,92,25,69,0,288,94.6,0.8,0.2,0.6,0,2.4,5.4,5044,3622,1422,71.81,28.19,448,3174,193,1229,641,4403,12.4,13.6,12.7,"Less than 25% P.O.C.","Less than $44000"
"29125","Maries County, Missouri",8803,47569,8403,26,90,91,0,113,95.5,0.3,1,1,0,1.3,4.5,3762,2817,945,74.88,25.12,232,2585,94,851,326,3436,8.2,9.9,8.7,"Less than 25% P.O.C.","$44000 - $52000"
"29127","Marion County, Missouri",28608,48784,25759,1070,122,185,32,509,90,3.7,0.4,0.6,0.1,1.8,10,11565,7563,4002,65.4,34.6,681,6882,343,3659,1024,10541,9,8.6,8.9,"Less than 25% P.O.C.","$44000 - $52000"
"29129","Mercer County, Missouri",3644,47298,3489,20,0,17,0,84,95.7,0.5,0,0.5,0,2.3,4.3,1271,999,272,78.6,21.4,90,909,8,264,98,1173,9,2.9,7.7,"Less than 25% P.O.C.","$44000 - $52000"
"29131","Miller County, Missouri",25201,47171,23898,63,313,121,0,489,94.8,0.2,1.2,0.5,0,1.9,5.2,10111,7506,2605,74.24,25.76,696,6810,256,2349,952,9159,9.3,9.8,9.4,"Less than 25% P.O.C.","$44000 - $52000"
"29133","Mississippi County, Missouri",13574,35357,9701,3314,116,9,6,296,71.5,24.4,0.9,0.1,0,2.2,28.5,5026,3001,2025,59.71,40.29,224,2777,128,1897,352,4674,7.5,6.3,7,"25% - 50% P.O.C.","Less than $44000"
"29135","Moniteau County, Missouri",16046,58010,14701,438,31,9,0,782,91.6,2.7,0.2,0.1,0,4.9,8.4,5436,4187,1249,77.02,22.98,554,3633,91,1158,645,4791,13.2,7.3,11.9,"Less than 25% P.O.C.","$52000 - $60000"
"29137","Monroe County, Missouri",8629,43966,8017,293,54,41,4,145,92.9,3.4,0.6,0.5,0,1.7,7.1,3702,2759,943,74.53,25.47,183,2576,88,855,271,3431,6.6,9.3,7.3,"Less than 25% P.O.C.","Less than $44000"
"29139","Montgomery County, Missouri",11487,46757,10804,164,3,29,7,225,94.1,1.4,0,0.3,0.1,2,5.9,5014,3510,1504,70,30,313,3197,169,1335,482,4532,8.9,11.2,9.6,"Less than 25% P.O.C.","$44000 - $52000"
"29141","Morgan County, Missouri",20271,39003,19081,178,76,171,0,458,94.1,0.9,0.4,0.8,0,2.3,5.9,7588,6126,1462,80.73,19.27,665,5461,82,1380,747,6841,10.9,5.6,9.8,"Less than 25% P.O.C.","Less than $44000"
"29143","New Madrid County, Missouri",17560,38679,14024,2689,62,0,0,330,79.9,15.3,0.4,0,0,1.9,20.1,7371,4677,2694,63.45,36.55,356,4321,232,2462,588,6783,7.6,8.6,8,"Less than 25% P.O.C.","Less than $44000"
"29145","Newton County, Missouri",58180,50813,50100,508,1354,831,577,3093,86.1,0.9,2.3,1.4,1,5.3,13.9,22202,15877,6325,71.51,28.49,1733,14144,707,5618,2440,19762,10.9,11.2,11,"Less than 25% P.O.C.","$44000 - $52000"
"29147","Nodaway County, Missouri",22359,44232,20702,617,48,306,28,386,92.6,2.8,0.2,1.4,0.1,1.7,7.4,8395,4854,3541,57.82,42.18,370,4484,222,3319,592,7803,7.6,6.3,7.1,"Less than 25% P.O.C.","$44000 - $52000"
"29149","Oregon County, Missouri",10647,33601,10012,16,159,51,12,195,94,0.2,1.5,0.5,0.1,1.8,6,4249,3137,1112,73.83,26.17,256,2881,71,1041,327,3922,8.2,6.4,7.7,"Less than 25% P.O.C.","Less than $44000"
"29151","Osage County, Missouri",13615,61687,13411,24,16,4,0,112,98.5,0.2,0.1,0,0,0.8,1.5,5120,4329,791,84.55,15.45,411,3918,66,725,477,4643,9.5,8.3,9.3,"Less than 25% P.O.C.","$60000 or more"
"29153","Ozark County, Missouri",9207,31947,8773,6,84,47,0,166,95.3,0.1,0.9,0.5,0,1.8,4.7,3958,3071,887,77.59,22.41,161,2910,53,834,214,3744,5.2,6,5.4,"Less than 25% P.O.C.","Less than $44000"
"29155","Pemiscot County, Missouri",16663,33859,11418,4527,0,0,2,435,68.5,27.2,0,0,0,2.6,31.5,6730,3644,3086,54.15,45.85,320,3324,335,2751,655,6075,8.8,10.9,9.7,"25% - 50% P.O.C.","Less than $44000"
"29157","Perry County, Missouri",19191,55863,18261,108,80,207,0,439,95.2,0.6,0.4,1.1,0,2.3,4.8,7576,5682,1894,75,25,589,5093,108,1786,697,6879,10.4,5.7,9.2,"Less than 25% P.O.C.","$52000 - $60000"
"29159","Pettis County, Missouri",42355,46157,35969,1483,38,279,12,3670,84.9,3.5,0.1,0.7,0,8.7,15.1,16033,11029,5004,68.79,31.21,1131,9898,403,4601,1534,14499,10.3,8.1,9.6,"Less than 25% P.O.C.","$44000 - $52000"
"29161","Phelps County, Missouri",44630,44154,39598,993,307,1610,0,1137,88.7,2.2,0.7,3.6,0,2.5,11.3,17981,10725,7256,59.65,40.35,1011,9714,401,6855,1412,16569,9.4,5.5,7.9,"Less than 25% P.O.C.","$44000 - $52000"
"29163","Pike County, Missouri",18455,46385,16251,1338,56,64,15,415,88.1,7.3,0.3,0.3,0.1,2.2,11.9,6589,4723,1866,71.68,28.32,356,4367,109,1757,465,6124,7.5,5.8,7.1,"Less than 25% P.O.C.","$44000 - $52000"
"29165","Platte County, Missouri",100682,80393,81559,6732,118,2723,444,6082,81,6.7,0.1,2.7,0.4,6,19,39305,25905,13400,65.91,34.09,2423,23482,912,12488,3335,35970,9.4,6.8,8.5,"Less than 25% P.O.C.","$60000 or more"
"29167","Polk County, Missouri",31748,45660,29759,294,379,78,24,775,93.7,0.9,1.2,0.2,0.1,2.4,6.3,11712,8081,3631,69,31,796,7285,431,3200,1227,10485,9.9,11.9,10.5,"Less than 25% P.O.C.","$44000 - $52000"
"29169","Pulaski County, Missouri",52425,53492,36370,5586,462,1267,303,5879,69.4,10.7,0.9,2.4,0.6,11.2,30.6,15154,7472,7682,49.31,50.69,661,6811,845,6837,1506,13648,8.8,11,9.9,"25% - 50% P.O.C.","$52000 - $60000"
"29171","Putnam County, Missouri",4781,42849,4588,5,10,6,0,23,96,0.1,0.2,0.1,0,0.5,4,1744,1346,398,77.18,22.82,78,1268,14,384,92,1652,5.8,3.5,5.3,"Less than 25% P.O.C.","Less than $44000"
"29173","Ralls County, Missouri",10234,55377,9769,128,57,59,0,128,95.5,1.3,0.6,0.6,0,1.3,4.5,4036,3360,676,83.25,16.75,212,3148,72,604,284,3752,6.3,10.7,7,"Less than 25% P.O.C.","$52000 - $60000"
"29175","Randolph County, Missouri",24878,47740,22013,1436,178,158,6,523,88.5,5.8,0.7,0.6,0,2.1,11.5,8626,6168,2458,71.5,28.5,468,5700,149,2309,617,8009,7.6,6.1,7.2,"Less than 25% P.O.C.","$44000 - $52000"
"29177","Ray County, Missouri",22875,61957,21425,302,111,44,0,564,93.7,1.3,0.5,0.2,0,2.5,6.3,8868,6965,1903,78.54,21.46,773,6192,267,1636,1040,7828,11.1,14,11.7,"Less than 25% P.O.C.","$60000 or more"
"29179","Reynolds County, Missouri",6290,40324,5896,128,22,19,13,50,93.7,2,0.3,0.3,0.2,0.8,6.3,2596,2043,553,78.7,21.3,158,1885,37,516,195,2401,7.7,6.7,7.5,"Less than 25% P.O.C.","Less than $44000"
"29181","Ripley County, Missouri",13567,34971,12895,94,84,54,30,197,95,0.7,0.6,0.4,0.2,1.5,5,5059,3996,1063,78.99,21.01,361,3635,110,953,471,4588,9,10.3,9.3,"Less than 25% P.O.C.","Less than $44000"
"29183","St. Charles County, Missouri",394290,84978,343580,17307,468,10025,117,12981,87.1,4.4,0.1,2.5,0,3.3,12.9,146631,118222,28409,80.63,19.37,11471,106751,1670,26739,13141,133490,9.7,5.9,9,"Less than 25% P.O.C.","$60000 or more"
"29185","St. Clair County, Missouri",9370,38870,8854,68,88,36,0,120,94.5,0.7,0.9,0.4,0,1.3,5.5,4139,3240,899,78.28,21.72,263,2977,25,874,288,3851,8.1,2.8,7,"Less than 25% P.O.C.","Less than $44000"
"29186","Ste. Genevieve County, Missouri",17848,60129,17073,350,0,102,0,211,95.7,2,0,0.6,0,1.2,4.3,7121,5703,1418,80.09,19.91,629,5074,158,1260,787,6334,11,11.1,11.1,"Less than 25% P.O.C.","$60000 or more"
"29187","St. Francois County, Missouri",66643,46466,61158,2923,217,344,13,1049,91.8,4.4,0.3,0.5,0,1.6,8.2,24898,17043,7855,68.45,31.55,1475,15568,778,7077,2253,22645,8.7,9.9,9,"Less than 25% P.O.C.","$44000 - $52000"
"29189","St. Louis County, Missouri",996919,67420,658354,240128,1284,42747,301,28834,66,24.1,0.1,4.3,0,2.9,34,405984,278342,127642,68.56,31.44,21691,256651,7752,119890,29443,376541,7.8,6.1,7.3,"25% - 50% P.O.C.","$60000 or more"
"29195","Saline County, Missouri",22976,44720,18442,1100,57,187,244,2341,80.3,4.8,0.2,0.8,1.1,10.2,19.7,8272,5754,2518,69.56,30.44,543,5211,157,2361,700,7572,9.4,6.2,8.5,"Less than 25% P.O.C.","$44000 - $52000"
"29197","Schuyler County, Missouri",4555,42694,4414,21,0,12,0,76,96.9,0.5,0,0.3,0,1.7,3.1,1475,1022,453,69.29,30.71,82,940,43,410,125,1350,8,9.5,8.5,"Less than 25% P.O.C.","Less than $44000"
"29199","Scotland County, Missouri",4902,50085,4866,0,5,0,0,0,99.3,0,0.1,0,0,0,0.7,1768,1371,397,77.55,22.45,211,1160,55,342,266,1502,15.4,13.9,15,"Less than 25% P.O.C.","$44000 - $52000"
"29201","Scott County, Missouri",38633,44139,32159,4494,144,160,0,893,83.2,11.6,0.4,0.4,0,2.3,16.8,15230,10152,5078,66.66,33.34,927,9225,475,4603,1402,13828,9.1,9.4,9.2,"Less than 25% P.O.C.","$44000 - $52000"
"29203","Shannon County, Missouri",8217,34265,7713,14,14,0,0,154,93.9,0.2,0.2,0,0,1.9,6.1,3064,2248,816,73.37,26.63,130,2118,85,731,215,2849,5.8,10.4,7,"Less than 25% P.O.C.","Less than $44000"
"29205","Shelby County, Missouri",6013,44083,5725,97,13,16,0,103,95.2,1.6,0.2,0.3,0,1.7,4.8,2432,1796,636,73.85,26.15,113,1683,116,520,229,2203,6.3,18.2,9.4,"Less than 25% P.O.C.","$44000 - $52000"
"29207","Stoddard County, Missouri",29377,41062,28022,437,6,3,0,514,95.4,1.5,0,0,0,1.7,4.6,11530,7845,3685,68.04,31.96,697,7148,303,3382,1000,10530,8.9,8.2,8.7,"Less than 25% P.O.C.","Less than $44000"
"29209","Stone County, Missouri",31615,49656,29972,64,224,74,30,729,94.8,0.2,0.7,0.2,0.1,2.3,5.2,12783,10449,2334,81.74,18.26,741,9708,239,2095,980,11803,7.1,10.2,7.7,"Less than 25% P.O.C.","$44000 - $52000"
"29211","Sullivan County, Missouri",6247,46481,4797,142,82,6,9,1143,76.8,2.3,1.3,0.1,0.1,18.3,23.2,2128,1585,543,74.48,25.52,124,1461,62,481,186,1942,7.8,11.4,8.7,"Less than 25% P.O.C.","$44000 - $52000"
"29213","Taney County, Missouri",55114,46031,48934,758,547,546,12,3260,88.8,1.4,1,1,0,5.9,11.2,22272,13740,8532,61.69,38.31,1163,12577,836,7696,1999,20273,8.5,9.8,9,"Less than 25% P.O.C.","$44000 - $52000"
"29215","Texas County, Missouri",25604,35067,23302,559,438,190,0,544,91,2.2,1.7,0.7,0,2.1,9,9728,7039,2689,72.36,27.64,418,6621,336,2353,754,8974,5.9,12.5,7.8,"Less than 25% P.O.C.","Less than $44000"
"29217","Vernon County, Missouri",20595,43276,19342,111,133,148,0,445,93.9,0.5,0.6,0.7,0,2.2,6.1,8207,5884,2323,71.69,28.31,616,5268,161,2162,777,7430,10.5,6.9,9.5,"Less than 25% P.O.C.","Less than $44000"
"29219","Warren County, Missouri",34453,60125,31582,689,102,171,16,1173,91.7,2,0.3,0.5,0,3.4,8.3,12654,9980,2674,78.87,21.13,938,9042,530,2144,1468,11186,9.4,19.8,11.6,"Less than 25% P.O.C.","$60000 or more"
"29221","Washington County, Missouri",24860,41483,23427,529,27,53,71,346,94.2,2.1,0.1,0.2,0.3,1.4,5.8,9231,7334,1897,79.45,20.55,998,6336,222,1675,1220,8011,13.6,11.7,13.2,"Less than 25% P.O.C.","Less than $44000"
"29223","Wayne County, Missouri",13195,34316,12514,73,24,36,0,238,94.8,0.6,0.2,0.3,0,1.8,5.2,5426,3988,1438,73.5,26.5,350,3638,185,1253,535,4891,8.8,12.9,9.9,"Less than 25% P.O.C.","Less than $44000"
"29225","Webster County, Missouri",38655,50560,36357,352,198,148,82,801,94.1,0.9,0.5,0.4,0.2,2.1,5.9,13575,10182,3393,75.01,24.99,1195,8987,538,2855,1733,11842,11.7,15.9,12.8,"Less than 25% P.O.C.","$44000 - $52000"
"29227","Worth County, Missouri",2027,53580,1954,11,1,3,0,31,96.4,0.5,0,0.1,0,1.5,3.6,859,656,203,76.37,23.63,70,586,34,169,104,755,10.7,16.7,12.1,"Less than 25% P.O.C.","$52000 - $60000"
"29229","Wright County, Missouri",18203,34776,17293,97,62,45,28,344,95,0.5,0.3,0.2,0.2,1.9,5,7063,4941,2122,69.96,30.04,657,4284,86,2036,743,6320,13.3,4.1,10.5,"Less than 25% P.O.C.","Less than $44000"
"29510","St. Louis city, Missouri",308174,43896,134491,142471,611,10278,169,12399,43.6,46.2,0.2,3.3,0.1,4,56.4,141952,61975,79977,43.66,56.34,3777,58198,3544,76433,7321,134631,6.1,4.4,5.2,"50% - 75% P.O.C.","Less than $44000"
"30001","Beaverhead County, Montana",9415,43201,8502,7,132,59,5,465,90.3,0.1,1.4,0.6,0.1,4.9,9.7,3992,2705,1287,67.76,32.24,176,2529,34,1253,210,3782,6.5,2.6,5.3,"Less than 25% P.O.C.","Less than $44000"
"30003","Big Horn County, Montana",13387,49859,3584,4,8602,12,6,852,26.8,0,64.3,0.1,0,6.4,73.2,3609,2288,1321,63.4,36.6,544,1744,371,950,915,2694,23.8,28.1,25.4,"50% - 75% P.O.C.","$44000 - $52000"
"30005","Blaine County, Montana",6719,41279,2994,27,3362,7,0,238,44.6,0.4,50,0.1,0,3.5,55.4,2366,1373,993,58.03,41.97,173,1200,197,796,370,1996,12.6,19.8,15.6,"50% - 75% P.O.C.","Less than $44000"
"30007","Broadwater County, Montana",5945,60594,5612,5,23,0,0,166,94.4,0.1,0.4,0,0,2.8,5.6,2364,1951,413,82.53,17.47,140,1811,14,399,154,2210,7.2,3.4,6.5,"Less than 25% P.O.C.","$60000 or more"
"30009","Carbon County, Montana",10597,58707,9989,43,139,30,0,261,94.3,0.4,1.3,0.3,0,2.5,5.7,4524,3456,1068,76.39,23.61,204,3252,55,1013,259,4265,5.9,5.1,5.7,"Less than 25% P.O.C.","$52000 - $60000"
"30011","Carter County, Montana",1331,48000,1289,0,10,0,0,1,96.8,0,0.8,0,0,0.1,3.2,628,452,176,71.97,28.03,27,425,28,148,55,573,6,15.9,8.8,"Less than 25% P.O.C.","$44000 - $52000"
"30013","Cascade County, Montana",81625,49913,69561,1055,3404,558,65,3682,85.2,1.3,4.2,0.7,0.1,4.5,14.8,34329,22099,12230,64.37,35.63,1587,20512,862,11368,2449,31880,7.2,7,7.1,"Less than 25% P.O.C.","$44000 - $52000"
"30015","Chouteau County, Montana",5732,42298,4409,14,1047,32,2,151,76.9,0.2,18.3,0.6,0,2.6,23.1,2274,1450,824,63.76,36.24,108,1342,115,709,223,2051,7.4,14,9.8,"Less than 25% P.O.C.","Less than $44000"
"30017","Custer County, Montana",11729,52965,10767,74,87,11,20,401,91.8,0.6,0.7,0.1,0.2,3.4,8.2,4903,3371,1532,68.75,31.25,290,3081,77,1455,367,4536,8.6,5,7.5,"Less than 25% P.O.C.","$52000 - $60000"
"30019","Daniels County, Montana",1730,57440,1609,0,55,14,0,46,93,0,3.2,0.8,0,2.7,7,857,672,185,78.41,21.59,34,638,13,172,47,810,5.1,7,5.5,"Less than 25% P.O.C.","$52000 - $60000"
"30021","Dawson County, Montana",9017,58596,8319,70,207,22,0,281,92.3,0.8,2.3,0.2,0,3.1,7.7,3930,2683,1247,68.27,31.73,205,2478,133,1114,338,3592,7.6,10.7,8.6,"Less than 25% P.O.C.","$52000 - $60000"
"30023","Deer Lodge County, Montana",9106,41820,8206,68,169,69,0,315,90.1,0.7,1.9,0.8,0,3.5,9.9,3903,2645,1258,67.77,32.23,126,2519,41,1217,167,3736,4.8,3.3,4.3,"Less than 25% P.O.C.","Less than $44000"
"30025","Fallon County, Montana",2921,64545,2756,1,3,51,0,58,94.4,0,0.1,1.7,0,2,5.6,1334,961,373,72.04,27.96,118,843,7,366,125,1209,12.3,1.9,9.4,"Less than 25% P.O.C.","$60000 or more"
"30027","Fergus County, Montana",11221,50540,10555,15,156,66,209,104,94.1,0.1,1.4,0.6,1.9,0.9,5.9,4912,3578,1334,72.84,27.16,284,3294,54,1280,338,4574,7.9,4,6.9,"Less than 25% P.O.C.","$44000 - $52000"
"30029","Flathead County, Montana",99899,56182,92665,342,1395,698,47,2829,92.8,0.3,1.4,0.7,0,2.8,7.2,38773,28738,10035,74.12,25.88,2154,26584,572,9463,2726,36047,7.5,5.7,7,"Less than 25% P.O.C.","$52000 - $60000"
"30031","Gallatin County, Montana",108063,66397,99001,425,820,1462,7,4032,91.6,0.4,0.8,1.4,0,3.7,8.4,43777,26781,16996,61.18,38.82,2117,24664,876,16120,2993,40784,7.9,5.2,6.8,"Less than 25% P.O.C.","$60000 or more"
"30033","Garfield County, Montana",1036,42000,1028,7,0,0,0,1,99.2,0.7,0,0,0,0.1,0.8,438,320,118,73.06,26.94,14,306,15,103,29,409,4.4,12.7,6.6,"Less than 25% P.O.C.","Less than $44000"
"30035","Glacier County, Montana",13732,36045,4112,39,8835,6,13,451,29.9,0.3,64.3,0,0.1,3.3,70.1,4163,2447,1716,58.78,41.22,245,2202,242,1474,487,3676,10,14.1,11.7,"50% - 75% P.O.C.","Less than $44000"
"30037","Golden Valley County, Montana",728,43875,652,0,0,0,0,49,89.6,0,0,0,0,6.7,10.4,351,270,81,76.92,23.08,6,264,11,70,17,334,2.2,13.6,4.8,"Less than 25% P.O.C.","Less than $44000"
"30039","Granite County, Montana",3311,49881,3121,3,12,2,0,75,94.3,0.1,0.4,0.1,0,2.3,5.7,1308,1035,273,79.13,20.87,41,994,29,244,70,1238,4,10.6,5.4,"Less than 25% P.O.C.","$44000 - $52000"
"30041","Hill County, Montana",16436,49321,11370,52,3670,60,0,623,69.2,0.3,22.3,0.4,0,3.8,30.8,6369,3939,2430,61.85,38.15,341,3598,128,2302,469,5900,8.7,5.3,7.4,"25% - 50% P.O.C.","$44000 - $52000"
"30043","Jefferson County, Montana",11917,69646,11042,45,125,6,0,305,92.7,0.4,1,0.1,0,2.6,7.3,4484,3781,703,84.32,15.68,330,3451,19,684,349,4135,8.7,2.7,7.8,"Less than 25% P.O.C.","$60000 or more"
"30045","Judith Basin County, Montana",1954,43661,1811,0,30,0,0,70,92.7,0,1.5,0,0,3.6,7.3,906,686,220,75.72,24.28,42,644,8,212,50,856,6.1,3.6,5.5,"Less than 25% P.O.C.","Less than $44000"
"30047","Lake County, Montana",30013,48829,19521,89,6941,85,40,1374,65,0.3,23.1,0.3,0.1,4.6,35,11802,8495,3307,71.98,28.02,706,7789,352,2955,1058,10744,8.3,10.6,9,"25% - 50% P.O.C.","$44000 - $52000"
"30049","Lewis and Clark County, Montana",67805,65791,61953,180,1111,448,47,2255,91.4,0.3,1.6,0.7,0.1,3.3,8.6,27893,19371,8522,69.45,30.55,1541,17830,407,8115,1948,25945,8,4.8,7,"Less than 25% P.O.C.","$60000 or more"
"30051","Liberty County, Montana",2351,44875,2311,0,0,0,0,29,98.3,0,0,0,0,1.2,1.7,895,564,331,63.02,36.98,38,526,24,307,62,833,6.7,7.3,6.9,"Less than 25% P.O.C.","$44000 - $52000"
"30053","Lincoln County, Montana",19537,40140,18096,40,243,79,46,611,92.6,0.2,1.2,0.4,0.2,3.1,7.4,8122,6525,1597,80.34,19.66,331,6194,200,1397,531,7591,5.1,12.5,6.5,"Less than 25% P.O.C.","Less than $44000"
"30055","McCone County, Montana",1790,49701,1589,0,105,29,0,67,88.8,0,5.9,1.6,0,3.7,11.2,723,584,139,80.77,19.23,44,540,12,127,56,667,7.5,8.6,7.7,"Less than 25% P.O.C.","$44000 - $52000"
"30057","Madison County, Montana",8302,54107,7676,2,17,3,0,372,92.5,0,0.2,0,0,4.5,7.5,3570,2748,822,76.97,23.03,88,2660,49,773,137,3433,3.2,6,3.8,"Less than 25% P.O.C.","$52000 - $60000"
"30059","Meagher County, Montana",1888,46607,1749,1,26,3,0,88,92.6,0.1,1.4,0.2,0,4.7,7.4,702,509,193,72.51,27.49,10,499,8,185,18,684,2,4.1,2.6,"Less than 25% P.O.C.","$44000 - $52000"
"30061","Mineral County, Montana",4251,41705,3886,34,114,36,0,56,91.4,0.8,2.7,0.8,0,1.3,8.6,1786,1321,465,73.96,26.04,66,1255,30,435,96,1690,5,6.5,5.4,"Less than 25% P.O.C.","Less than $44000"
"30063","Missoula County, Montana",117309,54062,104688,708,2230,2143,79,3841,89.2,0.6,1.9,1.8,0.1,3.3,10.8,49313,29040,20273,58.89,41.11,1974,27066,605,19668,2579,46734,6.8,3,5.2,"Less than 25% P.O.C.","$52000 - $60000"
"30065","Musselshell County, Montana",4766,43274,4343,0,124,43,0,147,91.1,0,2.6,0.9,0,3.1,8.9,2181,1570,611,71.99,28.01,99,1471,38,573,137,2044,6.3,6.2,6.3,"Less than 25% P.O.C.","Less than $44000"
"30067","Park County, Montana",16352,53068,15263,73,65,51,19,505,93.3,0.4,0.4,0.3,0.1,3.1,6.7,7782,5333,2449,68.53,31.47,351,4982,75,2374,426,7356,6.6,3.1,5.5,"Less than 25% P.O.C.","$52000 - $60000"
"30069","Petroleum County, Montana",453,51250,428,0,0,25,0,0,94.5,0,0,5.5,0,0,5.5,204,152,52,74.51,25.49,8,144,1,51,9,195,5.3,1.9,4.4,"Less than 25% P.O.C.","$44000 - $52000"
"30071","Phillips County, Montana",4077,46212,3417,0,375,12,0,114,83.8,0,9.2,0.3,0,2.8,16.2,1710,1318,392,77.08,22.92,107,1211,42,350,149,1561,8.1,10.7,8.7,"Less than 25% P.O.C.","$44000 - $52000"
"30073","Pondera County, Montana",5994,51151,4866,8,909,6,0,122,81.2,0.1,15.2,0.1,0,2,18.8,2103,1569,534,74.61,25.39,113,1456,53,481,166,1937,7.2,9.9,7.9,"Less than 25% P.O.C.","$44000 - $52000"
"30075","Powder River County, Montana",1607,54427,1495,0,27,0,0,51,93,0,1.7,0,0,3.2,7,737,550,187,74.63,25.37,30,520,4,183,34,703,5.5,2.1,4.6,"Less than 25% P.O.C.","$52000 - $60000"
"30077","Powell County, Montana",6854,54667,6126,64,308,26,0,119,89.4,0.9,4.5,0.4,0,1.7,10.6,2426,1627,799,67.07,32.93,109,1518,48,751,157,2269,6.7,6,6.5,"Less than 25% P.O.C.","$52000 - $60000"
"30079","Prairie County, Montana",1252,43625,1224,0,2,10,0,16,97.8,0,0.2,0.8,0,1.3,2.2,518,435,83,83.98,16.02,32,403,5,78,37,481,7.4,6,7.1,"Less than 25% P.O.C.","Less than $44000"
"30081","Ravalli County, Montana",42512,53054,39514,48,397,226,0,1490,92.9,0.1,0.9,0.5,0,3.5,7.1,17354,13239,4115,76.29,23.71,843,12396,224,3891,1067,16287,6.4,5.4,6.1,"Less than 25% P.O.C.","$52000 - $60000"
"30083","Richland County, Montana",11199,67205,9947,0,222,3,18,608,88.8,0,2,0,0.2,5.4,11.2,4535,2992,1543,65.98,34.02,267,2725,139,1404,406,4129,8.9,9,9,"Less than 25% P.O.C.","$60000 or more"
"30085","Roosevelt County, Montana",11175,43194,3839,24,6270,67,0,442,34.4,0.2,56.1,0.6,0,4,65.6,3150,1981,1169,62.89,37.11,244,1737,203,966,447,2703,12.3,17.4,14.2,"50% - 75% P.O.C.","Less than $44000"
"30087","Rosebud County, Montana",9152,57992,5018,16,3373,95,0,473,54.8,0.2,36.9,1,0,5.2,45.2,3166,2190,976,69.17,30.83,235,1955,162,814,397,2769,10.7,16.6,12.5,"25% - 50% P.O.C.","$52000 - $60000"
"30089","Sanders County, Montana",11681,40823,10526,36,393,49,1,352,90.1,0.3,3.4,0.4,0,3,9.9,5036,3906,1130,77.56,22.44,288,3618,100,1030,388,4648,7.4,8.8,7.7,"Less than 25% P.O.C.","Less than $44000"
"30091","Sheridan County, Montana",3483,55521,3172,0,36,9,0,132,91.1,0,1,0.3,0,3.8,8.9,1639,1291,348,78.77,21.23,95,1196,20,328,115,1524,7.4,5.7,7,"Less than 25% P.O.C.","$52000 - $60000"
"30093","Silver Bow County, Montana",34770,45718,31446,191,707,257,5,1585,90.4,0.5,2,0.7,0,4.6,9.6,14960,10308,4652,68.9,31.1,708,9600,61,4591,769,14191,6.9,1.3,5.1,"Less than 25% P.O.C.","$44000 - $52000"
"30095","Stillwater County, Montana",9466,64645,8783,8,93,32,0,374,92.8,0.1,1,0.3,0,4,7.2,3761,3036,725,80.72,19.28,265,2771,38,687,303,3458,8.7,5.2,8.1,"Less than 25% P.O.C.","$60000 or more"
"30097","Sweet Grass County, Montana",3670,49886,3454,0,36,10,0,83,94.1,0,1,0.3,0,2.3,5.9,1566,1133,433,72.35,27.65,33,1100,57,376,90,1476,2.9,13.2,5.7,"Less than 25% P.O.C.","$44000 - $52000"
"30099","Teton County, Montana",6086,55000,5697,32,60,16,0,99,93.6,0.5,1,0.3,0,1.6,6.4,2464,1722,742,69.89,30.11,142,1580,123,619,265,2199,8.2,16.6,10.8,"Less than 25% P.O.C.","$52000 - $60000"
"30101","Toole County, Montana",4892,50721,4260,23,314,21,0,196,87.1,0.5,6.4,0.4,0,4,12.9,1867,1109,758,59.4,40.6,83,1026,62,696,145,1722,7.5,8.2,7.8,"Less than 25% P.O.C.","$44000 - $52000"
"30103","Treasure County, Montana",668,43047,630,0,0,28,0,4,94.3,0,0,4.2,0,0.6,5.7,351,239,112,68.09,31.91,4,235,6,106,10,341,1.7,5.4,2.8,"Less than 25% P.O.C.","Less than $44000"
"30105","Valley County, Montana",7471,53162,6313,29,630,16,11,203,84.5,0.4,8.4,0.2,0.1,2.7,15.5,3386,2536,850,74.9,25.1,146,2390,70,780,216,3170,5.8,8.2,6.4,"Less than 25% P.O.C.","$52000 - $60000"
"30107","Wheatland County, Montana",2142,39655,2000,0,30,7,0,67,93.4,0,1.4,0.3,0,3.1,6.6,792,592,200,74.75,25.25,28,564,47,153,75,717,4.7,23.5,9.5,"Less than 25% P.O.C.","Less than $44000"
"30109","Wibaux County, Montana",1122,53958,1046,0,13,8,0,55,93.2,0,1.2,0.7,0,4.9,6.8,498,397,101,79.72,20.28,33,364,20,81,53,445,8.3,19.8,10.6,"Less than 25% P.O.C.","$52000 - $60000"
"30111","Yellowstone County, Montana",159008,61264,137320,764,6284,1090,136,8928,86.4,0.5,4,0.7,0.1,5.6,13.6,66385,45408,20977,68.4,31.6,4074,41334,1398,19579,5472,60913,9,6.7,8.2,"Less than 25% P.O.C.","$60000 or more"
"31001","Adams County, Nebraska",31587,53023,27129,188,89,394,6,3254,85.9,0.6,0.3,1.2,0,10.3,14.1,12712,8449,4263,66.46,33.54,1034,7415,337,3926,1371,11341,12.2,7.9,10.8,"Less than 25% P.O.C.","$52000 - $60000"
"31003","Antelope County, Nebraska",6341,49912,6031,58,6,15,0,210,95.1,0.9,0.1,0.2,0,3.3,4.9,2714,2050,664,75.53,24.47,193,1857,44,620,237,2477,9.4,6.6,8.7,"Less than 25% P.O.C.","$44000 - $52000"
"31005","Arthur County, Nebraska",427,42813,409,0,1,0,0,2,95.8,0,0.2,0,0,0.5,4.2,197,131,66,66.5,33.5,8,123,12,54,20,177,6.1,18.2,10.2,"Less than 25% P.O.C.","Less than $44000"
"31007","Banner County, Nebraska",722,51750,652,0,0,10,0,44,90.3,0,0,1.4,0,6.1,9.7,283,197,86,69.61,30.39,15,182,3,83,18,265,7.6,3.5,6.4,"Less than 25% P.O.C.","$44000 - $52000"
"31009","Blaine County, Nebraska",477,51094,477,0,0,0,0,0,100,0,0,0,0,0,0,213,157,56,73.71,26.29,9,148,4,52,13,200,5.7,7.1,6.1,"Less than 25% P.O.C.","$44000 - $52000"
"31011","Boone County, Nebraska",5279,54979,5087,17,2,29,3,115,96.4,0.3,0,0.5,0.1,2.2,3.6,2311,1760,551,76.16,23.84,144,1616,44,507,188,2123,8.2,8,8.1,"Less than 25% P.O.C.","$52000 - $60000"
"31013","Box Butte County, Nebraska",10970,54004,8930,149,220,119,0,1376,81.4,1.4,2,1.1,0,12.5,18.6,4743,3254,1489,68.61,31.39,482,2772,104,1385,586,4157,14.8,7,12.4,"Less than 25% P.O.C.","$52000 - $60000"
"31015","Boyd County, Nebraska",1937,47778,1840,11,20,19,0,18,95,0.6,1,1,0,0.9,5,904,737,167,81.53,18.47,51,686,28,139,79,825,6.9,16.8,8.7,"Less than 25% P.O.C.","$44000 - $52000"
"31017","Brown County, Nebraska",3015,43098,2881,1,11,14,0,54,95.6,0,0.4,0.5,0,1.8,4.4,1387,1046,341,75.41,24.59,49,997,52,289,101,1286,4.7,15.2,7.3,"Less than 25% P.O.C.","Less than $44000"
"31019","Buffalo County, Nebraska",49209,59431,42822,432,84,643,0,4429,87,0.9,0.2,1.3,0,9,13,19062,12388,6674,64.99,35.01,1215,11173,408,6266,1623,17439,9.8,6.1,8.5,"Less than 25% P.O.C.","$52000 - $60000"
"31021","Burt County, Nebraska",6510,54203,6050,31,130,51,0,200,92.9,0.5,2,0.8,0,3.1,7.1,2856,2187,669,76.58,23.42,226,1961,61,608,287,2569,10.3,9.1,10,"Less than 25% P.O.C.","$52000 - $60000"
"31023","Butler County, Nebraska",8029,58979,7581,12,34,28,0,287,94.4,0.1,0.4,0.3,0,3.6,5.6,3363,2619,744,77.88,22.12,233,2386,50,694,283,3080,8.9,6.7,8.4,"Less than 25% P.O.C.","$52000 - $60000"
"31025","Cass County, Nebraska",25888,71846,24225,87,129,63,57,867,93.6,0.3,0.5,0.2,0.2,3.3,6.4,9945,8124,1821,81.69,18.31,947,7177,221,1600,1168,8777,11.7,12.1,11.7,"Less than 25% P.O.C.","$60000 or more"
"31027","Cedar County, Nebraska",8498,61869,8195,13,68,2,0,175,96.4,0.2,0.8,0,0,2.1,3.6,3506,2824,682,80.55,19.45,382,2442,125,557,507,2999,13.5,18.3,14.5,"Less than 25% P.O.C.","$60000 or more"
"31029","Chase County, Nebraska",3783,57009,3293,2,0,10,0,465,87,0.1,0,0.3,0,12.3,13,1679,1270,409,75.64,24.36,76,1194,70,339,146,1533,6,17.1,8.7,"Less than 25% P.O.C.","$52000 - $60000"
"31031","Cherry County, Nebraska",5779,56651,5080,1,206,28,7,145,87.9,0,3.6,0.5,0.1,2.5,12.1,2537,1554,983,61.25,38.75,125,1429,115,868,240,2297,8,11.7,9.5,"Less than 25% P.O.C.","$52000 - $60000"
"31033","Cheyenne County, Nebraska",9604,53871,8596,80,42,66,2,671,89.5,0.8,0.4,0.7,0,7,10.5,4395,2928,1467,66.62,33.38,229,2699,121,1346,350,4045,7.8,8.2,8,"Less than 25% P.O.C.","$52000 - $60000"
"31035","Clay County, Nebraska",6203,57173,5535,13,13,5,0,549,89.2,0.2,0.2,0.1,0,8.9,10.8,2539,2025,514,79.76,20.24,204,1821,40,474,244,2295,10.1,7.8,9.6,"Less than 25% P.O.C.","$52000 - $60000"
"31037","Colfax County, Nebraska",10714,58872,5243,401,13,79,22,4869,48.9,3.7,0.1,0.7,0.2,45.4,51.1,3731,2699,1032,72.34,27.66,502,2197,165,867,667,3064,18.6,16,17.9,"50% - 75% P.O.C.","$52000 - $60000"
"31039","Cuming County, Nebraska",8952,56768,7888,9,16,27,11,905,88.1,0.1,0.2,0.3,0.1,10.1,11.9,3727,2598,1129,69.71,30.29,266,2332,149,980,415,3312,10.2,13.2,11.1,"Less than 25% P.O.C.","$52000 - $60000"
"31041","Custer County, Nebraska",10826,52184,10238,17,18,82,0,347,94.6,0.2,0.2,0.8,0,3.2,5.4,4862,3382,1480,69.56,30.44,191,3191,158,1322,349,4513,5.6,10.7,7.2,"Less than 25% P.O.C.","$52000 - $60000"
"31043","Dakota County, Nebraska",20173,59231,9680,1023,425,664,0,7823,48,5.1,2.1,3.3,0,38.8,52,7404,4828,2576,65.21,34.79,673,4155,299,2277,972,6432,13.9,11.6,13.1,"50% - 75% P.O.C.","$52000 - $60000"
"31045","Dawes County, Nebraska",8810,50750,7498,350,309,59,0,472,85.1,4,3.5,0.7,0,5.4,14.9,3525,2278,1247,64.62,35.38,109,2169,9,1238,118,3407,4.8,0.7,3.3,"Less than 25% P.O.C.","$44000 - $52000"
"31047","Dawson County, Nebraska",23733,53721,13953,1459,94,149,52,7893,58.8,6.1,0.4,0.6,0.2,33.3,41.2,8965,6035,2930,67.32,32.68,1028,5007,280,2650,1308,7657,17,9.6,14.6,"25% - 50% P.O.C.","$52000 - $60000"
"31049","Deuel County, Nebraska",1831,47287,1608,3,28,11,0,156,87.8,0.2,1.5,0.6,0,8.5,12.2,830,633,197,76.27,23.73,55,578,17,180,72,758,8.7,8.6,8.7,"Less than 25% P.O.C.","$44000 - $52000"
"31051","Dixon County, Nebraska",5719,56905,4818,25,22,22,0,786,84.2,0.4,0.4,0.4,0,13.7,15.8,2352,1847,505,78.53,21.47,240,1607,55,450,295,2057,13,10.9,12.5,"Less than 25% P.O.C.","$52000 - $60000"
"31053","Dodge County, Nebraska",36665,54085,30679,278,154,129,60,4718,83.7,0.8,0.4,0.4,0.2,12.9,16.3,15261,9481,5780,62.13,37.87,940,8541,634,5146,1574,13687,9.9,11,10.3,"Less than 25% P.O.C.","$52000 - $60000"
"31055","Douglas County, Nebraska",560617,64629,389094,61271,2338,21225,229,70367,69.4,10.9,0.4,3.8,0,12.6,30.6,218061,134569,83492,61.71,38.29,16105,118464,6880,76612,22985,195076,12,8.2,10.5,"25% - 50% P.O.C.","$60000 or more"
"31057","Dundy County, Nebraska",1913,41716,1676,4,0,0,0,226,87.6,0.2,0,0,0,11.8,12.4,872,629,243,72.13,27.87,32,597,62,181,94,778,5.1,25.5,10.8,"Less than 25% P.O.C.","Less than $44000"
"31059","Fillmore County, Nebraska",5547,60313,5194,21,22,31,0,218,93.6,0.4,0.4,0.6,0,3.9,6.4,2510,1946,564,77.53,22.47,176,1770,47,517,223,2287,9,8.3,8.9,"Less than 25% P.O.C.","$60000 or more"
"31061","Franklin County, Nebraska",2987,49282,2858,15,1,6,3,69,95.7,0.5,0,0.2,0.1,2.3,4.3,1377,1110,267,80.61,19.39,110,1000,10,257,120,1257,9.9,3.7,8.7,"Less than 25% P.O.C.","$44000 - $52000"
"31063","Frontier County, Nebraska",2640,54659,2537,15,9,2,0,33,96.1,0.6,0.3,0.1,0,1.2,3.9,1135,797,338,70.22,29.78,35,762,41,297,76,1059,4.4,12.1,6.7,"Less than 25% P.O.C.","$52000 - $60000"
"31065","Furnas County, Nebraska",4747,48838,4432,6,4,14,0,204,93.4,0.1,0.1,0.3,0,4.3,6.6,2128,1588,540,74.62,25.38,133,1455,27,513,160,1968,8.4,5,7.5,"Less than 25% P.O.C.","$44000 - $52000"
"31067","Gage County, Nebraska",21594,53110,20399,130,143,143,0,548,94.5,0.6,0.7,0.7,0,2.5,5.5,8979,6247,2732,69.57,30.43,390,5857,219,2513,609,8370,6.2,8,6.8,"Less than 25% P.O.C.","$52000 - $60000"
"31069","Garden County, Nebraska",1864,43750,1757,3,9,3,0,86,94.3,0.2,0.5,0.2,0,4.6,5.7,868,640,228,73.73,26.27,14,626,8,220,22,846,2.2,3.5,2.5,"Less than 25% P.O.C.","Less than $44000"
"31071","Garfield County, Nebraska",2001,53000,1942,7,0,4,0,37,97.1,0.3,0,0.2,0,1.8,2.9,884,688,196,77.83,22.17,60,628,0,196,60,824,8.7,0,6.8,"Less than 25% P.O.C.","$52000 - $60000"
"31073","Gosper County, Nebraska",2013,64053,1864,5,4,7,6,101,92.6,0.2,0.2,0.3,0.3,5,7.4,942,664,278,70.49,29.51,48,616,24,254,72,870,7.2,8.6,7.6,"Less than 25% P.O.C.","$60000 or more"
"31075","Grant County, Nebraska",722,46500,691,6,0,0,0,9,95.7,0.8,0,0,0,1.2,4.3,288,203,85,70.49,29.51,10,193,16,69,26,262,4.9,18.8,9,"Less than 25% P.O.C.","$44000 - $52000"
"31077","Greeley County, Nebraska",2382,47869,2290,10,8,4,0,50,96.1,0.4,0.3,0.2,0,2.1,3.9,1019,825,194,80.96,19.04,75,750,25,169,100,919,9.1,12.9,9.8,"Less than 25% P.O.C.","$44000 - $52000"
"31079","Hall County, Nebraska",61265,57104,40846,1514,247,667,141,16986,66.7,2.5,0.4,1.1,0.2,27.7,33.3,23096,14398,8698,62.34,37.66,1854,12544,878,7820,2732,20364,12.9,10.1,11.8,"25% - 50% P.O.C.","$52000 - $60000"
"31081","Hamilton County, Nebraska",9215,64210,8725,17,17,33,6,325,94.7,0.2,0.2,0.4,0.1,3.5,5.3,3713,2860,853,77.03,22.97,287,2573,90,763,377,3336,10,10.6,10.2,"Less than 25% P.O.C.","$60000 or more"
"31083","Harlan County, Nebraska",3415,49835,3258,18,1,7,1,89,95.4,0.5,0,0.2,0,2.6,4.6,1521,1207,314,79.36,20.64,123,1084,27,287,150,1371,10.2,8.6,9.9,"Less than 25% P.O.C.","$44000 - $52000"
"31085","Hayes County, Nebraska",893,51726,819,0,0,0,0,74,91.7,0,0,0,0,8.3,8.3,403,303,100,75.19,24.81,25,278,9,91,34,369,8.3,9,8.4,"Less than 25% P.O.C.","$44000 - $52000"
"31087","Hitchcock County, Nebraska",2815,49962,2791,2,3,0,0,15,99.1,0.1,0.1,0,0,0.5,0.9,1243,919,324,73.93,26.07,57,862,40,284,97,1146,6.2,12.3,7.8,"Less than 25% P.O.C.","$44000 - $52000"
"31089","Holt County, Nebraska",10177,60387,9492,14,63,57,4,496,93.3,0.1,0.6,0.6,0,4.9,6.7,4487,3238,1249,72.16,27.84,399,2839,74,1175,473,4014,12.3,5.9,10.5,"Less than 25% P.O.C.","$60000 or more"
"31091","Hooker County, Nebraska",693,41125,637,7,4,0,0,45,91.9,1,0.6,0,0,6.5,8.1,318,199,119,62.58,37.42,3,196,8,111,11,307,1.5,6.7,3.5,"Less than 25% P.O.C.","Less than $44000"
"31093","Howard County, Nebraska",6417,59348,6128,10,0,14,2,163,95.5,0.2,0,0.2,0,2.5,4.5,2720,2081,639,76.51,23.49,224,1857,59,580,283,2437,10.8,9.2,10.4,"Less than 25% P.O.C.","$52000 - $60000"
"31095","Jefferson County, Nebraska",7144,44510,6677,45,1,15,0,305,93.5,0.6,0,0.2,0,4.3,6.5,3302,2352,950,71.23,28.77,150,2202,65,885,215,3087,6.4,6.8,6.5,"Less than 25% P.O.C.","$44000 - $52000"
"31097","Johnson County, Nebraska",5161,54712,4149,313,34,81,0,527,80.4,6.1,0.7,1.6,0,10.2,19.6,1809,1328,481,73.41,26.59,80,1248,33,448,113,1696,6,6.9,6.2,"Less than 25% P.O.C.","$52000 - $60000"
"31099","Kearney County, Nebraska",6529,60266,6013,7,51,32,0,410,92.1,0.1,0.8,0.5,0,6.3,7.9,2666,1950,716,73.14,26.86,234,1716,38,678,272,2394,12,5.3,10.2,"Less than 25% P.O.C.","$60000 or more"
"31101","Keith County, Nebraska",8068,50735,7236,98,40,60,11,584,89.7,1.2,0.5,0.7,0.1,7.2,10.3,3882,2671,1211,68.8,31.2,199,2472,71,1140,270,3612,7.5,5.9,7,"Less than 25% P.O.C.","$44000 - $52000"
"31103","Keya Paha County, Nebraska",760,56500,749,0,0,0,0,7,98.6,0,0,0,0,0.9,1.4,304,221,83,72.7,27.3,18,203,6,77,24,280,8.1,7.2,7.9,"Less than 25% P.O.C.","$52000 - $60000"
"31105","Kimball County, Nebraska",3633,53403,3132,3,25,12,0,347,86.2,0.1,0.7,0.3,0,9.6,13.8,1577,1126,451,71.4,28.6,82,1044,21,430,103,1474,7.3,4.7,6.5,"Less than 25% P.O.C.","$52000 - $60000"
"31107","Knox County, Nebraska",8426,52332,7216,34,762,27,2,242,85.6,0.4,9,0.3,0,2.9,14.4,3586,2659,927,74.15,25.85,298,2361,113,814,411,3175,11.2,12.2,11.5,"Less than 25% P.O.C.","$52000 - $60000"
"31109","Lancaster County, Nebraska",313158,60527,254337,11941,1532,13106,225,22068,81.2,3.8,0.5,4.2,0.1,7,18.8,124324,74344,49980,59.8,40.2,7503,66841,2939,47041,10442,113882,10.1,5.9,8.4,"Less than 25% P.O.C.","$60000 or more"
"31111","Lincoln County, Nebraska",35263,59795,30936,438,120,305,11,3046,87.7,1.2,0.3,0.9,0,8.6,12.3,14856,9950,4906,66.98,33.02,897,9053,348,4558,1245,13611,9,7.1,8.4,"Less than 25% P.O.C.","$52000 - $60000"
"31113","Logan County, Nebraska",927,52708,875,0,6,0,0,44,94.4,0,0.6,0,0,4.7,5.6,347,256,91,73.78,26.22,50,206,19,72,69,278,19.5,20.9,19.9,"Less than 25% P.O.C.","$52000 - $60000"
"31115","Loup County, Nebraska",605,51000,592,0,2,0,0,11,97.9,0,0.3,0,0,1.8,2.1,294,225,69,76.53,23.47,8,217,8,61,16,278,3.6,11.6,5.4,"Less than 25% P.O.C.","$44000 - $52000"
"31117","McPherson County, Nebraska",395,48125,389,0,0,0,0,6,98.5,0,0,0,0,1.5,1.5,191,139,52,72.77,27.23,0,139,8,44,8,183,0,15.4,4.2,"Less than 25% P.O.C.","$44000 - $52000"
"31119","Madison County, Nebraska",35080,53188,27970,442,467,601,0,5267,79.7,1.3,1.3,1.7,0,15,20.3,14205,9320,4885,65.61,34.39,1046,8274,410,4475,1456,12749,11.2,8.4,10.2,"Less than 25% P.O.C.","$52000 - $60000"
"31121","Merrick County, Nebraska",7798,55649,7212,36,1,34,0,349,92.5,0.5,0,0.4,0,4.5,7.5,3373,2514,859,74.53,25.47,247,2267,90,769,337,3036,9.8,10.5,10,"Less than 25% P.O.C.","$52000 - $60000"
"31123","Morrill County, Nebraska",4781,46194,3909,37,24,23,0,737,81.8,0.8,0.5,0.5,0,15.4,18.2,1954,1398,556,71.55,28.45,123,1275,50,506,173,1781,8.8,9,8.9,"Less than 25% P.O.C.","$44000 - $52000"
"31125","Nance County, Nebraska",3544,49032,3418,14,10,0,0,99,96.4,0.4,0.3,0,0,2.8,3.6,1546,1244,302,80.47,19.53,80,1164,14,288,94,1452,6.4,4.6,6.1,"Less than 25% P.O.C.","$44000 - $52000"
"31127","Nemaha County, Nebraska",6973,51828,6541,104,38,53,2,194,93.8,1.5,0.5,0.8,0,2.8,6.2,2977,2171,806,72.93,27.07,171,2000,77,729,248,2729,7.9,9.6,8.3,"Less than 25% P.O.C.","$44000 - $52000"
"31129","Nuckolls County, Nebraska",4244,43388,4015,6,4,75,5,119,94.6,0.1,0.1,1.8,0.1,2.8,5.4,1867,1416,451,75.84,24.16,115,1301,26,425,141,1726,8.1,5.8,7.6,"Less than 25% P.O.C.","Less than $44000"
"31131","Otoe County, Nebraska",15949,59167,14156,65,11,54,0,1288,88.8,0.4,0.1,0.3,0,8.1,11.2,6510,4544,1966,69.8,30.2,271,4273,221,1745,492,6018,6,11.2,7.6,"Less than 25% P.O.C.","$52000 - $60000"
"31133","Pawnee County, Nebraska",2649,46452,2528,4,0,0,0,48,95.4,0.2,0,0,0,1.8,4.6,1222,1019,203,83.39,16.61,73,946,62,141,135,1087,7.2,30.5,11,"Less than 25% P.O.C.","$44000 - $52000"
"31135","Perkins County, Nebraska",2901,65543,2761,4,3,0,0,122,95.2,0.1,0.1,0,0,4.2,4.8,1228,956,272,77.85,22.15,90,866,17,255,107,1121,9.4,6.2,8.7,"Less than 25% P.O.C.","$60000 or more"
"31137","Phelps County, Nebraska",9100,59040,8389,33,19,14,0,519,92.2,0.4,0.2,0.2,0,5.7,7.8,3905,2803,1102,71.78,28.22,294,2509,74,1028,368,3537,10.5,6.7,9.4,"Less than 25% P.O.C.","$52000 - $60000"
"31139","Pierce County, Nebraska",7144,64511,6870,15,6,44,13,109,96.2,0.2,0.1,0.6,0.2,1.5,3.8,3022,2294,728,75.91,24.09,222,2072,31,697,253,2769,9.7,4.3,8.4,"Less than 25% P.O.C.","$60000 or more"
"31141","Platte County, Nebraska",33174,62305,25996,179,148,249,5,6297,78.4,0.5,0.4,0.8,0,19,21.6,12947,9381,3566,72.46,27.54,1153,8228,465,3101,1618,11329,12.3,13,12.5,"Less than 25% P.O.C.","$60000 or more"
"31143","Polk County, Nebraska",5225,67719,4850,4,13,0,0,288,92.8,0.1,0.2,0,0,5.5,7.2,2052,1705,347,83.09,16.91,172,1533,48,299,220,1832,10.1,13.8,10.7,"Less than 25% P.O.C.","$60000 or more"
"31145","Red Willow County, Nebraska",10768,48808,9874,66,7,8,0,566,91.7,0.6,0.1,0.1,0,5.3,8.3,4519,3296,1223,72.94,27.06,237,3059,133,1090,370,4149,7.2,10.9,8.2,"Less than 25% P.O.C.","$44000 - $52000"
"31147","Richardson County, Nebraska",7961,47917,7339,16,205,6,0,155,92.2,0.2,2.6,0.1,0,1.9,7.8,3704,2811,893,75.89,24.11,158,2653,15,878,173,3531,5.6,1.7,4.7,"Less than 25% P.O.C.","$44000 - $52000"
"31149","Rock County, Nebraska",1414,56250,1365,21,11,0,0,17,96.5,1.5,0.8,0,0,1.2,3.5,623,497,126,79.78,20.22,20,477,12,114,32,591,4,9.5,5.1,"Less than 25% P.O.C.","$52000 - $60000"
"31151","Saline County, Nebraska",14270,51502,9847,322,35,281,0,3616,69,2.3,0.2,2,0,25.3,31,5157,3641,1516,70.6,29.4,620,3021,288,1228,908,4249,17,19,17.6,"25% - 50% P.O.C.","$44000 - $52000"
"31153","Sarpy County, Nebraska",181232,82032,146729,6626,619,4583,194,16896,81,3.7,0.3,2.5,0.1,9.3,19,66260,45679,20581,68.94,31.06,6522,39157,1869,18712,8391,57869,14.3,9.1,12.7,"Less than 25% P.O.C.","$60000 or more"
"31155","Saunders County, Nebraska",21165,68682,20162,104,81,89,0,482,95.3,0.5,0.4,0.4,0,2.3,4.7,8501,6637,1864,78.07,21.93,711,5926,174,1690,885,7616,10.7,9.3,10.4,"Less than 25% P.O.C.","$60000 or more"
"31157","Scotts Bluff County, Nebraska",36074,49745,25975,266,561,237,1,8594,72,0.7,1.6,0.7,0,23.8,28,14732,9863,4869,66.95,33.05,699,9164,402,4467,1101,13631,7.1,8.3,7.5,"25% - 50% P.O.C.","$44000 - $52000"
"31159","Seward County, Nebraska",17171,70389,16258,94,16,84,0,452,94.7,0.5,0.1,0.5,0,2.6,5.3,6600,4734,1866,71.73,28.27,432,4302,161,1705,593,6007,9.1,8.6,9,"Less than 25% P.O.C.","$60000 or more"
"31161","Sheridan County, Nebraska",5231,45371,4243,109,352,42,2,289,81.1,2.1,6.7,0.8,0,5.5,18.9,2273,1564,709,68.81,31.19,71,1493,86,623,157,2116,4.5,12.1,6.9,"Less than 25% P.O.C.","$44000 - $52000"
"31163","Sherman County, Nebraska",3033,50781,2922,5,1,9,1,68,96.3,0.2,0,0.3,0,2.2,3.7,1368,1056,312,77.19,22.81,105,951,16,296,121,1247,9.9,5.1,8.8,"Less than 25% P.O.C.","$44000 - $52000"
"31165","Sioux County, Nebraska",1219,48269,1129,5,6,0,0,41,92.6,0.4,0.5,0,0,3.4,7.4,544,392,152,72.06,27.94,33,359,10,142,43,501,8.4,6.6,7.9,"Less than 25% P.O.C.","$44000 - $52000"
"31167","Stanton County, Nebraska",5957,63986,5469,87,0,29,0,330,91.8,1.5,0,0.5,0,5.5,8.2,2418,1984,434,82.05,17.95,228,1756,6,428,234,2184,11.5,1.4,9.7,"Less than 25% P.O.C.","$60000 or more"
"31169","Thayer County, Nebraska",5057,51821,4799,25,12,0,0,131,94.9,0.5,0.2,0,0,2.6,5.1,2244,1763,481,78.57,21.43,122,1641,24,457,146,2098,6.9,5,6.5,"Less than 25% P.O.C.","$44000 - $52000"
"31171","Thomas County, Nebraska",645,59432,613,0,6,0,0,0,95,0,0.9,0,0,0,5,277,212,65,76.53,23.47,18,194,0,65,18,259,8.5,0,6.5,"Less than 25% P.O.C.","$52000 - $60000"
"31173","Thurston County, Nebraska",7181,51034,2566,14,4039,59,0,427,35.7,0.2,56.2,0.8,0,5.9,64.3,2176,1324,852,60.85,39.15,246,1078,247,605,493,1683,18.6,29,22.7,"50% - 75% P.O.C.","$44000 - $52000"
"31175","Valley County, Nebraska",4206,55324,3985,20,19,0,0,143,94.7,0.5,0.5,0,0,3.4,5.3,1865,1385,480,74.26,25.74,115,1270,67,413,182,1683,8.3,14,9.8,"Less than 25% P.O.C.","$52000 - $60000"
"31177","Washington County, Nebraska",20361,71430,19241,176,11,53,15,593,94.5,0.9,0.1,0.3,0.1,2.9,5.5,8185,6405,1780,78.25,21.75,769,5636,86,1694,855,7330,12,4.8,10.4,"Less than 25% P.O.C.","$60000 or more"
"31179","Wayne County, Nebraska",9332,56456,8392,135,14,43,0,557,89.9,1.4,0.2,0.5,0,6,10.1,3708,2378,1330,64.13,35.87,276,2102,84,1246,360,3348,11.6,6.3,9.7,"Less than 25% P.O.C.","$52000 - $60000"
"31181","Webster County, Nebraska",3537,46188,3237,10,32,0,8,181,91.5,0.3,0.9,0,0.2,5.1,8.5,1507,1200,307,79.63,20.37,75,1125,18,289,93,1414,6.2,5.9,6.2,"Less than 25% P.O.C.","$44000 - $52000"
"31183","Wheeler County, Nebraska",783,51591,759,0,0,2,0,20,96.9,0,0,0.3,0,2.6,3.1,346,232,114,67.05,32.95,22,210,2,112,24,322,9.5,1.8,6.9,"Less than 25% P.O.C.","$44000 - $52000"
"31185","York County, Nebraska",13745,60298,12443,214,66,58,0,709,90.5,1.6,0.5,0.4,0,5.2,9.5,5656,4048,1608,71.57,28.43,401,3647,83,1525,484,5172,9.9,5.2,8.6,"Less than 25% P.O.C.","$60000 or more"
"32001","Churchill County, Nevada",24259,57824,17762,593,923,676,16,3376,73.2,2.4,3.8,2.8,0.1,13.9,26.8,9940,6503,3437,65.42,34.58,490,6013,288,3149,778,9162,7.5,8.4,7.8,"25% - 50% P.O.C.","$52000 - $60000"
"32003","Clark County, Nevada",2182004,59340,933344,245063,10090,208409,14855,679381,42.8,11.2,0.5,9.6,0.7,31.1,57.2,783524,421252,362272,53.76,46.24,47368,373884,38407,323865,85775,697749,11.2,10.6,10.9,"50% - 75% P.O.C.","$52000 - $60000"
"32005","Douglas County, Nevada",48132,66810,38877,357,818,791,86,6108,80.8,0.7,1.7,1.6,0.2,12.7,19.2,20741,14811,5930,71.41,28.59,610,14201,415,5515,1025,19716,4.1,7,4.9,"Less than 25% P.O.C.","$60000 or more"
"32007","Elko County, Nevada",52297,81232,34901,257,3192,584,79,12751,66.7,0.5,6.1,1.1,0.2,24.4,33.3,18065,12870,5195,71.24,28.76,1834,11036,638,4557,2472,15593,14.3,12.3,13.7,"25% - 50% P.O.C.","$60000 or more"
"32009","Esmeralda County, Nevada",969,37375,774,25,16,0,0,153,79.9,2.6,1.7,0,0,15.8,20.1,491,286,205,58.25,41.75,9,277,21,184,30,461,3.1,10.2,6.1,"Less than 25% P.O.C.","Less than $44000"
"32011","Eureka County, Nevada",1859,67105,1671,1,93,13,0,81,89.9,0.1,5,0.7,0,4.4,10.1,774,571,203,73.77,26.23,32,539,10,193,42,732,5.6,4.9,5.4,"Less than 25% P.O.C.","$60000 or more"
"32013","Humboldt County, Nevada",16828,67756,11000,109,865,109,0,4547,65.4,0.6,5.1,0.6,0,27,34.6,6500,4642,1858,71.42,28.58,561,4081,305,1553,866,5634,12.1,16.4,13.3,"25% - 50% P.O.C.","$60000 or more"
"32015","Lander County, Nevada",5643,88030,3616,4,179,6,0,1759,64.1,0.1,3.2,0.1,0,31.2,35.9,2198,1614,584,73.43,26.57,160,1454,23,561,183,2015,9.9,3.9,8.3,"25% - 50% P.O.C.","$60000 or more"
"32017","Lincoln County, Nevada",5180,58462,4504,197,38,46,0,357,86.9,3.8,0.7,0.9,0,6.9,13.1,2018,1510,508,74.83,25.17,151,1359,0,508,151,1867,10,0,7.5,"Less than 25% P.O.C.","$52000 - $60000"
"32019","Lyon County, Nevada",54380,56875,40722,402,1374,707,91,9306,74.9,0.7,2.5,1.3,0.2,17.1,25.1,21189,14985,6204,70.72,29.28,1572,13413,922,5282,2494,18695,10.5,14.9,11.8,"25% - 50% P.O.C.","$52000 - $60000"
"32021","Mineral County, Nevada",4460,35806,2690,229,842,57,0,519,60.3,5.1,18.9,1.3,0,11.6,39.7,2048,1446,602,70.61,29.39,31,1415,86,516,117,1931,2.1,14.3,5.7,"25% - 50% P.O.C.","Less than $44000"
"32023","Nye County, Nevada",44380,47300,33861,826,690,725,236,6513,76.3,1.9,1.6,1.6,0.5,14.7,23.7,19088,13517,5571,70.81,29.19,811,12706,431,5140,1242,17846,6,7.7,6.5,"Less than 25% P.O.C.","$44000 - $52000"
"32027","Pershing County, Nevada",6615,50491,4310,234,162,65,17,1617,65.2,3.5,2.4,1,0.3,24.4,34.8,1948,1301,647,66.79,33.21,82,1219,67,580,149,1799,6.3,10.4,7.6,"25% - 50% P.O.C.","$44000 - $52000"
"32029","Storey County, Nevada",3988,66292,3374,67,14,37,0,129,84.6,1.7,0.4,0.9,0,3.2,15.4,1627,1470,157,90.35,9.65,116,1354,22,135,138,1489,7.9,14,8.5,"Less than 25% P.O.C.","$60000 or more"
"32031","Washoe County, Nevada",456936,64791,288214,9821,6198,23841,2747,111653,63.1,2.1,1.4,5.2,0.6,24.4,36.9,182180,106255,75925,58.32,41.68,10098,96157,7371,68554,17469,164711,9.5,9.7,9.6,"25% - 50% P.O.C.","$60000 or more"
"32033","White Pine County, Nevada",9679,60827,6929,543,477,87,12,1565,71.6,5.6,4.9,0.9,0.1,16.2,28.4,3516,2657,859,75.57,24.43,173,2484,84,775,257,3259,6.5,9.8,7.3,"25% - 50% P.O.C.","$60000 or more"
"32510","Carson City, Nevada",54773,55718,36688,1074,1099,1435,23,13226,67,2,2,2.6,0,24.1,33,22755,12915,9840,56.76,43.24,1125,11790,1164,8676,2289,20466,8.7,11.8,10.1,"25% - 50% P.O.C.","$52000 - $60000"
"33001","Belknap County, New Hampshire",60887,69447,57842,375,182,569,10,1018,95,0.6,0.3,0.9,0,1.7,5,25052,18918,6134,75.51,24.49,1192,17726,268,5866,1460,23592,6.3,4.4,5.8,"Less than 25% P.O.C.","$60000 or more"
"33003","Carroll County, New Hampshire",48138,63153,46129,225,31,327,12,713,95.8,0.5,0.1,0.7,0,1.5,4.2,21456,17025,4431,79.35,20.65,803,16222,312,4119,1115,20341,4.7,7,5.2,"Less than 25% P.O.C.","$60000 or more"
"33005","Cheshire County, New Hampshire",76042,64751,71552,555,131,959,39,1408,94.1,0.7,0.2,1.3,0.1,1.9,5.9,30141,20929,9212,69.44,30.56,1327,19602,420,8792,1747,28394,6.3,4.6,5.8,"Less than 25% P.O.C.","$60000 or more"
"33007","Coos County, New Hampshire",31741,47117,29216,770,98,168,28,935,92,2.4,0.3,0.5,0.1,2.9,8,13768,9728,4040,70.66,29.34,512,9216,260,3780,772,12996,5.3,6.4,5.6,"Less than 25% P.O.C.","$44000 - $52000"
"33009","Grafton County, New Hampshire",89777,63389,81380,924,224,3293,42,2150,90.6,1,0.2,3.7,0,2.4,9.4,34727,24081,10646,69.34,30.66,1527,22554,403,10243,1930,32797,6.3,3.8,5.6,"Less than 25% P.O.C.","$60000 or more"
"33011","Hillsborough County, New Hampshire",413035,81460,348800,9655,451,16600,123,27970,84.4,2.3,0.1,4,0,6.8,15.6,161086,106397,54689,66.05,33.95,9444,96953,3706,50983,13150,147936,8.9,6.8,8.2,"Less than 25% P.O.C.","$60000 or more"
"33013","Merrimack County, New Hampshire",149917,75737,138560,2040,374,3135,15,3233,92.4,1.4,0.2,2.1,0,2.2,7.6,58452,41953,16499,71.77,28.23,3216,38737,760,15739,3976,54476,7.7,4.6,6.8,"Less than 25% P.O.C.","$60000 or more"
"33015","Rockingham County, New Hampshire",306359,93756,283469,2299,92,6313,26,9161,92.5,0.8,0,2.1,0,3,7.5,121045,94111,26934,77.75,22.25,7821,86290,981,25953,8802,112243,8.3,3.6,7.3,"Less than 25% P.O.C.","$60000 or more"
"33017","Strafford County, New Hampshire",129124,72960,117027,1210,94,4263,53,3231,90.6,0.9,0.1,3.3,0,2.5,9.4,48982,32335,16647,66.01,33.99,2221,30114,967,15680,3188,45794,6.9,5.8,6.5,"Less than 25% P.O.C.","$60000 or more"
"33019","Sullivan County, New Hampshire",43104,61312,40952,282,139,344,0,674,95,0.7,0.3,0.8,0,1.6,5,17328,12701,4627,73.3,26.7,785,11916,456,4171,1241,16087,6.2,9.9,7.2,"Less than 25% P.O.C.","$60000 or more"
"34001","Atlantic County, New Jersey",266105,62110,150070,37289,633,20898,103,50150,56.4,14,0.2,7.9,0,18.8,43.6,99850,67025,32825,67.13,32.87,6816,60209,3412,29413,10228,89622,10.2,10.4,10.2,"25% - 50% P.O.C.","$60000 or more"
"34003","Bergen County, New Jersey",930390,101144,526241,49249,1000,151090,281,185238,56.6,5.3,0.1,16.2,0,19.9,43.4,339856,220190,119666,64.79,35.21,25060,195130,8159,111507,33219,306637,11.4,6.8,9.8,"25% - 50% P.O.C.","$60000 or more"
"34005","Burlington County, New Jersey",445702,87416,300533,71501,191,22367,167,35855,67.4,16,0,5,0,8,32.6,166391,125494,40897,75.42,24.58,12581,112913,3658,37239,16239,150152,10,8.9,9.8,"25% - 50% P.O.C.","$60000 or more"
"34007","Camden County, New Jersey",506738,70451,287169,92537,393,28941,109,84972,56.7,18.3,0.1,5.7,0,16.8,43.3,187383,125229,62154,66.83,33.17,13791,111438,5159,56995,18950,168433,11,8.3,10.1,"25% - 50% P.O.C.","$60000 or more"
"34009","Cape May County, New Jersey",93086,67074,79373,4124,20,860,0,7153,85.3,4.4,0,0.9,0,7.7,14.7,40171,31189,8982,77.64,22.36,2021,29168,913,8069,2934,37237,6.5,10.2,7.3,"Less than 25% P.O.C.","$60000 or more"
"34011","Cumberland County, New Jersey",151906,54149,70499,27490,930,2011,8,46643,46.4,18.1,0.6,1.3,0,30.7,53.6,50729,33093,17636,65.23,34.77,4054,29039,2551,15085,6605,44124,12.3,14.5,13,"50% - 75% P.O.C.","$52000 - $60000"
"34013","Essex County, New Jersey",795404,61510,242965,305796,1107,41976,116,183182,30.5,38.4,0.1,5.3,0,23,69.5,285908,125777,160131,43.99,56.01,15421,110356,13119,147012,28540,257368,12.3,8.2,10,"50% - 75% P.O.C.","$60000 or more"
"34015","Gloucester County, New Jersey",291165,87283,228576,28452,204,9002,23,18059,78.5,9.8,0.1,3.1,0,6.2,21.5,104908,84056,20852,80.12,19.88,8635,75421,1117,19735,9752,95156,10.3,5.4,9.3,"Less than 25% P.O.C.","$60000 or more"
"34017","Hudson County, New Jersey",670046,71189,192880,70655,1095,100182,451,288647,28.8,10.5,0.2,15,0.1,43.1,71.2,258591,81934,176657,31.68,68.32,9895,72039,15208,161449,25103,233488,12.1,8.6,9.7,"50% - 75% P.O.C.","$60000 or more"
"34019","Hunterdon County, New Jersey",124823,115379,106763,2995,23,5124,47,8166,85.5,2.4,0,4.1,0,6.5,14.5,47175,39081,8094,82.84,17.16,3224,35857,475,7619,3699,43476,8.2,5.9,7.8,"Less than 25% P.O.C.","$60000 or more"
"34021","Mercer County, New Jersey",367922,81057,182882,73029,330,40730,88,64504,49.7,19.8,0.1,11.1,0,17.5,50.3,129936,81925,48011,63.05,36.95,7131,74794,4549,43462,11680,118256,8.7,9.5,9,"50% - 75% P.O.C.","$60000 or more"
"34023","Middlesex County, New Jersey",825920,89533,355653,78707,1132,197737,280,174747,43.1,9.5,0.1,23.9,0,21.2,56.9,285005,180979,104026,63.5,36.5,20896,160083,10301,93725,31197,253808,11.5,9.9,10.9,"50% - 75% P.O.C.","$60000 or more"
"34025","Monmouth County, New Jersey",621659,99733,467752,41697,440,33451,239,67168,75.2,6.7,0.1,5.4,0,10.8,24.8,235362,173580,61782,73.75,26.25,17510,156070,4918,56864,22428,212934,10.1,8,9.5,"Less than 25% P.O.C.","$60000 or more"
"34027","Morris County, New Jersey",493379,115527,352199,15675,289,50640,38,65683,71.4,3.2,0.1,10.3,0,13.3,28.6,181884,134496,47388,73.95,26.05,13256,121240,3026,44362,16282,165602,9.9,6.4,9,"25% - 50% P.O.C.","$60000 or more"
"34029","Ocean County, New Jersey",596415,70909,504971,16510,246,11009,164,54932,84.7,2.8,0,1.8,0,9.2,15.3,226160,180844,45316,79.96,20.04,16098,164746,7562,37754,23660,202500,8.9,16.7,10.5,"Less than 25% P.O.C.","$60000 or more"
"34031","Passaic County, New Jersey",503637,69688,208005,52523,651,25732,96,209203,41.3,10.4,0.1,5.1,0,41.5,58.7,165429,87262,78167,52.75,47.25,12045,75217,10887,67280,22932,142497,13.8,13.9,13.9,"50% - 75% P.O.C.","$60000 or more"
"34033","Salem County, New Jersey",62990,66842,46772,8107,159,663,31,5676,74.3,12.9,0.3,1.1,0,9,25.7,23933,17019,6914,71.11,28.89,1541,15478,514,6400,2055,21878,9.1,7.4,8.6,"25% - 50% P.O.C.","$60000 or more"
"34035","Somerset County, New Jersey",329838,113611,185677,30428,412,58034,19,48326,56.3,9.2,0.1,17.6,0,14.7,43.7,118193,89574,28619,75.79,24.21,8890,80684,2144,26475,11034,107159,9.9,7.5,9.3,"25% - 50% P.O.C.","$60000 or more"
"34037","Sussex County, New Jersey",141483,94520,122081,2991,16,2887,0,11617,86.3,2.1,0,2,0,8.2,13.7,53322,44328,8994,83.13,16.87,4228,40100,703,8291,4931,48391,9.5,7.8,9.2,"Less than 25% P.O.C.","$60000 or more"
"34039","Union County, New Jersey",554033,80198,218856,111174,419,27927,24,174998,39.5,20.1,0.1,5,0,31.6,60.5,190101,111350,78751,58.57,41.43,13684,97666,8019,70732,21703,168398,12.3,10.2,11.4,"50% - 75% P.O.C.","$60000 or more"
"34041","Warren County, New Jersey",105862,81307,86463,4612,123,2812,2,9817,81.7,4.4,0.1,2.7,0,9.3,18.3,41587,29815,11772,71.69,28.31,2753,27062,810,10962,3563,38024,9.2,6.9,8.6,"Less than 25% P.O.C.","$60000 or more"
"35001","Bernalillo County, New Mexico",677858,53329,262184,16747,27855,17069,433,338856,38.7,2.5,4.1,2.5,0.1,50,61.3,267699,168608,99091,62.98,37.02,12661,155947,6642,92449,19303,248396,7.5,6.7,7.2,"50% - 75% P.O.C.","$52000 - $60000"
"35003","Catron County, New Mexico",3526,41910,2853,0,2,0,0,671,80.9,0,0.1,0,0,19,19.1,1325,1162,163,87.7,12.3,55,1107,10,153,65,1260,4.7,6.1,4.9,"Less than 25% P.O.C.","Less than $44000"
"35005","Chaves County, New Mexico",65144,43359,25325,929,690,584,6,36967,38.9,1.4,1.1,0.9,0,56.7,61.1,23284,16040,7244,68.89,31.11,2067,13973,928,6316,2995,20289,12.9,12.8,12.9,"50% - 75% P.O.C.","Less than $44000"
"35006","Cibola County, New Mexico",26891,39413,5193,237,10496,40,9,10316,19.3,0.9,39,0.1,0,38.4,80.7,8708,5981,2727,68.68,31.32,862,5119,432,2295,1294,7414,14.4,15.8,14.9,"75% or more P.O.C.","Less than $44000"
"35007","Colfax County, New Mexico",12168,36302,5687,81,47,52,0,6011,46.7,0.7,0.4,0.4,0,49.4,53.3,5853,4157,1696,71.02,28.98,233,3924,51,1645,284,5569,5.6,3,4.9,"50% - 75% P.O.C.","Less than $44000"
"35009","Curry County, New Mexico",49732,45092,23686,2463,384,628,129,20971,47.6,5,0.8,1.3,0.3,42.2,52.4,18548,10576,7972,57.02,42.98,1182,9394,815,7157,1997,16551,11.2,10.2,10.8,"50% - 75% P.O.C.","$44000 - $52000"
"35011","De Baca County, New Mexico",2040,31625,906,32,5,0,0,1091,44.4,1.6,0.2,0,0,53.5,55.6,672,421,251,62.65,37.35,11,410,43,208,54,618,2.6,17.1,8,"50% - 75% P.O.C.","Less than $44000"
"35013","Doña Ana County, New Mexico",216069,40973,58848,3476,1421,2279,66,147491,27.2,1.6,0.7,1.1,0,68.3,72.8,77842,49113,28729,63.09,36.91,5011,44102,3263,25466,8274,69568,10.2,11.4,10.6,"50% - 75% P.O.C.","Less than $44000"
"35015","Eddy County, New Mexico",57732,65328,27012,836,818,265,0,28363,46.8,1.4,1.4,0.5,0,49.1,53.2,21251,14768,6483,69.49,30.51,1608,13160,1097,5386,2705,18546,10.9,16.9,12.7,"50% - 75% P.O.C.","$60000 or more"
"35017","Grant County, New Mexico",27669,37843,12675,242,513,131,3,13969,45.8,0.9,1.9,0.5,0,50.5,54.2,11851,8067,3784,68.07,31.93,516,7551,165,3619,681,11170,6.4,4.4,5.7,"50% - 75% P.O.C.","Less than $44000"
"35019","Guadalupe County, New Mexico",4353,24798,844,25,232,9,0,3217,19.4,0.6,5.3,0.2,0,73.9,80.6,1384,867,517,62.64,37.36,24,843,6,511,30,1354,2.8,1.2,2.2,"75% or more P.O.C.","Less than $44000"
"35021","Harding County, New Mexico",441,29375,260,0,0,0,3,175,59,0,0,0,0.7,39.7,41,211,138,73,65.4,34.6,2,136,6,67,8,203,1.4,8.2,3.8,"25% - 50% P.O.C.","Less than $44000"
"35023","Hidalgo County, New Mexico",4297,42526,1676,54,58,0,0,2497,39,1.3,1.3,0,0,58.1,61,1679,1186,493,70.64,29.36,82,1104,84,409,166,1513,6.9,17,9.9,"50% - 75% P.O.C.","Less than $44000"
"35025","Lea County, New Mexico",70277,60546,24885,2386,570,402,11,41230,35.4,3.4,0.8,0.6,0,58.7,64.6,22523,15045,7478,66.8,33.2,2204,12841,1069,6409,3273,19250,14.6,14.3,14.5,"50% - 75% P.O.C.","$60000 or more"
"35027","Lincoln County, New Mexico",19461,46216,12632,101,98,13,0,6458,64.9,0.5,0.5,0.1,0,33.2,35.1,7566,6096,1470,80.57,19.43,248,5848,72,1398,320,7246,4.1,4.9,4.2,"25% - 50% P.O.C.","$44000 - $52000"
"35028","Los Alamos County, New Mexico",18625,121324,13377,107,167,926,0,3346,71.8,0.6,0.9,5,0,18,28.2,7931,5878,2053,74.11,25.89,386,5492,43,2010,429,7502,6.6,2.1,5.4,"25% - 50% P.O.C.","$60000 or more"
"35029","Luna County, New Mexico",24083,29360,7108,316,179,199,0,16151,29.5,1.3,0.7,0.8,0,67.1,70.5,8904,5422,3482,60.89,39.11,613,4809,243,3239,856,8048,11.3,7,9.6,"50% - 75% P.O.C.","Less than $44000"
"35031","McKinley County, New Mexico",72438,33834,6259,409,53246,711,30,10320,8.6,0.6,73.5,1,0,14.2,91.4,20942,14852,6090,70.92,29.08,2857,11995,1070,5020,3927,17015,19.2,17.6,18.8,"75% or more P.O.C.","Less than $44000"
"35033","Mora County, New Mexico",4536,28446,713,2,0,0,0,3696,15.7,0,0,0,0,81.5,84.3,1713,1465,248,85.52,14.48,45,1420,0,248,45,1668,3.1,0,2.6,"75% or more P.O.C.","Less than $44000"
"35035","Otero County, New Mexico",66137,41988,32314,2133,4015,826,97,25315,48.9,3.2,6.1,1.2,0.1,38.3,51.1,23634,15172,8462,64.2,35.8,1180,13992,882,7580,2062,21572,7.8,10.4,8.7,"50% - 75% P.O.C.","Less than $44000"
"35037","Quay County, New Mexico",8326,29035,4131,134,114,50,16,3771,49.6,1.6,1.4,0.6,0.2,45.3,50.4,3040,1869,1171,61.48,38.52,129,1740,55,1116,184,2856,6.9,4.7,6.1,"50% - 75% P.O.C.","Less than $44000"
"35039","Rio Arriba County, New Mexico",39159,39952,4870,173,5604,189,13,27896,12.4,0.4,14.3,0.5,0,71.2,87.6,12730,9784,2946,76.86,23.14,439,9345,187,2759,626,12104,4.5,6.3,4.9,"75% or more P.O.C.","Less than $44000"
"35041","Roosevelt County, New Mexico",18888,42702,9790,456,100,95,14,7956,51.8,2.4,0.5,0.5,0.1,42.1,48.2,6814,3984,2830,58.47,41.53,469,3515,379,2451,848,5966,11.8,13.4,12.4,"25% - 50% P.O.C.","Less than $44000"
"35043","Sandoval County, New Mexico",142704,63802,62056,2959,17221,1680,179,55525,43.5,2.1,12.1,1.2,0.1,38.9,56.5,51001,40082,10919,78.59,21.41,4491,35591,1135,9784,5626,45375,11.2,10.4,11,"50% - 75% P.O.C.","$60000 or more"
"35045","San Juan County, New Mexico",126515,50518,48320,853,48083,809,76,25668,38.2,0.7,38,0.6,0.1,20.3,61.8,43387,30813,12574,71.02,28.98,3894,26919,2058,10516,5952,37435,12.6,16.4,13.7,"50% - 75% P.O.C.","$44000 - $52000"
"35047","San Miguel County, New Mexico",27738,30946,4945,259,286,268,0,21563,17.8,0.9,1,1,0,77.7,82.2,11609,8166,3443,70.34,29.66,511,7655,294,3149,805,10804,6.3,8.5,6.9,"75% or more P.O.C.","Less than $44000"
"35049","Santa Fe County, New Mexico",149293,61200,63865,1325,3773,1813,103,76446,42.8,0.9,2.5,1.2,0.1,51.2,57.2,61921,43900,18021,70.9,29.1,3118,40782,1010,17011,4128,57793,7.1,5.6,6.7,"50% - 75% P.O.C.","$60000 or more"
"35051","Sierra County, New Mexico",11031,29755,7136,44,226,83,0,3348,64.7,0.4,2,0.8,0,30.4,35.3,5555,4106,1449,73.92,26.08,123,3983,134,1315,257,5298,3,9.2,4.6,"25% - 50% P.O.C.","Less than $44000"
"35053","Socorro County, New Mexico",16858,42083,5764,95,1763,548,0,8388,34.2,0.6,10.5,3.3,0,49.8,65.8,4520,3316,1204,73.36,26.64,188,3128,114,1090,302,4218,5.7,9.5,6.7,"50% - 75% P.O.C.","Less than $44000"
"35055","Taos County, New Mexico",32786,38329,11563,54,1921,258,1,18652,35.3,0.2,5.9,0.8,0,56.9,64.7,12103,9249,2854,76.42,23.58,454,8795,55,2799,509,11594,4.9,1.9,4.2,"50% - 75% P.O.C.","Less than $44000"
"35057","Torrance County, New Mexico",15519,36120,8488,121,47,23,0,6687,54.7,0.8,0.3,0.1,0,43.1,45.3,5644,4697,947,83.22,16.78,309,4388,101,846,410,5234,6.6,10.7,7.3,"25% - 50% P.O.C.","Less than $44000"
"35059","Union County, New Mexico",4133,35884,2120,59,63,1,0,1750,51.3,1.4,1.5,0,0,42.3,48.7,1395,906,489,64.95,35.05,40,866,56,433,96,1299,4.4,11.5,6.9,"25% - 50% P.O.C.","Less than $44000"
"35061","Valencia County, New Mexico",76027,48945,24784,803,2877,390,0,46056,32.6,1.1,3.8,0.5,0,60.6,67.4,27010,22010,5000,81.49,18.51,2633,19377,476,4524,3109,23901,12,9.5,11.5,"50% - 75% P.O.C.","$44000 - $52000"
"36001","Albany County, New York",306968,66252,221542,35311,262,20128,120,18325,72.2,11.5,0.1,6.6,0,6,27.8,126540,71341,55199,56.38,43.62,5237,66104,2319,52880,7556,118984,7.3,4.2,6,"25% - 50% P.O.C.","$60000 or more"
"36003","Allegany County, New York",46688,48412,44075,665,107,546,15,761,94.4,1.4,0.2,1.2,0,1.6,5.6,17948,13678,4270,76.21,23.79,1309,12369,354,3916,1663,16285,9.6,8.3,9.3,"Less than 25% P.O.C.","$44000 - $52000"
"36005","Bronx County, New York",1435068,40088,131140,419473,3269,51470,437,804018,9.1,29.2,0.2,3.6,0,56,90.9,503829,99212,404617,19.69,80.31,14045,85167,48382,356235,62427,441402,14.2,12,12.4,"75% or more P.O.C.","Less than $44000"
"36007","Broome County, New York",193188,52226,161081,9958,284,8374,46,8140,83.4,5.2,0.1,4.3,0,4.2,16.6,78549,51189,27360,65.17,34.83,3953,47236,1916,25444,5869,72680,7.7,7,7.5,"Less than 25% P.O.C.","$52000 - $60000"
"36009","Cattaraugus County, New York",77121,48703,69857,1091,2399,610,0,1620,90.6,1.4,3.1,0.8,0,2.1,9.4,31779,22778,9001,71.68,28.32,1889,20889,631,8370,2520,29259,8.3,7,7.9,"Less than 25% P.O.C.","$44000 - $52000"
"36011","Cayuga County, New York",77425,58377,69753,3175,88,437,5,2286,90.1,4.1,0.1,0.6,0,3,9.9,31221,22251,8970,71.27,28.73,1875,20376,888,8082,2763,28458,8.4,9.9,8.8,"Less than 25% P.O.C.","$52000 - $60000"
"36013","Chautauqua County, New York",128496,46820,112354,3018,378,723,62,9608,87.4,2.3,0.3,0.6,0,7.5,12.6,53075,36755,16320,69.25,30.75,2457,34298,938,15382,3395,49680,6.7,5.7,6.4,"Less than 25% P.O.C.","$44000 - $52000"
"36015","Chemung County, New York",84895,54940,73203,5011,238,1135,7,2619,86.2,5.9,0.3,1.3,0,3.1,13.8,33989,23217,10772,68.31,31.69,1587,21630,875,9897,2462,31527,6.8,8.1,7.2,"Less than 25% P.O.C.","$52000 - $60000"
"36017","Chenango County, New York",47909,52002,45389,420,145,207,0,1049,94.7,0.9,0.3,0.4,0,2.2,5.3,20697,15414,5283,74.47,25.53,1286,14128,331,4952,1617,19080,8.3,6.3,7.8,"Less than 25% P.O.C.","$52000 - $60000"
"36019","Clinton County, New York",80583,56365,72468,3278,221,1133,15,2344,89.9,4.1,0.3,1.4,0,2.9,10.1,31301,20810,10491,66.48,33.52,1017,19793,682,9809,1699,29602,4.9,6.5,5.4,"Less than 25% P.O.C.","$52000 - $60000"
"36021","Columbia County, New York",60371,66787,52129,2600,34,1051,0,2879,86.3,4.3,0.1,1.7,0,4.8,13.7,24966,18403,6563,73.71,26.29,996,17407,384,6179,1380,23586,5.4,5.9,5.5,"Less than 25% P.O.C.","$60000 or more"
"36023","Cortland County, New York",47865,56023,44332,908,107,364,0,1293,92.6,1.9,0.2,0.8,0,2.7,7.4,17745,11648,6097,65.64,34.36,1027,10621,509,5588,1536,16209,8.8,8.3,8.7,"Less than 25% P.O.C.","$52000 - $60000"
"36025","Delaware County, New York",44995,49544,41434,690,34,349,2,1744,92.1,1.5,0.1,0.8,0,3.9,7.9,18968,14010,4958,73.86,26.14,882,13128,392,4566,1274,17694,6.3,7.9,6.7,"Less than 25% P.O.C.","$44000 - $52000"
"36027","Dutchess County, New York",293754,81219,209941,28787,429,10332,107,35812,71.5,9.8,0.1,3.5,0,12.2,28.5,108413,74540,33873,68.76,31.24,6885,67655,2646,31227,9531,98882,9.2,7.8,8.8,"25% - 50% P.O.C.","$60000 or more"
"36029","Erie County, New York",919355,58121,694067,119638,4149,32623,260,50599,75.5,13,0.5,3.5,0,5.5,24.5,389585,251583,138002,64.58,35.42,18994,232589,7661,130341,26655,362930,7.5,5.6,6.8,"Less than 25% P.O.C.","$52000 - $60000"
"36031","Essex County, New York",37459,56763,34447,1087,93,103,7,1129,92,2.9,0.2,0.3,0,3,8,15790,11903,3887,75.38,24.62,648,11255,276,3611,924,14866,5.4,7.1,5.9,"Less than 25% P.O.C.","$52000 - $60000"
"36033","Franklin County, New York",50477,50407,41201,2839,3609,274,111,1789,81.6,5.6,7.1,0.5,0.2,3.5,18.4,19015,13577,5438,71.4,28.6,1054,12523,441,4997,1495,17520,7.8,8.1,7.9,"Less than 25% P.O.C.","$44000 - $52000"
"36035","Fulton County, New York",53646,50482,49727,1063,153,417,7,1662,92.7,2,0.3,0.8,0,3.1,7.3,22557,15942,6615,70.67,29.33,1081,14861,731,5884,1812,20745,6.8,11.1,8,"Less than 25% P.O.C.","$44000 - $52000"
"36037","Genesee County, New York",57808,60524,52329,1166,480,455,0,1906,90.5,2,0.8,0.8,0,3.3,9.5,23759,17168,6591,72.26,27.74,1471,15697,442,6149,1913,21846,8.6,6.7,8.1,"Less than 25% P.O.C.","$60000 or more"
"36039","Greene County, New York",47424,53601,40445,2584,223,497,3,2804,85.3,5.4,0.5,1,0,5.9,14.7,17100,12796,4304,74.83,25.17,830,11966,168,4136,998,16102,6.5,3.9,5.8,"Less than 25% P.O.C.","$52000 - $60000"
"36041","Hamilton County, New York",4515,58675,4332,36,5,3,2,75,95.9,0.8,0.1,0.1,0,1.7,4.1,1157,1003,154,86.69,13.31,54,949,8,146,62,1095,5.4,5.2,5.4,"Less than 25% P.O.C.","$52000 - $60000"
"36043","Herkimer County, New York",62057,54646,58651,641,130,365,14,1340,94.5,1,0.2,0.6,0,2.2,5.5,24524,18052,6472,73.61,26.39,1327,16725,441,6031,1768,22756,7.4,6.8,7.2,"Less than 25% P.O.C.","$52000 - $60000"
"36045","Jefferson County, New York",112842,52685,92121,6450,414,1925,215,8489,81.6,5.7,0.4,1.7,0.2,7.5,18.4,42734,24135,18599,56.48,43.52,1984,22151,1320,17279,3304,39430,8.2,7.1,7.7,"Less than 25% P.O.C.","$52000 - $60000"
"36047","Kings County, New York",2589974,60231,942865,776274,3528,305094,939,493232,36.4,30,0.1,11.8,0,19,63.6,958567,288632,669935,30.11,69.89,47037,241595,71227,598708,118264,840303,16.3,10.6,12.3,"50% - 75% P.O.C.","$60000 or more"
"36049","Lewis County, New York",26572,54524,25470,185,76,141,24,461,95.9,0.7,0.3,0.5,0.1,1.7,4.1,10247,8282,1965,80.82,19.18,819,7463,144,1821,963,9284,9.9,7.3,9.4,"Less than 25% P.O.C.","$52000 - $60000"
"36051","Livingston County, New York",63591,59510,57714,1638,118,824,30,2328,90.8,2.6,0.2,1.3,0,3.7,9.2,24176,18054,6122,74.68,25.32,1311,16743,397,5725,1708,22468,7.3,6.5,7.1,"Less than 25% P.O.C.","$52000 - $60000"
"36053","Madison County, New York",71205,61633,66285,1189,334,638,79,1572,93.1,1.7,0.5,0.9,0.1,2.2,6.9,25877,20016,5861,77.35,22.65,1515,18501,346,5515,1861,24016,7.6,5.9,7.2,"Less than 25% P.O.C.","$60000 or more"
"36055","Monroe County, New York",743341,60075,524588,107602,1303,26669,136,65176,70.6,14.5,0.2,3.6,0,8.8,29.4,301948,191783,110165,63.52,36.48,14032,177751,6600,103565,20632,281316,7.3,6,6.8,"25% - 50% P.O.C.","$60000 or more"
"36057","Montgomery County, New York",49302,49462,40068,933,73,339,0,6950,81.3,1.9,0.1,0.7,0,14.1,18.7,19660,13455,6205,68.44,31.56,1095,12360,580,5625,1675,17985,8.1,9.3,8.5,"Less than 25% P.O.C.","$44000 - $52000"
"36059","Nassau County, New York",1356509,116100,813683,151233,1681,130277,212,229281,60,11.1,0.1,9.6,0,16.9,40,446977,360578,86399,80.67,19.33,54066,306512,11497,74902,65563,381414,15,13.3,14.7,"25% - 50% P.O.C.","$60000 or more"
"36061","New York County, New York",1631993,86553,765627,203590,1922,196688,506,421540,46.9,12.5,0.1,12.1,0,25.8,53.1,759460,182796,576664,24.07,75.93,6145,176651,22720,553944,28865,730595,3.4,3.9,3.8,"50% - 75% P.O.C.","$60000 or more"
"36063","Niagara County, New York",210820,55522,180115,14534,2063,2327,52,6364,85.4,6.9,1,1.1,0,3,14.6,88519,62543,25976,70.65,29.35,4709,57834,1491,24485,6200,82319,7.5,5.7,7,"Less than 25% P.O.C.","$52000 - $60000"
"36065","Oneida County, New York",229959,56027,188592,13067,472,9257,70,13276,82,5.7,0.2,4,0,5.8,18,89729,60547,29182,67.48,32.52,4978,55569,2612,26570,7590,82139,8.2,9,8.5,"Less than 25% P.O.C.","$52000 - $60000"
"36067","Onondaga County, New York",462872,61359,355699,50189,2290,17003,95,22734,76.8,10.8,0.5,3.7,0,4.9,23.2,185324,119871,65453,64.68,35.32,9622,110249,4291,61162,13913,171411,8,6.6,7.5,"Less than 25% P.O.C.","$60000 or more"
"36069","Ontario County, New York",109511,64944,98384,2358,263,1501,36,5195,89.8,2.2,0.2,1.4,0,4.7,10.2,44787,33054,11733,73.8,26.2,2638,30416,597,11136,3235,41552,8,5.1,7.2,"Less than 25% P.O.C.","$60000 or more"
"36071","Orange County, New York",380085,79944,244179,37989,887,10167,111,77882,64.2,10,0.2,2.7,0,20.5,35.8,128016,85584,42432,66.85,33.15,11377,74207,5458,36974,16835,111181,13.3,12.9,13.2,"25% - 50% P.O.C.","$60000 or more"
"36073","Orleans County, New York",40904,52620,35328,2305,136,228,0,2012,86.4,5.6,0.3,0.6,0,4.9,13.6,16563,12520,4043,75.59,24.41,1242,11278,278,3765,1520,15043,9.9,6.9,9.2,"Less than 25% P.O.C.","$52000 - $60000"
"36075","Oswego County, New York",118339,55967,111284,1137,148,780,11,3068,94,1,0.1,0.7,0,2.6,6,46079,33965,12114,73.71,26.29,2933,31032,1263,10851,4196,41883,8.6,10.4,9.1,"Less than 25% P.O.C.","$52000 - $60000"
"36077","Otsego County, New York",59972,54028,54652,1094,47,790,6,2211,91.1,1.8,0.1,1.3,0,3.7,8.9,23409,16892,6517,72.16,27.84,1083,15809,402,6115,1485,21924,6.4,6.2,6.3,"Less than 25% P.O.C.","$52000 - $60000"
"36079","Putnam County, New York",98787,104486,77760,2698,91,2016,23,14787,78.7,2.7,0.1,2,0,15,21.3,34854,28513,6341,81.81,18.19,2631,25882,598,5743,3229,31625,9.2,9.4,9.3,"Less than 25% P.O.C.","$60000 or more"
"36081","Queens County, New York",2287388,68666,572903,393740,5270,579731,820,641496,25,17.2,0.2,25.3,0,28,75,778932,348732,430200,44.77,55.23,54463,294269,46827,383373,101290,677642,15.6,10.9,13,"75% or more P.O.C.","$60000 or more"
"36083","Rensselaer County, New York",159185,68991,132458,9519,113,4260,2,7842,83.2,6,0.1,2.7,0,4.9,16.8,64906,40771,24135,62.82,37.18,3135,37636,1229,22906,4364,60542,7.7,5.1,6.7,"Less than 25% P.O.C.","$60000 or more"
"36085","Richmond County, New York",474893,82783,289751,44472,474,43779,126,87576,61,9.4,0.1,9.2,0,18.4,39,166246,115265,50981,69.33,30.67,17538,97727,5220,45761,22758,143488,15.2,10.2,13.7,"25% - 50% P.O.C.","$60000 or more"
"36087","Rockland County, New York",324422,93024,204815,36699,368,18984,14,57447,63.1,11.3,0.1,5.9,0,17.7,36.9,100438,68591,31847,68.29,31.71,11492,57099,6856,24991,18348,82090,16.8,21.5,18.3,"25% - 50% P.O.C.","$60000 or more"
"36089","St. Lawrence County, New York",108913,50940,100169,2424,818,1076,60,2565,92,2.2,0.8,1,0.1,2.4,8,41933,30596,11337,72.96,27.04,2846,27750,748,10589,3594,38339,9.3,6.6,8.6,"Less than 25% P.O.C.","$44000 - $52000"
"36091","Saratoga County, New York",228502,84291,206462,3497,445,6651,27,7337,90.4,1.5,0.2,2.9,0,3.2,9.6,94406,68158,26248,72.2,27.8,5599,62559,985,25263,6584,87822,8.2,3.8,7,"Less than 25% P.O.C.","$60000 or more"
"36093","Schenectady County, New York",154859,65499,112420,14623,335,6853,84,10932,72.6,9.4,0.2,4.4,0.1,7.1,27.4,54302,35654,18648,65.66,34.34,2528,33126,882,17766,3410,50892,7.1,4.7,6.3,"25% - 50% P.O.C.","$60000 or more"
"36095","Schoharie County, New York",31222,57714,29089,422,48,275,7,998,93.2,1.4,0.2,0.9,0,3.2,6.8,12559,9522,3037,75.82,24.18,620,8902,206,2831,826,11733,6.5,6.8,6.6,"Less than 25% P.O.C.","$52000 - $60000"
"36097","Schuyler County, New York",17920,52327,17016,148,14,126,0,333,95,0.8,0.1,0.7,0,1.9,5,7324,5505,1819,75.16,24.84,350,5155,109,1710,459,6865,6.4,6,6.3,"Less than 25% P.O.C.","$52000 - $60000"
"36099","Seneca County, New York",34390,54545,30611,1636,143,285,8,1199,89,4.8,0.4,0.8,0,3.5,11,13564,10022,3542,73.89,26.11,898,9124,181,3361,1079,12485,9,5.1,8,"Less than 25% P.O.C.","$52000 - $60000"
"36101","Steuben County, New York",96422,53663,90220,1510,103,1480,3,1588,93.6,1.6,0.1,1.5,0,1.6,6.4,39861,28995,10866,72.74,27.26,2249,26746,728,10138,2977,36884,7.8,6.7,7.5,"Less than 25% P.O.C.","$52000 - $60000"
"36103","Suffolk County, New York",1483832,101031,1002590,107713,2367,57564,306,286577,67.6,7.3,0.2,3.9,0,19.3,32.4,489301,394236,95065,80.57,19.43,53804,340432,10323,84742,64127,425174,13.6,10.9,13.1,"25% - 50% P.O.C.","$60000 or more"
"36105","Sullivan County, New York",75116,57426,53719,5560,173,1225,0,12009,71.5,7.4,0.2,1.6,0,16,28.5,28184,19255,8929,68.32,31.68,1393,17862,899,8030,2292,25892,7.2,10.1,8.1,"25% - 50% P.O.C.","$52000 - $60000"
"36107","Tioga County, New York",48686,62999,46251,300,99,374,0,948,95,0.6,0.2,0.8,0,1.9,5,20030,15409,4621,76.93,23.07,1460,13949,257,4364,1717,18313,9.5,5.6,8.6,"Less than 25% P.O.C.","$60000 or more"
"36109","Tompkins County, New York",102642,60240,79161,3575,148,9851,57,5294,77.1,3.5,0.1,9.6,0.1,5.2,22.9,39618,21755,17863,54.91,45.09,1251,20504,829,17034,2080,37538,5.8,4.6,5.3,"Less than 25% P.O.C.","$60000 or more"
"36111","Ulster County, New York",178665,64304,141235,9846,177,3327,102,18237,79.1,5.5,0.1,1.9,0.1,10.2,20.9,69320,47321,21999,68.26,31.74,3328,43993,1159,20840,4487,64833,7,5.3,6.5,"Less than 25% P.O.C.","$60000 or more"
"36113","Warren County, New York",64276,61024,60271,769,172,633,36,1646,93.8,1.2,0.3,1,0.1,2.6,6.2,28015,19820,8195,70.75,29.25,1152,18668,496,7699,1648,26367,5.8,6.1,5.9,"Less than 25% P.O.C.","$60000 or more"
"36115","Washington County, New York",61616,57258,56881,1718,190,371,7,1691,92.3,2.8,0.3,0.6,0,2.7,7.7,24014,17782,6232,74.05,25.95,1168,16614,408,5824,1576,22438,6.6,6.5,6.6,"Less than 25% P.O.C.","$52000 - $60000"
"36117","Wayne County, New York",90519,59449,81402,2459,113,710,105,3992,89.9,2.7,0.1,0.8,0.1,4.4,10.1,36720,28071,8649,76.45,23.55,2532,25539,757,7892,3289,33431,9,8.8,9,"Less than 25% P.O.C.","$52000 - $60000"
"36119","Westchester County, New York",968890,96610,518150,130137,1571,57394,154,239034,53.5,13.4,0.2,5.9,0,24.7,46.5,349292,214474,134818,61.4,38.6,21872,192602,12705,122113,34577,314715,10.2,9.4,9.9,"25% - 50% P.O.C.","$60000 or more"
"36121","Wyoming County, New York",40305,58052,36239,1593,189,167,0,1326,89.9,4,0.5,0.4,0,3.3,10.1,15917,12241,3676,76.91,23.09,1151,11090,248,3428,1399,14518,9.4,6.7,8.8,"Less than 25% P.O.C.","$52000 - $60000"
"36123","Yates County, New York",25011,56563,23688,240,21,163,6,556,94.7,1,0.1,0.7,0,2.2,5.3,8919,7137,1782,80.02,19.98,749,6388,187,1595,936,7983,10.5,10.5,10.5,"Less than 25% P.O.C.","$52000 - $60000"
"37001","Alamance County, North Carolina",163324,49688,104623,31676,453,2546,66,20511,64.1,19.4,0.3,1.6,0,12.6,35.9,64439,41994,22445,65.17,34.83,3391,38603,1805,20640,5196,59243,8.1,8,8.1,"25% - 50% P.O.C.","$44000 - $52000"
"37003","Alexander County, North Carolina",37213,48756,32297,2173,138,389,0,1743,86.8,5.8,0.4,1,0,4.7,13.2,14169,10728,3441,75.71,24.29,743,9985,535,2906,1278,12891,6.9,15.5,9,"Less than 25% P.O.C.","$44000 - $52000"
"37005","Alleghany County, North Carolina",11008,37830,9564,260,42,46,1,1066,86.9,2.4,0.4,0.4,0,9.7,13.1,4920,3752,1168,76.26,23.74,161,3591,106,1062,267,4653,4.3,9.1,5.4,"Less than 25% P.O.C.","Less than $44000"
"37007","Anson County, North Carolina",24902,40213,11106,12016,65,331,8,1005,44.6,48.3,0.3,1.3,0,4,55.4,9521,6297,3224,66.14,33.86,378,5919,300,2924,678,8843,6,9.3,7.1,"50% - 75% P.O.C.","Less than $44000"
"37009","Ashe County, North Carolina",26863,40962,24853,197,110,113,26,1330,92.5,0.7,0.4,0.4,0.1,5,7.5,11938,9056,2882,75.86,24.14,587,8469,72,2810,659,11279,6.5,2.5,5.5,"Less than 25% P.O.C.","Less than $44000"
"37011","Avery County, North Carolina",17506,40340,15534,684,231,77,4,886,88.7,3.9,1.3,0.4,0,5.1,11.3,6551,4930,1621,75.26,24.74,271,4659,94,1527,365,6186,5.5,5.8,5.6,"Less than 25% P.O.C.","Less than $44000"
"37013","Beaufort County, North Carolina",47168,45212,31047,11723,124,52,0,3658,65.8,24.9,0.3,0.1,0,7.8,34.2,19701,13765,5936,69.87,30.13,839,12926,308,5628,1147,18554,6.1,5.2,5.8,"25% - 50% P.O.C.","$44000 - $52000"
"37015","Bertie County, North Carolina",19380,35527,6696,11849,111,151,1,413,34.6,61.1,0.6,0.8,0,2.1,65.4,7909,5887,2022,74.43,25.57,202,5685,146,1876,348,7561,3.4,7.2,4.4,"50% - 75% P.O.C.","Less than $44000"
"37017","Bladen County, North Carolina",33407,36173,18290,11493,841,50,0,2499,54.7,34.4,2.5,0.1,0,7.5,45.3,13636,9732,3904,71.37,28.63,623,9109,287,3617,910,12726,6.4,7.4,6.7,"25% - 50% P.O.C.","Less than $44000"
"37019","Brunswick County, North Carolina",131815,58236,107968,12754,872,766,9,6339,81.9,9.7,0.7,0.6,0,4.8,18.1,56056,45223,10833,80.67,19.33,1767,43456,711,10122,2478,53578,3.9,6.6,4.4,"Less than 25% P.O.C.","$52000 - $60000"
"37021","Buncombe County, North Carolina",256886,52207,214615,15988,1038,3189,354,16889,83.5,6.2,0.4,1.2,0.1,6.6,16.5,107479,68139,39340,63.4,36.6,3501,64638,1899,37441,5400,102079,5.1,4.8,5,"Less than 25% P.O.C.","$52000 - $60000"
"37023","Burke County, North Carolina",89968,44557,73375,5442,371,3252,114,5498,81.6,6,0.4,3.6,0.1,6.1,18.4,35156,25993,9163,73.94,26.06,2083,23910,910,8253,2993,32163,8,9.9,8.5,"Less than 25% P.O.C.","$44000 - $52000"
"37025","Cabarrus County, North Carolina",206615,67328,135523,36048,658,7700,142,21570,65.6,17.4,0.3,3.7,0.1,10.4,34.4,72238,51626,20612,71.47,28.53,4885,46741,2325,18287,7210,65028,9.5,11.3,10,"25% - 50% P.O.C.","$60000 or more"
"37027","Caldwell County, North Carolina",81884,44511,71489,3726,299,415,36,4488,87.3,4.6,0.4,0.5,0,5.5,12.7,32864,23819,9045,72.48,27.52,1761,22058,758,8287,2519,30345,7.4,8.4,7.7,"Less than 25% P.O.C.","$44000 - $52000"
"37029","Camden County, North Carolina",10551,64572,8489,1460,0,189,13,308,80.5,13.8,0,1.8,0.1,2.9,19.5,3933,3221,712,81.9,18.1,304,2917,130,582,434,3499,9.4,18.3,11,"Less than 25% P.O.C.","$60000 or more"
"37031","Carteret County, North Carolina",69070,57194,59661,3667,206,808,40,2966,86.4,5.3,0.3,1.2,0.1,4.3,13.6,29755,21590,8165,72.56,27.44,1065,20525,480,7685,1545,28210,4.9,5.9,5.2,"Less than 25% P.O.C.","$52000 - $60000"
"37033","Caswell County, North Carolina",22684,45733,13876,7421,48,152,22,915,61.2,32.7,0.2,0.7,0.1,4,38.8,9145,6990,2155,76.44,23.56,467,6523,247,1908,714,8431,6.7,11.5,7.8,"25% - 50% P.O.C.","$44000 - $52000"
"37035","Catawba County, North Carolina",157613,52056,119056,12697,349,6786,0,15257,75.5,8.1,0.2,4.3,0,9.7,24.5,62319,43246,19073,69.39,30.61,3400,39846,1577,17496,4977,57342,7.9,8.3,8,"Less than 25% P.O.C.","$52000 - $60000"
"37037","Chatham County, North Carolina",71338,67031,51146,7898,63,1068,48,8707,71.7,11.1,0.1,1.5,0.1,12.2,28.3,29033,22167,6866,76.35,23.65,1306,20861,556,6310,1862,27171,5.9,8.1,6.4,"25% - 50% P.O.C.","$60000 or more"
"37039","Cherokee County, North Carolina",27969,41438,25450,348,427,203,0,881,91,1.2,1.5,0.7,0,3.1,9,12471,9856,2615,79.03,20.97,559,9297,299,2316,858,11613,5.7,11.4,6.9,"Less than 25% P.O.C.","Less than $44000"
"37041","Chowan County, North Carolina",14097,46519,8449,4962,60,0,0,520,59.9,35.2,0.4,0,0,3.7,40.1,6133,4092,2041,66.72,33.28,137,3955,156,1885,293,5840,3.3,7.6,4.8,"25% - 50% P.O.C.","$44000 - $52000"
"37043","Clay County, North Carolina",10946,42222,10224,228,43,22,17,364,93.4,2.1,0.4,0.2,0.2,3.3,6.6,4996,3895,1101,77.96,22.04,93,3802,2,1099,95,4901,2.4,0.2,1.9,"Less than 25% P.O.C.","Less than $44000"
"37045","Cleveland County, North Carolina",97282,42247,70925,20350,256,1006,0,3423,72.9,20.9,0.3,1,0,3.5,27.1,35638,24156,11482,67.78,32.22,1912,22244,1038,10444,2950,32688,7.9,9,8.3,"25% - 50% P.O.C.","Less than $44000"
"37047","Columbus County, North Carolina",56068,37628,33257,16813,1904,228,8,2983,59.3,30,3.4,0.4,0,5.3,40.7,21580,15637,5943,72.46,27.54,1217,14420,439,5504,1656,19924,7.8,7.4,7.7,"25% - 50% P.O.C.","Less than $44000"
"37049","Craven County, North Carolina",102491,52687,67517,21907,587,2807,112,7469,65.9,21.4,0.6,2.7,0.1,7.3,34.1,41226,25944,15282,62.93,37.07,1789,24155,1626,13656,3415,37811,6.9,10.6,8.3,"25% - 50% P.O.C.","$52000 - $60000"
"37051","Cumberland County, North Carolina",332861,46875,144661,119718,4374,7965,874,38555,43.5,36,1.3,2.4,0.3,11.6,56.5,125427,63624,61803,50.73,49.27,5677,57947,4535,57268,10212,115215,8.9,7.3,8.1,"50% - 75% P.O.C.","$44000 - $52000"
"37053","Currituck County, North Carolina",26363,69964,22990,1457,87,110,6,1048,87.2,5.5,0.3,0.4,0,4,12.8,10522,8626,1896,81.98,18.02,1003,7623,297,1599,1300,9222,11.6,15.7,12.4,"Less than 25% P.O.C.","$60000 or more"
"37055","Dare County, North Carolina",36222,59381,31609,919,138,279,12,2714,87.3,2.5,0.4,0.8,0,7.5,12.7,15529,11551,3978,74.38,25.62,593,10958,237,3741,830,14699,5.1,6,5.3,"Less than 25% P.O.C.","$52000 - $60000"
"37057","Davidson County, North Carolina",165381,49546,132598,15129,441,2536,16,11754,80.2,9.1,0.3,1.5,0,7.1,19.8,66653,46531,20122,69.81,30.19,3230,43301,1949,18173,5179,61474,6.9,9.7,7.8,"Less than 25% P.O.C.","$44000 - $52000"
"37059","Davie County, North Carolina",42257,60434,35669,2094,126,300,0,2875,84.4,5,0.3,0.7,0,6.8,15.6,16405,13084,3321,79.76,20.24,736,12348,536,2785,1272,15133,5.6,16.1,7.8,"Less than 25% P.O.C.","$60000 or more"
"37061","Duplin County, North Carolina",58967,41764,30404,13915,263,223,48,13072,51.6,23.6,0.4,0.4,0.1,22.2,48.4,21466,15106,6360,70.37,29.63,1224,13882,753,5607,1977,19489,8.1,11.8,9.2,"25% - 50% P.O.C.","Less than $44000"
"37063","Durham County, North Carolina",311848,60958,132449,111903,661,15192,129,42079,42.5,35.9,0.2,4.9,0,13.5,57.5,125953,68460,57493,54.35,45.65,4792,63668,4015,53478,8807,117146,7,7,7,"50% - 75% P.O.C.","$60000 or more"
"37065","Edgecombe County, North Carolina",52648,36866,19065,30251,70,113,62,2415,36.2,57.5,0.1,0.2,0.1,4.6,63.8,21151,12436,8715,58.8,41.2,990,11446,894,7821,1884,19267,8,10.3,8.9,"50% - 75% P.O.C.","Less than $44000"
"37067","Forsyth County, North Carolina",375195,51569,212708,96298,1140,8752,153,48057,56.7,25.7,0.3,2.3,0,12.8,43.3,146816,90399,56417,61.57,38.43,7397,83002,4346,52071,11743,135073,8.2,7.7,8,"25% - 50% P.O.C.","$44000 - $52000"
"37069","Franklin County, North Carolina",66362,55193,42120,16456,258,326,2,5587,63.5,24.8,0.4,0.5,0,8.4,36.5,25381,18729,6652,73.79,26.21,1365,17364,812,5840,2177,23204,7.3,12.2,8.6,"25% - 50% P.O.C.","$52000 - $60000"
"37071","Gaston County, North Carolina",219271,52835,158895,35454,618,3346,131,15368,72.5,16.2,0.3,1.5,0.1,7,27.5,83735,54654,29081,65.27,34.73,4415,50239,2411,26670,6826,76909,8.1,8.3,8.2,"25% - 50% P.O.C.","$52000 - $60000"
"37073","Gates County, North Carolina",11548,50750,7305,3859,109,61,0,11,63.3,33.4,0.9,0.5,0,0.1,36.7,4638,3596,1042,77.53,22.47,168,3428,48,994,216,4422,4.7,4.6,4.7,"25% - 50% P.O.C.","$44000 - $52000"
"37075","Graham County, North Carolina",8509,39571,7368,17,859,0,1,178,86.6,0.2,10.1,0,0,2.1,13.4,3393,2817,576,83.02,16.98,140,2677,62,514,202,3191,5,10.8,6,"Less than 25% P.O.C.","Less than $44000"
"37077","Granville County, North Carolina",59328,55856,34408,17667,220,312,42,4715,58,29.8,0.4,0.5,0.1,7.9,42,21400,15440,5960,72.15,27.85,1329,14111,366,5594,1695,19705,8.6,6.1,7.9,"25% - 50% P.O.C.","$52000 - $60000"
"37079","Greene County, North Carolina",21033,39837,9835,7289,93,17,7,3173,46.8,34.7,0.4,0.1,0,15.1,53.2,7164,5063,2101,70.67,29.33,500,4563,186,1915,686,6478,9.9,8.9,9.6,"50% - 75% P.O.C.","Less than $44000"
"37081","Guilford County, North Carolina",527868,53261,265781,177002,2147,26004,240,42071,50.3,33.5,0.4,4.9,0,8,49.7,203987,119903,84084,58.78,41.22,9683,110220,6292,77792,15975,188012,8.1,7.5,7.8,"25% - 50% P.O.C.","$52000 - $60000"
"37083","Halifax County, North Carolina",51190,35502,19657,26931,1800,374,74,1475,38.4,52.6,3.5,0.7,0.1,2.9,61.6,21017,13162,7855,62.63,37.37,855,12307,765,7090,1620,19397,6.5,9.7,7.7,"50% - 75% P.O.C.","Less than $44000"
"37085","Harnett County, North Carolina",132283,53554,81138,27004,1035,1382,198,16889,61.3,20.4,0.8,1,0.1,12.8,38.7,45416,29688,15728,65.37,34.63,2932,26756,2223,13505,5155,40261,9.9,14.1,11.4,"25% - 50% P.O.C.","$52000 - $60000"
"37087","Haywood County, North Carolina",61053,51659,56545,572,262,355,0,2425,92.6,0.9,0.4,0.6,0,4,7.4,26653,19465,7188,73.03,26.97,944,18521,456,6732,1400,25253,4.8,6.3,5.3,"Less than 25% P.O.C.","$44000 - $52000"
"37089","Henderson County, North Carolina",114913,55945,95501,3859,425,1489,0,11575,83.1,3.4,0.4,1.3,0,10.1,16.9,49221,36101,13120,73.34,26.66,2215,33886,658,12462,2873,46348,6.1,5,5.8,"Less than 25% P.O.C.","$52000 - $60000"
"37091","Hertford County, North Carolina",24012,41028,7984,14090,271,184,38,921,33.3,58.7,1.1,0.8,0.2,3.8,66.7,8845,5821,3024,65.81,34.19,316,5505,253,2771,569,8276,5.4,8.4,6.4,"50% - 75% P.O.C.","Less than $44000"
"37093","Hoke County, North Carolina",53957,48072,21519,17834,4219,816,44,7198,39.9,33.1,7.8,1.5,0.1,13.3,60.1,17799,11936,5863,67.06,32.94,1230,10706,674,5189,1904,15895,10.3,11.5,10.7,"50% - 75% P.O.C.","$44000 - $52000"
"37095","Hyde County, North Carolina",5213,39663,3069,1547,6,0,0,539,58.9,29.7,0.1,0,0,10.3,41.1,1947,1320,627,67.8,32.2,37,1283,126,501,163,1784,2.8,20.1,8.4,"25% - 50% P.O.C.","Less than $44000"
"37097","Iredell County, North Carolina",175538,60955,133370,20854,259,4340,0,13386,76,11.9,0.1,2.5,0,7.6,24,66369,47962,18407,72.27,27.73,4260,43702,1669,16738,5929,60440,8.9,9.1,8.9,"Less than 25% P.O.C.","$60000 or more"
"37099","Jackson County, North Carolina",42938,47252,34635,928,3283,302,0,2552,80.7,2.2,7.6,0.7,0,5.9,19.3,16773,10785,5988,64.3,35.7,641,10144,421,5567,1062,15711,5.9,7,6.3,"Less than 25% P.O.C.","$44000 - $52000"
"37101","Johnston County, North Carolina",196870,59865,133478,30421,899,1242,69,26781,67.8,15.5,0.5,0.6,0,13.6,32.2,68968,50336,18632,72.98,27.02,5505,44831,2270,16362,7775,61193,10.9,12.2,11.3,"25% - 50% P.O.C.","$52000 - $60000"
"37103","Jones County, North Carolina",9594,38158,6003,2913,88,8,0,443,62.6,30.4,0.9,0.1,0,4.6,37.4,4045,2966,1079,73.33,26.67,146,2820,105,974,251,3794,4.9,9.7,6.2,"25% - 50% P.O.C.","Less than $44000"
"37105","Lee County, North Carolina",60481,49994,35156,11792,442,726,31,11584,58.1,19.5,0.7,1.2,0.1,19.2,41.9,21894,14601,7293,66.69,33.31,1293,13308,650,6643,1943,19951,8.9,8.9,8.9,"25% - 50% P.O.C.","$44000 - $52000"
"37107","Lenoir County, North Carolina",56756,39402,27933,21943,106,279,14,4414,49.2,38.7,0.2,0.5,0,7.8,50.8,23148,13738,9410,59.35,40.65,911,12827,864,8546,1775,21373,6.6,9.2,7.7,"50% - 75% P.O.C.","Less than $44000"
"37109","Lincoln County, North Carolina",82919,57536,70326,4099,160,593,42,6014,84.8,4.9,0.2,0.7,0.1,7.3,15.2,32894,25132,7762,76.4,23.6,1851,23281,559,7203,2410,30484,7.4,7.2,7.3,"Less than 25% P.O.C.","$52000 - $60000"
"37111","McDowell County, North Carolina",45227,43646,39518,1616,155,415,0,2766,87.4,3.6,0.3,0.9,0,6.1,12.6,18173,13206,4967,72.67,27.33,1040,12166,459,4508,1499,16674,7.9,9.2,8.2,"Less than 25% P.O.C.","Less than $44000"
"37113","Macon County, North Carolina",34813,45507,30998,541,240,302,0,2440,89,1.6,0.7,0.9,0,7,11,15921,11605,4316,72.89,27.11,565,11040,295,4021,860,15061,4.9,6.8,5.4,"Less than 25% P.O.C.","$44000 - $52000"
"37115","Madison County, North Carolina",21499,45873,20218,335,57,125,0,523,94,1.6,0.3,0.6,0,2.4,6,8403,6227,2176,74.1,25.9,393,5834,140,2036,533,7870,6.3,6.4,6.3,"Less than 25% P.O.C.","$44000 - $52000"
"37117","Martin County, North Carolina",22849,40090,11895,9605,54,139,0,911,52.1,42,0.2,0.6,0,4,47.9,9378,6375,3003,67.98,32.02,256,6119,229,2774,485,8893,4,7.6,5.2,"25% - 50% P.O.C.","Less than $44000"
"37119","Mecklenburg County, North Carolina",1074475,66641,503210,333294,2828,62551,514,142472,46.8,31,0.3,5.8,0,13.3,53.2,411097,231784,179313,56.38,43.62,18407,213377,11881,167432,30288,380809,7.9,6.6,7.4,"50% - 75% P.O.C.","$60000 or more"
"37121","Mitchell County, North Carolina",15004,46103,13803,51,21,27,0,837,92,0.3,0.1,0.2,0,5.6,8,6344,4949,1395,78.01,21.99,294,4655,132,1263,426,5918,5.9,9.5,6.7,"Less than 25% P.O.C.","$44000 - $52000"
"37123","Montgomery County, North Carolina",27252,44146,17241,4793,82,393,0,4184,63.3,17.6,0.3,1.4,0,15.4,36.7,10195,7626,2569,74.8,25.2,438,7188,301,2268,739,9456,5.7,11.7,7.2,"25% - 50% P.O.C.","$44000 - $52000"
"37125","Moore County, North Carolina",97294,59963,74994,11970,795,1239,68,6544,77.1,12.3,0.8,1.3,0.1,6.7,22.9,39821,30143,9678,75.7,24.3,2034,28109,643,9035,2677,37144,6.7,6.6,6.7,"Less than 25% P.O.C.","$52000 - $60000"
"37127","Nash County, North Carolina",94030,49537,46906,36866,570,772,29,6569,49.9,39.2,0.6,0.8,0,7,50.1,37011,24181,12830,65.33,34.67,2520,21661,822,12008,3342,33669,10.4,6.4,9,"50% - 75% P.O.C.","$44000 - $52000"
"37129","New Hanover County, North Carolina",227938,54891,175756,30666,508,2972,199,12657,77.1,13.5,0.2,1.3,0.1,5.6,22.9,95638,55525,40113,58.06,41.94,2942,52583,1790,38323,4732,90906,5.3,4.5,4.9,"Less than 25% P.O.C.","$52000 - $60000"
"37131","Northampton County, North Carolina",19946,37146,7726,11233,59,56,0,453,38.7,56.3,0.3,0.3,0,2.3,61.3,8547,5842,2705,68.35,31.65,307,5535,138,2567,445,8102,5.3,5.1,5.2,"50% - 75% P.O.C.","Less than $44000"
"37133","Onslow County, North Carolina",195069,50278,129013,25914,689,4075,257,24543,66.1,13.3,0.4,2.1,0.1,12.6,33.9,64386,34160,30226,53.06,46.94,2954,31206,2855,27371,5809,58577,8.6,9.4,9,"25% - 50% P.O.C.","$44000 - $52000"
"37135","Orange County, North Carolina",144836,71723,100490,16186,723,11223,9,12236,69.4,11.2,0.5,7.7,0,8.4,30.6,53376,33436,19940,62.64,37.36,2447,30989,1123,18817,3570,49806,7.3,5.6,6.7,"25% - 50% P.O.C.","$60000 or more"
"37137","Pamlico County, North Carolina",12701,46728,9426,2319,23,77,0,493,74.2,18.3,0.2,0.6,0,3.9,25.8,5416,4206,1210,77.66,22.34,203,4003,109,1101,312,5104,4.8,9,5.8,"25% - 50% P.O.C.","$44000 - $52000"
"37139","Pasquotank County, North Carolina",39514,50558,21636,14389,27,465,0,2123,54.8,36.4,0.1,1.2,0,5.4,45.2,14697,8764,5933,59.63,40.37,541,8223,609,5324,1150,13547,6.2,10.3,7.8,"25% - 50% P.O.C.","$44000 - $52000"
"37141","Pender County, North Carolina",60399,57240,45342,8612,196,244,51,4263,75.1,14.3,0.3,0.4,0.1,7.1,24.9,21740,17654,4086,81.21,18.79,1347,16307,468,3618,1815,19925,7.6,11.5,8.3,"Less than 25% P.O.C.","$52000 - $60000"
"37143","Perquimans County, North Carolina",13430,47162,9709,3107,42,48,14,349,72.3,23.1,0.3,0.4,0.1,2.6,27.7,5936,4473,1463,75.35,24.65,292,4181,137,1326,429,5507,6.5,9.4,7.2,"25% - 50% P.O.C.","$44000 - $52000"
"37145","Person County, North Carolina",39345,51020,26124,10252,156,129,21,1691,66.4,26.1,0.4,0.3,0.1,4.3,33.6,15896,12152,3744,76.45,23.55,783,11369,305,3439,1088,14808,6.4,8.1,6.8,"25% - 50% P.O.C.","$44000 - $52000"
"37147","Pitt County, North Carolina",178433,47437,97088,61407,482,3106,102,11168,54.4,34.4,0.3,1.7,0.1,6.3,45.6,69799,36378,33421,52.12,47.88,2739,33639,2271,31150,5010,64789,7.5,6.8,7.2,"25% - 50% P.O.C.","$44000 - $52000"
"37149","Polk County, North Carolina",20557,48787,17608,995,64,136,0,1204,85.7,4.8,0.3,0.7,0,5.9,14.3,9071,6714,2357,74.02,25.98,381,6333,128,2229,509,8562,5.7,5.4,5.6,"Less than 25% P.O.C.","$44000 - $52000"
"37151","Randolph County, North Carolina",143118,47288,113095,8157,556,1735,14,16361,79,5.7,0.4,1.2,0,11.4,21,56541,40599,15942,71.8,28.2,3285,37314,1805,14137,5090,51451,8.1,11.3,9,"Less than 25% P.O.C.","$44000 - $52000"
"37153","Richmond County, North Carolina",44997,36148,25675,14306,1075,424,0,2914,57.1,31.8,2.4,0.9,0,6.5,42.9,18380,12162,6218,66.17,33.83,642,11520,451,5767,1093,17287,5.3,7.3,5.9,"25% - 50% P.O.C.","Less than $44000"
"37155","Robeson County, North Carolina",132596,34976,33332,31370,52500,784,34,11774,25.1,23.7,39.6,0.6,0,8.9,74.9,45927,30128,15799,65.6,34.4,2969,27159,1686,14113,4655,41272,9.9,10.7,10.1,"50% - 75% P.O.C.","Less than $44000"
"37157","Rockingham County, North Carolina",91077,43579,65897,16592,296,503,22,5560,72.4,18.2,0.3,0.6,0,6.1,27.6,37388,26008,11380,69.56,30.44,1701,24307,878,10502,2579,34809,6.5,7.7,6.9,"25% - 50% P.O.C.","Less than $44000"
"37159","Rowan County, North Carolina",140296,49842,101067,22033,402,1216,19,12381,72,15.7,0.3,0.9,0,8.8,28,52843,36621,16222,69.3,30.7,3032,33589,2035,14187,5067,47776,8.3,12.5,9.6,"25% - 50% P.O.C.","$44000 - $52000"
"37161","Rutherford County, North Carolina",66599,42608,55473,6338,298,282,16,2941,83.3,9.5,0.4,0.4,0,4.4,16.7,26683,19088,7595,71.54,28.46,1191,17897,826,6769,2017,24666,6.2,10.9,7.6,"Less than 25% P.O.C.","Less than $44000"
"37163","Sampson County, North Carolina",63385,42151,32319,15898,1008,356,0,12445,51,25.1,1.6,0.6,0,19.6,49,23416,16228,7188,69.3,30.7,1703,14525,749,6439,2452,20964,10.5,10.4,10.5,"25% - 50% P.O.C.","Less than $44000"
"37165","Scotland County, North Carolina",35076,37238,15148,13627,4141,284,0,1053,43.2,38.8,11.8,0.8,0,3,56.8,12922,7817,5105,60.49,39.51,668,7149,546,4559,1214,11708,8.5,10.7,9.4,"50% - 75% P.O.C.","Less than $44000"
"37167","Stanly County, North Carolina",61588,52623,49777,6894,73,1104,0,2590,80.8,11.2,0.1,1.8,0,4.2,19.2,23332,17355,5977,74.38,25.62,1602,15753,569,5408,2171,21161,9.2,9.5,9.3,"Less than 25% P.O.C.","$52000 - $60000"
"37169","Stokes County, North Carolina",45781,48054,41701,1909,191,167,0,1400,91.1,4.2,0.4,0.4,0,3.1,8.9,19578,15185,4393,77.56,22.44,908,14277,153,4240,1061,18517,6,3.5,5.4,"Less than 25% P.O.C.","$44000 - $52000"
"37171","Surry County, North Carolina",71971,43597,60359,2581,229,409,135,7632,83.9,3.6,0.3,0.6,0.2,10.6,16.1,29153,21416,7737,73.46,26.54,1737,19679,561,7176,2298,26855,8.1,7.3,7.9,"Less than 25% P.O.C.","Less than $44000"
"37173","Swain County, North Carolina",14260,39317,8799,67,3989,54,0,757,61.7,0.5,28,0.4,0,5.3,38.3,5620,4019,1601,71.51,28.49,262,3757,236,1365,498,5122,6.5,14.7,8.9,"25% - 50% P.O.C.","Less than $44000"
"37175","Transylvania County, North Carolina",33775,50212,30528,1560,89,47,17,1124,90.4,4.6,0.3,0.1,0.1,3.3,9.6,14567,11072,3495,76.01,23.99,535,10537,209,3286,744,13823,4.8,6,5.1,"Less than 25% P.O.C.","$44000 - $52000"
"37177","Tyrrell County, North Carolina",4095,35300,2175,1510,37,18,0,284,53.1,36.9,0.9,0.4,0,6.9,46.9,1594,1088,506,68.26,31.74,14,1074,57,449,71,1523,1.3,11.3,4.5,"25% - 50% P.O.C.","Less than $44000"
"37179","Union County, North Carolina",231053,80033,166677,25962,477,6890,82,25731,72.1,11.2,0.2,3,0,11.1,27.9,76346,62093,14253,81.33,18.67,7875,54218,2291,11962,10166,66180,12.7,16.1,13.3,"25% - 50% P.O.C.","$60000 or more"
"37181","Vance County, North Carolina",44479,40529,17620,22103,132,319,25,3466,39.6,49.7,0.3,0.7,0.1,7.8,60.4,16875,9529,7346,56.47,43.53,772,8757,690,6656,1462,15413,8.1,9.4,8.7,"50% - 75% P.O.C.","Less than $44000"
"37183","Wake County, North Carolina",1069079,80591,641723,212353,2726,74111,403,108379,60,19.9,0.3,6.9,0,10.1,40,400172,255708,144464,63.9,36.1,23148,232560,10455,134009,33603,366569,9.1,7.2,8.4,"25% - 50% P.O.C.","$60000 or more"
"37185","Warren County, North Carolina",19898,36466,7629,9965,1009,99,34,750,38.3,50.1,5.1,0.5,0.2,3.8,61.7,7786,5699,2087,73.2,26.8,379,5320,131,1956,510,7276,6.7,6.3,6.6,"50% - 75% P.O.C.","Less than $44000"
"37187","Washington County, North Carolina",11922,35979,5290,5658,22,26,0,622,44.4,47.5,0.2,0.2,0,5.2,55.6,4977,3311,1666,66.53,33.47,116,3195,82,1584,198,4779,3.5,4.9,4,"50% - 75% P.O.C.","Less than $44000"
"37189","Watauga County, North Carolina",54925,47526,50357,954,359,606,53,2009,91.7,1.7,0.7,1.1,0.1,3.7,8.3,21077,12658,8419,60.06,39.94,885,11773,556,7863,1441,19636,7,6.6,6.8,"Less than 25% P.O.C.","$44000 - $52000"
"37191","Wayne County, North Carolina",123603,44416,66033,37509,375,1479,49,14525,53.4,30.3,0.3,1.2,0,11.8,46.6,48343,30032,18311,62.12,37.88,2341,27691,1502,16809,3843,44500,7.8,8.2,7.9,"25% - 50% P.O.C.","$44000 - $52000"
"37193","Wilkes County, North Carolina",68469,44107,59738,2635,217,398,188,4475,87.2,3.8,0.3,0.6,0.3,6.5,12.8,28753,21765,6988,75.7,24.3,1235,20530,628,6360,1863,26890,5.7,9,6.5,"Less than 25% P.O.C.","$44000 - $52000"
"37195","Wilson County, North Carolina",81435,43877,38248,31812,257,675,0,8430,47,39.1,0.3,0.8,0,10.4,53,32014,18918,13096,59.09,40.91,1236,17682,1340,11756,2576,29438,6.5,10.2,8,"50% - 75% P.O.C.","Less than $44000"
"37197","Yadkin County, North Carolina",37602,44682,31691,1243,48,23,28,4163,84.3,3.3,0.1,0.1,0.1,11.1,15.7,15425,11761,3664,76.25,23.75,833,10928,276,3388,1109,14316,7.1,7.5,7.2,"Less than 25% P.O.C.","$44000 - $52000"
"37199","Yancey County, North Carolina",17760,42222,16427,119,72,50,3,917,92.5,0.7,0.4,0.3,0,5.2,7.5,7510,5507,2003,73.33,26.67,338,5169,173,1830,511,6999,6.1,8.6,6.8,"Less than 25% P.O.C.","Less than $44000"
"38001","Adams County, North Dakota",2311,56681,2133,48,24,58,0,39,92.3,2.1,1,2.5,0,1.7,7.7,1035,761,274,73.53,26.47,86,675,8,266,94,941,11.3,2.9,9.1,"Less than 25% P.O.C.","$52000 - $60000"
"38003","Barnes County, North Dakota",10706,58365,9905,239,129,109,7,219,92.5,2.2,1.2,1,0.1,2,7.5,5074,3514,1560,69.26,30.74,341,3173,45,1515,386,4688,9.7,2.9,7.6,"Less than 25% P.O.C.","$52000 - $60000"
"38005","Benson County, North Dakota",6873,47667,2783,3,3771,4,4,64,40.5,0,54.9,0.1,0.1,0.9,59.5,2248,1506,742,66.99,33.01,210,1296,228,514,438,1810,13.9,30.7,19.5,"50% - 75% P.O.C.","$44000 - $52000"
"38007","Billings County, North Dakota",922,75208,895,0,0,0,0,27,97.1,0,0,0,0,2.9,2.9,383,303,80,79.11,20.89,28,275,0,80,28,355,9.2,0,7.3,"Less than 25% P.O.C.","$60000 or more"
"38009","Bottineau County, North Dakota",6502,60381,5939,39,268,7,0,150,91.3,0.6,4.1,0.1,0,2.3,8.7,2992,2376,616,79.41,20.59,173,2203,24,592,197,2795,7.3,3.9,6.6,"Less than 25% P.O.C.","$60000 or more"
"38011","Bowman County, North Dakota",3148,62442,2917,1,26,0,3,172,92.7,0,0.8,0,0.1,5.5,7.3,1350,1017,333,75.33,24.67,81,936,47,286,128,1222,8,14.1,9.5,"Less than 25% P.O.C.","$60000 or more"
"38013","Burke County, North Dakota",2182,77232,2090,5,15,11,0,25,95.8,0.2,0.7,0.5,0,1.1,4.2,905,714,191,78.9,21.1,73,641,12,179,85,820,10.2,6.3,9.4,"Less than 25% P.O.C.","$60000 or more"
"38015","Burleigh County, North Dakota",94793,71524,84282,2090,3693,730,89,2368,88.9,2.2,3.9,0.8,0.1,2.5,11.1,39507,27128,12379,68.67,31.33,2742,24386,435,11944,3177,36330,10.1,3.5,8,"Less than 25% P.O.C.","$60000 or more"
"38017","Cass County, North Dakota",176975,64482,151212,9818,1522,5047,44,4769,85.4,5.5,0.9,2.9,0,2.7,14.6,75843,39536,36307,52.13,47.87,3556,35980,1681,34626,5237,70606,9,4.6,6.9,"Less than 25% P.O.C.","$60000 or more"
"38019","Cavalier County, North Dakota",3803,64798,3608,2,55,0,0,68,94.9,0.1,1.4,0,0,1.8,5.1,1737,1401,336,80.66,19.34,79,1322,8,328,87,1650,5.6,2.4,5,"Less than 25% P.O.C.","$60000 or more"
"38021","Dickey County, North Dakota",4938,65492,4605,65,63,8,0,167,93.3,1.3,1.3,0.2,0,3.4,6.7,2119,1574,545,74.28,25.72,194,1380,42,503,236,1883,12.3,7.7,11.1,"Less than 25% P.O.C.","$60000 or more"
"38023","Divide County, North Dakota",2335,62865,2082,74,29,29,0,100,89.2,3.2,1.2,1.2,0,4.3,10.8,1061,768,293,72.38,27.62,37,731,33,260,70,991,4.8,11.3,6.6,"Less than 25% P.O.C.","$60000 or more"
"38025","Dunn County, North Dakota",4395,76719,3668,75,424,35,9,111,83.5,1.7,9.6,0.8,0.2,2.5,16.5,1692,1303,389,77.01,22.99,118,1185,37,352,155,1537,9.1,9.5,9.2,"Less than 25% P.O.C.","$60000 or more"
"38027","Eddy County, North Dakota",2301,54868,2068,0,122,0,0,29,89.9,0,5.3,0,0,1.3,10.1,1062,754,308,71,29,70,684,2,306,72,990,9.3,0.6,6.8,"Less than 25% P.O.C.","$52000 - $60000"
"38029","Emmons County, North Dakota",3310,55902,3161,0,3,36,0,52,95.5,0,0.1,1.1,0,1.6,4.5,1585,1361,224,85.87,14.13,138,1223,12,212,150,1435,10.1,5.4,9.5,"Less than 25% P.O.C.","$52000 - $60000"
"38031","Foster County, North Dakota",3260,61425,3104,0,46,1,11,35,95.2,0,1.4,0,0.3,1.1,4.8,1423,1056,367,74.21,25.79,137,919,21,346,158,1265,13,5.7,11.1,"Less than 25% P.O.C.","$60000 or more"
"38033","Golden Valley County, North Dakota",1845,58690,1664,0,35,0,0,58,90.2,0,1.9,0,0,3.1,9.8,842,589,253,69.95,30.05,67,522,8,245,75,767,11.4,3.2,8.9,"Less than 25% P.O.C.","$52000 - $60000"
"38035","Grand Forks County, North Dakota",70224,54051,58787,2590,1697,1952,404,3011,83.7,3.7,2.4,2.8,0.6,4.3,16.3,30502,14796,15706,48.51,51.49,1227,13569,700,15006,1927,28575,8.3,4.5,6.3,"Less than 25% P.O.C.","$52000 - $60000"
"38037","Grant County, North Dakota",2353,50938,2250,2,18,28,1,25,95.6,0.1,0.8,1.2,0,1.1,4.4,1074,931,143,86.69,13.31,89,842,9,134,98,976,9.6,6.3,9.1,"Less than 25% P.O.C.","$44000 - $52000"
"38039","Griggs County, North Dakota",2409,53565,2296,0,43,0,0,20,95.3,0,1.8,0,0,0.8,4.7,1089,829,260,76.12,23.88,41,788,15,245,56,1033,4.9,5.8,5.1,"Less than 25% P.O.C.","$52000 - $60000"
"38041","Hettinger County, North Dakota",2547,60164,2317,10,71,0,1,79,91,0.4,2.8,0,0,3.1,9,1073,866,207,80.71,19.29,73,793,25,182,98,975,8.4,12.1,9.1,"Less than 25% P.O.C.","$60000 or more"
"38043","Kidder County, North Dakota",2466,54643,2321,5,37,6,0,89,94.1,0.2,1.5,0.2,0,3.6,5.9,1092,822,270,75.27,24.73,67,755,36,234,103,989,8.2,13.3,9.4,"Less than 25% P.O.C.","$52000 - $60000"
"38045","LaMoure County, North Dakota",4125,60806,3960,25,10,8,0,80,96,0.6,0.2,0.2,0,1.9,4,1822,1401,421,76.89,23.11,117,1284,68,353,185,1637,8.4,16.2,10.2,"Less than 25% P.O.C.","$60000 or more"
"38047","Logan County, North Dakota",1872,59375,1817,0,4,2,0,16,97.1,0,0.2,0.1,0,0.9,2.9,849,712,137,83.86,16.14,62,650,9,128,71,778,8.7,6.6,8.4,"Less than 25% P.O.C.","$52000 - $60000"
"38049","McHenry County, North Dakota",5878,64179,5598,21,65,23,0,127,95.2,0.4,1.1,0.4,0,2.2,4.8,2594,2151,443,82.92,17.08,197,1954,5,438,202,2392,9.2,1.1,7.8,"Less than 25% P.O.C.","$60000 or more"
"38051","McIntosh County, North Dakota",2597,52587,2465,14,16,13,0,72,94.9,0.5,0.6,0.5,0,2.8,5.1,1291,948,343,73.43,26.57,58,890,30,313,88,1203,6.1,8.7,6.8,"Less than 25% P.O.C.","$52000 - $60000"
"38053","McKenzie County, North Dakota",13334,77845,10332,214,1382,53,0,1114,77.5,1.6,10.4,0.4,0,8.4,22.5,4302,2322,1980,53.97,46.03,282,2040,158,1822,440,3862,12.1,8,10.2,"Less than 25% P.O.C.","$60000 or more"
"38055","McLean County, North Dakota",9584,68529,8540,63,611,8,15,237,89.1,0.7,6.4,0.1,0.2,2.5,10.9,4334,3518,816,81.17,18.83,293,3225,106,710,399,3935,8.3,13,9.2,"Less than 25% P.O.C.","$60000 or more"
"38057","Mercer County, North Dakota",8462,82181,7737,73,247,38,0,249,91.4,0.9,2.9,0.4,0,2.9,8.6,3709,3066,643,82.66,17.34,193,2873,87,556,280,3429,6.3,13.5,7.5,"Less than 25% P.O.C.","$60000 or more"
"38059","Morton County, North Dakota",30868,70556,27717,306,961,201,0,1072,89.8,1,3.1,0.7,0,3.5,10.2,13565,9585,3980,70.66,29.34,841,8744,216,3764,1057,12508,8.8,5.4,7.8,"Less than 25% P.O.C.","$60000 or more"
"38061","Mountrail County, North Dakota",10321,72147,6259,146,2801,49,0,838,60.6,1.4,27.1,0.5,0,8.1,39.4,3360,2289,1071,68.12,31.87,309,1980,85,986,394,2966,13.5,7.9,11.7,"25% - 50% P.O.C.","$60000 or more"
"38063","Nelson County, North Dakota",2894,52039,2758,0,9,1,0,101,95.3,0,0.3,0,0,3.5,4.7,1467,1060,407,72.26,27.74,70,990,7,400,77,1390,6.6,1.7,5.2,"Less than 25% P.O.C.","$52000 - $60000"
"38065","Oliver County, North Dakota",1842,78929,1662,0,8,32,10,52,90.2,0,0.4,1.7,0.5,2.8,9.8,738,654,84,88.62,11.38,99,555,13,71,112,626,15.1,15.5,15.2,"Less than 25% P.O.C.","$60000 or more"
"38067","Pembina County, North Dakota",6947,64549,6314,23,197,37,0,241,90.9,0.3,2.8,0.5,0,3.5,9.1,3158,2432,726,77.01,22.99,157,2275,10,716,167,2991,6.5,1.4,5.3,"Less than 25% P.O.C.","$60000 or more"
"38069","Pierce County, North Dakota",4126,55660,3857,25,154,12,0,18,93.5,0.6,3.7,0.3,0,0.4,6.5,1908,1404,504,73.58,26.42,128,1276,29,475,157,1751,9.1,5.8,8.2,"Less than 25% P.O.C.","$52000 - $60000"
"38071","Ramsey County, North Dakota",11583,58910,9617,12,1152,99,0,341,83,0.1,9.9,0.9,0,2.9,17,4828,2911,1917,60.29,39.71,340,2571,77,1840,417,4411,11.7,4,8.6,"Less than 25% P.O.C.","$52000 - $60000"
"38073","Ransom County, North Dakota",5314,63903,5007,43,30,57,0,83,94.2,0.8,0.6,1.1,0,1.6,5.8,2371,1682,689,70.94,29.06,129,1553,43,646,172,2199,7.7,6.2,7.3,"Less than 25% P.O.C.","$60000 or more"
"38075","Renville County, North Dakota",2442,73182,2214,6,3,5,0,183,90.7,0.2,0.1,0.2,0,7.5,9.3,950,785,165,82.63,17.37,60,725,27,138,87,863,7.6,16.4,9.2,"Less than 25% P.O.C.","$60000 or more"
"38077","Richland County, North Dakota",16254,61371,14835,112,290,62,0,512,91.3,0.7,1.8,0.4,0,3.1,8.7,6777,4803,1974,70.87,29.13,505,4298,124,1850,629,6148,10.5,6.3,9.3,"Less than 25% P.O.C.","$60000 or more"
"38079","Rolette County, North Dakota",14511,43158,2633,93,11325,21,0,80,18.1,0.6,78,0.1,0,0.6,81.9,4608,3286,1322,71.31,28.69,476,2810,172,1150,648,3960,14.5,13,14.1,"75% or more P.O.C.","Less than $44000"
"38081","Sargent County, North Dakota",3872,63073,3560,92,14,11,0,120,91.9,2.4,0.4,0.3,0,3.1,8.1,1864,1357,507,72.8,27.2,66,1291,41,466,107,1757,4.9,8.1,5.7,"Less than 25% P.O.C.","$60000 or more"
"38083","Sheridan County, North Dakota",1409,51055,1393,0,10,0,0,0,98.9,0,0.7,0,0,0,1.1,731,583,148,79.75,20.25,43,540,13,135,56,675,7.4,8.8,7.7,"Less than 25% P.O.C.","$44000 - $52000"
"38085","Sioux County, North Dakota",4373,38939,552,7,3525,0,3,203,12.6,0.2,80.6,0,0.1,4.6,87.4,1112,483,629,43.44,56.56,77,406,190,439,267,845,15.9,30.2,24,"75% or more P.O.C.","Less than $44000"
"38087","Slope County, North Dakota",742,63611,715,13,5,0,0,0,96.4,1.8,0.7,0,0,0,3.6,326,268,58,82.21,17.79,24,244,5,53,29,297,9,8.6,8.9,"Less than 25% P.O.C.","$60000 or more"
"38089","Stark County, North Dakota",31081,72045,27146,609,371,387,102,1690,87.3,2,1.2,1.2,0.3,5.4,12.7,12524,7647,4877,61.06,38.94,789,6858,299,4578,1088,11436,10.3,6.1,8.7,"Less than 25% P.O.C.","$60000 or more"
"38091","Steele County, North Dakota",1744,70724,1701,13,0,0,0,30,97.5,0.7,0,0,0,1.7,2.5,777,658,119,84.68,15.32,53,605,8,111,61,716,8.1,6.7,7.9,"Less than 25% P.O.C.","$60000 or more"
"38093","Stutsman County, North Dakota",20965,57674,19319,305,336,101,4,524,92.1,1.5,1.6,0.5,0,2.5,7.9,8908,5842,3066,65.58,34.42,371,5471,142,2924,513,8395,6.4,4.6,5.8,"Less than 25% P.O.C.","$52000 - $60000"
"38095","Towner County, North Dakota",2224,52300,1970,17,88,4,0,88,88.6,0.8,4,0.2,0,4,11.4,1058,773,285,73.06,26.94,67,706,1,284,68,990,8.7,0.4,6.4,"Less than 25% P.O.C.","$52000 - $60000"
"38097","Traill County, North Dakota",8008,64453,7369,84,78,30,25,289,92,1,1,0.4,0.3,3.6,8,3383,2418,965,71.48,28.52,246,2172,65,900,311,3072,10.2,6.7,9.2,"Less than 25% P.O.C.","$60000 or more"
"38099","Walsh County, North Dakota",10751,55700,9064,44,210,51,0,1240,84.3,0.4,2,0.5,0,11.5,15.7,4780,3651,1129,76.38,23.62,348,3303,75,1054,423,4357,9.5,6.6,8.8,"Less than 25% P.O.C.","$52000 - $60000"
"38101","Ward County, North Dakota",68812,68871,56956,2587,1409,1160,84,4231,82.8,3.8,2,1.7,0.1,6.1,17.2,28277,16826,11451,59.5,40.5,1619,15207,872,10579,2491,25786,9.6,7.6,8.8,"Less than 25% P.O.C.","$60000 or more"
"38103","Wells County, North Dakota",3976,57582,3828,0,9,9,0,100,96.3,0,0.2,0.2,0,2.5,3.7,1943,1529,414,78.69,21.31,131,1398,11,403,142,1801,8.6,2.7,7.3,"Less than 25% P.O.C.","$52000 - $60000"
"38105","Williams County, North Dakota",35208,87161,28003,1564,1071,341,47,2709,79.5,4.4,3,1,0.1,7.7,20.5,14320,7533,6787,52.6,47.4,990,6543,513,6274,1503,12817,13.1,7.6,10.5,"Less than 25% P.O.C.","$60000 or more"
"39001","Adams County, Ohio",27776,39079,27243,99,6,8,0,283,98.1,0.4,0,0,0,1,1.9,10673,7559,3114,70.82,29.18,682,6877,250,2864,932,9741,9,8,8.7,"Less than 25% P.O.C.","Less than $44000"
"39003","Allen County, Ohio",103175,53131,83272,12215,191,846,0,3221,80.7,11.8,0.2,0.8,0,3.1,19.3,40650,27263,13387,67.07,32.93,2411,24852,1217,12170,3628,37022,8.8,9.1,8.9,"Less than 25% P.O.C.","$52000 - $60000"
"39005","Ashland County, Ohio",53536,52823,51179,394,14,352,0,739,95.6,0.7,0,0.7,0,1.4,4.4,20417,15065,5352,73.79,26.21,1215,13850,437,4915,1652,18765,8.1,8.2,8.1,"Less than 25% P.O.C.","$52000 - $60000"
"39007","Ashtabula County, Ohio",97830,46700,87554,3297,146,533,12,4134,89.5,3.4,0.1,0.5,0,4.2,10.5,37832,26680,11152,70.52,29.48,2217,24463,984,10168,3201,34631,8.3,8.8,8.5,"Less than 25% P.O.C.","$44000 - $52000"
"39009","Athens County, Ohio",65917,40905,59069,1908,140,1728,40,1268,89.6,2.9,0.2,2.6,0.1,1.9,10.4,22557,13048,9509,57.84,42.16,970,12078,504,9005,1474,21083,7.4,5.3,6.5,"Less than 25% P.O.C.","Less than $44000"
"39011","Auglaize County, Ohio",45729,64074,43736,291,95,164,3,770,95.6,0.6,0.2,0.4,0,1.7,4.4,18888,14304,4584,75.73,24.27,1620,12684,360,4224,1980,16908,11.3,7.9,10.5,"Less than 25% P.O.C.","$60000 or more"
"39013","Belmont County, Ohio",68024,50904,63053,2642,139,333,8,674,92.7,3.9,0.2,0.5,0,1,7.3,25919,19807,6112,76.42,23.58,1333,18474,281,5831,1614,24305,6.7,4.6,6.2,"Less than 25% P.O.C.","$44000 - $52000"
"39015","Brown County, Ohio",43572,54575,42005,353,53,124,0,456,96.4,0.8,0.1,0.3,0,1,3.6,17829,12901,4928,72.36,27.64,1509,11392,365,4563,1874,15955,11.7,7.4,10.5,"Less than 25% P.O.C.","$52000 - $60000"
"39017","Butler County, Ohio",380019,66117,307838,30343,481,12447,330,17914,81,8,0.1,3.3,0.1,4.7,19,139113,94762,44351,68.12,31.88,10208,84554,3858,40493,14066,125047,10.8,8.7,10.1,"Less than 25% P.O.C.","$60000 or more"
"39019","Carroll County, Ohio",27332,55267,26789,72,8,9,0,359,98,0.3,0,0,0,1.3,2,11298,8886,2412,78.65,21.35,793,8093,216,2196,1009,10289,8.9,9,8.9,"Less than 25% P.O.C.","$52000 - $60000"
"39021","Champaign County, Ohio",38845,60112,36240,712,136,187,9,617,93.3,1.8,0.4,0.5,0,1.6,6.7,15159,11091,4068,73.16,26.84,984,10107,606,3462,1590,13569,8.9,14.9,10.5,"Less than 25% P.O.C.","$60000 or more"
"39023","Clark County, Ohio",134726,50873,113246,10832,209,825,38,4627,84.1,8,0.2,0.6,0,3.4,15.9,54696,36093,18603,65.99,34.01,2831,33262,1979,16624,4810,49886,7.8,10.6,8.8,"Less than 25% P.O.C.","$44000 - $52000"
"39025","Clermont County, Ohio",204275,66968,191037,2873,235,2550,36,3964,93.5,1.4,0.1,1.2,0,1.9,6.5,78009,57854,20155,74.16,25.84,5700,52154,1764,18391,7464,70545,9.9,8.8,9.6,"Less than 25% P.O.C.","$60000 or more"
"39027","Clinton County, Ohio",41957,52815,39165,857,6,200,10,677,93.3,2,0,0.5,0,1.6,6.7,16528,10683,5845,64.64,35.36,1093,9590,581,5264,1674,14854,10.2,9.9,10.1,"Less than 25% P.O.C.","$52000 - $60000"
"39029","Columbiana County, Ohio",103190,48345,96921,2049,130,149,7,1833,93.9,2,0.1,0.1,0,1.8,6.1,41537,30536,11001,73.52,26.48,2226,28310,1133,9868,3359,38178,7.3,10.3,8.1,"Less than 25% P.O.C.","$44000 - $52000"
"39031","Coshocton County, Ohio",36585,46606,35075,419,84,107,0,389,95.9,1.1,0.2,0.3,0,1.1,4.1,14476,10709,3767,73.98,26.02,1013,9696,358,3409,1371,13105,9.5,9.5,9.5,"Less than 25% P.O.C.","$44000 - $52000"
"39033","Crawford County, Ohio",41821,44971,39837,415,34,220,18,700,95.3,1,0.1,0.5,0,1.7,4.7,17782,12390,5392,69.68,30.32,953,11437,495,4897,1448,16334,7.7,9.2,8.1,"Less than 25% P.O.C.","$44000 - $52000"
"39035","Cuyahoga County, Ohio",1247451,50366,734951,364770,1678,37507,269,74024,58.9,29.2,0.1,3,0,5.9,41.1,540965,315059,225906,58.24,41.76,21081,293978,13449,212457,34530,506435,6.7,6,6.4,"25% - 50% P.O.C.","$44000 - $52000"
"39037","Darke County, Ohio",51513,55620,49495,385,147,255,0,807,96.1,0.7,0.3,0.5,0,1.6,3.9,20861,15186,5675,72.8,27.2,1640,13546,548,5127,2188,18673,10.8,9.7,10.5,"Less than 25% P.O.C.","$52000 - $60000"
"39039","Defiance County, Ohio",38160,59931,32969,541,145,121,13,3804,86.4,1.4,0.4,0.3,0,10,13.6,15297,11669,3628,76.28,23.72,1133,10536,259,3369,1392,13905,9.7,7.1,9.1,"Less than 25% P.O.C.","$52000 - $60000"
"39041","Delaware County, Ohio",201135,106908,171054,6639,217,12716,23,5253,85,3.3,0.1,6.3,0,2.6,15,69985,56957,13028,81.38,18.62,6484,50473,769,12259,7253,62732,11.4,5.9,10.4,"Less than 25% P.O.C.","$60000 or more"
"39043","Erie County, Ohio",74780,54226,62161,6453,257,441,6,3282,83.1,8.6,0.3,0.6,0,4.4,16.9,31183,21593,9590,69.25,30.75,1428,20165,482,9108,1910,29273,6.6,5,6.1,"Less than 25% P.O.C.","$52000 - $60000"
"39045","Fairfield County, Ohio",154457,67609,132876,11188,74,2459,71,3398,86,7.2,0,1.6,0,2.2,14,56339,41654,14685,73.93,26.07,4550,37104,1477,13208,6027,50312,10.9,10.1,10.7,"Less than 25% P.O.C.","$60000 or more"
"39047","Fayette County, Ohio",28620,47308,26457,660,9,282,11,615,92.4,2.3,0,1,0,2.1,7.6,11773,7642,4131,64.91,35.09,755,6887,455,3676,1210,10563,9.9,11,10.3,"Less than 25% P.O.C.","$44000 - $52000"
"39049","Franklin County, Ohio",1290360,61305,813034,287759,1991,67469,414,71292,63,22.3,0.2,5.2,0,5.5,37,511447,273045,238402,53.39,46.61,23598,249447,19332,219070,42930,468517,8.6,8.1,8.4,"25% - 50% P.O.C.","$60000 or more"
"39051","Fulton County, Ohio",42253,63092,37605,164,125,182,19,3689,89,0.4,0.3,0.4,0,8.7,11,16506,13050,3456,79.06,20.94,1320,11730,440,3016,1760,14746,10.1,12.7,10.7,"Less than 25% P.O.C.","$60000 or more"
"39053","Gallia County, Ohio",30088,44858,28024,655,130,232,40,408,93.1,2.2,0.4,0.8,0.1,1.4,6.9,11588,8631,2957,74.48,25.52,761,7870,310,2647,1071,10517,8.8,10.5,9.2,"Less than 25% P.O.C.","$44000 - $52000"
"39055","Geauga County, Ohio",93843,82303,89670,1269,112,620,0,1422,95.6,1.4,0.1,0.7,0,1.5,4.4,35298,30466,4832,86.31,13.69,3475,26991,426,4406,3901,31397,11.4,8.8,11.1,"Less than 25% P.O.C.","$60000 or more"
"39057","Greene County, Ohio",166502,68720,139552,11197,193,4882,99,4735,83.8,6.7,0.1,2.9,0.1,2.8,16.2,65604,43356,22248,66.09,33.91,3451,39905,1605,20643,5056,60548,8,7.2,7.7,"Less than 25% P.O.C.","$60000 or more"
"39059","Guernsey County, Ohio",39111,45917,36842,425,109,171,0,460,94.2,1.1,0.3,0.4,0,1.2,5.8,16220,11591,4629,71.46,28.54,969,10622,413,4216,1382,14838,8.4,8.9,8.5,"Less than 25% P.O.C.","$44000 - $52000"
"39061","Hamilton County, Ohio",813589,57212,530525,206538,694,21463,497,26867,65.2,25.4,0.1,2.6,0.1,3.3,34.8,341873,197984,143889,57.91,42.09,17030,180954,8826,135063,25856,316017,8.6,6.1,7.6,"25% - 50% P.O.C.","$52000 - $60000"
"39063","Hancock County, Ohio",75837,58450,67509,1178,53,1467,0,4145,89,1.6,0.1,1.9,0,5.5,11,31937,21977,9960,68.81,31.19,1866,20111,890,9070,2756,29181,8.5,8.9,8.6,"Less than 25% P.O.C.","$52000 - $60000"
"39065","Hardin County, Ohio",31425,50506,29824,230,3,249,0,546,94.9,0.7,0,0.8,0,1.7,5.1,11678,8297,3381,71.05,28.95,902,7395,271,3110,1173,10505,10.9,8,10,"Less than 25% P.O.C.","$44000 - $52000"
"39067","Harrison County, Ohio",15211,49689,14427,434,12,75,0,60,94.8,2.9,0.1,0.5,0,0.4,5.2,6223,4909,1314,78.88,21.12,394,4515,116,1198,510,5713,8,8.8,8.2,"Less than 25% P.O.C.","$44000 - $52000"
"39069","Henry County, Ohio",27208,59695,24434,235,23,85,4,2089,89.8,0.9,0.1,0.3,0,7.7,10.2,10992,8505,2487,77.37,22.63,870,7635,278,2209,1148,9844,10.2,11.2,10.4,"Less than 25% P.O.C.","$52000 - $60000"
"39071","Highland County, Ohio",43016,44169,40908,610,108,170,0,476,95.1,1.4,0.3,0.4,0,1.1,4.9,16772,11478,5294,68.44,31.56,1165,10313,467,4827,1632,15140,10.1,8.8,9.7,"Less than 25% P.O.C.","$44000 - $52000"
"39073","Hocking County, Ohio",28390,52363,27341,218,12,63,0,284,96.3,0.8,0,0.2,0,1,3.7,11286,8479,2807,75.13,24.87,772,7707,270,2537,1042,10244,9.1,9.6,9.2,"Less than 25% P.O.C.","$52000 - $60000"
"39075","Holmes County, Ohio",43901,63753,42956,60,19,114,0,423,97.8,0.1,0,0.3,0,1,2.2,12342,9318,3024,75.5,24.5,2682,6636,371,2653,3053,9289,28.8,12.3,24.7,"Less than 25% P.O.C.","$60000 or more"
"39077","Huron County, Ohio",58339,52560,52583,704,95,131,12,3826,90.1,1.2,0.2,0.2,0,6.6,9.9,22935,16263,6672,70.91,29.09,1711,14552,569,6103,2280,20655,10.5,8.5,9.9,"Less than 25% P.O.C.","$52000 - $60000"
"39079","Jackson County, Ohio",32450,47550,31149,200,12,44,22,346,96,0.6,0,0.1,0.1,1.1,4,12780,8847,3933,69.23,30.77,865,7982,311,3622,1176,11604,9.8,7.9,9.2,"Less than 25% P.O.C.","$44000 - $52000"
"39081","Jefferson County, Ohio",66371,46581,59955,3578,65,311,0,966,90.3,5.4,0.1,0.5,0,1.5,9.7,27428,18922,8506,68.99,31.01,1194,17728,698,7808,1892,25536,6.3,8.2,6.9,"Less than 25% P.O.C.","$44000 - $52000"
"39083","Knox County, Ohio",61481,57749,58635,532,63,282,13,923,95.4,0.9,0.1,0.5,0,1.5,4.6,23248,16740,6508,72.01,27.99,1567,15173,533,5975,2100,21148,9.4,8.2,9,"Less than 25% P.O.C.","$52000 - $60000"
"39085","Lake County, Ohio",229954,64466,202885,9524,217,2835,34,10081,88.2,4.1,0.1,1.2,0,4.4,11.8,96361,71515,24846,74.22,25.78,4954,66561,1758,23088,6712,89649,6.9,7.1,7,"Less than 25% P.O.C.","$60000 or more"
"39087","Lawrence County, Ohio",60184,45118,57035,1211,19,315,14,590,94.8,2,0,0.5,0,1,5.2,23221,16775,6446,72.24,27.76,1246,15529,372,6074,1618,21603,7.4,5.8,7,"Less than 25% P.O.C.","$44000 - $52000"
"39089","Licking County, Ohio",173750,64589,156495,6401,171,2139,14,3337,90.1,3.7,0.1,1.2,0,1.9,9.9,64035,46688,17347,72.91,27.09,4418,42270,1366,15981,5784,58251,9.5,7.9,9,"Less than 25% P.O.C.","$60000 or more"
"39091","Logan County, Ohio",45316,56754,42306,753,63,372,31,740,93.4,1.7,0.1,0.8,0.1,1.6,6.6,18677,13854,4823,74.18,25.82,1319,12535,596,4227,1915,16762,9.5,12.4,10.3,"Less than 25% P.O.C.","$52000 - $60000"
"39093","Lorain County, Ohio",307670,58427,240640,24202,822,3564,64,30628,78.2,7.9,0.3,1.2,0,10,21.8,120281,86989,33292,72.32,27.68,6964,80025,2687,30605,9651,110630,8,8.1,8,"Less than 25% P.O.C.","$52000 - $60000"
"39095","Lucas County, Ohio",431102,48736,295844,81000,703,7187,112,30622,68.6,18.8,0.2,1.7,0,7.1,31.4,179930,107464,72466,59.73,40.27,8906,98558,5258,67208,14164,165766,8.3,7.3,7.9,"25% - 50% P.O.C.","$44000 - $52000"
"39097","Madison County, Ohio",44135,68022,39056,2576,44,310,5,900,88.5,5.8,0.1,0.7,0,2,11.5,15013,10687,4326,71.18,28.82,1155,9532,456,3870,1611,13402,10.8,10.5,10.7,"Less than 25% P.O.C.","$60000 or more"
"39099","Mahoning County, Ohio",229961,46042,174662,33652,441,1971,6,13804,76,14.6,0.2,0.9,0,6,24,98472,67633,30839,68.68,31.32,4348,63285,2054,28785,6402,92070,6.4,6.7,6.5,"Less than 25% P.O.C.","$44000 - $52000"
"39101","Marion County, Ohio",65299,47498,57683,3501,84,385,26,1747,88.3,5.4,0.1,0.6,0,2.7,11.7,24737,16419,8318,66.37,33.63,1540,14879,830,7488,2370,22367,9.4,10,9.6,"Less than 25% P.O.C.","$44000 - $52000"
"39103","Medina County, Ohio",177980,76600,166999,2555,187,1979,0,3760,93.8,1.4,0.1,1.1,0,2.1,6.2,69007,55128,13879,79.89,20.11,5133,49995,743,13136,5876,63131,9.3,5.4,8.5,"Less than 25% P.O.C.","$60000 or more"
"39105","Meigs County, Ohio",23078,44899,22306,256,13,1,0,170,96.7,1.1,0.1,0,0,0.7,3.3,9045,7111,1934,78.62,21.38,519,6592,231,1703,750,8295,7.3,11.9,8.3,"Less than 25% P.O.C.","$44000 - $52000"
"39107","Mercer County, Ohio",40884,62952,38994,335,0,228,236,788,95.4,0.8,0,0.6,0.6,1.9,4.6,16234,12503,3731,77.02,22.98,1522,10981,223,3508,1745,14489,12.2,6,10.7,"Less than 25% P.O.C.","$60000 or more"
"39109","Miami County, Ohio",105371,61041,97248,2128,114,1317,6,1774,92.3,2,0.1,1.2,0,1.7,7.7,41043,29173,11870,71.08,28.92,2942,26231,747,11123,3689,37354,10.1,6.3,9,"Less than 25% P.O.C.","$60000 or more"
"39111","Monroe County, Ohio",13942,45289,13543,53,0,65,0,168,97.1,0.4,0,0.5,0,1.2,2.9,5745,4496,1249,78.26,21.74,294,4202,99,1150,393,5352,6.5,7.9,6.8,"Less than 25% P.O.C.","$44000 - $52000"
"39113","Montgomery County, Ohio",531670,51542,376009,107827,954,11462,157,15959,70.7,20.3,0.2,2.2,0,3,29.3,224328,136792,87536,60.98,39.02,9680,127112,5953,81583,15633,208695,7.1,6.8,7,"25% - 50% P.O.C.","$44000 - $52000"
"39115","Morgan County, Ohio",14640,42341,13485,721,10,30,0,58,92.1,4.9,0.1,0.2,0,0.4,7.9,6108,4685,1423,76.7,23.3,362,4323,141,1282,503,5605,7.7,9.9,8.2,"Less than 25% P.O.C.","Less than $44000"
"39117","Morrow County, Ohio",35043,59452,33617,312,40,40,0,519,95.9,0.9,0.1,0.1,0,1.5,4.1,12922,10572,2350,81.81,18.19,1059,9513,141,2209,1200,11722,10,6,9.3,"Less than 25% P.O.C.","$52000 - $60000"
"39119","Muskingum County, Ohio",86131,47254,78726,2697,222,385,33,967,91.4,3.1,0.3,0.4,0,1.1,8.6,33878,23372,10506,68.99,31.01,1980,21392,779,9727,2759,31119,8.5,7.4,8.1,"Less than 25% P.O.C.","$44000 - $52000"
"39121","Noble County, Ohio",14416,46897,13331,807,22,11,0,124,92.5,5.6,0.2,0.1,0,0.9,7.5,5067,4152,915,81.94,18.06,198,3954,45,870,243,4824,4.8,4.9,4.8,"Less than 25% P.O.C.","$44000 - $52000"
"39123","Ottawa County, Ohio",40632,59099,37501,497,108,87,0,2050,92.3,1.2,0.3,0.2,0,5,7.7,18051,14231,3820,78.84,21.16,965,13266,288,3532,1253,16798,6.8,7.5,6.9,"Less than 25% P.O.C.","$52000 - $60000"
"39125","Paulding County, Ohio",18809,55330,17400,147,28,41,15,896,92.5,0.8,0.1,0.2,0.1,4.8,7.5,7705,6086,1619,78.99,21.01,706,5380,120,1499,826,6879,11.6,7.4,10.7,"Less than 25% P.O.C.","$52000 - $60000"
"39127","Perry County, Ohio",36022,50150,34800,135,121,48,53,309,96.6,0.4,0.3,0.1,0.1,0.9,3.4,13500,9950,3550,73.7,26.3,875,9075,365,3185,1240,12260,8.8,10.3,9.2,"Less than 25% P.O.C.","$44000 - $52000"
"39129","Pickaway County, Ohio",57762,63633,53505,1914,163,372,0,801,92.6,3.3,0.3,0.6,0,1.4,7.4,19710,14698,5012,74.57,25.43,1617,13081,511,4501,2128,17582,11,10.2,10.8,"Less than 25% P.O.C.","$60000 or more"
"39131","Pike County, Ohio",28000,42832,26651,468,151,23,0,126,95.2,1.7,0.5,0.1,0,0.4,4.8,10959,7100,3859,64.79,35.21,510,6590,383,3476,893,10066,7.2,9.9,8.1,"Less than 25% P.O.C.","Less than $44000"
"39133","Portage County, Ohio",162511,57618,145584,6449,236,2907,24,2999,89.6,4,0.1,1.8,0,1.8,10.4,61817,42987,18830,69.54,30.46,3362,39625,1159,17671,4521,57296,7.8,6.2,7.3,"Less than 25% P.O.C.","$52000 - $60000"
"39135","Preble County, Ohio",41093,58957,39601,201,60,182,3,368,96.4,0.5,0.1,0.4,0,0.9,3.6,16251,12733,3518,78.35,21.65,1108,11625,388,3130,1496,14755,8.7,11,9.2,"Less than 25% P.O.C.","$52000 - $60000"
"39137","Putnam County, Ohio",33911,64822,31202,131,2,53,0,2103,92,0.4,0,0.2,0,6.2,8,13327,10873,2454,81.59,18.41,1372,9501,302,2152,1674,11653,12.6,12.3,12.6,"Less than 25% P.O.C.","$60000 or more"
"39139","Richland County, Ohio",121100,49547,103517,10657,117,959,26,2318,85.5,8.8,0.1,0.8,0,1.9,14.5,48449,32633,15816,67.36,32.64,2409,30224,1464,14352,3873,44576,7.4,9.3,8,"Less than 25% P.O.C.","$44000 - $52000"
"39141","Ross County, Ohio",76948,51092,68949,3934,10,392,13,978,89.6,5.1,0,0.5,0,1.3,10.4,28802,20428,8374,70.93,29.07,1965,18463,538,7836,2503,26299,9.6,6.4,8.7,"Less than 25% P.O.C.","$44000 - $52000"
"39143","Sandusky County, Ohio",59029,54089,49816,1741,148,183,12,5858,84.4,2.9,0.3,0.3,0,9.9,15.6,23574,17144,6430,72.72,27.28,1361,15783,594,5836,1955,21619,7.9,9.2,8.3,"Less than 25% P.O.C.","$52000 - $60000"
"39145","Scioto County, Ohio",76040,41330,70937,2100,248,321,6,1030,93.3,2.8,0.3,0.4,0,1.4,6.7,29858,20188,9670,67.61,32.39,1642,18546,719,8951,2361,27497,8.1,7.4,7.9,"Less than 25% P.O.C.","Less than $44000"
"39147","Seneca County, Ohio",55351,52500,49701,1563,58,344,0,2836,89.8,2.8,0.1,0.6,0,5.1,10.2,21648,15642,6006,72.26,27.74,1392,14250,622,5384,2014,19634,8.9,10.4,9.3,"Less than 25% P.O.C.","$52000 - $60000"
"39149","Shelby County, Ohio",48749,63806,45274,1230,122,571,0,758,92.9,2.5,0.3,1.2,0,1.6,7.1,18608,13246,5362,71.18,28.82,1526,11720,619,4743,2145,16463,11.5,11.5,11.5,"Less than 25% P.O.C.","$60000 or more"
"39151","Stark County, Ohio",372404,53860,321693,27646,401,3407,21,7732,86.4,7.4,0.1,0.9,0,2.1,13.6,153460,104660,48800,68.2,31.8,8161,96499,3571,45229,11732,141728,7.8,7.3,7.6,"Less than 25% P.O.C.","$52000 - $60000"
"39153","Summit County, Ohio",541334,57181,416687,77859,920,18417,69,11598,77,14.4,0.2,3.4,0,2.1,23,224726,147876,76850,65.8,34.2,10809,137067,5007,71843,15816,208910,7.3,6.5,7,"Less than 25% P.O.C.","$52000 - $60000"
"39155","Trumbull County, Ohio",200367,47280,174552,16234,175,1044,62,3639,87.1,8.1,0.1,0.5,0,1.8,12.9,85621,60431,25190,70.58,29.42,4283,56148,1898,23292,6181,79440,7.1,7.5,7.2,"Less than 25% P.O.C.","$44000 - $52000"
"39157","Tuscarawas County, Ohio",92335,53243,87235,551,170,370,0,2612,94.5,0.6,0.2,0.4,0,2.8,5.5,36631,25905,10726,70.72,29.28,2317,23588,994,9732,3311,33320,8.9,9.3,9,"Less than 25% P.O.C.","$52000 - $60000"
"39159","Union County, Ohio",56707,86715,50769,1452,195,2269,48,983,89.5,2.6,0.3,4,0.1,1.7,10.5,20212,15862,4350,78.48,21.52,1701,14161,323,4027,2024,18188,10.7,7.4,10,"Less than 25% P.O.C.","$60000 or more"
"39161","Van Wert County, Ohio",28261,54254,26541,371,2,81,0,960,93.9,1.3,0,0.3,0,3.4,6.1,11544,8899,2645,77.09,22.91,732,8167,332,2313,1064,10480,8.2,12.6,9.2,"Less than 25% P.O.C.","$52000 - $60000"
"39163","Vinton County, Ohio",13083,45673,12626,34,7,23,0,90,96.5,0.3,0.1,0.2,0,0.7,3.5,5140,3907,1233,76.01,23.99,465,3442,150,1083,615,4525,11.9,12.2,12,"Less than 25% P.O.C.","$44000 - $52000"
"39165","Warren County, Ohio",229132,87125,197434,7578,161,13174,0,6321,86.2,3.3,0.1,5.7,0,2.8,13.8,82957,64425,18532,77.66,22.34,6115,58310,1116,17416,7231,75726,9.5,6,8.7,"Less than 25% P.O.C.","$60000 or more"
"39167","Washington County, Ohio",60426,50021,57438,745,255,387,0,665,95.1,1.2,0.4,0.6,0,1.1,4.9,25197,18553,6644,73.63,26.37,1388,17165,365,6279,1753,23444,7.5,5.5,7,"Less than 25% P.O.C.","$44000 - $52000"
"39169","Wayne County, Ohio",116099,58300,108752,1571,219,1203,15,2335,93.7,1.4,0.2,1,0,2,6.3,43824,31974,11850,72.96,27.04,3863,28111,1049,10801,4912,38912,12.1,8.9,11.2,"Less than 25% P.O.C.","$52000 - $60000"
"39171","Williams County, Ohio",36816,53183,34092,393,94,210,10,1661,92.6,1.1,0.3,0.6,0,4.5,7.4,15090,11620,3470,77,23,874,10746,275,3195,1149,13941,7.5,7.9,7.6,"Less than 25% P.O.C.","$52000 - $60000"
"39173","Wood County, Ohio",130150,62390,114904,3346,196,2164,54,7228,88.3,2.6,0.2,1.7,0,5.6,11.7,50589,33012,17577,65.26,34.74,3046,29966,681,16896,3727,46862,9.2,3.9,7.4,"Less than 25% P.O.C.","$60000 or more"
"39175","Wyandot County, Ohio",22000,55767,20895,36,0,183,0,660,95,0.2,0,0.8,0,3,5,9081,6726,2355,74.07,25.93,608,6118,119,2236,727,8354,9,5.1,8,"Less than 25% P.O.C.","$52000 - $60000"
"40001","Adair County, Oklahoma",22220,34695,8864,31,9536,178,48,1518,39.9,0.1,42.9,0.8,0.2,6.8,60.1,7733,5356,2377,69.26,30.74,569,4787,390,1987,959,6774,10.6,16.4,12.4,"50% - 75% P.O.C.","Less than $44000"
"40003","Alfalfa County, Oklahoma",5847,61852,4902,181,107,0,0,329,83.8,3.1,1.8,0,0,5.6,16.2,1870,1499,371,80.16,19.84,164,1335,34,337,198,1672,10.9,9.2,10.6,"Less than 25% P.O.C.","$60000 or more"
"40005","Atoka County, Oklahoma",13823,39316,9812,492,1396,99,9,486,71,3.6,10.1,0.7,0.1,3.5,29,5284,3880,1404,73.43,26.57,339,3541,116,1288,455,4829,8.7,8.3,8.6,"25% - 50% P.O.C.","Less than $44000"
"40007","Beaver County, Oklahoma",5377,52349,3880,31,73,2,0,1281,72.2,0.6,1.4,0,0,23.8,27.8,1971,1508,463,76.51,23.49,150,1358,70,393,220,1751,9.9,15.1,11.2,"25% - 50% P.O.C.","$52000 - $60000"
"40009","Beckham County, Oklahoma",22268,50721,16765,936,495,76,15,3241,75.3,4.2,2.2,0.3,0.1,14.6,24.7,7578,5020,2558,66.24,33.76,512,4508,182,2376,694,6884,10.2,7.1,9.2,"Less than 25% P.O.C.","$44000 - $52000"
"40011","Blaine County, Oklahoma",9556,45792,6946,377,679,2,0,1063,72.7,3.9,7.1,0,0,11.1,27.3,3898,2861,1037,73.4,26.6,226,2635,111,926,337,3561,7.9,10.7,8.6,"25% - 50% P.O.C.","$44000 - $52000"
"40013","Bryan County, Oklahoma",46457,44212,32997,815,6544,284,68,2773,71,1.8,14.1,0.6,0.1,6,29,17253,10733,6520,62.21,37.79,1025,9708,723,5797,1748,15505,9.5,11.1,10.1,"25% - 50% P.O.C.","$44000 - $52000"
"40015","Caddo County, Oklahoma",29242,46592,16607,651,6100,79,42,3778,56.8,2.2,20.9,0.3,0.1,12.9,43.2,10320,7355,2965,71.27,28.73,702,6653,332,2633,1034,9286,9.5,11.2,10,"25% - 50% P.O.C.","$44000 - $52000"
"40017","Canadian County, Oklahoma",140455,72056,106957,3902,5451,4168,0,12629,76.2,2.8,3.9,3,0,9,23.8,44906,33862,11044,75.41,24.59,3705,30157,1472,9572,5177,39729,10.9,13.3,11.5,"Less than 25% P.O.C.","$60000 or more"
"40019","Carter County, Oklahoma",48319,51419,33831,3141,3502,598,21,3520,70,6.5,7.2,1.2,0,7.3,30,18339,12521,5818,68.28,31.72,1140,11381,691,5127,1831,16508,9.1,11.9,10,"25% - 50% P.O.C.","$44000 - $52000"
"40021","Cherokee County, Oklahoma",48664,42774,23148,637,15981,359,139,3482,47.6,1.3,32.8,0.7,0.3,7.2,52.4,16665,11391,5274,68.35,31.65,1062,10329,461,4813,1523,15142,9.3,8.7,9.1,"50% - 75% P.O.C.","Less than $44000"
"40023","Choctaw County, Oklahoma",14807,34489,8977,1604,2211,13,25,649,60.6,10.8,14.9,0.1,0.2,4.4,39.4,5971,4136,1835,69.27,30.73,339,3797,141,1694,480,5491,8.2,7.7,8,"25% - 50% P.O.C.","Less than $44000"
"40025","Cimarron County, Oklahoma",2174,46328,1666,4,8,6,0,487,76.6,0.2,0.4,0.3,0,22.4,23.4,977,712,265,72.88,27.12,58,654,34,231,92,885,8.1,12.8,9.4,"Less than 25% P.O.C.","$44000 - $52000"
"40027","Cleveland County, Oklahoma",279274,64016,200328,12927,10765,12279,155,24275,71.7,4.6,3.9,4.4,0.1,8.7,28.3,106172,67586,38586,63.66,36.34,6758,60828,2563,36023,9321,96851,10,6.6,8.8,"25% - 50% P.O.C.","$60000 or more"
"40029","Coal County, Oklahoma",5581,40938,3817,11,553,24,0,260,68.4,0.2,9.9,0.4,0,4.7,31.6,2227,1649,578,74.05,25.95,173,1476,104,474,277,1950,10.5,18,12.4,"25% - 50% P.O.C.","Less than $44000"
"40031","Comanche County, Oklahoma",121762,52161,68419,18902,5357,2898,464,15954,56.2,15.5,4.4,2.4,0.4,13.1,43.8,42842,22762,20080,53.13,46.87,2104,20658,2299,17781,4403,38439,9.2,11.4,10.3,"25% - 50% P.O.C.","$52000 - $60000"
"40033","Cotton County, Oklahoma",5858,50885,4452,133,526,0,0,466,76,2.3,9,0,0,8,24,2195,1707,488,77.77,22.23,104,1603,22,466,126,2069,6.1,4.5,5.7,"Less than 25% P.O.C.","$44000 - $52000"
"40035","Craig County, Oklahoma",14390,43329,9114,441,3062,119,12,533,63.3,3.1,21.3,0.8,0.1,3.7,36.7,5422,3769,1653,69.51,30.49,301,3468,182,1471,483,4939,8,11,8.9,"25% - 50% P.O.C.","Less than $44000"
"40037","Creek County, Oklahoma",71427,51318,54258,1522,8182,310,15,3015,76,2.1,11.5,0.4,0,4.2,24,26427,19438,6989,73.55,26.45,1853,17585,784,6205,2637,23790,9.5,11.2,10,"Less than 25% P.O.C.","$44000 - $52000"
"40039","Custer County, Oklahoma",29152,49900,19891,900,984,329,10,5322,68.2,3.1,3.4,1.1,0,18.3,31.8,10653,6668,3985,62.59,37.41,462,6206,406,3579,868,9785,6.9,10.2,8.1,"25% - 50% P.O.C.","$44000 - $52000"
"40041","Delaware County, Oklahoma",42433,41696,27036,194,9309,520,36,1618,63.7,0.5,21.9,1.2,0.1,3.8,36.3,16739,12662,4077,75.64,24.36,1010,11652,459,3618,1469,15270,8,11.3,8.8,"25% - 50% P.O.C.","Less than $44000"
"40043","Dewey County, Oklahoma",4922,52428,4035,8,230,6,0,371,82,0.2,4.7,0.1,0,7.5,18,1689,1288,401,76.26,23.74,106,1182,38,363,144,1545,8.2,9.5,8.5,"Less than 25% P.O.C.","$52000 - $60000"
"40045","Ellis County, Oklahoma",4015,53245,3471,7,78,27,0,287,86.5,0.2,1.9,0.7,0,7.1,13.5,1614,1198,416,74.23,25.77,68,1130,14,402,82,1532,5.7,3.4,5.1,"Less than 25% P.O.C.","$52000 - $60000"
"40047","Garfield County, Oklahoma",61898,54006,46013,1485,1044,556,2103,7694,74.3,2.4,1.7,0.9,3.4,12.4,25.7,23541,15488,8053,65.79,34.21,1337,14151,1109,6944,2446,21095,8.6,13.8,10.4,"25% - 50% P.O.C.","$52000 - $60000"
"40049","Garvin County, Oklahoma",27835,47125,21018,609,1489,85,0,2464,75.5,2.2,5.3,0.3,0,8.9,24.5,10447,7241,3206,69.31,30.69,701,6540,331,2875,1032,9415,9.7,10.3,9.9,"Less than 25% P.O.C.","$44000 - $52000"
"40051","Grady County, Oklahoma",55071,60875,44864,1290,2581,226,0,3207,81.5,2.3,4.7,0.4,0,5.8,18.5,19857,15313,4544,77.12,22.88,1589,13724,468,4076,2057,17800,10.4,10.3,10.4,"Less than 25% P.O.C.","$60000 or more"
"40053","Grant County, Oklahoma",4397,57727,3870,41,72,8,4,222,88,0.9,1.6,0.2,0.1,5,12,1736,1330,406,76.61,23.39,106,1224,35,371,141,1595,8,8.6,8.1,"Less than 25% P.O.C.","$52000 - $60000"
"40055","Greer County, Oklahoma",5861,41488,4369,370,163,0,0,669,74.5,6.3,2.8,0,0,11.4,25.5,2054,1432,622,69.72,30.28,172,1260,100,522,272,1782,12,16.1,13.2,"25% - 50% P.O.C.","Less than $44000"
"40057","Harmon County, Oklahoma",2710,48344,1540,254,12,20,0,789,56.8,9.4,0.4,0.7,0,29.1,43.2,1113,814,299,73.14,26.86,105,709,46,253,151,962,12.9,15.4,13.6,"25% - 50% P.O.C.","$44000 - $52000"
"40059","Harper County, Oklahoma",3760,46154,2851,1,14,0,0,839,75.8,0,0.4,0,0,22.3,24.2,1258,986,272,78.38,21.62,131,855,60,212,191,1067,13.3,22.1,15.2,"Less than 25% P.O.C.","$44000 - $52000"
"40061","Haskell County, Oklahoma",12687,42348,8936,91,1159,90,3,560,70.4,0.7,9.1,0.7,0,4.4,29.6,4931,3685,1246,74.73,25.27,468,3217,135,1111,603,4328,12.7,10.8,12.2,"25% - 50% P.O.C.","Less than $44000"
"40063","Hughes County, Oklahoma",13372,39365,8382,761,2832,18,0,749,62.7,5.7,21.2,0.1,0,5.6,37.3,4132,3010,1122,72.85,27.15,242,2768,101,1021,343,3789,8,9,8.3,"25% - 50% P.O.C.","Less than $44000"
"40065","Jackson County, Oklahoma",25063,49703,15720,1640,380,308,15,6043,62.7,6.5,1.5,1.2,0.1,24.1,37.3,9762,5710,4052,58.49,41.51,543,5167,370,3682,913,8849,9.5,9.1,9.4,"25% - 50% P.O.C.","$44000 - $52000"
"40067","Jefferson County, Oklahoma",6158,39895,4788,85,342,1,0,651,77.8,1.4,5.6,0,0,10.6,22.2,2371,1710,661,72.12,27.88,141,1569,94,567,235,2136,8.2,14.2,9.9,"Less than 25% P.O.C.","Less than $44000"
"40069","Johnston County, Oklahoma",11064,41332,7692,204,762,10,0,599,69.5,1.8,6.9,0.1,0,5.4,30.5,4267,3137,1130,73.52,26.48,311,2826,127,1003,438,3829,9.9,11.2,10.3,"25% - 50% P.O.C.","Less than $44000"
"40071","Kay County, Oklahoma",44402,46809,33105,907,3657,188,0,3554,74.6,2,8.2,0.4,0,8,25.4,17610,11879,5731,67.46,32.54,1089,10790,619,5112,1708,15902,9.2,10.8,9.7,"25% - 50% P.O.C.","$44000 - $52000"
"40073","Kingfisher County, Oklahoma",15694,57777,11978,189,461,60,0,2501,76.3,1.2,2.9,0.4,0,15.9,23.7,5609,4280,1329,76.31,23.69,303,3977,213,1116,516,5093,7.1,16,9.2,"Less than 25% P.O.C.","$52000 - $60000"
"40075","Kiowa County, Oklahoma",8886,38019,6595,302,422,57,9,1049,74.2,3.4,4.7,0.6,0.1,11.8,25.8,3571,2576,995,72.14,27.86,179,2397,91,904,270,3301,6.9,9.1,7.6,"25% - 50% P.O.C.","Less than $44000"
"40077","Latimer County, Oklahoma",10348,44214,6698,113,2106,95,0,392,64.7,1.1,20.4,0.9,0,3.8,35.3,4088,2854,1234,69.81,30.19,197,2657,172,1062,369,3719,6.9,13.9,9,"25% - 50% P.O.C.","$44000 - $52000"
"40079","Le Flore County, Oklahoma",50026,40677,35691,939,5455,341,0,3511,71.3,1.9,10.9,0.7,0,7,28.7,18261,12966,5295,71,29,1337,11629,593,4702,1930,16331,10.3,11.2,10.6,"25% - 50% P.O.C.","Less than $44000"
"40081","Lincoln County, Oklahoma",34895,50671,28681,658,2478,89,30,1199,82.2,1.9,7.1,0.3,0.1,3.4,17.8,12763,10166,2597,79.65,20.35,927,9239,262,2335,1189,11574,9.1,10.1,9.3,"Less than 25% P.O.C.","$44000 - $52000"
"40083","Logan County, Oklahoma",46683,65357,36248,3808,1625,153,14,2891,77.6,8.2,3.5,0.3,0,6.2,22.4,15512,12858,2654,82.89,17.11,1177,11681,323,2331,1500,14012,9.2,12.2,9.7,"Less than 25% P.O.C.","$60000 or more"
"40085","Love County, Oklahoma",10063,49399,7141,263,526,82,0,1580,71,2.6,5.2,0.8,0,15.7,29,3268,2505,763,76.65,23.35,296,2209,70,693,366,2902,11.8,9.2,11.2,"25% - 50% P.O.C.","$44000 - $52000"
"40087","McClain County, Oklahoma",39247,67662,31070,420,2253,114,23,3151,79.2,1.1,5.7,0.3,0.1,8,20.8,14428,11455,2973,79.39,20.61,1038,10417,414,2559,1452,12976,9.1,13.9,10.1,"Less than 25% P.O.C.","$60000 or more"
"40089","McCurtain County, Oklahoma",33016,37061,20490,2599,4065,274,368,2001,62.1,7.9,12.3,0.8,1.1,6.1,37.9,12646,8956,3690,70.82,29.18,862,8094,566,3124,1428,11218,9.6,15.3,11.3,"25% - 50% P.O.C.","Less than $44000"
"40091","McIntosh County, Oklahoma",19725,39084,13389,528,3153,22,0,552,67.9,2.7,16,0.1,0,2.8,32.1,8327,6531,1796,78.43,21.57,590,5941,300,1496,890,7437,9,16.7,10.7,"25% - 50% P.O.C.","Less than $44000"
"40093","Major County, Oklahoma",7692,54332,6520,32,106,67,9,743,84.8,0.4,1.4,0.9,0.1,9.7,15.2,3123,2479,644,79.38,20.62,175,2304,80,564,255,2868,7.1,12.4,8.2,"Less than 25% P.O.C.","$52000 - $60000"
"40095","Marshall County, Oklahoma",16505,45746,10745,283,1147,34,0,2921,65.1,1.7,6.9,0.2,0,17.7,34.9,6195,4499,1696,72.62,27.38,420,4079,201,1495,621,5574,9.3,11.9,10,"25% - 50% P.O.C.","$44000 - $52000"
"40097","Mayes County, Oklahoma",41044,50345,26622,201,7128,173,145,1479,64.9,0.5,17.4,0.4,0.4,3.6,35.1,15983,11651,4332,72.9,27.1,1223,10428,558,3774,1781,14202,10.5,12.9,11.1,"25% - 50% P.O.C.","$44000 - $52000"
"40099","Murray County, Oklahoma",13946,52478,10043,221,1363,86,0,924,72,1.6,9.8,0.6,0,6.6,28,5238,3678,1560,70.22,29.78,293,3385,215,1345,508,4730,8,13.8,9.7,"25% - 50% P.O.C.","$52000 - $60000"
"40101","Muskogee County, Oklahoma",68736,43078,38425,7171,12104,469,21,4285,55.9,10.4,17.6,0.7,0,6.2,44.1,26234,17133,9101,65.31,34.69,1578,15555,823,8278,2401,23833,9.2,9,9.2,"25% - 50% P.O.C.","Less than $44000"
"40103","Noble County, Oklahoma",11335,56117,9184,30,720,9,4,439,81,0.3,6.4,0.1,0,3.9,19,4515,3469,1046,76.83,23.17,275,3194,142,904,417,4098,7.9,13.6,9.2,"Less than 25% P.O.C.","$52000 - $60000"
"40105","Nowata County, Oklahoma",10322,43145,6887,253,1548,15,19,318,66.7,2.5,15,0.1,0.2,3.1,33.3,4099,3023,1076,73.75,26.25,203,2820,103,973,306,3793,6.7,9.6,7.5,"25% - 50% P.O.C.","Less than $44000"
"40107","Okfuskee County, Oklahoma",12067,38411,7396,891,1756,0,0,481,61.3,7.4,14.6,0,0,4,38.7,3976,2831,1145,71.2,28.8,318,2513,164,981,482,3494,11.2,14.3,12.1,"25% - 50% P.O.C.","Less than $44000"
"40109","Oklahoma County, Oklahoma",787216,54520,440742,116115,20336,26343,515,136829,56,14.8,2.6,3.3,0.1,17.4,44,301570,177555,124015,58.88,41.12,16851,160704,11717,112298,28568,273002,9.5,9.4,9.5,"25% - 50% P.O.C.","$52000 - $60000"
"40111","Okmulgee County, Oklahoma",38749,42998,24116,3127,5370,169,0,1623,62.2,8.1,13.9,0.4,0,4.2,37.8,14724,10452,4272,70.99,29.01,910,9542,514,3758,1424,13300,8.7,12,9.7,"25% - 50% P.O.C.","Less than $44000"
"40113","Osage County, Oklahoma",47226,49103,29932,5248,5837,193,16,1704,63.4,11.1,12.4,0.4,0,3.6,36.6,18263,14304,3959,78.32,21.68,1294,13010,465,3494,1759,16504,9,11.7,9.6,"25% - 50% P.O.C.","$44000 - $52000"
"40115","Ottawa County, Oklahoma",31454,39872,20449,340,5578,228,215,1798,65,1.1,17.7,0.7,0.7,5.7,35,11847,8170,3677,68.96,31.04,723,7447,442,3235,1165,10682,8.8,12,9.8,"25% - 50% P.O.C.","Less than $44000"
"40117","Pawnee County, Oklahoma",16412,48009,12582,164,1785,60,3,507,76.7,1,10.9,0.4,0,3.1,23.3,6179,4672,1507,75.61,24.39,425,4247,190,1317,615,5564,9.1,12.6,10,"Less than 25% P.O.C.","$44000 - $52000"
"40119","Payne County, Oklahoma",81815,41603,62937,3223,3281,3508,71,3858,76.9,3.9,4,4.3,0.1,4.7,23.1,30788,15910,14878,51.68,48.32,1224,14686,1032,13846,2256,28532,7.7,6.9,7.3,"Less than 25% P.O.C.","Less than $44000"
"40121","Pittsburg County, Oklahoma",44146,46784,30662,1241,2624,153,49,2236,69.5,2.8,5.9,0.3,0.1,5.1,30.5,17816,12913,4903,72.48,27.52,1064,11849,573,4330,1637,16179,8.2,11.7,9.2,"25% - 50% P.O.C.","$44000 - $52000"
"40123","Pontotoc County, Oklahoma",38355,50392,25083,930,4788,298,36,2058,65.4,2.4,12.5,0.8,0.1,5.4,34.6,14278,9414,4864,65.93,34.07,876,8538,278,4586,1154,13124,9.3,5.7,8.1,"25% - 50% P.O.C.","$44000 - $52000"
"40125","Pottawatomie County, Oklahoma",72154,49250,52233,2453,10060,472,62,3730,72.4,3.4,13.9,0.7,0.1,5.2,27.6,25917,18006,7911,69.48,30.52,1691,16315,771,7140,2462,23455,9.4,9.7,9.5,"25% - 50% P.O.C.","$44000 - $52000"
"40127","Pushmataha County, Oklahoma",11128,37692,7900,84,1487,41,16,440,71,0.8,13.4,0.4,0.1,4,29,4477,3386,1091,75.63,24.37,285,3101,105,986,390,4087,8.4,9.6,8.7,"25% - 50% P.O.C.","Less than $44000"
"40129","Roger Mills County, Oklahoma",3667,51302,3066,9,208,0,0,264,83.6,0.2,5.7,0,0,7.2,16.4,1377,1033,344,75.02,24.98,116,917,33,311,149,1228,11.2,9.6,10.8,"Less than 25% P.O.C.","$44000 - $52000"
"40131","Rogers County, Oklahoma",91353,65434,65588,906,11333,1284,62,4345,71.8,1,12.4,1.4,0.1,4.8,28.2,34755,27177,7578,78.2,21.8,2991,24186,685,6893,3676,31079,11,9,10.6,"25% - 50% P.O.C.","$60000 or more"
"40133","Seminole County, Oklahoma",24832,39373,15999,1163,4889,134,3,1276,64.4,4.7,19.7,0.5,0,5.1,35.6,9317,6339,2978,68.04,31.96,635,5704,314,2664,949,8368,10,10.5,10.2,"25% - 50% P.O.C.","Less than $44000"
"40135","Sequoyah County, Oklahoma",41709,40351,26051,740,8216,333,24,1753,62.5,1.8,19.7,0.8,0.1,4.2,37.5,15474,11120,4354,71.86,28.14,1014,10106,588,3766,1602,13872,9.1,13.5,10.4,"25% - 50% P.O.C.","Less than $44000"
"40137","Stephens County, Oklahoma",43647,47214,34982,743,2133,235,36,3392,80.1,1.7,4.9,0.5,0.1,7.8,19.9,16720,12108,4612,72.42,27.58,852,11256,403,4209,1255,15465,7,8.7,7.5,"Less than 25% P.O.C.","$44000 - $52000"
"40139","Texas County, Oklahoma",20805,52282,9147,509,264,691,5,9552,44,2.4,1.3,3.3,0,45.9,56,6768,4601,2167,67.98,32.02,591,4010,326,1841,917,5851,12.8,15,13.5,"50% - 75% P.O.C.","$52000 - $60000"
"40141","Tillman County, Oklahoma",7413,42280,4386,555,198,16,0,2005,59.2,7.5,2.7,0.2,0,27,40.8,2807,2129,678,75.85,24.15,139,1990,89,589,228,2579,6.5,13.1,8.1,"25% - 50% P.O.C.","Less than $44000"
"40143","Tulsa County, Oklahoma",646419,55517,400632,64101,30187,21371,614,82309,62,9.9,4.7,3.3,0.1,12.7,38,252661,148594,104067,58.81,41.19,14870,133724,8744,95323,23614,229047,10,8.4,9.3,"25% - 50% P.O.C.","$52000 - $60000"
"40145","Wagoner County, Oklahoma",78958,62795,56445,2755,6769,1148,64,4895,71.5,3.5,8.6,1.5,0.1,6.2,28.5,29208,22966,6242,78.63,21.37,2604,20362,860,5382,3464,25744,11.3,13.8,11.9,"25% - 50% P.O.C.","$60000 or more"
"40147","Washington County, Oklahoma",51886,54997,37768,1400,5356,1147,10,3116,72.8,2.7,10.3,2.2,0,6,27.2,20455,14487,5968,70.82,29.18,1083,13404,379,5589,1462,18993,7.5,6.4,7.1,"25% - 50% P.O.C.","$52000 - $60000"
"40149","Washita County, Oklahoma",11225,53274,9359,142,180,8,0,1098,83.4,1.3,1.6,0.1,0,9.8,16.6,4224,2995,1229,70.9,29.1,249,2746,109,1120,358,3866,8.3,8.9,8.5,"Less than 25% P.O.C.","$52000 - $60000"
"40151","Woods County, Oklahoma",9043,54282,7499,246,128,106,0,661,82.9,2.7,1.4,1.2,0,7.3,17.1,3281,2245,1036,68.42,31.58,187,2058,70,966,257,3024,8.3,6.8,7.8,"Less than 25% P.O.C.","$52000 - $60000"
"40153","Woodward County, Oklahoma",20727,60147,16549,264,343,56,2,2663,79.8,1.3,1.7,0.3,0,12.8,20.2,7495,5340,2155,71.25,28.75,372,4968,146,2009,518,6977,7,6.8,6.9,"Less than 25% P.O.C.","$60000 or more"
"41001","Baker County, Oregon",16019,45998,14479,147,180,109,59,691,90.4,0.9,1.1,0.7,0.4,4.3,9.6,6921,4893,2028,70.7,29.3,268,4625,144,1884,412,6509,5.5,7.1,6,"Less than 25% P.O.C.","$44000 - $52000"
"41003","Benton County, Oregon",91107,62077,73083,937,480,6436,212,6740,80.2,1,0.5,7.1,0.2,7.4,19.8,35718,20438,15280,57.22,42.78,1488,18950,932,14348,2420,33298,7.3,6.1,6.8,"Less than 25% P.O.C.","$60000 or more"
"41005","Clackamas County, Oregon",410463,80484,336220,3613,2496,17280,913,35666,81.9,0.9,0.6,4.2,0.2,8.7,18.1,157408,111885,45523,71.08,28.92,10866,101019,3425,42098,14291,143117,9.7,7.5,9.1,"Less than 25% P.O.C.","$60000 or more"
"41007","Clatsop County, Oregon",39102,54886,33440,314,141,387,118,3329,85.5,0.8,0.4,1,0.3,8.5,14.5,15800,9826,5974,62.19,37.81,665,9161,404,5570,1069,14731,6.8,6.8,6.8,"Less than 25% P.O.C.","$52000 - $60000"
"41009","Columbia County, Oregon",51375,62257,45478,231,478,506,88,2652,88.5,0.4,0.9,1,0.2,5.2,11.5,19671,14832,4839,75.4,24.6,1281,13551,489,4350,1770,17901,8.6,10.1,9,"Less than 25% P.O.C.","$60000 or more"
"41011","Coos County, Oregon",63686,45051,54296,258,1207,652,30,4139,85.3,0.4,1.9,1,0,6.5,14.7,27025,17798,9227,65.86,34.14,1235,16563,608,8619,1843,25182,6.9,6.6,6.8,"Less than 25% P.O.C.","$44000 - $52000"
"41013","Crook County, Oregon",23011,49006,20296,126,181,80,101,1753,88.2,0.5,0.8,0.3,0.4,7.6,11.8,9588,6925,2663,72.23,27.77,513,6412,299,2364,812,8776,7.4,11.2,8.5,"Less than 25% P.O.C.","$44000 - $52000"
"41015","Curry County, Oregon",22650,48440,19536,99,245,118,0,1612,86.3,0.4,1.1,0.5,0,7.1,13.7,10546,7526,3020,71.36,28.64,236,7290,134,2886,370,10176,3.1,4.4,3.5,"Less than 25% P.O.C.","$44000 - $52000"
"41017","Deschutes County, Oregon",186251,67043,162506,1082,1029,2004,297,14853,87.3,0.6,0.6,1.1,0.2,8,12.7,74397,49809,24588,66.95,33.05,3278,46531,1833,22755,5111,69286,6.6,7.5,6.9,"Less than 25% P.O.C.","$60000 or more"
"41019","Douglas County, Oregon",109114,47267,95842,462,966,1078,65,6337,87.8,0.4,0.9,1,0.1,5.8,12.2,45456,30986,14470,68.17,31.83,2206,28780,1414,13056,3620,41836,7.1,9.8,8,"Less than 25% P.O.C.","$44000 - $52000"
"41021","Gilliam County, Oregon",1878,47500,1652,0,74,15,13,115,88,0,3.9,0.8,0.7,6.1,12,842,567,275,67.34,32.66,31,536,31,244,62,780,5.5,11.3,7.4,"Less than 25% P.O.C.","$44000 - $52000"
"41023","Grant County, Oregon",7189,44712,6575,7,96,55,17,272,91.5,0.1,1.3,0.8,0.2,3.8,8.5,3381,2404,977,71.1,28.9,79,2325,92,885,171,3210,3.3,9.4,5.1,"Less than 25% P.O.C.","$44000 - $52000"
"41025","Harney County, Oregon",7267,40735,6325,35,100,0,2,371,87,0.5,1.4,0,0,5.1,13,3244,2342,902,72.19,27.81,210,2132,76,826,286,2958,9,8.4,8.8,"Less than 25% P.O.C.","Less than $44000"
"41027","Hood River County, Oregon",23209,65679,14790,136,131,379,0,7293,63.7,0.6,0.6,1.6,0,31.4,36.3,8600,5782,2818,67.23,32.77,452,5330,413,2405,865,7735,7.8,14.7,10.1,"25% - 50% P.O.C.","$60000 or more"
"41029","Jackson County, Oregon",216574,53412,175058,1462,2294,2755,727,27778,80.8,0.7,1.1,1.3,0.3,12.8,19.2,88241,55792,32449,63.23,36.77,4134,51658,2902,29547,7036,81205,7.4,8.9,8,"Less than 25% P.O.C.","$52000 - $60000"
"41031","Jefferson County, Oregon",23607,53277,14260,179,3723,146,22,4715,60.4,0.8,15.8,0.6,0.1,20,39.6,8094,5510,2584,68.08,31.92,545,4965,252,2332,797,7297,9.9,9.8,9.8,"25% - 50% P.O.C.","$52000 - $60000"
"41033","Josephine County, Oregon",86251,45616,74953,399,934,842,50,6408,86.9,0.5,1.1,1,0.1,7.4,13.1,36367,24116,12251,66.31,33.69,1905,22211,1008,11243,2913,33454,7.9,8.2,8,"Less than 25% P.O.C.","$44000 - $52000"
"41035","Klamath County, Oregon",66921,46491,52101,446,2626,682,38,8740,77.9,0.7,3.9,1,0.1,13.1,22.1,27886,17924,9962,64.28,35.72,1600,16324,971,8991,2571,25315,8.9,9.7,9.2,"Less than 25% P.O.C.","$44000 - $52000"
"41037","Lake County, Oregon",7837,37898,6618,27,189,77,0,640,84.4,0.3,2.4,1,0,8.2,15.6,3515,2176,1339,61.91,38.09,93,2083,100,1239,193,3322,4.3,7.5,5.5,"Less than 25% P.O.C.","Less than $44000"
"41039","Lane County, Oregon",373340,52426,305453,3754,3311,9936,879,33109,81.8,1,0.9,2.7,0.2,8.9,18.2,152312,89359,62953,58.67,41.33,6123,83236,4488,58465,10611,141701,6.9,7.1,7,"Less than 25% P.O.C.","$52000 - $60000"
"41041","Lincoln County, Oregon",48547,47882,40034,218,1193,603,96,4447,82.5,0.4,2.5,1.2,0.2,9.2,17.5,21298,13977,7321,65.63,34.37,745,13232,438,6883,1183,20115,5.3,6,5.6,"Less than 25% P.O.C.","$44000 - $52000"
"41043","Linn County, Oregon",125048,55893,106183,616,884,1310,123,11393,84.9,0.5,0.7,1,0.1,9.1,15.1,47762,30748,17014,64.38,35.62,3254,27494,1600,15414,4854,42908,10.6,9.4,10.2,"Less than 25% P.O.C.","$52000 - $60000"
"41045","Malheur County, Oregon",30412,43313,18591,297,249,413,30,10257,61.1,1,0.8,1.4,0.1,33.7,38.9,10062,5865,4197,58.29,41.71,694,5171,574,3623,1268,8794,11.8,13.7,12.6,"25% - 50% P.O.C.","Less than $44000"
"41047","Marion County, Oregon",339641,59625,222354,3596,1958,6792,2973,90277,65.5,1.1,0.6,2,0.9,26.6,34.5,118038,71101,46937,60.24,39.76,9094,62007,5770,41167,14864,103174,12.8,12.3,12.6,"25% - 50% P.O.C.","$52000 - $60000"
"41049","Morrow County, Oregon",11303,54269,6698,26,57,70,58,4126,59.3,0.2,0.5,0.6,0.5,36.5,40.7,4108,2876,1232,70.01,29.99,387,2489,263,969,650,3458,13.5,21.3,15.8,"25% - 50% P.O.C.","$52000 - $60000"
"41051","Multnomah County, Oregon",804606,69176,560762,42693,5525,59127,4909,93276,69.7,5.3,0.7,7.3,0.6,11.6,30.3,326229,177889,148340,54.53,45.47,14370,163519,9261,139079,23631,302598,8.1,6.2,7.2,"25% - 50% P.O.C.","$60000 or more"
"41053","Polk County, Oregon",83037,62691,64837,659,1474,1520,391,11545,78.1,0.8,1.8,1.8,0.5,13.9,21.9,30305,20081,10224,66.26,33.74,2227,17854,920,9304,3147,27158,11.1,9,10.4,"Less than 25% P.O.C.","$60000 or more"
"41055","Sherman County, Oregon",1642,51071,1467,3,12,2,23,81,89.3,0.2,0.7,0.1,1.4,4.9,10.7,748,483,265,64.57,35.43,28,455,28,237,56,692,5.8,10.6,7.5,"Less than 25% P.O.C.","$44000 - $52000"
"41057","Tillamook County, Oregon",26389,49895,22258,102,236,181,123,2727,84.3,0.4,0.9,0.7,0.5,10.3,15.7,10784,7469,3315,69.26,30.74,394,7075,430,2885,824,9960,5.3,13,7.6,"Less than 25% P.O.C.","$44000 - $52000"
"41059","Umatilla County, Oregon",77129,54699,50691,721,1915,769,199,20665,65.7,0.9,2.5,1,0.3,26.8,34.3,26908,17678,9230,65.7,34.3,2081,15597,1226,8004,3307,23601,11.8,13.3,12.3,"25% - 50% P.O.C.","$52000 - $60000"
"41061","Union County, Oregon",26337,52171,23365,174,216,283,385,1276,88.7,0.7,0.8,1.1,1.5,4.8,11.3,10708,6911,3797,64.54,35.46,542,6369,457,3340,999,9709,7.8,12,9.3,"Less than 25% P.O.C.","$52000 - $60000"
"41063","Wallowa County, Oregon",7004,51224,6509,12,74,18,9,217,92.9,0.2,1.1,0.3,0.1,3.1,7.1,3214,2239,975,69.66,30.34,191,2048,53,922,244,2970,8.5,5.4,7.6,"Less than 25% P.O.C.","$44000 - $52000"
"41065","Wasco County, Oregon",26130,53105,19482,79,773,238,154,4755,74.6,0.3,3,0.9,0.6,18.2,25.4,10305,6408,3897,62.18,37.82,477,5931,456,3441,933,9372,7.4,11.7,9.1,"25% - 50% P.O.C.","$52000 - $60000"
"41067","Washington County, Oregon",589481,82215,387456,11469,1539,62050,2417,98201,65.7,1.9,0.3,10.5,0.4,16.7,34.3,219053,135022,84031,61.64,38.36,12591,122431,7139,76892,19730,199323,9.3,8.5,9,"25% - 50% P.O.C.","$60000 or more"
"41069","Wheeler County, Oregon",1415,40926,1235,0,9,4,2,122,87.3,0,0.6,0.3,0.1,8.6,12.7,640,487,153,76.09,23.91,10,477,21,132,31,609,2.1,13.7,4.8,"Less than 25% P.O.C.","Less than $44000"
"41071","Yamhill County, Oregon",104831,63902,80959,853,1055,1495,262,16639,77.2,0.8,1,1.4,0.2,15.9,22.8,36808,25772,11036,70.02,29.98,3127,22645,1217,9819,4344,32464,12.1,11,11.8,"Less than 25% P.O.C.","$60000 or more"
"42001","Adams County, Pennsylvania",102470,67253,91205,1317,74,717,0,7267,89,1.3,0.1,0.7,0,7.1,11,39345,30692,8653,78.01,21.99,2782,27910,615,8038,3397,35948,9.1,7.1,8.6,"Less than 25% P.O.C.","$60000 or more"
"42003","Allegheny County, Pennsylvania",1221744,61043,959267,154976,1028,45091,253,25777,78.5,12.7,0.1,3.7,0,2.1,21.5,541541,348130,193411,64.29,35.71,22388,325742,7359,186052,29747,511794,6.4,3.8,5.5,"Less than 25% P.O.C.","$60000 or more"
"42005","Armstrong County, Pennsylvania",65867,51410,63945,548,26,201,0,509,97.1,0.8,0,0.3,0,0.8,2.9,28137,21373,6764,75.96,24.04,1615,19758,251,6513,1866,26271,7.6,3.7,6.6,"Less than 25% P.O.C.","$44000 - $52000"
"42007","Beaver County, Pennsylvania",165833,57807,148374,9509,106,868,93,2661,89.5,5.7,0.1,0.5,0.1,1.6,10.5,71167,52043,19124,73.13,26.87,3543,48500,1109,18015,4652,66515,6.8,5.8,6.5,"Less than 25% P.O.C.","$52000 - $60000"
"42009","Bedford County, Pennsylvania",48337,50509,46747,307,69,188,0,589,96.7,0.6,0.1,0.4,0,1.2,3.3,19882,15722,4160,79.08,20.92,1237,14485,291,3869,1528,18354,7.9,7,7.7,"Less than 25% P.O.C.","$44000 - $52000"
"42011","Berks County, Pennsylvania",418025,63728,299730,17728,353,5711,50,87914,71.7,4.2,0.1,1.4,0,21,28.3,154712,110655,44057,71.52,28.48,10809,99846,4513,39544,15322,139390,9.8,10.2,9.9,"25% - 50% P.O.C.","$60000 or more"
"42013","Blair County, Pennsylvania",123157,49181,116471,1971,154,756,60,1562,94.6,1.6,0.1,0.6,0,1.3,5.4,52126,36377,15749,69.79,30.21,2925,33452,1099,14650,4024,48102,8,7,7.7,"Less than 25% P.O.C.","$44000 - $52000"
"42015","Bradford County, Pennsylvania",60963,52358,58337,308,28,437,96,901,95.7,0.5,0,0.7,0.2,1.5,4.3,25021,18520,6501,74.02,25.98,1621,16899,664,5837,2285,22736,8.8,10.2,9.1,"Less than 25% P.O.C.","$52000 - $60000"
"42017","Bucks County, Pennsylvania",626806,89139,526866,24216,877,30010,93,33339,84.1,3.9,0.1,4.8,0,5.3,15.9,238830,183853,54977,76.98,23.02,18125,165728,2727,52250,20852,217978,9.9,5,8.7,"Less than 25% P.O.C.","$60000 or more"
"42019","Butler County, Pennsylvania",186899,70668,176984,1690,71,2333,25,2790,94.7,0.9,0,1.2,0,1.5,5.3,76502,58061,18441,75.89,24.11,4757,53304,848,17593,5605,70897,8.2,4.6,7.3,"Less than 25% P.O.C.","$60000 or more"
"42021","Cambria County, Pennsylvania",133009,46659,123309,4211,56,574,38,2174,92.7,3.2,0,0.4,0,1.6,7.3,56674,42000,14674,74.11,25.89,2836,39164,895,13779,3731,52943,6.8,6.1,6.6,"Less than 25% P.O.C.","$44000 - $52000"
"42023","Cameron County, Pennsylvania",4611,41165,4414,2,2,39,0,51,95.7,0,0,0.8,0,1.1,4.3,2184,1572,612,71.98,28.02,75,1497,37,575,112,2072,4.8,6,5.1,"Less than 25% P.O.C.","Less than $44000"
"42025","Carbon County, Pennsylvania",63887,57006,58585,1223,117,360,8,3035,91.7,1.9,0.2,0.6,0,4.8,8.3,26043,19753,6290,75.85,24.15,1428,18325,574,5716,2002,24041,7.2,9.1,7.7,"Less than 25% P.O.C.","$52000 - $60000"
"42027","Centre County, Pennsylvania",161960,60403,138374,5805,76,9897,52,4777,85.4,3.6,0,6.1,0,2.9,14.6,58201,35806,22395,61.52,38.48,2568,33238,1183,21212,3751,54450,7.2,5.3,6.4,"Less than 25% P.O.C.","$60000 or more"
"42029","Chester County, Pennsylvania",519560,100214,412720,29146,452,28373,106,38522,79.4,5.6,0.1,5.5,0,7.4,20.6,190980,143192,47788,74.98,25.02,14586,128606,3135,44653,17721,173259,10.2,6.6,9.3,"Less than 25% P.O.C.","$60000 or more"
"42031","Clarion County, Pennsylvania",38715,46680,37154,469,53,220,21,373,96,1.2,0.1,0.6,0.1,1,4,16021,11073,4948,69.12,30.88,808,10265,266,4682,1074,14947,7.3,5.4,6.7,"Less than 25% P.O.C.","$44000 - $52000"
"42033","Clearfield County, Pennsylvania",79908,49015,74325,2092,172,401,0,2363,93,2.6,0.2,0.5,0,3,7,31248,23992,7256,76.78,23.22,1714,22278,508,6748,2222,29026,7.1,7,7.1,"Less than 25% P.O.C.","$44000 - $52000"
"42035","Clinton County, Pennsylvania",38915,50923,37035,680,47,323,5,590,95.2,1.7,0.1,0.8,0,1.5,4.8,14690,10312,4378,70.2,29.8,834,9478,299,4079,1133,13557,8.1,6.8,7.7,"Less than 25% P.O.C.","$44000 - $52000"
"42037","Columbia County, Pennsylvania",65715,50550,61253,1125,78,735,20,1810,93.2,1.7,0.1,1.1,0,2.8,6.8,26372,18259,8113,69.24,30.76,1162,17097,490,7623,1652,24720,6.4,6,6.3,"Less than 25% P.O.C.","$44000 - $52000"
"42039","Crawford County, Pennsylvania",85665,50304,81208,1342,33,462,21,1119,94.8,1.6,0,0.5,0,1.3,5.2,35164,25633,9531,72.9,27.1,2058,23575,548,8983,2606,32558,8,5.7,7.4,"Less than 25% P.O.C.","$44000 - $52000"
"42041","Cumberland County, Pennsylvania",249328,71269,213638,9190,200,10602,20,9815,85.7,3.7,0.1,4.3,0,3.9,14.3,99804,70210,29594,70.35,29.65,4961,65249,1550,28044,6511,93293,7.1,5.2,6.5,"Less than 25% P.O.C.","$60000 or more"
"42043","Dauphin County, Pennsylvania",275632,60715,181239,49695,357,12042,9,25457,65.8,18,0.1,4.4,0,9.2,34.2,112212,70933,41279,63.21,36.79,5410,65523,2933,38346,8343,103869,7.6,7.1,7.4,"25% - 50% P.O.C.","$60000 or more"
"42045","Delaware County, Pennsylvania",564554,74477,377160,119143,664,32053,34,21472,66.8,21.1,0.1,5.7,0,3.8,33.2,207257,142562,64695,68.79,31.21,14875,127687,4390,60305,19265,187992,10.4,6.8,9.3,"25% - 50% P.O.C.","$60000 or more"
"42047","Elk County, Pennsylvania",30340,53440,29535,261,42,153,0,247,97.3,0.9,0.1,0.5,0,0.8,2.7,14020,11014,3006,78.56,21.44,623,10391,125,2881,748,13272,5.7,4.2,5.3,"Less than 25% P.O.C.","$52000 - $60000"
"42049","Erie County, Pennsylvania",273835,51529,230646,18700,674,4538,41,11532,84.2,6.8,0.2,1.7,0,4.2,15.8,110318,72878,37440,66.06,33.94,6282,66596,2737,34703,9019,101299,8.6,7.3,8.2,"Less than 25% P.O.C.","$44000 - $52000"
"42051","Fayette County, Pennsylvania",131302,47364,120483,5443,26,474,81,1611,91.8,4.1,0,0.4,0.1,1.2,8.2,54837,40804,14033,74.41,25.59,2967,37837,860,13173,3827,51010,7.3,6.1,7,"Less than 25% P.O.C.","$44000 - $52000"
"42053","Forest County, Pennsylvania",7313,39717,4899,1854,3,8,0,405,67,25.4,0,0.1,0,5.5,33,1839,1543,296,83.9,16.1,48,1495,16,280,64,1775,3.1,5.4,3.5,"25% - 50% P.O.C.","Less than $44000"
"42055","Franklin County, Pennsylvania",154147,63379,135774,5389,150,1253,0,8694,88.1,3.5,0.1,0.8,0,5.6,11.9,60438,43021,17417,71.18,28.82,3820,39201,1647,15770,5467,54971,8.9,9.5,9,"Less than 25% P.O.C.","$60000 or more"
"42057","Fulton County, Pennsylvania",14506,53476,13931,195,42,18,0,174,96,1.3,0.3,0.1,0,1.2,4,5989,4638,1351,77.44,22.56,321,4317,132,1219,453,5536,6.9,9.8,7.6,"Less than 25% P.O.C.","$52000 - $60000"
"42059","Greene County, Pennsylvania",36870,54776,34442,1058,11,132,0,563,93.4,2.9,0,0.4,0,1.5,6.6,14230,10650,3580,74.84,25.16,742,9908,244,3336,986,13244,7,6.8,6.9,"Less than 25% P.O.C.","$52000 - $60000"
"42061","Huntingdon County, Pennsylvania",45369,51678,41075,2386,75,261,3,896,90.5,5.3,0.2,0.6,0,2,9.5,16779,12695,4084,75.66,24.34,1039,11656,238,3846,1277,15502,8.2,5.8,7.6,"Less than 25% P.O.C.","$44000 - $52000"
"42063","Indiana County, Pennsylvania",85032,49320,79858,1839,49,840,8,1101,93.9,2.2,0.1,1,0,1.3,6.1,33246,23660,9586,71.17,28.83,1965,21695,633,8953,2598,30648,8.3,6.6,7.8,"Less than 25% P.O.C.","$44000 - $52000"
"42065","Jefferson County, Pennsylvania",43846,47603,42600,206,42,121,19,403,97.2,0.5,0.1,0.3,0,0.9,2.8,18427,13689,4738,74.29,25.71,1105,12584,356,4382,1461,16966,8.1,7.5,7.9,"Less than 25% P.O.C.","$44000 - $52000"
"42067","Juniata County, Pennsylvania",24624,53879,23195,270,0,97,0,941,94.2,1.1,0,0.4,0,3.8,5.8,9372,6985,2387,74.53,25.47,731,6254,258,2129,989,8383,10.5,10.8,10.6,"Less than 25% P.O.C.","$52000 - $60000"
"42069","Lackawanna County, Pennsylvania",210652,52821,179465,5430,54,5905,80,15845,85.2,2.6,0,2.8,0,7.5,14.8,87161,56028,31133,64.28,35.72,4088,51940,2684,28449,6772,80389,7.3,8.6,7.8,"Less than 25% P.O.C.","$52000 - $60000"
"42071","Lancaster County, Pennsylvania",540999,66056,443533,18900,476,11796,89,56715,82,3.5,0.1,2.2,0,10.5,18,201620,137217,64403,68.06,31.94,15729,121488,5550,58853,21279,180341,11.5,8.6,10.6,"Less than 25% P.O.C.","$60000 or more"
"42073","Lawrence County, Pennsylvania",86727,50204,79771,3104,67,367,0,1261,92,3.6,0.1,0.4,0,1.5,8,37055,27624,9431,74.55,25.45,2230,25394,613,8818,2843,34212,8.1,6.5,7.7,"Less than 25% P.O.C.","$44000 - $52000"
"42075","Lebanon County, Pennsylvania",139729,60281,114872,2914,104,1906,22,18328,82.2,2.1,0.1,1.4,0,13.1,17.8,53579,37479,16100,69.95,30.05,3233,34246,1490,14610,4723,48856,8.6,9.3,8.8,"Less than 25% P.O.C.","$60000 or more"
"42077","Lehigh County, Pennsylvania",365052,63897,235175,20346,291,12077,50,89367,64.4,5.6,0.1,3.3,0,24.5,35.6,138714,89359,49355,64.42,35.58,8468,80891,5413,43942,13881,124833,9.5,11,10,"25% - 50% P.O.C.","$60000 or more"
"42079","Luzerne County, Pennsylvania",317663,53473,259005,11813,418,3859,59,37790,81.5,3.7,0.1,1.2,0,11.9,18.5,128660,87431,41229,67.96,32.04,6504,80927,3197,38032,9701,118959,7.4,7.8,7.5,"Less than 25% P.O.C.","$52000 - $60000"
"42081","Lycoming County, Pennsylvania",114330,54241,103616,5579,221,806,25,2290,90.6,4.9,0.2,0.7,0,2,9.4,45608,31581,14027,69.24,30.76,2311,29270,1058,12969,3369,42239,7.3,7.5,7.4,"Less than 25% P.O.C.","$52000 - $60000"
"42083","McKean County, Pennsylvania",41401,48647,38700,975,55,212,21,868,93.5,2.4,0.1,0.5,0.1,2.1,6.5,17147,12699,4448,74.06,25.94,785,11914,349,4099,1134,16013,6.2,7.8,6.6,"Less than 25% P.O.C.","$44000 - $52000"
"42085","Mercer County, Pennsylvania",111518,50696,100566,6257,115,802,2,1670,90.2,5.6,0.1,0.7,0,1.5,9.8,46340,33597,12743,72.5,27.5,2537,31060,828,11915,3365,42975,7.6,6.5,7.3,"Less than 25% P.O.C.","$44000 - $52000"
"42087","Mifflin County, Pennsylvania",46276,50219,44369,241,92,153,3,724,95.9,0.5,0.2,0.3,0,1.6,4.1,19043,13580,5463,71.31,28.69,1239,12341,362,5101,1601,17442,9.1,6.6,8.4,"Less than 25% P.O.C.","$44000 - $52000"
"42089","Monroe County, Pennsylvania",168032,63934,111011,22699,206,3900,8,26701,66.1,13.5,0.1,2.3,0,15.9,33.9,57098,43960,13138,76.99,23.01,4641,39319,1295,11843,5936,51162,10.6,9.9,10.4,"25% - 50% P.O.C.","$60000 or more"
"42091","Montgomery County, Pennsylvania",823823,91546,624278,74027,606,62420,225,42350,75.8,9,0.1,7.6,0,5.1,24.2,316206,226985,89221,71.78,28.22,21934,205051,5107,84114,27041,289165,9.7,5.7,8.6,"Less than 25% P.O.C.","$60000 or more"
"42093","Montour County, Pennsylvania",18259,58333,16677,328,11,632,0,504,91.3,1.8,0.1,3.5,0,2.8,8.7,7404,4972,2432,67.15,32.85,354,4618,84,2348,438,6966,7.1,3.5,5.9,"Less than 25% P.O.C.","$52000 - $60000"
"42095","Northampton County, Pennsylvania",302809,70471,232123,15287,293,8349,114,40088,76.7,5,0.1,2.8,0,13.2,23.3,114185,81503,32682,71.38,28.62,7058,74445,3193,29489,10251,103934,8.7,9.8,9,"Less than 25% P.O.C.","$60000 or more"
"42097","Northumberland County, Pennsylvania",91761,48671,84864,2208,182,360,35,3192,92.5,2.4,0.2,0.4,0,3.5,7.5,39075,27654,11421,70.77,29.23,1953,25701,913,10508,2866,36209,7.1,8,7.3,"Less than 25% P.O.C.","$44000 - $52000"
"42099","Perry County, Pennsylvania",46053,63718,43898,424,92,162,0,939,95.3,0.9,0.2,0.4,0,2,4.7,18231,14399,3832,78.98,21.02,1317,13082,385,3447,1702,16529,9.1,10,9.3,"Less than 25% P.O.C.","$60000 or more"
"42101","Philadelphia County, Pennsylvania",1579075,45927,544434,644723,3343,113484,395,231858,34.5,40.8,0.2,7.2,0,14.7,65.5,601337,318872,282465,53.03,46.97,27974,290898,20626,261839,48600,552737,8.8,7.3,8.1,"50% - 75% P.O.C.","$44000 - $52000"
"42103","Pike County, Pennsylvania",55453,65928,44597,2983,54,656,20,6052,80.4,5.4,0.1,1.2,0,10.9,19.6,22119,18411,3708,83.24,16.76,1518,16893,345,3363,1863,20256,8.2,9.3,8.4,"Less than 25% P.O.C.","$60000 or more"
"42105","Potter County, Pennsylvania",16806,45419,16217,67,34,59,0,229,96.5,0.4,0.2,0.4,0,1.4,3.5,6480,4939,1541,76.22,23.78,339,4600,103,1438,442,6038,6.9,6.7,6.8,"Less than 25% P.O.C.","$44000 - $52000"
"42107","Schuylkill County, Pennsylvania",142674,52280,129831,4134,180,688,8,6284,91,2.9,0.1,0.5,0,4.4,9,58749,44446,14303,75.65,24.35,2914,41532,926,13377,3840,54909,6.6,6.5,6.5,"Less than 25% P.O.C.","$52000 - $60000"
"42109","Snyder County, Pennsylvania",40483,58997,38493,373,30,275,0,867,95.1,0.9,0.1,0.7,0,2.1,4.9,14794,10676,4118,72.16,27.84,1196,9480,250,3868,1446,13348,11.2,6.1,9.8,"Less than 25% P.O.C.","$52000 - $60000"
"42111","Somerset County, Pennsylvania",74361,49089,70096,1820,35,251,5,1115,94.3,2.4,0,0.3,0,1.5,5.7,29644,23143,6501,78.07,21.93,1386,21757,525,5976,1911,27733,6,8.1,6.4,"Less than 25% P.O.C.","$44000 - $52000"
"42113","Sullivan County, Pennsylvania",6135,47407,5833,146,5,5,2,112,95.1,2.4,0.1,0.1,0,1.8,4.9,2723,2232,491,81.97,18.03,106,2126,36,455,142,2581,4.7,7.3,5.2,"Less than 25% P.O.C.","$44000 - $52000"
"42115","Susquehanna County, Pennsylvania",40970,54966,39438,260,8,157,0,704,96.3,0.6,0,0.4,0,1.7,3.7,17235,13281,3954,77.06,22.94,891,12390,369,3585,1260,15975,6.7,9.3,7.3,"Less than 25% P.O.C.","$52000 - $60000"
"42117","Tioga County, Pennsylvania",40944,51324,39340,283,25,215,13,518,96.1,0.7,0.1,0.5,0,1.3,3.9,16310,11877,4433,72.82,27.18,925,10952,340,4093,1265,15045,7.8,7.7,7.8,"Less than 25% P.O.C.","$44000 - $52000"
"42119","Union County, Pennsylvania",45111,59399,38014,2802,224,754,4,2654,84.3,6.2,0.5,1.7,0,5.9,15.7,14533,10521,4012,72.39,27.61,1035,9486,418,3594,1453,13080,9.8,10.4,10,"Less than 25% P.O.C.","$52000 - $60000"
"42121","Venango County, Pennsylvania",51818,49945,49645,368,13,193,0,567,95.8,0.7,0,0.4,0,1.1,4.2,22050,16549,5501,75.05,24.95,1187,15362,384,5117,1571,20479,7.2,7,7.1,"Less than 25% P.O.C.","$44000 - $52000"
"42123","Warren County, Pennsylvania",39756,50250,38471,186,43,191,0,432,96.8,0.5,0.1,0.5,0,1.1,3.2,17115,13157,3958,76.87,23.13,819,12338,220,3738,1039,16076,6.2,5.6,6.1,"Less than 25% P.O.C.","$44000 - $52000"
"42125","Washington County, Pennsylvania",207212,63543,191012,6298,93,1971,81,3540,92.2,3,0,1,0,1.7,7.8,84948,64232,20716,75.61,24.39,4650,59582,1352,19364,6002,78946,7.2,6.5,7.1,"Less than 25% P.O.C.","$60000 or more"
"42127","Wayne County, Pennsylvania",51422,56096,46533,1489,70,281,9,2297,90.5,2.9,0.1,0.5,0,4.5,9.5,18841,15259,3582,80.99,19.01,1127,14132,293,3289,1420,17421,7.4,8.2,7.5,"Less than 25% P.O.C.","$52000 - $60000"
"42129","Westmoreland County, Pennsylvania",352590,60471,330692,8085,154,3231,30,4187,93.8,2.3,0,0.9,0,1.2,6.2,152283,117573,34710,77.21,22.79,7116,110457,1995,32715,9111,143172,6.1,5.7,6,"Less than 25% P.O.C.","$60000 or more"
"42131","Wyoming County, Pennsylvania",27327,59415,26125,279,21,60,0,513,95.6,1,0.1,0.2,0,1.9,4.4,10790,8333,2457,77.23,22.77,644,7689,154,2303,798,9992,7.7,6.3,7.4,"Less than 25% P.O.C.","$52000 - $60000"
"42133","York County, Pennsylvania",445565,66457,371691,23921,661,6650,160,33221,83.4,5.4,0.1,1.5,0,7.5,16.6,172421,129109,43312,74.88,25.12,10523,118586,4094,39218,14617,157804,8.2,9.5,8.5,"Less than 25% P.O.C.","$60000 or more"
"44001","Bristol County, Rhode Island",48764,83092,44582,615,34,1006,0,1486,91.4,1.3,0.1,2.1,0,3,8.6,19217,13592,5625,70.73,29.27,805,12787,121,5504,926,18291,5.9,2.2,4.8,"Less than 25% P.O.C.","$60000 or more"
"44003","Kent County, Rhode Island",163869,73521,144749,2640,310,4446,0,8157,88.3,1.6,0.2,2.7,0,5,11.7,69422,48692,20730,70.14,29.86,3866,44826,1015,19715,4881,64541,7.9,4.9,7,"Less than 25% P.O.C.","$60000 or more"
"44005","Newport County, Rhode Island",82801,79454,71016,2899,350,1612,73,4718,85.8,3.5,0.4,1.9,0.1,5.7,14.2,34777,21993,12784,63.24,36.76,1028,20965,649,12135,1677,33100,4.7,5.1,4.8,"Less than 25% P.O.C.","$60000 or more"
"44007","Providence County, Rhode Island",635737,58974,386474,52674,1803,25923,490,144826,60.8,8.3,0.3,4.1,0.1,22.8,39.2,237971,128897,109074,54.17,45.83,11333,117564,7584,101490,18917,219054,8.8,7,7.9,"25% - 50% P.O.C.","$52000 - $60000"
"44009","Washington County, Rhode Island",126060,85531,114611,1587,905,2414,98,4039,90.9,1.3,0.7,1.9,0.1,3.2,9.1,49102,36318,12784,73.96,26.04,2125,34193,952,11832,3077,46025,5.9,7.4,6.3,"Less than 25% P.O.C.","$60000 or more"
"45001","Abbeville County, South Carolina",24627,38741,16956,6804,15,79,0,367,68.9,27.6,0.1,0.3,0,1.5,31.1,9660,7248,2412,75.03,24.97,375,6873,144,2268,519,9141,5.2,6,5.4,"25% - 50% P.O.C.","Less than $44000"
"45003","Aiken County, South Carolina",168301,51399,111410,41371,510,1557,80,9622,66.2,24.6,0.3,0.9,0,5.7,33.8,67598,49051,18547,72.56,27.44,3452,45599,1718,16829,5170,62428,7,9.3,7.6,"25% - 50% P.O.C.","$44000 - $52000"
"45005","Allendale County, South Carolina",9024,27185,1993,6644,25,14,4,302,22.1,73.6,0.3,0.2,0,3.3,77.9,3365,2295,1070,68.2,31.8,168,2127,94,976,262,3103,7.3,8.8,7.8,"75% or more P.O.C.","Less than $44000"
"45007","Anderson County, South Carolina",198064,50865,153211,30865,310,1845,54,7432,77.4,15.6,0.2,0.9,0,3.8,22.6,76798,55081,21717,71.72,28.28,4727,50354,1899,19818,6626,70172,8.6,8.7,8.6,"Less than 25% P.O.C.","$44000 - $52000"
"45009","Bamberg County, South Carolina",14376,31422,5171,8769,13,50,0,300,36,61,0.1,0.3,0,2.1,64,5334,3768,1566,70.64,29.36,226,3542,273,1293,499,4835,6,17.4,9.4,"50% - 75% P.O.C.","Less than $44000"
"45011","Barnwell County, South Carolina",21346,35803,10756,9721,0,24,0,524,50.4,45.5,0,0.1,0,2.5,49.6,8360,5815,2545,69.56,30.44,417,5398,243,2302,660,7700,7.2,9.5,7.9,"25% - 50% P.O.C.","Less than $44000"
"45013","Beaufort County, South Carolina",186095,68377,126401,32593,405,2365,122,20635,67.9,17.5,0.2,1.3,0.1,11.1,32.1,71477,52424,19053,73.34,26.66,2559,49865,1762,17291,4321,67156,4.9,9.2,6,"25% - 50% P.O.C.","$60000 or more"
"45015","Berkeley County, South Carolina",215044,63309,136645,51286,792,4726,188,14206,63.5,23.8,0.4,2.2,0.1,6.6,36.5,76881,55295,21586,71.92,28.08,5322,49973,1864,19722,7186,69695,9.6,8.6,9.3,"25% - 50% P.O.C.","$60000 or more"
"45017","Calhoun County, South Carolina",14663,46339,7915,5988,122,4,54,553,54,40.8,0.8,0,0.4,3.8,46,6179,4963,1216,80.32,19.68,425,4538,141,1075,566,5613,8.6,11.6,9.2,"25% - 50% P.O.C.","$44000 - $52000"
"45019","Charleston County, South Carolina",401165,64022,258868,106449,717,6036,269,20591,64.5,26.5,0.2,1.5,0.1,5.1,35.5,159195,97986,61209,61.55,38.45,5614,92372,2458,58751,8072,151123,5.7,4,5.1,"25% - 50% P.O.C.","$60000 or more"
"45021","Cherokee County, South Carolina",56895,36883,41408,11394,59,332,25,2479,72.8,20,0.1,0.6,0,4.4,27.2,20699,14270,6429,68.94,31.06,703,13567,315,6114,1018,19681,4.9,4.9,4.9,"25% - 50% P.O.C.","Less than $44000"
"45023","Chester County, South Carolina",32311,42442,18954,11948,153,65,0,653,58.7,37,0.5,0.2,0,2,41.3,12653,9628,3025,76.09,23.91,787,8841,225,2800,1012,11641,8.2,7.4,8,"25% - 50% P.O.C.","Less than $44000"
"45025","Chesterfield County, South Carolina",45953,41505,27707,14596,139,230,33,1985,60.3,31.8,0.3,0.5,0.1,4.3,39.7,17900,12723,5177,71.08,28.92,973,11750,567,4610,1540,16360,7.6,11,8.6,"25% - 50% P.O.C.","Less than $44000"
"45027","Clarendon County, South Carolina",33957,40900,16205,16038,30,201,0,1054,47.7,47.2,0.1,0.6,0,3.1,52.3,13161,10133,3028,76.99,23.01,865,9268,319,2709,1184,11977,8.5,10.5,9,"50% - 75% P.O.C.","Less than $44000"
"45029","Colleton County, South Carolina",37585,36324,21273,14375,304,49,0,1205,56.6,38.2,0.8,0.1,0,3.2,43.4,15075,11298,3777,74.95,25.05,830,10468,311,3466,1141,13934,7.3,8.2,7.6,"25% - 50% P.O.C.","Less than $44000"
"45031","Darlington County, South Carolina",67027,38448,36690,27510,158,247,17,1368,54.7,41,0.2,0.4,0,2,45.3,26484,18425,8059,69.57,30.43,1371,17054,594,7465,1965,24519,7.4,7.4,7.4,"25% - 50% P.O.C.","Less than $44000"
"45033","Dillon County, South Carolina",30689,30812,13992,14630,560,22,0,848,45.6,47.7,1.8,0.1,0,2.8,54.4,11029,6547,4482,59.36,40.64,688,5859,381,4101,1069,9960,10.5,8.5,9.7,"50% - 75% P.O.C.","Less than $44000"
"45035","Dorchester County, South Carolina",158299,63080,101637,39291,601,2866,198,8516,64.2,24.8,0.4,1.8,0.1,5.4,35.8,55351,39667,15684,71.66,28.34,3366,36301,1621,14063,4987,50364,8.5,10.3,9,"25% - 50% P.O.C.","$60000 or more"
"45037","Edgefield County, South Carolina",26927,49127,15265,9443,79,52,12,1606,56.7,35.1,0.3,0.2,0,6,43.3,9176,6797,2379,74.07,25.93,669,6128,288,2091,957,8219,9.8,12.1,10.4,"25% - 50% P.O.C.","$44000 - $52000"
"45039","Fairfield County, South Carolina",22565,38213,8613,13180,46,2,0,494,38.2,58.4,0.2,0,0,2.2,61.8,9191,6917,2274,75.26,24.74,325,6592,186,2088,511,8680,4.7,8.2,5.6,"50% - 75% P.O.C.","Less than $44000"
"45041","Florence County, South Carolina",138475,47058,71793,58893,296,1789,109,3657,51.8,42.5,0.2,1.3,0.1,2.6,48.2,52188,34292,17896,65.71,34.29,2392,31900,2100,15796,4492,47696,7,11.7,8.6,"25% - 50% P.O.C.","$44000 - $52000"
"45043","Georgetown County, South Carolina",61952,48456,39733,19115,48,317,0,1902,64.1,30.9,0.1,0.5,0,3.1,35.9,25498,20099,5399,78.83,21.17,1294,18805,412,4987,1706,23792,6.4,7.6,6.7,"25% - 50% P.O.C.","$44000 - $52000"
"45045","Greenville County, South Carolina",507003,60351,346500,88511,1086,12550,1372,46399,68.3,17.5,0.2,2.5,0.3,9.2,31.7,192975,130228,62747,67.48,32.52,11100,119128,4744,58003,15844,177131,8.5,7.6,8.2,"25% - 50% P.O.C.","$60000 or more"
"45047","Greenwood County, South Carolina",70411,42336,42022,22196,57,726,0,4238,59.7,31.5,0.1,1,0,6,40.3,27612,17681,9931,64.03,35.97,1309,16372,998,8933,2307,25305,7.4,10,8.4,"25% - 50% P.O.C.","Less than $44000"
"45049","Hampton County, South Carolina",19564,33429,8000,10424,29,52,0,787,40.9,53.3,0.1,0.3,0,4,59.1,6993,5313,1680,75.98,24.02,348,4965,91,1589,439,6554,6.5,5.4,6.3,"50% - 75% P.O.C.","Less than $44000"
"45051","Horry County, South Carolina",332172,50704,256746,43641,1432,4458,109,20050,77.3,13.1,0.4,1.3,0,6,22.7,131143,94163,36980,71.8,28.2,4280,89883,3006,33974,7286,123857,4.5,8.1,5.6,"Less than 25% P.O.C.","$44000 - $52000"
"45053","Jasper County, South Carolina",28657,45601,12263,11909,46,120,0,3851,42.8,41.6,0.2,0.4,0,13.4,57.2,10269,7366,2903,71.73,28.27,524,6842,440,2463,964,9305,7.1,15.2,9.4,"50% - 75% P.O.C.","$44000 - $52000"
"45055","Kershaw County, South Carolina",65112,51479,44783,15176,114,119,89,2886,68.8,23.3,0.2,0.2,0.1,4.4,31.2,24980,20509,4471,82.1,17.9,1243,19266,524,3947,1767,23213,6.1,11.7,7.1,"25% - 50% P.O.C.","$44000 - $52000"
"45057","Lancaster County, South Carolina",92308,58849,64758,19187,91,1212,0,4968,70.2,20.8,0.1,1.3,0,5.4,29.8,33899,27019,6880,79.7,20.3,1671,25348,829,6051,2500,31399,6.2,12,7.4,"25% - 50% P.O.C.","$52000 - $60000"
"45059","Laurens County, South Carolina",66846,43304,45364,16032,87,306,44,3263,67.9,24,0.1,0.5,0.1,4.9,32.1,25563,17848,7715,69.82,30.18,1588,16260,814,6901,2402,23161,8.9,10.6,9.4,"25% - 50% P.O.C.","Less than $44000"
"45061","Lee County, South Carolina",17365,32371,5633,11080,2,8,0,426,32.4,63.8,0,0,0,2.5,67.6,6423,4798,1625,74.7,25.3,266,4532,91,1534,357,6066,5.5,5.6,5.6,"50% - 75% P.O.C.","Less than $44000"
"45063","Lexington County, South Carolina",290278,61173,217279,42548,797,5427,211,17438,74.9,14.7,0.3,1.9,0.1,6,25.1,113104,83972,29132,74.24,25.76,6926,77046,2410,26722,9336,103768,8.2,8.3,8.3,"25% - 50% P.O.C.","$60000 or more"
"45065","McCormick County, South Carolina",9531,43633,4845,4271,23,23,0,79,50.8,44.8,0.2,0.2,0,0.8,49.2,3957,3030,927,76.57,23.43,102,2928,11,916,113,3844,3.4,1.2,2.9,"25% - 50% P.O.C.","Less than $44000"
"45067","Marion County, South Carolina",31308,32063,12077,17692,195,223,0,884,38.6,56.5,0.6,0.7,0,2.8,61.4,11600,7659,3941,66.03,33.97,456,7203,224,3717,680,10920,6,5.7,5.9,"50% - 75% P.O.C.","Less than $44000"
"45069","Marlboro County, South Carolina",26753,33586,10456,13472,781,116,0,887,39.1,50.4,2.9,0.4,0,3.3,60.9,9613,6042,3571,62.85,37.15,364,5678,232,3339,596,9017,6,6.5,6.2,"50% - 75% P.O.C.","Less than $44000"
"45071","Newberry County, South Carolina",38194,44226,22883,11860,132,93,0,2854,59.9,31.1,0.3,0.2,0,7.5,40.1,14810,10849,3961,73.25,26.75,834,10015,336,3625,1170,13640,7.7,8.5,7.9,"25% - 50% P.O.C.","$44000 - $52000"
"45073","Oconee County, South Carolina",77528,49134,65463,5288,231,570,11,4235,84.4,6.8,0.3,0.7,0,5.5,15.6,31978,23253,8725,72.72,27.28,1421,21832,605,8120,2026,29952,6.1,6.9,6.3,"Less than 25% P.O.C.","$44000 - $52000"
"45075","Orangeburg County, South Carolina",87687,37955,29184,53787,306,572,95,1950,33.3,61.3,0.3,0.7,0.1,2.2,66.7,33060,22257,10803,67.32,32.68,1407,20850,937,9866,2344,30716,6.3,8.7,7.1,"50% - 75% P.O.C.","Less than $44000"
"45077","Pickens County, South Carolina",124029,49573,106292,8392,306,2424,26,4557,85.7,6.8,0.2,2,0,3.7,14.3,47934,32153,15781,67.08,32.92,2767,29386,855,14926,3622,44312,8.6,5.4,7.6,"Less than 25% P.O.C.","$44000 - $52000"
"45079","Richland County, South Carolina",411357,54767,174065,191067,812,11719,464,21238,42.3,46.4,0.2,2.8,0.1,5.2,57.7,151853,90427,61426,59.55,40.45,7624,82803,4601,56825,12225,139628,8.4,7.5,8.1,"50% - 75% P.O.C.","$52000 - $60000"
"45081","Saluda County, South Carolina",20303,45714,11831,5061,21,0,0,3137,58.3,24.9,0.1,0,0,15.5,41.7,7094,5257,1837,74.1,25.9,354,4903,294,1543,648,6446,6.7,16,9.1,"25% - 50% P.O.C.","$44000 - $52000"
"45083","Spartanburg County, South Carolina",307617,52332,210222,62269,427,7217,66,21033,68.3,20.2,0.1,2.3,0,6.8,31.7,116645,82396,34249,70.64,29.36,7453,74943,2877,31372,10330,106315,9,8.4,8.9,"25% - 50% P.O.C.","$52000 - $60000"
"45085","Sumter County, South Carolina",106757,45661,48219,49757,243,1467,50,4225,45.2,46.6,0.2,1.4,0,4,54.8,41776,26982,14794,64.59,35.41,1812,25170,1312,13482,3124,38652,6.7,8.9,7.5,"50% - 75% P.O.C.","$44000 - $52000"
"45087","Union County, South Carolina",27490,41186,17757,8345,22,4,0,427,64.6,30.4,0.1,0,0,1.6,35.4,11432,7803,3629,68.26,31.74,443,7360,484,3145,927,10505,5.7,13.3,8.1,"25% - 50% P.O.C.","Less than $44000"
"45089","Williamsburg County, South Carolina",31324,32485,9785,20150,148,213,0,709,31.2,64.3,0.5,0.7,0,2.3,68.8,12686,9255,3431,72.95,27.05,818,8437,375,3056,1193,11493,8.8,10.9,9.4,"50% - 75% P.O.C.","Less than $44000"
"45091","York County, South Carolina",265872,65361,187398,50858,1978,5611,82,14638,70.5,19.1,0.7,2.1,0,5.5,29.5,101211,72857,28354,71.99,28.01,6324,66533,2006,26348,8330,92881,8.7,7.1,8.2,"25% - 50% P.O.C.","$60000 or more"
"46003","Aurora County, South Dakota",2763,64083,2439,46,55,0,0,202,88.3,1.7,2,0,0,7.3,11.7,1182,890,292,75.3,24.7,98,792,6,286,104,1078,11,2.1,8.8,"Less than 25% P.O.C.","$60000 or more"
"46005","Beadle County, South Dakota",18346,52313,14112,215,250,1673,71,1845,76.9,1.2,1.4,9.1,0.4,10.1,23.1,7557,4968,2589,65.74,34.26,485,4483,266,2323,751,6806,9.8,10.3,9.9,"Less than 25% P.O.C.","$52000 - $60000"
"46007","Bennett County, South Dakota",3425,47500,1138,2,2044,14,0,95,33.2,0.1,59.7,0.4,0,2.8,66.8,984,595,389,60.47,39.53,74,521,164,225,238,746,12.4,42.2,24.2,"50% - 75% P.O.C.","$44000 - $52000"
"46009","Bon Homme County, South Dakota",6929,54737,6017,102,481,28,0,189,86.8,1.5,6.9,0.4,0,2.7,13.2,2536,1864,672,73.5,26.5,138,1726,82,590,220,2316,7.4,12.2,8.7,"Less than 25% P.O.C.","$52000 - $60000"
"46011","Brookings County, South Dakota",34601,58136,31219,452,359,1041,0,1063,90.2,1.3,1,3,0,3.1,9.8,12896,7628,5268,59.15,40.85,775,6853,353,4915,1128,11768,10.2,6.7,8.7,"Less than 25% P.O.C.","$52000 - $60000"
"46013","Brown County, South Dakota",38915,58216,33904,843,1293,1169,0,1143,87.1,2.2,3.3,3,0,2.9,12.9,16305,10435,5870,64,36,994,9441,181,5689,1175,15130,9.5,3.1,7.2,"Less than 25% P.O.C.","$52000 - $60000"
"46015","Brule County, South Dakota",5258,57196,4417,26,554,15,0,147,84,0.5,10.5,0.3,0,2.8,16,2231,1376,855,61.68,38.32,154,1222,95,760,249,1982,11.2,11.1,11.2,"Less than 25% P.O.C.","$52000 - $60000"
"46017","Buffalo County, South Dakota",2026,34808,277,3,1641,0,0,84,13.7,0.1,81,0,0,4.1,86.3,564,261,303,46.28,53.72,56,205,99,204,155,409,21.5,32.7,27.5,"75% or more P.O.C.","Less than $44000"
"46019","Butte County, South Dakota",10225,46508,9325,68,337,12,0,371,91.2,0.7,3.3,0.1,0,3.6,8.8,4164,3211,953,77.11,22.89,268,2943,37,916,305,3859,8.3,3.9,7.3,"Less than 25% P.O.C.","$44000 - $52000"
"46021","Campbell County, South Dakota",1485,54449,1457,0,16,1,0,3,98.1,0,1.1,0.1,0,0.2,1.9,673,582,91,86.48,13.52,11,571,5,86,16,657,1.9,5.5,2.4,"Less than 25% P.O.C.","$52000 - $60000"
"46023","Charles Mix County, South Dakota",9349,50481,5848,8,2708,11,9,334,62.6,0.1,29,0.1,0.1,3.6,37.4,3166,2244,922,70.88,29.12,221,2023,123,799,344,2822,9.8,13.3,10.9,"25% - 50% P.O.C.","$44000 - $52000"
"46025","Clark County, South Dakota",3685,48980,3449,3,6,17,0,120,93.6,0.1,0.2,0.5,0,3.3,6.4,1546,1227,319,79.37,20.63,109,1118,26,293,135,1411,8.9,8.2,8.7,"Less than 25% P.O.C.","$44000 - $52000"
"46027","Clay County, South Dakota",13957,50724,12184,232,422,403,0,419,87.3,1.7,3,2.9,0,3,12.7,5233,2811,2422,53.72,46.28,220,2591,118,2304,338,4895,7.8,4.9,6.5,"Less than 25% P.O.C.","$44000 - $52000"
"46029","Codington County, South Dakota",28026,56376,25997,219,591,151,0,657,92.8,0.8,2.1,0.5,0,2.3,7.2,12075,7881,4194,65.27,34.73,915,6966,115,4079,1030,11045,11.6,2.7,8.5,"Less than 25% P.O.C.","$52000 - $60000"
"46031","Corson County, South Dakota",4150,35759,1198,14,2855,1,0,19,28.9,0.3,68.8,0,0,0.5,71.1,1195,643,552,53.81,46.19,91,552,162,390,253,942,14.2,29.3,21.2,"50% - 75% P.O.C.","Less than $44000"
"46033","Custer County, South Dakota",8719,58522,7832,22,333,30,0,336,89.8,0.3,3.8,0.3,0,3.9,10.2,3876,3256,620,84,16,134,3122,28,592,162,3714,4.1,4.5,4.2,"Less than 25% P.O.C.","$52000 - $60000"
"46035","Davison County, South Dakota",19871,50570,18001,273,388,145,0,620,90.6,1.4,2,0.7,0,3.1,9.4,8660,5170,3490,59.7,40.3,404,4766,217,3273,621,8039,7.8,6.2,7.2,"Less than 25% P.O.C.","$44000 - $52000"
"46037","Day County, South Dakota",5486,46679,4714,0,545,7,0,124,85.9,0,9.9,0.1,0,2.3,14.1,2574,1938,636,75.29,24.71,112,1826,56,580,168,2406,5.8,8.8,6.5,"Less than 25% P.O.C.","$44000 - $52000"
"46039","Deuel County, South Dakota",4318,65437,4151,1,8,0,0,148,96.1,0,0.2,0,0,3.4,3.9,1798,1421,377,79.03,20.97,122,1299,18,359,140,1658,8.6,4.8,7.8,"Less than 25% P.O.C.","$60000 or more"
"46041","Dewey County, South Dakota",5833,47475,1157,5,4567,5,14,59,19.8,0.1,78.3,0.1,0.2,1,80.2,1651,1008,643,61.05,38.95,158,850,185,458,343,1308,15.7,28.8,20.8,"75% or more P.O.C.","$44000 - $52000"
"46043","Douglas County, South Dakota",2929,58684,2764,0,62,0,0,19,94.4,0,2.1,0,0,0.6,5.6,1220,974,246,79.84,20.16,121,853,2,244,123,1097,12.4,0.8,10.1,"Less than 25% P.O.C.","$52000 - $60000"
"46045","Edmunds County, South Dakota",3909,71324,3756,7,30,2,0,96,96.1,0.2,0.8,0.1,0,2.5,3.9,1544,1266,278,81.99,18.01,64,1202,32,246,96,1448,5.1,11.5,6.2,"Less than 25% P.O.C.","$60000 or more"
"46047","Fall River County, South Dakota",6747,50588,5710,0,382,105,0,272,84.6,0,5.7,1.6,0,4,15.4,2986,2331,655,78.06,21.94,105,2226,31,624,136,2850,4.5,4.7,4.6,"Less than 25% P.O.C.","$44000 - $52000"
"46049","Faulk County, South Dakota",2312,55096,2221,1,70,0,0,8,96.1,0,3,0,0,0.3,3.9,895,719,176,80.34,19.66,57,662,6,170,63,832,7.9,3.4,7,"Less than 25% P.O.C.","$52000 - $60000"
"46051","Grant County, South Dakota",7149,58158,6619,33,75,8,0,325,92.6,0.5,1,0.1,0,4.5,7.4,3218,2612,606,81.17,18.83,153,2459,24,582,177,3041,5.9,4,5.5,"Less than 25% P.O.C.","$52000 - $60000"
"46053","Gregory County, South Dakota",4186,43438,3672,0,280,74,0,37,87.7,0,6.7,1.8,0,0.9,12.3,1840,1318,522,71.63,28.37,96,1222,50,472,146,1694,7.3,9.6,7.9,"Less than 25% P.O.C.","Less than $44000"
"46055","Haakon County, South Dakota",2018,42250,1800,1,151,0,0,13,89.2,0,7.5,0,0,0.6,10.8,822,634,188,77.13,22.87,69,565,5,183,74,748,10.9,2.7,9,"Less than 25% P.O.C.","Less than $44000"
"46057","Hamlin County, South Dakota",6025,67105,5634,26,3,17,0,259,93.5,0.4,0,0.3,0,4.3,6.5,2256,1817,439,80.54,19.46,354,1463,53,386,407,1849,19.5,12.1,18,"Less than 25% P.O.C.","$60000 or more"
"46059","Hand County, South Dakota",3256,54155,3140,4,0,19,0,54,96.4,0.1,0,0.6,0,1.7,3.6,1508,1030,478,68.3,31.7,103,927,9,469,112,1396,10,1.9,7.4,"Less than 25% P.O.C.","$52000 - $60000"
"46061","Hanson County, South Dakota",3399,64696,3383,0,0,0,0,0,99.5,0,0,0,0,0,0.5,1045,919,126,87.94,12.06,80,839,26,100,106,939,8.7,20.6,10.1,"Less than 25% P.O.C.","$60000 or more"
"46063","Harding County, South Dakota",1306,59655,1203,27,28,0,0,31,92.1,2.1,2.1,0,0,2.4,7.9,532,357,175,67.11,32.89,38,319,9,166,47,485,10.6,5.1,8.8,"Less than 25% P.O.C.","$52000 - $60000"
"46065","Hughes County, South Dakota",17608,64783,14477,24,2086,3,0,563,82.2,0.1,11.8,0,0,3.2,17.8,7460,5129,2331,68.75,31.25,337,4792,149,2182,486,6974,6.6,6.4,6.5,"Less than 25% P.O.C.","$60000 or more"
"46067","Hutchinson County, South Dakota",7308,57089,6920,0,87,21,0,158,94.7,0,1.2,0.3,0,2.2,5.3,2903,2242,661,77.23,22.77,276,1966,52,609,328,2575,12.3,7.9,11.3,"Less than 25% P.O.C.","$52000 - $60000"
"46069","Hyde County, South Dakota",1319,57788,1160,32,85,0,0,9,87.9,2.4,6.4,0,0,0.7,12.1,597,448,149,75.04,24.96,41,407,12,137,53,544,9.2,8.1,8.9,"Less than 25% P.O.C.","$52000 - $60000"
"46071","Jackson County, South Dakota",3290,33295,1282,10,1900,14,0,9,39,0.3,57.8,0.4,0,0.3,61,858,500,358,58.28,41.72,50,450,121,237,171,687,10,33.8,19.9,"50% - 75% P.O.C.","Less than $44000"
"46073","Jerauld County, South Dakota",2018,49632,1907,0,40,0,0,61,94.5,0,2,0,0,3,5.5,921,669,252,72.64,27.36,76,593,8,244,84,837,11.4,3.2,9.1,"Less than 25% P.O.C.","$44000 - $52000"
"46075","Jones County, South Dakota",793,46149,737,9,47,0,0,0,92.9,1.1,5.9,0,0,0,7.1,408,306,102,75,25,16,290,9,93,25,383,5.2,8.8,6.1,"Less than 25% P.O.C.","$44000 - $52000"
"46077","Kingsbury County, South Dakota",4944,61699,4786,0,8,11,0,110,96.8,0,0.2,0.2,0,2.2,3.2,2279,1812,467,79.51,20.49,151,1661,5,462,156,2123,8.3,1.1,6.8,"Less than 25% P.O.C.","$60000 or more"
"46079","Lake County, South Dakota",12717,61846,11855,41,176,208,9,140,93.2,0.3,1.4,1.6,0.1,1.1,6.8,4700,3504,1196,74.55,25.45,275,3229,175,1021,450,4250,7.8,14.6,9.6,"Less than 25% P.O.C.","$60000 or more"
"46081","Lawrence County, South Dakota",25478,52641,23148,227,555,235,32,831,90.9,0.9,2.2,0.9,0.1,3.3,9.1,11048,7147,3901,64.69,35.31,537,6610,206,3695,743,10305,7.5,5.3,6.7,"Less than 25% P.O.C.","$52000 - $60000"
"46083","Lincoln County, South Dakota",56826,82473,52836,752,247,627,9,1212,93,1.3,0.4,1.1,0,2.1,7,19749,15153,4596,76.73,23.27,2084,13069,399,4197,2483,17266,13.8,8.7,12.6,"Less than 25% P.O.C.","$60000 or more"
"46085","Lyman County, South Dakota",3848,53862,2138,4,1581,24,4,49,55.6,0.1,41.1,0.6,0.1,1.3,44.4,1397,939,458,67.22,32.78,127,812,112,346,239,1158,13.5,24.5,17.1,"25% - 50% P.O.C.","$52000 - $60000"
"46087","McCook County, South Dakota",5548,61507,5181,39,33,0,0,225,93.4,0.7,0.6,0,0,4.1,6.6,2228,1692,536,75.94,24.06,211,1481,30,506,241,1987,12.5,5.6,10.8,"Less than 25% P.O.C.","$60000 or more"
"46089","McPherson County, South Dakota",2297,44574,2183,48,8,18,0,30,95,2.1,0.3,0.8,0,1.3,5,1030,794,236,77.09,22.91,38,756,9,227,47,983,4.8,3.8,4.6,"Less than 25% P.O.C.","$44000 - $52000"
"46091","Marshall County, South Dakota",4891,63723,4059,31,367,0,0,408,83,0.6,7.5,0,0,8.3,17,1873,1382,491,73.79,26.21,168,1214,40,451,208,1665,12.2,8.1,11.1,"Less than 25% P.O.C.","$60000 or more"
"46093","Meade County, South Dakota",27717,60578,24272,513,705,339,10,1176,87.6,1.9,2.5,1.2,0,4.2,12.4,11027,8199,2828,74.35,25.65,739,7460,329,2499,1068,9959,9,11.6,9.7,"Less than 25% P.O.C.","$60000 or more"
"46095","Mellette County, South Dakota",2052,30650,791,3,1125,0,0,91,38.5,0.1,54.8,0,0,4.4,61.5,661,459,202,69.44,30.56,62,397,66,136,128,533,13.5,32.7,19.4,"50% - 75% P.O.C.","Less than $44000"
"46097","Miner County, South Dakota",2211,52910,2102,6,11,8,0,45,95.1,0.3,0.5,0.4,0,2,4.9,948,727,221,76.69,23.31,92,635,14,207,106,842,12.7,6.3,11.2,"Less than 25% P.O.C.","$52000 - $60000"
"46099","Minnehaha County, South Dakota",188674,61772,155670,10607,3709,3929,36,9417,82.5,5.6,2,2.1,0,5,17.5,76819,48546,28273,63.2,36.8,5123,43423,1610,26663,6733,70086,10.6,5.7,8.8,"Less than 25% P.O.C.","$60000 or more"
"46101","Moody County, South Dakota",6507,61538,4998,32,749,138,0,288,76.8,0.5,11.5,2.1,0,4.4,23.2,2640,1886,754,71.44,28.56,177,1709,92,662,269,2371,9.4,12.2,10.2,"Less than 25% P.O.C.","$60000 or more"
"46102","Oglala Lakota County, South Dakota",14335,31997,637,11,12929,0,0,585,4.4,0.1,90.2,0,0,4.1,95.6,2729,1370,1359,50.2,49.8,513,857,606,753,1119,1610,37.4,44.6,41,"75% or more P.O.C.","Less than $44000"
"46103","Pennington County, South Dakota",110685,57039,88441,1297,9024,1414,190,5730,79.9,1.2,8.2,1.3,0.2,5.2,20.1,44074,30252,13822,68.64,31.36,2433,27819,698,13124,3131,40943,8,5,7.1,"Less than 25% P.O.C.","$52000 - $60000"
"46105","Perkins County, South Dakota",2897,57981,2730,0,108,0,0,29,94.2,0,3.7,0,0,1,5.8,1284,932,352,72.59,27.41,63,869,32,320,95,1189,6.8,9.1,7.4,"Less than 25% P.O.C.","$52000 - $60000"
"46107","Potter County, South Dakota",2315,54583,2119,0,58,41,0,37,91.5,0,2.5,1.8,0,1.6,8.5,982,774,208,78.82,21.18,55,719,8,200,63,919,7.1,3.8,6.4,"Less than 25% P.O.C.","$52000 - $60000"
"46109","Roberts County, South Dakota",10287,50348,5811,62,3819,11,0,357,56.5,0.6,37.1,0.1,0,3.5,43.5,3873,2574,1299,66.46,33.54,216,2358,218,1081,434,3439,8.4,16.8,11.2,"25% - 50% P.O.C.","$44000 - $52000"
"46111","Sanborn County, South Dakota",2379,56875,2237,0,19,11,0,89,94,0,0.8,0.5,0,3.7,6,1010,740,270,73.27,26.73,69,671,5,265,74,936,9.3,1.9,7.3,"Less than 25% P.O.C.","$52000 - $60000"
"46115","Spink County, South Dakota",6483,54423,6075,14,108,0,12,201,93.7,0.2,1.7,0,0.2,3.1,6.3,2624,1947,677,74.2,25.8,182,1765,52,625,234,2390,9.3,7.7,8.9,"Less than 25% P.O.C.","$52000 - $60000"
"46117","Stanley County, South Dakota",3017,71382,2657,0,164,0,36,88,88.1,0,5.4,0,1.2,2.9,11.9,1344,1060,284,78.87,21.13,105,955,9,275,114,1230,9.9,3.2,8.5,"Less than 25% P.O.C.","$60000 or more"
"46119","Sully County, South Dakota",1305,62153,1253,0,14,0,0,17,96,0,1.1,0,0,1.3,4,569,489,80,85.94,14.06,31,458,17,63,48,521,6.3,21.2,8.4,"Less than 25% P.O.C.","$60000 or more"
"46121","Todd County, South Dakota",10195,24331,809,6,8910,189,0,118,7.9,0.1,87.4,1.9,0,1.2,92.1,2700,1180,1520,43.7,56.3,203,977,379,1141,582,2118,17.2,24.9,21.6,"75% or more P.O.C.","Less than $44000"
"46123","Tripp County, South Dakota",5458,57720,4415,0,593,44,0,11,80.9,0,10.9,0.8,0,0.2,19.1,2356,1796,560,76.23,23.77,151,1645,31,529,182,2174,8.4,5.5,7.7,"Less than 25% P.O.C.","$52000 - $60000"
"46125","Turner County, South Dakota",8300,59242,7907,38,38,24,0,203,95.3,0.5,0.5,0.3,0,2.4,4.7,3498,2739,759,78.3,21.7,234,2505,58,701,292,3206,8.5,7.6,8.3,"Less than 25% P.O.C.","$52000 - $60000"
"46127","Union County, South Dakota",15368,70378,14154,124,171,194,0,490,92.1,0.8,1.1,1.3,0,3.2,7.9,6619,4579,2040,69.18,30.82,480,4099,141,1899,621,5998,10.5,6.9,9.4,"Less than 25% P.O.C.","$60000 or more"
"46129","Walworth County, South Dakota",5457,55583,4314,275,568,0,0,120,79.1,5,10.4,0,0,2.2,20.9,2258,1668,590,73.87,26.13,67,1601,44,546,111,2147,4,7.5,4.9,"Less than 25% P.O.C.","$52000 - $60000"
"46135","Yankton County, South Dakota",22717,58342,20090,353,729,43,18,1026,88.4,1.6,3.2,0.2,0.1,4.5,11.6,9445,6156,3289,65.18,34.82,536,5620,143,3146,679,8766,8.7,4.3,7.2,"Less than 25% P.O.C.","$52000 - $60000"
"46137","Ziebach County, South Dakota",2791,37400,657,0,2091,17,1,9,23.5,0,74.9,0.6,0,0.3,76.5,754,431,323,57.16,42.84,62,369,123,200,185,569,14.4,38.1,24.5,"75% or more P.O.C.","Less than $44000"
"47001","Anderson County, Tennessee",76061,50392,67777,2671,378,982,66,2215,89.1,3.5,0.5,1.3,0.1,2.9,10.9,30541,20746,9795,67.93,32.07,1452,19294,813,8982,2265,28276,7,8.3,7.4,"Less than 25% P.O.C.","$44000 - $52000"
"47003","Bedford County, Tennessee",48292,50415,37090,3822,107,96,21,5987,76.8,7.9,0.2,0.2,0,12.4,23.2,17029,11673,5356,68.55,31.45,1136,10537,739,4617,1875,15154,9.7,13.8,11,"Less than 25% P.O.C.","$44000 - $52000"
"47005","Benton County, Tennessee",16140,37512,14967,487,65,5,0,392,92.7,3,0.4,0,0,2.4,7.3,6762,5214,1548,77.11,22.89,157,5057,147,1401,304,6458,3,9.5,4.5,"Less than 25% P.O.C.","Less than $44000"
"47007","Bledsoe County, Tennessee",14836,44122,13048,491,307,10,0,368,87.9,3.3,2.1,0.1,0,2.5,12.1,4894,3612,1282,73.8,26.2,496,3116,128,1154,624,4270,13.7,10,12.8,"Less than 25% P.O.C.","$44000 - $52000"
"47009","Blount County, Tennessee",129927,56667,118159,3417,264,1016,83,4378,90.9,2.6,0.2,0.8,0.1,3.4,9.1,50557,38128,12429,75.42,24.58,2691,35437,977,11452,3668,46889,7.1,7.9,7.3,"Less than 25% P.O.C.","$52000 - $60000"
"47011","Bradley County, Tennessee",105749,51331,90403,5054,133,1254,34,6541,85.5,4.8,0.1,1.2,0,6.2,14.5,40192,26342,13850,65.54,34.46,2803,23539,1185,12665,3988,36204,10.6,8.6,9.9,"Less than 25% P.O.C.","$44000 - $52000"
"47013","Campbell County, Tennessee",39797,39803,38328,127,97,170,0,556,96.3,0.3,0.2,0.4,0,1.4,3.7,16192,11026,5166,68.1,31.9,692,10334,304,4862,996,15196,6.3,5.9,6.2,"Less than 25% P.O.C.","Less than $44000"
"47015","Cannon County, Tennessee",14178,55330,13344,265,40,4,2,317,94.1,1.9,0.3,0,0,2.2,5.9,5488,4103,1385,74.76,25.24,346,3757,183,1202,529,4959,8.4,13.2,9.6,"Less than 25% P.O.C.","$52000 - $60000"
"47017","Carroll County, Tennessee",27886,42637,23583,2844,63,108,21,741,84.6,10.2,0.2,0.4,0.1,2.7,15.4,10962,8012,2950,73.09,26.91,437,7575,255,2695,692,10270,5.5,8.6,6.3,"Less than 25% P.O.C.","Less than $44000"
"47019","Carter County, Tennessee",56433,38092,53491,957,211,254,27,1055,94.8,1.7,0.4,0.5,0,1.9,5.2,23784,16838,6946,70.8,29.2,1149,15689,641,6305,1790,21994,6.8,9.2,7.5,"Less than 25% P.O.C.","Less than $44000"
"47021","Cheatham County, Tennessee",40181,61913,37184,637,173,155,13,1204,92.5,1.6,0.4,0.4,0,3,7.5,15089,11612,3477,76.96,23.04,1023,10589,303,3174,1326,13763,8.8,8.7,8.8,"Less than 25% P.O.C.","$60000 or more"
"47023","Chester County, Tennessee",17190,51946,14691,1535,6,78,0,452,85.5,8.9,0,0.5,0,2.6,14.5,6060,4672,1388,77.1,22.9,354,4318,112,1276,466,5594,7.6,8.1,7.7,"Less than 25% P.O.C.","$44000 - $52000"
"47025","Claiborne County, Tennessee",31732,36835,30206,314,70,247,52,419,95.2,1,0.2,0.8,0.2,1.3,4.8,13281,9411,3870,70.86,29.14,743,8668,367,3503,1110,12171,7.9,9.5,8.4,"Less than 25% P.O.C.","Less than $44000"
"47027","Clay County, Tennessee",7654,32167,7226,183,0,8,0,200,94.4,2.4,0,0.1,0,2.6,5.6,3039,2380,659,78.32,21.68,133,2247,68,591,201,2838,5.6,10.3,6.6,"Less than 25% P.O.C.","Less than $44000"
"47029","Cocke County, Tennessee",35552,36716,33154,494,256,67,41,837,93.3,1.4,0.7,0.2,0.1,2.4,6.7,14060,9431,4629,67.08,32.92,442,8989,320,4309,762,13298,4.7,6.9,5.4,"Less than 25% P.O.C.","Less than $44000"
"47031","Coffee County, Tennessee",55209,50351,48792,2092,27,596,10,2382,88.4,3.8,0,1.1,0,4.3,11.6,21646,14747,6899,68.13,31.87,1147,13600,795,6104,1942,19704,7.8,11.5,9,"Less than 25% P.O.C.","$44000 - $52000"
"47033","Crockett County, Tennessee",14399,44717,10645,1871,15,48,6,1521,73.9,13,0.1,0.3,0,10.6,26.1,5491,3930,1561,71.57,28.43,256,3674,247,1314,503,4988,6.5,15.8,9.2,"25% - 50% P.O.C.","$44000 - $52000"
"47035","Cumberland County, Tennessee",59216,45958,55916,396,288,209,0,1770,94.4,0.7,0.5,0.4,0,3,5.6,25801,20011,5790,77.56,22.44,1275,18736,372,5418,1647,24154,6.4,6.4,6.4,"Less than 25% P.O.C.","$44000 - $52000"
"47037","Davidson County, Tennessee",687488,60388,386383,185114,1337,24813,397,70319,56.2,26.9,0.2,3.6,0.1,10.2,43.8,282366,153439,128927,54.34,45.66,11910,141529,8765,120162,20675,261691,7.8,6.8,7.3,"25% - 50% P.O.C.","$60000 or more"
"47039","Decatur County, Tennessee",11686,42031,10683,518,0,0,0,169,91.4,4.4,0,0,0,1.4,8.6,4440,3596,844,80.99,19.01,229,3367,73,771,302,4138,6.4,8.6,6.8,"Less than 25% P.O.C.","Less than $44000"
"47041","DeKalb County, Tennessee",19847,45511,17463,337,62,31,11,1639,88,1.7,0.3,0.2,0.1,8.3,12,7704,5266,2438,68.35,31.65,386,4880,250,2188,636,7068,7.3,10.3,8.3,"Less than 25% P.O.C.","$44000 - $52000"
"47043","Dickson County, Tennessee",52680,53076,47135,2196,213,264,0,1885,89.5,4.2,0.4,0.5,0,3.6,10.5,19198,14412,4786,75.07,24.93,907,13505,479,4307,1386,17812,6.3,10,7.2,"Less than 25% P.O.C.","$52000 - $60000"
"47045","Dyer County, Tennessee",37416,44185,29934,4731,182,290,56,1274,80,12.6,0.5,0.8,0.1,3.4,20,15120,9300,5820,61.51,38.49,721,8579,672,5148,1393,13727,7.8,11.5,9.2,"Less than 25% P.O.C.","$44000 - $52000"
"47047","Fayette County, Tennessee",40164,60711,27319,10961,166,269,1,1086,68,27.3,0.4,0.7,0,2.7,32,15596,12464,3132,79.92,20.08,1059,11405,387,2745,1446,14150,8.5,12.4,9.3,"25% - 50% P.O.C.","$60000 or more"
"47049","Fentress County, Tennessee",18213,36520,17579,59,0,100,0,278,96.5,0.3,0,0.5,0,1.5,3.5,7443,5592,1851,75.13,24.87,481,5111,207,1644,688,6755,8.6,11.2,9.2,"Less than 25% P.O.C.","Less than $44000"
"47051","Franklin County, Tennessee",41725,51585,36877,1885,18,185,28,1415,88.4,4.5,0,0.4,0.1,3.4,11.6,16326,12160,4166,74.48,25.52,887,11273,453,3713,1340,14986,7.3,10.9,8.2,"Less than 25% P.O.C.","$44000 - $52000"
"47053","Gibson County, Tennessee",49228,43171,37731,8420,181,149,40,1339,76.6,17.1,0.4,0.3,0.1,2.7,23.4,19320,13187,6133,68.26,31.74,896,12291,565,5568,1461,17859,6.8,9.2,7.6,"Less than 25% P.O.C.","Less than $44000"
"47055","Giles County, Tennessee",29285,49614,24637,2831,92,65,0,741,84.1,9.7,0.3,0.2,0,2.5,15.9,11904,8285,3619,69.6,30.4,451,7834,250,3369,701,11203,5.4,6.9,5.9,"Less than 25% P.O.C.","$44000 - $52000"
"47057","Grainger County, Tennessee",23101,44064,21703,104,71,64,0,772,93.9,0.5,0.3,0.3,0,3.3,6.1,8959,7087,1872,79.1,20.9,509,6578,209,1663,718,8241,7.2,11.2,8,"Less than 25% P.O.C.","$44000 - $52000"
"47059","Greene County, Tennessee",68834,42595,64048,1475,176,273,0,1989,93,2.1,0.3,0.4,0,2.9,7,27396,20270,7126,73.99,26.01,1185,19085,528,6598,1713,25683,5.8,7.4,6.3,"Less than 25% P.O.C.","Less than $44000"
"47061","Grundy County, Tennessee",13344,40516,11595,96,131,26,0,167,86.9,0.7,1,0.2,0,1.3,13.1,4820,3760,1060,78.01,21.99,293,3467,121,939,414,4406,7.8,11.4,8.6,"Less than 25% P.O.C.","Less than $44000"
"47063","Hamblen County, Tennessee",64132,43619,52249,2383,190,554,186,7508,81.5,3.7,0.3,0.9,0.3,11.7,18.5,24456,16349,8107,66.85,33.15,1302,15047,890,7217,2192,22264,8,11,9,"Less than 25% P.O.C.","Less than $44000"
"47065","Hamilton County, Tennessee",360919,55070,256573,68280,676,7325,142,20391,71.1,18.9,0.2,2,0,5.6,28.9,145213,92887,52326,63.97,36.03,6377,86510,3199,49127,9576,135637,6.9,6.1,6.6,"25% - 50% P.O.C.","$52000 - $60000"
"47067","Hancock County, Tennessee",6587,30136,6371,33,3,39,0,105,96.7,0.5,0,0.6,0,1.6,3.3,2742,2184,558,79.65,20.35,137,2047,36,522,173,2569,6.3,6.5,6.3,"Less than 25% P.O.C.","Less than $44000"
"47069","Hardeman County, Tennessee",25443,40304,13794,10630,78,187,0,447,54.2,41.8,0.3,0.7,0,1.8,45.8,8891,6332,2559,71.22,28.78,355,5977,308,2251,663,8228,5.6,12,7.5,"25% - 50% P.O.C.","Less than $44000"
"47071","Hardin County, Tennessee",25715,40682,23604,1001,51,119,0,657,91.8,3.9,0.2,0.5,0,2.6,8.2,10137,7349,2788,72.5,27.5,603,6746,152,2636,755,9382,8.2,5.5,7.4,"Less than 25% P.O.C.","Less than $44000"
"47073","Hawkins County, Tennessee",56611,41924,53811,747,99,293,41,878,95.1,1.3,0.2,0.5,0.1,1.6,4.9,23135,17010,6125,73.52,26.48,811,16199,474,5651,1285,21850,4.8,7.7,5.6,"Less than 25% P.O.C.","Less than $44000"
"47075","Haywood County, Tennessee",17623,37905,7754,8950,0,8,5,762,44,50.8,0,0,0,4.3,56,7181,4177,3004,58.17,41.83,292,3885,204,2800,496,6685,7,6.8,6.9,"50% - 75% P.O.C.","Less than $44000"
"47077","Henderson County, Tennessee",27977,43305,24452,2192,0,35,22,678,87.4,7.8,0,0.1,0.1,2.4,12.6,10711,7793,2918,72.76,27.24,570,7223,224,2694,794,9917,7.3,7.7,7.4,"Less than 25% P.O.C.","Less than $44000"
"47079","Henry County, Tennessee",32284,40502,28185,2637,84,127,0,839,87.3,8.2,0.3,0.4,0,2.6,12.7,13394,10211,3183,76.24,23.76,578,9633,175,3008,753,12641,5.7,5.5,5.6,"Less than 25% P.O.C.","Less than $44000"
"47081","Hickman County, Tennessee",24813,43596,22430,1299,59,94,7,611,90.4,5.2,0.2,0.4,0,2.5,9.6,8636,6936,1700,80.31,19.69,651,6285,151,1549,802,7834,9.4,8.9,9.3,"Less than 25% P.O.C.","Less than $44000"
"47083","Houston County, Tennessee",8164,42711,7511,441,60,14,16,31,92,5.4,0.7,0.2,0.2,0.4,8,2878,2201,677,76.48,23.52,100,2101,72,605,172,2706,4.5,10.6,6,"Less than 25% P.O.C.","Less than $44000"
"47085","Humphreys County, Tennessee",18435,45667,17046,380,142,129,7,455,92.5,2.1,0.8,0.7,0,2.5,7.5,6763,5261,1502,77.79,22.21,334,4927,128,1374,462,6301,6.3,8.5,6.8,"Less than 25% P.O.C.","$44000 - $52000"
"47087","Jackson County, Tennessee",11682,35207,11135,37,18,5,0,244,95.3,0.3,0.2,0,0,2.1,4.7,4566,3519,1047,77.07,22.93,216,3303,66,981,282,4284,6.1,6.3,6.2,"Less than 25% P.O.C.","Less than $44000"
"47089","Jefferson County, Tennessee",53679,49139,49508,910,69,336,14,1928,92.2,1.7,0.1,0.6,0,3.6,7.8,20154,15164,4990,75.24,24.76,1301,13863,578,4412,1879,18275,8.6,11.6,9.3,"Less than 25% P.O.C.","$44000 - $52000"
"47091","Johnson County, Tennessee",17753,36004,16385,613,90,85,0,361,92.3,3.5,0.5,0.5,0,2,7.7,6794,5136,1658,75.6,24.4,302,4834,163,1495,465,6329,5.9,9.8,6.8,"Less than 25% P.O.C.","Less than $44000"
"47093","Knox County, Tennessee",461104,57470,379329,39908,1069,10094,191,19707,82.3,8.7,0.2,2.2,0,4.3,17.7,187319,120390,66929,64.27,35.73,8397,111993,4291,62638,12688,174631,7,6.4,6.8,"Less than 25% P.O.C.","$52000 - $60000"
"47095","Lake County, Tennessee",7401,35191,4935,2100,10,18,0,172,66.7,28.4,0.1,0.2,0,2.3,33.3,2243,1227,1016,54.7,45.3,8,1219,82,934,90,2153,0.7,8.1,4,"25% - 50% P.O.C.","Less than $44000"
"47097","Lauderdale County, Tennessee",25989,39896,15757,8769,218,67,0,661,60.6,33.7,0.8,0.3,0,2.5,39.4,9675,5428,4247,56.1,43.9,418,5010,746,3501,1164,8511,7.7,17.6,12,"25% - 50% P.O.C.","Less than $44000"
"47099","Lawrence County, Tennessee",43390,43614,40462,724,147,226,77,969,93.3,1.7,0.3,0.5,0.2,2.2,6.7,15960,12025,3935,75.34,24.66,1229,10796,285,3650,1514,14446,10.2,7.2,9.5,"Less than 25% P.O.C.","Less than $44000"
"47101","Lewis County, Tennessee",12027,37277,11223,219,0,164,0,276,93.3,1.8,0,1.4,0,2.3,6.7,4715,3676,1039,77.96,22.04,290,3386,129,910,419,4296,7.9,12.4,8.9,"Less than 25% P.O.C.","Less than $44000"
"47103","Lincoln County, Tennessee",33924,49485,29456,2405,70,183,0,1192,86.8,7.1,0.2,0.5,0,3.5,13.2,13548,10170,3378,75.07,24.93,766,9404,441,2937,1207,12341,7.5,13.1,8.9,"Less than 25% P.O.C.","$44000 - $52000"
"47105","Loudon County, Tennessee",52340,58065,45899,482,70,375,0,4595,87.7,0.9,0.1,0.7,0,8.8,12.3,20669,16076,4593,77.78,22.22,1091,14985,586,4007,1677,18992,6.8,12.8,8.1,"Less than 25% P.O.C.","$52000 - $60000"
"47107","McMinn County, Tennessee",53053,43285,47330,1923,205,415,37,2130,89.2,3.6,0.4,0.8,0.1,4,10.8,20804,15283,5521,73.46,26.54,1323,13960,500,5021,1823,18981,8.7,9.1,8.8,"Less than 25% P.O.C.","Less than $44000"
"47109","McNairy County, Tennessee",25844,39161,23210,1427,49,54,0,545,89.8,5.5,0.2,0.2,0,2.1,10.2,10022,7286,2736,72.7,27.3,449,6837,315,2421,764,9258,6.2,11.5,7.6,"Less than 25% P.O.C.","Less than $44000"
"47111","Macon County, Tennessee",23842,37430,21903,44,102,113,37,1231,91.9,0.2,0.4,0.5,0.2,5.2,8.1,9170,6821,2349,74.38,25.62,890,5931,131,2218,1021,8149,13,5.6,11.1,"Less than 25% P.O.C.","Less than $44000"
"47113","Madison County, Tennessee",97625,48161,54430,36091,104,1054,0,3765,55.8,37,0.1,1.1,0,3.9,44.2,37944,23651,14293,62.33,37.67,1708,21943,1289,13004,2997,34947,7.2,9,7.9,"25% - 50% P.O.C.","$44000 - $52000"
"47115","Marion County, Tennessee",28538,49432,26174,734,11,128,0,517,91.7,2.6,0,0.4,0,1.8,8.3,11477,8602,2875,74.95,25.05,656,7946,205,2670,861,10616,7.6,7.1,7.5,"Less than 25% P.O.C.","$44000 - $52000"
"47117","Marshall County, Tennessee",32965,53197,27973,2491,0,106,0,1778,84.9,7.6,0,0.3,0,5.4,15.1,12324,8843,3481,71.75,28.25,773,8070,374,3107,1147,11177,8.7,10.7,9.3,"Less than 25% P.O.C.","$52000 - $60000"
"47119","Maury County, Tennessee",91976,57170,72928,10553,129,866,12,5354,79.3,11.5,0.1,0.9,0,5.8,20.7,34688,24236,10452,69.87,30.13,2153,22083,761,9691,2914,31774,8.9,7.3,8.4,"Less than 25% P.O.C.","$52000 - $60000"
"47121","Meigs County, Tennessee",12104,49167,11390,230,26,26,0,255,94.1,1.9,0.2,0.2,0,2.1,5.9,4938,3887,1051,78.72,21.28,323,3564,65,986,388,4550,8.3,6.2,7.9,"Less than 25% P.O.C.","$44000 - $52000"
"47123","Monroe County, Tennessee",46064,42429,41940,920,274,185,0,2029,91,2,0.6,0.4,0,4.4,9,17987,13797,4190,76.71,23.29,1192,12605,376,3814,1568,16419,8.6,9,8.7,"Less than 25% P.O.C.","Less than $44000"
"47125","Montgomery County, Tennessee",200180,57541,126782,38611,913,4289,745,20036,63.3,19.3,0.5,2.1,0.4,10,36.7,72617,43243,29374,59.55,40.45,4797,38446,2785,26589,7582,65035,11.1,9.5,10.4,"25% - 50% P.O.C.","$52000 - $60000"
"47127","Moore County, Tennessee",6378,57708,5905,140,105,153,0,14,92.6,2.2,1.6,2.4,0,0.2,7.4,2592,2198,394,84.8,15.2,154,2044,3,391,157,2435,7,0.8,6.1,"Less than 25% P.O.C.","$52000 - $60000"
"47129","Morgan County, Tennessee",21545,41333,19833,1226,80,11,0,287,92.1,5.7,0.4,0.1,0,1.3,7.9,7625,6223,1402,81.61,18.39,347,5876,183,1219,530,7095,5.6,13.1,7,"Less than 25% P.O.C.","Less than $44000"
"47131","Obion County, Tennessee",30365,39615,25171,3108,73,116,7,1339,82.9,10.2,0.2,0.4,0,4.4,17.1,12717,8254,4463,64.91,35.09,469,7785,343,4120,812,11905,5.7,7.7,6.4,"Less than 25% P.O.C.","Less than $44000"
"47133","Overton County, Tennessee",22068,37197,21208,144,14,99,92,327,96.1,0.7,0.1,0.4,0.4,1.5,3.9,9140,7289,1851,79.75,20.25,604,6685,149,1702,753,8387,8.3,8,8.2,"Less than 25% P.O.C.","Less than $44000"
"47135","Perry County, Tennessee",7962,41034,7314,218,12,178,0,108,91.9,2.7,0.2,2.2,0,1.4,8.1,3073,2533,540,82.43,17.57,265,2268,49,491,314,2759,10.5,9.1,10.2,"Less than 25% P.O.C.","Less than $44000"
"47137","Pickett County, Tennessee",5079,39554,5049,9,0,0,0,19,99.4,0.2,0,0,0,0.4,0.6,2281,1864,417,81.72,18.28,175,1689,19,398,194,2087,9.4,4.6,8.5,"Less than 25% P.O.C.","Less than $44000"
"47139","Polk County, Tennessee",16814,43306,15939,56,49,17,0,353,94.8,0.3,0.3,0.1,0,2.1,5.2,7383,5443,1940,73.72,26.28,356,5087,228,1712,584,6799,6.5,11.8,7.9,"Less than 25% P.O.C.","Less than $44000"
"47141","Putnam County, Tennessee",77447,44259,68481,1673,267,971,0,4838,88.4,2.2,0.3,1.3,0,6.2,11.6,31424,19317,12107,61.47,38.53,1521,17796,865,11242,2386,29038,7.9,7.1,7.6,"Less than 25% P.O.C.","$44000 - $52000"
"47143","Rhea County, Tennessee",32719,42206,29620,741,39,156,0,1620,90.5,2.3,0.1,0.5,0,5,9.5,12177,8672,3505,71.22,28.78,460,8212,419,3086,879,11298,5.3,12,7.2,"Less than 25% P.O.C.","Less than $44000"
"47145","Roane County, Tennessee",53075,53367,49220,1227,208,399,19,980,92.7,2.3,0.4,0.8,0,1.8,7.3,20901,16143,4758,77.24,22.76,1137,15006,565,4193,1702,19199,7,11.9,8.1,"Less than 25% P.O.C.","$52000 - $60000"
"47147","Robertson County, Tennessee",70280,63307,58516,5056,165,391,42,4873,83.3,7.2,0.2,0.6,0.1,6.9,16.7,25713,19022,6691,73.98,26.02,1471,17551,1096,5595,2567,23146,7.7,16.4,10,"Less than 25% P.O.C.","$60000 or more"
"47149","Rutherford County, Tennessee",315815,67429,223482,45871,710,10689,61,25329,70.8,14.5,0.2,3.4,0,8,29.2,111676,72860,38816,65.24,34.76,8006,64854,3800,35016,11806,99870,11,9.8,10.6,"25% - 50% P.O.C.","$60000 or more"
"47151","Scott County, Tennessee",21969,38864,21341,126,68,2,0,212,97.1,0.6,0.3,0,0,1,2.9,8664,6061,2603,69.96,30.04,556,5505,216,2387,772,7892,9.2,8.3,8.9,"Less than 25% P.O.C.","Less than $44000"
"47153","Sequatchie County, Tennessee",14816,49370,13857,33,16,0,0,525,93.5,0.2,0.1,0,0,3.5,6.5,5528,4132,1396,74.75,25.25,371,3761,85,1311,456,5072,9,6.1,8.2,"Less than 25% P.O.C.","$44000 - $52000"
"47155","Sevier County, Tennessee",97068,49610,87347,877,380,759,19,5818,90,0.9,0.4,0.8,0,6,10,37210,25815,11395,69.38,30.62,1693,24122,1132,10263,2825,34385,6.6,9.9,7.6,"Less than 25% P.O.C.","$44000 - $52000"
"47157","Shelby County, Tennessee",936374,51657,334839,500339,1010,24494,217,59571,35.8,53.4,0.1,2.6,0,6.4,64.2,351194,193347,157847,55.05,44.95,15438,177909,14140,143707,29578,321616,8,9,8.4,"50% - 75% P.O.C.","$44000 - $52000"
"47159","Smith County, Tennessee",19740,48068,18279,394,106,74,0,537,92.6,2,0.5,0.4,0,2.7,7.4,7603,5618,1985,73.89,26.11,555,5063,194,1791,749,6854,9.9,9.8,9.9,"Less than 25% P.O.C.","$44000 - $52000"
"47161","Stewart County, Tennessee",13427,45809,12324,124,33,96,52,406,91.8,0.9,0.2,0.7,0.4,3,8.2,5178,3884,1294,75.01,24.99,219,3665,181,1113,400,4778,5.6,14,7.7,"Less than 25% P.O.C.","$44000 - $52000"
"47163","Sullivan County, Tennessee",157050,46684,146687,2884,151,953,88,2978,93.4,1.8,0.1,0.6,0.1,1.9,6.6,66511,47784,18727,71.84,28.16,3053,44731,1398,17329,4451,62060,6.4,7.5,6.7,"Less than 25% P.O.C.","$44000 - $52000"
"47165","Sumner County, Tennessee",183437,67204,154313,13330,462,2564,80,8949,84.1,7.3,0.3,1.4,0,4.9,15.9,67089,49394,17695,73.62,26.38,4641,44753,1648,16047,6289,60800,9.4,9.3,9.4,"Less than 25% P.O.C.","$60000 or more"
"47167","Tipton County, Tennessee",61447,61291,46509,11279,180,409,2,1708,75.7,18.4,0.3,0.7,0,2.8,24.3,21452,15305,6147,71.35,28.65,1293,14012,726,5421,2019,19433,8.4,11.8,9.4,"Less than 25% P.O.C.","$60000 or more"
"47169","Trousdale County, Tennessee",10231,56321,8610,1042,54,25,0,110,84.2,10.2,0.5,0.2,0,1.1,15.8,3189,2514,675,78.83,21.17,212,2302,56,619,268,2921,8.4,8.3,8.4,"Less than 25% P.O.C.","$52000 - $60000"
"47171","Unicoi County, Tennessee",17811,41890,16589,60,18,50,0,873,93.1,0.3,0.1,0.3,0,4.9,6.9,7658,5508,2150,71.92,28.08,320,5188,84,2066,404,7254,5.8,3.9,5.3,"Less than 25% P.O.C.","Less than $44000"
"47173","Union County, Tennessee",19488,44671,18755,98,6,54,53,326,96.2,0.5,0,0.3,0.3,1.7,3.8,7405,5584,1821,75.41,24.59,565,5019,189,1632,754,6651,10.1,10.4,10.2,"Less than 25% P.O.C.","$44000 - $52000"
"47175","Van Buren County, Tennessee",5760,42724,5513,16,0,0,0,41,95.7,0.3,0,0,0,0.7,4.3,2141,1744,397,81.46,18.54,123,1621,51,346,174,1967,7.1,12.8,8.1,"Less than 25% P.O.C.","Less than $44000"
"47177","Warren County, Tennessee",40702,41125,34697,838,129,283,95,3697,85.2,2.1,0.3,0.7,0.2,9.1,14.8,15727,10926,4801,69.47,30.53,1249,9677,477,4324,1726,14001,11.4,9.9,11,"Less than 25% P.O.C.","Less than $44000"
"47179","Washington County, Tennessee",127805,48334,113269,5095,373,2100,4,4386,88.6,4,0.3,1.6,0,3.4,11.4,53859,34682,19177,64.39,35.61,2091,32591,1009,18168,3100,50759,6,5.3,5.8,"Less than 25% P.O.C.","$44000 - $52000"
"47181","Wayne County, Tennessee",16693,41427,14974,1143,25,132,0,348,89.7,6.8,0.1,0.8,0,2.1,10.3,5764,4463,1301,77.43,22.57,316,4147,189,1112,505,5259,7.1,14.5,8.8,"Less than 25% P.O.C.","Less than $44000"
"47183","Weakley County, Tennessee",33510,39937,29078,2831,141,84,21,865,86.8,8.4,0.4,0.3,0.1,2.6,13.2,13640,8904,4736,65.28,34.72,530,8374,242,4494,772,12868,6,5.1,5.7,"Less than 25% P.O.C.","Less than $44000"
"47185","White County, Tennessee",26800,41998,25053,568,7,47,0,690,93.5,2.1,0,0.2,0,2.6,6.5,10048,8039,2009,80.01,19.99,771,7268,87,1922,858,9190,9.6,4.3,8.5,"Less than 25% P.O.C.","Less than $44000"
"47187","Williamson County, Tennessee",225389,112962,190642,9239,137,9469,60,10748,84.6,4.1,0.1,4.2,0,4.8,15.4,77855,62713,15142,80.55,19.45,7931,54782,1026,14116,8957,68898,12.6,6.8,11.5,"Less than 25% P.O.C.","$60000 or more"
"47189","Wilson County, Tennessee",136666,75991,116124,9735,390,2239,27,5784,85,7.1,0.3,1.6,0,4.2,15,49664,38156,11508,76.83,23.17,3753,34403,1171,10337,4924,44740,9.8,10.2,9.9,"Less than 25% P.O.C.","$60000 or more"
"48001","Anderson County, Texas",57810,43455,34069,12111,181,321,9,10283,58.9,20.9,0.3,0.6,0,17.8,41.1,16677,11606,5071,69.59,30.41,1123,10483,381,4690,1504,15173,9.7,7.5,9,"25% - 50% P.O.C.","Less than $44000"
"48003","Andrews County, Texas",18036,76158,7246,122,0,65,31,10151,40.2,0.7,0,0.4,0.2,56.3,59.8,5573,4130,1443,74.11,25.89,637,3493,388,1055,1025,4548,15.4,26.9,18.4,"50% - 75% P.O.C.","$60000 or more"
"48005","Angelina County, Texas",87322,50453,52832,12747,105,957,5,19326,60.5,14.6,0.1,1.1,0,22.1,39.5,31035,20531,10504,66.15,33.85,2872,17659,1347,9157,4219,26816,14,12.8,13.6,"25% - 50% P.O.C.","$44000 - $52000"
"48007","Aransas County, Texas",24462,45137,16486,337,27,489,0,6721,67.4,1.4,0.1,2,0,27.5,32.6,9548,7657,1891,80.19,19.81,481,7176,248,1643,729,8819,6.3,13.1,7.6,"25% - 50% P.O.C.","$44000 - $52000"
"48009","Archer County, Texas",8716,63835,7700,76,59,15,0,722,88.3,0.9,0.7,0.2,0,8.3,11.7,3452,2888,564,83.66,16.34,161,2727,89,475,250,3202,5.6,15.8,7.2,"Less than 25% P.O.C.","$60000 or more"
"48011","Armstrong County, Texas",1973,72500,1763,5,22,0,0,149,89.4,0.3,1.1,0,0,7.6,10.6,694,611,83,88.04,11.96,42,569,29,54,71,623,6.9,34.9,10.2,"Less than 25% P.O.C.","$60000 or more"
"48013","Atascosa County, Texas",49528,55366,16487,135,53,173,0,31855,33.3,0.3,0.1,0.3,0,64.3,66.7,15546,11711,3835,75.33,24.67,1975,9736,668,3167,2643,12903,16.9,17.4,17,"50% - 75% P.O.C.","$52000 - $60000"
"48015","Austin County, Texas",29764,66206,18515,2600,30,111,0,7989,62.2,8.7,0.1,0.4,0,26.8,37.8,11301,8613,2688,76.21,23.79,926,7687,379,2309,1305,9996,10.8,14.1,11.5,"25% - 50% P.O.C.","$60000 or more"
"48017","Bailey County, Texas",7100,52273,2519,33,80,57,0,4411,35.5,0.5,1.1,0.8,0,62.1,64.5,2054,1532,522,74.59,25.41,169,1363,89,433,258,1796,11,17,12.6,"50% - 75% P.O.C.","$52000 - $60000"
"48019","Bandera County, Texas",22215,58661,17289,154,78,62,0,4175,77.8,0.7,0.4,0.3,0,18.8,22.2,8399,7141,1258,85.02,14.98,332,6809,82,1176,414,7985,4.6,6.5,4.9,"Less than 25% P.O.C.","$52000 - $60000"
"48021","Bastrop County, Texas",84522,64597,44228,5977,228,710,0,31852,52.3,7.1,0.3,0.8,0,37.7,47.7,25571,19862,5709,77.67,22.33,2726,17136,884,4825,3610,21961,13.7,15.5,14.1,"25% - 50% P.O.C.","$60000 or more"
"48023","Baylor County, Texas",3577,40739,3098,110,9,0,40,305,86.6,3.1,0.3,0,1.1,8.5,13.4,1530,1107,423,72.35,27.65,55,1052,58,365,113,1417,5,13.7,7.4,"Less than 25% P.O.C.","Less than $44000"
"48025","Bee County, Texas",32611,44578,10234,2228,138,169,4,19194,31.4,6.8,0.4,0.5,0,58.9,68.6,8269,5185,3084,62.7,37.3,830,4355,339,2745,1169,7100,16,11,14.1,"50% - 75% P.O.C.","$44000 - $52000"
"48027","Bell County, Texas",348574,54884,159545,74996,835,9905,2210,86533,45.8,21.5,0.2,2.8,0.6,24.8,54.2,122689,66632,56057,54.31,45.69,7634,58998,6183,49874,13817,108872,11.5,11,11.3,"50% - 75% P.O.C.","$52000 - $60000"
"48029","Bexar County, Texas",1952843,57157,540436,138727,3185,53530,1753,1175975,27.7,7.1,0.2,2.7,0.1,60.2,72.3,636245,372372,263873,58.53,41.47,48173,324199,27498,236375,75671,560574,12.9,10.4,11.9,"50% - 75% P.O.C.","$52000 - $60000"
"48031","Blanco County, Texas",11478,66390,8837,3,14,165,42,2224,77,0,0.1,1.4,0.4,19.4,23,4343,3413,930,78.59,21.41,266,3147,79,851,345,3998,7.8,8.5,7.9,"Less than 25% P.O.C.","$60000 or more"
"48033","Borden County, Texas",613,72188,514,0,0,0,0,84,83.8,0,0,0,0,13.7,16.2,227,172,55,75.77,24.23,3,169,6,49,9,218,1.7,10.9,4,"Less than 25% P.O.C.","$60000 or more"
"48035","Bosque County, Texas",18296,52148,14239,295,65,100,0,3356,77.8,1.6,0.4,0.5,0,18.3,22.2,7211,5579,1632,77.37,22.63,622,4957,142,1490,764,6447,11.1,8.7,10.6,"Less than 25% P.O.C.","$52000 - $60000"
"48037","Bowie County, Texas",93373,50164,59562,22768,825,971,20,7098,63.8,24.4,0.9,1,0,7.6,36.2,34076,21624,12452,63.46,36.54,1900,19724,1110,11342,3010,31066,8.8,8.9,8.8,"25% - 50% P.O.C.","$44000 - $52000"
"48039","Brazoria County, Texas",360677,81447,170272,49226,1288,23803,21,110463,47.2,13.6,0.4,6.6,0,30.6,52.8,121523,87645,33878,72.12,27.88,12271,75374,3470,30408,15741,105782,14,10.2,13,"50% - 75% P.O.C.","$60000 or more"
"48041","Brazos County, Texas",222981,49181,124411,22923,291,13619,123,56995,55.8,10.3,0.1,6.1,0.1,25.6,44.2,79412,37425,41987,47.13,52.87,4266,33159,2702,39285,6968,72444,11.4,6.4,8.8,"25% - 50% P.O.C.","$44000 - $52000"
"48043","Brewster County, Texas",9231,47080,4642,19,173,138,0,4133,50.3,0.2,1.9,1.5,0,44.8,49.7,4088,2363,1725,57.8,42.2,189,2174,173,1552,362,3726,8,10,8.9,"25% - 50% P.O.C.","$44000 - $52000"
"48045","Briscoe County, Texas",1457,40227,845,12,0,0,22,519,58,0.8,0,0,1.5,35.6,42,602,417,185,69.27,30.73,20,397,14,171,34,568,4.8,7.6,5.6,"25% - 50% P.O.C.","Less than $44000"
"48047","Brooks County, Texas",7141,28333,478,0,0,0,0,6646,6.7,0,0,0,0,93.1,93.3,2120,1300,820,61.32,38.68,138,1162,170,650,308,1812,10.6,20.7,14.5,"75% or more P.O.C.","Less than $44000"
"48049","Brown County, Texas",37855,48365,27115,1337,109,270,0,8422,71.6,3.5,0.3,0.7,0,22.2,28.4,14409,10441,3968,72.46,27.54,1138,9303,254,3714,1392,13017,10.9,6.4,9.7,"25% - 50% P.O.C.","$44000 - $52000"
"48051","Burleson County, Texas",18058,57731,11688,2370,62,7,0,3736,64.7,13.1,0.3,0,0,20.7,35.3,6810,5323,1487,78.16,21.84,398,4925,125,1362,523,6287,7.5,8.4,7.7,"25% - 50% P.O.C.","$52000 - $60000"
"48053","Burnet County, Texas",46530,59492,34246,815,149,400,21,10342,73.6,1.8,0.3,0.9,0,22.2,26.4,16743,12924,3819,77.19,22.81,960,11964,432,3387,1392,15351,7.4,11.3,8.3,"25% - 50% P.O.C.","$52000 - $60000"
"48055","Caldwell County, Texas",42144,54152,16718,2360,176,407,53,21993,39.7,5.6,0.4,1,0.1,52.2,60.3,13460,9071,4389,67.39,32.61,1300,7771,504,3885,1804,11656,14.3,11.5,13.4,"50% - 75% P.O.C.","$52000 - $60000"
"48057","Calhoun County, Texas",21668,58776,9163,505,0,1140,7,10589,42.3,2.3,0,5.3,0,48.9,57.7,7582,5518,2064,72.78,27.22,695,4823,235,1829,930,6652,12.6,11.4,12.3,"50% - 75% P.O.C.","$52000 - $60000"
"48059","Callahan County, Texas",13856,48651,11916,126,5,69,0,1334,86,0.9,0,0.5,0,9.6,14,5367,4406,961,82.09,17.91,303,4103,94,867,397,4970,6.9,9.8,7.4,"Less than 25% P.O.C.","$44000 - $52000"
"48061","Cameron County, Texas",421666,38758,37770,1683,573,2792,47,378081,9,0.4,0.1,0.7,0,89.7,91,124605,82097,42508,65.89,34.11,17038,65059,8695,33813,25733,98872,20.8,20.5,20.7,"75% or more P.O.C.","Less than $44000"
"48063","Camp County, Texas",12878,48207,7183,2036,58,56,0,3215,55.8,15.8,0.5,0.4,0,25,44.2,4605,3335,1270,72.42,27.58,291,3044,146,1124,437,4168,8.7,11.5,9.5,"25% - 50% P.O.C.","$44000 - $52000"
"48065","Carson County, Texas",6009,74872,5151,48,97,22,0,596,85.7,0.8,1.6,0.4,0,9.9,14.3,2288,1854,434,81.03,18.97,95,1759,75,359,170,2118,5.1,17.3,7.4,"Less than 25% P.O.C.","$60000 or more"
"48067","Cass County, Texas",30059,44848,22938,5133,13,166,1,1352,76.3,17.1,0,0.6,0,4.5,23.7,11934,9469,2465,79.34,20.66,779,8690,350,2115,1129,10805,8.2,14.2,9.5,"Less than 25% P.O.C.","$44000 - $52000"
"48069","Castro County, Texas",7673,50142,2452,163,14,47,3,4957,32,2.1,0.2,0.6,0,64.6,68,2532,1632,900,64.45,35.55,213,1419,201,699,414,2118,13.1,22.3,16.4,"50% - 75% P.O.C.","$44000 - $52000"
"48071","Chambers County, Texas",41305,91141,27661,2997,63,465,0,9267,67,7.3,0.2,1.1,0,22.4,33,14069,11669,2400,82.94,17.06,1556,10113,530,1870,2086,11983,13.3,22.1,14.8,"25% - 50% P.O.C.","$60000 or more"
"48073","Cherokee County, Texas",52118,48186,31628,7035,290,227,43,12058,60.7,13.5,0.6,0.4,0.1,23.1,39.3,18138,13034,5104,71.86,28.14,1821,11213,771,4333,2592,15546,14,15.1,14.3,"25% - 50% P.O.C.","$44000 - $52000"
"48075","Childress County, Texas",7253,43181,4240,583,0,39,0,2249,58.5,8,0,0.5,0,31,41.5,2407,1441,966,59.87,40.13,144,1297,6,960,150,2257,10,0.6,6.2,"25% - 50% P.O.C.","Less than $44000"
"48077","Clay County, Texas",10403,55989,9339,47,101,117,0,653,89.8,0.5,1,1.1,0,6.3,10.2,4105,3463,642,84.36,15.64,212,3251,97,545,309,3796,6.1,15.1,7.5,"Less than 25% P.O.C.","$52000 - $60000"
"48079","Cochran County, Texas",2887,40962,1041,111,0,0,0,1695,36.1,3.8,0,0,0,58.7,63.9,998,782,216,78.36,21.64,107,675,32,184,139,859,13.7,14.8,13.9,"50% - 75% P.O.C.","Less than $44000"
"48081","Coke County, Texas",3303,45000,2517,32,22,0,0,711,76.2,1,0.7,0,0,21.5,23.8,1644,1219,425,74.15,25.85,72,1147,44,381,116,1528,5.9,10.4,7.1,"Less than 25% P.O.C.","$44000 - $52000"
"48083","Coleman County, Texas",8334,46743,6403,134,44,42,0,1460,76.8,1.6,0.5,0.5,0,17.5,23.2,3423,2553,870,74.58,25.42,159,2394,49,821,208,3215,6.2,5.6,6.1,"Less than 25% P.O.C.","$44000 - $52000"
"48085","Collin County, Texas",973977,96913,554789,93804,3261,146966,622,148696,57,9.6,0.3,15.1,0.1,15.3,43,341163,221828,119335,65.02,34.98,28656,193172,9765,109570,38421,302742,12.9,8.2,11.3,"25% - 50% P.O.C.","$60000 or more"
"48087","Collingsworth County, Texas",2969,39120,1784,248,62,0,0,854,60.1,8.4,2.1,0,0,28.8,39.9,1035,779,256,75.27,24.73,128,651,31,225,159,876,16.4,12.1,15.4,"25% - 50% P.O.C.","Less than $44000"
"48089","Colorado County, Texas",21224,52559,11871,2683,20,5,0,6310,55.9,12.6,0.1,0,0,29.7,44.1,7450,6142,1308,82.44,17.56,645,5497,155,1153,800,6650,10.5,11.9,10.7,"25% - 50% P.O.C.","$52000 - $60000"
"48091","Comal County, Texas",141642,79936,95622,2828,119,1577,44,38756,67.5,2,0.1,1.1,0,27.4,32.5,51367,38463,12904,74.88,25.12,3725,34738,1137,11767,4862,46505,9.7,8.8,9.5,"25% - 50% P.O.C.","$60000 or more"
"48093","Comanche County, Texas",13529,53516,9397,81,94,82,0,3777,69.5,0.6,0.7,0.6,0,27.9,30.5,5487,4389,1098,79.99,20.01,370,4019,117,981,487,5000,8.4,10.7,8.9,"25% - 50% P.O.C.","$52000 - $60000"
"48095","Concho County, Texas",3266,47500,1726,38,10,13,0,1474,52.8,1.2,0.3,0.4,0,45.1,47.2,912,686,226,75.22,24.78,32,654,24,202,56,856,4.7,10.6,6.1,"25% - 50% P.O.C.","$44000 - $52000"
"48097","Cooke County, Texas",40041,60202,30166,1121,278,344,24,7269,75.3,2.8,0.7,0.9,0.1,18.2,24.7,15351,10642,4709,69.32,30.68,874,9768,617,4092,1491,13860,8.2,13.1,9.7,"Less than 25% P.O.C.","$60000 or more"
"48099","Coryell County, Texas",75280,52893,44173,9617,489,1468,561,13761,58.7,12.8,0.6,2,0.7,18.3,41.3,22322,12931,9391,57.93,42.07,1620,11311,1035,8356,2655,19667,12.5,11,11.9,"25% - 50% P.O.C.","$52000 - $60000"
"48101","Cottle County, Texas",1642,32305,850,238,15,0,0,380,51.8,14.5,0.9,0,0,23.1,48.2,707,397,310,56.15,43.85,48,349,49,261,97,610,12.1,15.8,13.7,"25% - 50% P.O.C.","Less than $44000"
"48103","Crane County, Texas",4802,65969,1495,111,10,95,0,3091,31.1,2.3,0.2,2,0,64.4,68.9,1421,1217,204,85.64,14.36,246,971,59,145,305,1116,20.2,28.9,21.5,"50% - 75% P.O.C.","$60000 or more"
"48105","Crockett County, Texas",3484,47386,1304,24,0,0,0,2156,37.4,0.7,0,0,0,61.9,62.6,1354,1001,353,73.93,26.07,83,918,10,343,93,1261,8.3,2.8,6.9,"50% - 75% P.O.C.","$44000 - $52000"
"48107","Crosby County, Texas",5836,40759,2299,183,0,33,11,3269,39.4,3.1,0,0.6,0.2,56,60.6,2061,1552,509,75.3,24.7,194,1358,102,407,296,1765,12.5,20,14.4,"50% - 75% P.O.C.","Less than $44000"
"48109","Culberson County, Texas",2214,37900,562,3,1,13,0,1573,25.4,0.1,0,0.6,0,71,74.6,580,387,193,66.72,33.28,33,354,24,169,57,523,8.5,12.4,9.8,"50% - 75% P.O.C.","Less than $44000"
"48111","Dallam County, Texas",7304,58811,3626,56,84,142,0,3347,49.6,0.8,1.2,1.9,0,45.8,50.4,2364,1523,841,64.42,35.58,186,1337,128,713,314,2050,12.2,15.2,13.3,"50% - 75% P.O.C.","$52000 - $60000"
"48113","Dallas County, Texas",2606868,59607,759485,580189,5411,162770,1014,1047434,29.1,22.3,0.2,6.2,0,40.2,70.9,928341,464220,464121,50.01,49.99,68542,395678,49093,415028,117635,810706,14.8,10.6,12.7,"50% - 75% P.O.C.","$52000 - $60000"
"48115","Dawson County, Texas",12813,43239,4265,985,46,24,0,7363,33.3,7.7,0.4,0.2,0,57.5,66.7,4322,2995,1327,69.3,30.7,388,2607,81,1246,469,3853,13,6.1,10.9,"50% - 75% P.O.C.","Less than $44000"
"48117","Deaf Smith County, Texas",18736,49701,4626,119,70,118,18,13646,24.7,0.6,0.4,0.6,0.1,72.8,75.3,6145,3935,2210,64.04,35.96,636,3299,348,1862,984,5161,16.2,15.7,16,"75% or more P.O.C.","$44000 - $52000"
"48119","Delta County, Texas",5249,51038,4239,461,4,28,0,408,80.8,8.8,0.1,0.5,0,7.8,19.2,1999,1563,436,78.19,21.81,198,1365,47,389,245,1754,12.7,10.8,12.3,"Less than 25% P.O.C.","$44000 - $52000"
"48121","Denton County, Texas",833822,86913,494029,79871,3045,72148,629,160933,59.2,9.6,0.4,8.7,0.1,19.3,40.8,290229,188842,101387,65.07,34.93,23555,165287,7574,93813,31129,259100,12.5,7.5,10.7,"25% - 50% P.O.C.","$60000 or more"
"48123","DeWitt County, Texas",20340,55357,11143,1888,5,1,0,7192,54.8,9.3,0,0,0,35.4,45.2,7048,5129,1919,72.77,27.23,678,4451,249,1670,927,6121,13.2,13,13.2,"25% - 50% P.O.C.","$52000 - $60000"
"48125","Dickens County, Texas",2203,42540,1476,59,0,11,0,657,67,2.7,0,0.5,0,29.8,33,845,648,197,76.69,23.31,70,578,4,193,74,771,10.8,2,8.8,"25% - 50% P.O.C.","Less than $44000"
"48127","Dimmit County, Texas",10438,27161,1143,4,0,147,0,9072,11,0,0,1.4,0,86.9,89,3148,2085,1063,66.23,33.77,354,1731,219,844,573,2575,17,20.6,18.2,"75% or more P.O.C.","Less than $44000"
"48129","Donley County, Texas",3342,42961,2702,183,12,12,0,370,80.8,5.5,0.4,0.4,0,11.1,19.2,1335,938,397,70.26,29.74,63,875,10,387,73,1262,6.7,2.5,5.5,"Less than 25% P.O.C.","Less than $44000"
"48131","Duval County, Texas",11268,41186,1053,148,0,0,0,10066,9.3,1.3,0,0,0,89.3,90.7,3511,2298,1213,65.45,34.55,321,1977,270,943,591,2920,14,22.3,16.8,"75% or more P.O.C.","Less than $44000"
"48133","Eastland County, Texas",18273,37276,14494,522,54,113,0,2989,79.3,2.9,0.3,0.6,0,16.4,20.7,6492,4973,1519,76.6,23.4,365,4608,172,1347,537,5955,7.3,11.3,8.3,"Less than 25% P.O.C.","Less than $44000"
"48135","Ector County, Texas",160579,62973,51855,7109,320,1748,31,97439,32.3,4.4,0.2,1.1,0,60.7,67.7,52530,34087,18443,64.89,35.11,5145,28942,2064,16379,7209,45321,15.1,11.2,13.7,"50% - 75% P.O.C.","$60000 or more"
"48137","Edwards County, Texas",1918,40766,830,0,1,0,0,1086,43.3,0,0.1,0,0,56.6,56.7,789,675,114,85.55,14.45,30,645,12,102,42,747,4.4,10.5,5.3,"50% - 75% P.O.C.","Less than $44000"
"48139","Ellis County, Texas",173772,76871,105705,17028,485,1104,65,45577,60.8,9.8,0.3,0.6,0,26.2,39.2,57307,42622,14685,74.37,25.63,6676,35946,1954,12731,8630,48677,15.7,13.3,15.1,"25% - 50% P.O.C.","$60000 or more"
"48141","El Paso County, Texas",836062,46871,100109,24770,2315,9510,1044,690273,12,3,0.3,1.1,0.1,82.6,88,268310,164018,104292,61.13,38.87,24053,139965,12302,91990,36355,231955,14.7,11.8,13.5,"75% or more P.O.C.","$44000 - $52000"
"48143","Erath County, Texas",41841,52742,31197,776,30,369,85,8821,74.6,1.9,0.1,0.9,0.2,21.1,25.4,13595,8623,4972,63.43,36.57,1081,7542,438,4534,1519,12076,12.5,8.8,11.2,"25% - 50% P.O.C.","$52000 - $60000"
"48145","Falls County, Texas",17272,39497,8851,4164,68,82,0,4000,51.2,24.1,0.4,0.5,0,23.2,48.8,5199,3764,1435,72.4,27.6,396,3368,164,1271,560,4639,10.5,11.4,10.8,"25% - 50% P.O.C.","Less than $44000"
"48147","Fannin County, Texas",34537,54648,27211,1944,231,220,13,3900,78.8,5.6,0.7,0.6,0,11.3,21.2,12453,9117,3336,73.21,26.79,906,8211,460,2876,1366,11087,9.9,13.8,11,"Less than 25% P.O.C.","$52000 - $60000"
"48149","Fayette County, Texas",25141,60189,17907,1645,11,119,0,5276,71.2,6.5,0,0.5,0,21,28.8,9135,7460,1675,81.66,18.34,627,6833,143,1532,770,8365,8.4,8.5,8.4,"25% - 50% P.O.C.","$60000 or more"
"48151","Fisher County, Texas",3856,46146,2382,102,5,12,0,1261,61.8,2.6,0.1,0.3,0,32.7,38.2,1601,1179,422,73.64,26.36,112,1067,44,378,156,1445,9.5,10.4,9.7,"25% - 50% P.O.C.","$44000 - $52000"
"48153","Floyd County, Texas",5803,50580,2136,167,3,10,0,3405,36.8,2.9,0.1,0.2,0,58.7,63.2,2271,1700,571,74.86,25.14,222,1478,89,482,311,1960,13.1,15.6,13.7,"50% - 75% P.O.C.","$44000 - $52000"
"48155","Foard County, Texas",1275,43625,919,29,6,0,0,284,72.1,2.3,0.5,0,0,22.3,27.9,533,443,90,83.11,16.89,23,420,0,90,23,510,5.2,0,4.3,"25% - 50% P.O.C.","Less than $44000"
"48157","Fort Bend County, Texas",765394,97743,253263,153972,1713,153245,396,187500,33.1,20.1,0.2,20,0.1,24.5,66.9,237883,183583,54300,77.17,22.83,29804,153779,8301,45999,38105,199778,16.2,15.3,16,"50% - 75% P.O.C.","$60000 or more"
"48159","Franklin County, Texas",10716,53783,8430,468,31,5,0,1550,78.7,4.4,0.3,0,0,14.5,21.3,3965,3121,844,78.71,21.29,236,2885,93,751,329,3636,7.6,11,8.3,"Less than 25% P.O.C.","$52000 - $60000"
"48161","Freestone County, Texas",19714,49471,13130,2973,81,88,0,3055,66.6,15.1,0.4,0.4,0,15.5,33.4,6758,5234,1524,77.45,22.55,459,4775,189,1335,648,6110,8.8,12.4,9.6,"25% - 50% P.O.C.","$44000 - $52000"
"48163","Frio County, Texas",19871,46729,3233,631,9,160,0,15753,16.3,3.2,0,0.8,0,79.3,83.7,4542,3136,1406,69.04,30.96,332,2804,317,1089,649,3893,10.6,22.5,14.3,"75% or more P.O.C.","$44000 - $52000"
"48165","Gaines County, Texas",20706,63054,11493,450,57,102,9,8591,55.5,2.2,0.3,0.5,0,41.5,44.5,5812,4493,1319,77.31,22.69,1138,3355,127,1192,1265,4547,25.3,9.6,21.8,"25% - 50% P.O.C.","$60000 or more"
"48167","Galveston County, Texas",332885,73330,190948,41105,785,10840,110,82003,57.4,12.3,0.2,3.3,0,24.6,42.6,121438,81995,39443,67.52,32.48,8853,73142,3333,36110,12186,109252,10.8,8.5,10,"25% - 50% P.O.C.","$60000 or more"
"48169","Garza County, Texas",6070,49627,2407,342,8,119,0,3170,39.7,5.6,0.1,2,0,52.2,60.3,1543,1088,455,70.51,29.49,90,998,113,342,203,1340,8.3,24.8,13.2,"50% - 75% P.O.C.","$44000 - $52000"
"48171","Gillespie County, Texas",26459,59155,19765,21,85,32,0,6132,74.7,0.1,0.3,0.1,0,23.2,25.3,10694,7747,2947,72.44,27.56,642,7105,180,2767,822,9872,8.3,6.1,7.7,"25% - 50% P.O.C.","$52000 - $60000"
"48173","Glasscock County, Texas",1510,78456,849,0,0,0,0,661,56.2,0,0,0,0,43.8,43.8,403,265,138,65.76,34.24,24,241,20,118,44,359,9.1,14.5,10.9,"25% - 50% P.O.C.","$60000 or more"
"48175","Goliad County, Texas",7565,60690,4408,372,0,55,0,2712,58.3,4.9,0,0.7,0,35.8,41.7,2727,2182,545,80.01,19.99,102,2080,6,539,108,2619,4.7,1.1,4,"25% - 50% P.O.C.","$60000 or more"
"48177","Gonzales County, Texas",20731,53577,8635,1341,28,76,5,10518,41.7,6.5,0.1,0.4,0,50.7,58.3,7364,4956,2408,67.3,32.7,672,4284,315,2093,987,6377,13.6,13.1,13.4,"50% - 75% P.O.C.","$52000 - $60000"
"48179","Gray County, Texas",22410,47952,14189,965,149,150,45,6498,63.3,4.3,0.7,0.7,0.2,29,36.7,7884,5798,2086,73.54,26.46,710,5088,157,1929,867,7017,12.2,7.5,11,"25% - 50% P.O.C.","$44000 - $52000"
"48181","Grayson County, Texas",131014,54815,98801,6871,1355,2062,12,17577,75.4,5.2,1,1.6,0,13.4,24.6,48454,32756,15698,67.6,32.4,3071,29685,1464,14234,4535,43919,9.4,9.3,9.4,"Less than 25% P.O.C.","$52000 - $60000"
"48183","Gregg County, Texas",123443,50180,70988,24425,213,1577,130,23100,57.5,19.8,0.2,1.3,0.1,18.7,42.5,45460,26886,18574,59.14,40.86,3009,23877,1264,17310,4273,41187,11.2,6.8,9.4,"25% - 50% P.O.C.","$44000 - $52000"
"48185","Grimes County, Texas",27984,52913,16371,4164,71,55,0,6761,58.5,14.9,0.3,0.2,0,24.2,41.5,9011,6892,2119,76.48,23.52,750,6142,364,1755,1114,7897,10.9,17.2,12.4,"25% - 50% P.O.C.","$52000 - $60000"
"48187","Guadalupe County, Texas",158966,74496,80056,12055,281,2587,166,60278,50.4,7.6,0.2,1.6,0.1,37.9,49.6,54110,41499,12611,76.69,23.31,5225,36274,1852,10759,7077,47033,12.6,14.7,13.1,"25% - 50% P.O.C.","$60000 or more"
"48189","Hale County, Texas",33826,48384,11443,1535,33,99,6,20109,33.8,4.5,0.1,0.3,0,59.4,66.2,10933,6810,4123,62.29,37.71,872,5938,584,3539,1456,9477,12.8,14.2,13.3,"50% - 75% P.O.C.","$44000 - $52000"
"48191","Hall County, Texas",3048,34673,1695,188,16,8,0,1060,55.6,6.2,0.5,0.3,0,34.8,44.4,1267,827,440,65.27,34.73,91,736,42,398,133,1134,11,9.5,10.5,"25% - 50% P.O.C.","Less than $44000"
"48193","Hamilton County, Texas",8332,50825,7003,66,120,0,0,1062,84,0.8,1.4,0,0,12.7,16,2989,2447,542,81.87,18.13,170,2277,109,433,279,2710,6.9,20.1,9.3,"Less than 25% P.O.C.","$44000 - $52000"
"48195","Hansford County, Texas",5520,38000,2849,5,8,4,0,2650,51.6,0.1,0.1,0.1,0,48,48.4,1838,1295,543,70.46,29.54,162,1133,44,499,206,1632,12.5,8.1,11.2,"25% - 50% P.O.C.","Less than $44000"
"48197","Hardeman County, Texas",3945,41859,2828,232,45,0,0,749,71.7,5.9,1.1,0,0,19,28.3,1596,1084,512,67.92,32.08,66,1018,17,495,83,1513,6.1,3.3,5.2,"25% - 50% P.O.C.","Less than $44000"
"48199","Hardin County, Texas",56765,60339,49096,3153,148,351,0,3230,86.5,5.6,0.3,0.6,0,5.7,13.5,20626,16752,3874,81.22,18.78,1788,14964,319,3555,2107,18519,10.7,8.2,10.2,"Less than 25% P.O.C.","$60000 or more"
"48201","Harris County, Texas",4646630,61705,1374905,863044,8105,321392,2441,1995115,29.6,18.6,0.2,6.9,0.1,42.9,70.4,1605368,876454,728914,54.6,45.4,131501,744953,83562,645352,215063,1390305,15,11.5,13.4,"50% - 75% P.O.C.","$60000 or more"
"48203","Harrison County, Texas",66580,52220,42336,13760,164,528,14,8727,63.6,20.7,0.2,0.8,0,13.1,36.4,23292,16840,6452,72.3,27.7,1713,15127,729,5723,2442,20850,10.2,11.3,10.5,"25% - 50% P.O.C.","$52000 - $60000"
"48205","Hartley County, Texas",5669,58298,3400,420,20,82,0,1515,60,7.4,0.4,1.4,0,26.7,40,1678,1052,626,62.69,37.31,128,924,101,525,229,1449,12.2,16.1,13.6,"25% - 50% P.O.C.","$52000 - $60000"
"48207","Haskell County, Texas",5726,40313,3702,217,27,16,0,1636,64.7,3.8,0.5,0.3,0,28.6,35.3,2146,1622,524,75.58,24.42,146,1476,52,472,198,1948,9,9.9,9.2,"25% - 50% P.O.C.","Less than $44000"
"48209","Hays County, Texas",213366,68717,114727,8207,522,3210,0,83069,53.8,3.8,0.2,1.5,0,38.9,46.2,73437,45739,27698,62.28,37.72,5005,40734,2725,24973,7730,65707,10.9,9.8,10.5,"25% - 50% P.O.C.","$60000 or more"
"48211","Hemphill County, Texas",3994,70625,2519,39,0,1,0,1391,63.1,1,0,0,0,34.8,36.9,1298,925,373,71.26,28.74,121,804,69,304,190,1108,13.1,18.5,14.6,"25% - 50% P.O.C.","$60000 or more"
"48213","Henderson County, Texas",81070,47355,63378,5150,622,525,26,10347,78.2,6.4,0.8,0.6,0,12.8,21.8,30757,23133,7624,75.21,24.79,1872,21261,989,6635,2861,27896,8.1,13,9.3,"Less than 25% P.O.C.","$44000 - $52000"
"48215","Hidalgo County, Texas",855176,40014,52492,3612,532,8043,73,788282,6.1,0.4,0.1,0.9,0,92.2,93.9,238345,162163,76182,68.04,31.96,40051,122112,15277,60905,55328,183017,24.7,20.1,23.2,"75% or more P.O.C.","Less than $44000"
"48217","Hill County, Texas",35689,53307,25196,2239,108,143,59,7354,70.6,6.3,0.3,0.4,0.2,20.6,29.4,12992,9429,3563,72.58,27.42,1017,8412,348,3215,1365,11627,10.8,9.8,10.5,"25% - 50% P.O.C.","$52000 - $60000"
"48219","Hockley County, Texas",23064,48248,10824,738,117,81,21,11023,46.9,3.2,0.5,0.4,0.1,47.8,53.1,7997,5640,2357,70.53,29.47,701,4939,440,1917,1141,6856,12.4,18.7,14.3,"50% - 75% P.O.C.","$44000 - $52000"
"48221","Hood County, Texas",58318,64041,49117,441,517,411,37,7232,84.2,0.8,0.9,0.7,0.1,12.4,15.8,22152,17134,5018,77.35,22.65,1157,15977,436,4582,1593,20559,6.8,8.7,7.2,"Less than 25% P.O.C.","$60000 or more"
"48223","Hopkins County, Texas",36486,52078,26738,2555,100,243,44,6157,73.3,7,0.3,0.7,0.1,16.9,26.7,13424,9343,4081,69.6,30.4,775,8568,542,3539,1317,12107,8.3,13.3,9.8,"25% - 50% P.O.C.","$52000 - $60000"
"48225","Houston County, Texas",22954,37904,14192,5717,53,88,0,2544,61.8,24.9,0.2,0.4,0,11.1,38.2,8252,5774,2478,69.97,30.03,309,5465,281,2197,590,7662,5.4,11.3,7.1,"25% - 50% P.O.C.","Less than $44000"
"48227","Howard County, Texas",36349,54208,17684,1888,259,252,11,15452,48.7,5.2,0.7,0.7,0,42.5,51.3,11064,7235,3829,65.39,34.61,716,6519,409,3420,1125,9939,9.9,10.7,10.2,"50% - 75% P.O.C.","$52000 - $60000"
"48229","Hudspeth County, Texas",4415,31677,766,72,0,34,0,3435,17.3,1.6,0,0.8,0,77.8,82.7,978,703,275,71.88,28.12,85,618,9,266,94,884,12.1,3.3,9.6,"75% or more P.O.C.","Less than $44000"
"48231","Hunt County, Texas",94162,54959,67443,7350,950,1164,43,15396,71.6,7.8,1,1.2,0,16.4,28.4,33189,22860,10329,68.88,31.12,3147,19713,971,9358,4118,29071,13.8,9.4,12.4,"25% - 50% P.O.C.","$52000 - $60000"
"48233","Hutchinson County, Texas",21344,52524,15018,307,331,76,150,4964,70.4,1.4,1.6,0.4,0.7,23.3,29.6,6929,5566,1363,80.33,19.67,483,5083,98,1265,581,6348,8.7,7.2,8.4,"25% - 50% P.O.C.","$52000 - $60000"
"48235","Irion County, Texas",1620,47500,1132,66,0,0,0,414,69.9,4.1,0,0,0,25.6,30.1,682,529,153,77.57,22.43,15,514,35,118,50,632,2.8,22.9,7.3,"25% - 50% P.O.C.","$44000 - $52000"
"48237","Jack County, Texas",8852,52045,6830,420,24,9,0,1494,77.2,4.7,0.3,0.1,0,16.9,22.8,3168,2575,593,81.28,18.72,276,2299,83,510,359,2809,10.7,14,11.3,"Less than 25% P.O.C.","$52000 - $60000"
"48239","Jackson County, Texas",14816,62806,8665,960,0,155,9,4905,58.5,6.5,0,1,0.1,33.1,41.5,4917,3422,1495,69.6,30.4,390,3032,235,1260,625,4292,11.4,15.7,12.7,"25% - 50% P.O.C.","$60000 or more"
"48241","Jasper County, Texas",35506,44370,26460,5869,44,160,24,2386,74.5,16.5,0.1,0.5,0.1,6.7,25.5,12936,10035,2901,77.57,22.43,663,9372,438,2463,1101,11835,6.6,15.1,8.5,"25% - 50% P.O.C.","$44000 - $52000"
"48243","Jeff Davis County, Texas",2241,53088,1308,23,0,0,0,893,58.4,1,0,0,0,39.8,41.6,1054,860,194,81.59,18.41,38,822,30,164,68,986,4.4,15.5,6.5,"25% - 50% P.O.C.","$52000 - $60000"
"48245","Jefferson County, Texas",254340,51248,103229,85092,515,9493,130,52708,40.6,33.5,0.2,3.7,0.1,20.7,59.4,92988,56792,36196,61.07,38.93,5085,51707,2952,33244,8037,84951,9,8.2,8.6,"50% - 75% P.O.C.","$44000 - $52000"
"48247","Jim Hogg County, Texas",5231,33382,423,2,0,0,0,4778,8.1,0,0,0,0,91.3,91.9,1626,1165,461,71.65,28.35,164,1001,63,398,227,1399,14.1,13.7,14,"75% or more P.O.C.","Less than $44000"
"48249","Jim Wells County, Texas",40972,41505,7357,255,82,210,54,32893,18,0.6,0.2,0.5,0.1,80.3,82,12987,9170,3817,70.61,29.39,1525,7645,449,3368,1974,11013,16.6,11.8,15.2,"75% or more P.O.C.","Less than $44000"
"48251","Johnson County, Texas",167212,64359,120380,5794,568,1536,661,35714,72,3.5,0.3,0.9,0.4,21.4,28,57310,42032,15278,73.34,26.66,5979,36053,2011,13267,7990,49320,14.2,13.2,13.9,"25% - 50% P.O.C.","$60000 or more"
"48253","Jones County, Texas",19943,50344,10799,2790,42,77,0,5494,54.1,14,0.2,0.4,0,27.5,45.9,5696,4249,1447,74.6,25.4,244,4005,121,1326,365,5331,5.7,8.4,6.4,"25% - 50% P.O.C.","$44000 - $52000"
"48255","Karnes County, Texas",15545,56127,5572,997,19,161,0,8506,35.8,6.4,0.1,1,0,54.7,64.2,4282,3190,1092,74.5,25.5,214,2976,81,1011,295,3987,6.7,7.4,6.9,"50% - 75% P.O.C.","$52000 - $60000"
"48257","Kaufman County, Texas",123804,70107,78847,14504,332,1590,55,26524,63.7,11.7,0.3,1.3,0,21.4,36.3,38015,29123,8892,76.61,23.39,4403,24720,1667,7225,6070,31945,15.1,18.7,16,"25% - 50% P.O.C.","$60000 or more"
"48259","Kendall County, Texas",43769,84747,31664,214,52,392,55,10450,72.3,0.5,0.1,0.9,0.1,23.9,27.7,14253,10563,3690,74.11,25.89,1116,9447,528,3162,1644,12609,10.6,14.3,11.5,"25% - 50% P.O.C.","$60000 or more"
"48261","Kenedy County, Texas",568,38021,30,0,0,0,0,538,5.3,0,0,0,0,94.7,94.7,197,46,151,23.35,76.65,0,46,35,116,35,162,0,23.2,17.8,"75% or more P.O.C.","Less than $44000"
"48263","Kent County, Texas",647,44688,542,6,8,0,0,91,83.8,0.9,1.2,0,0,14.1,16.2,273,190,83,69.6,30.4,12,178,7,76,19,254,6.3,8.4,7,"Less than 25% P.O.C.","$44000 - $52000"
"48265","Kerr County, Texas",51843,55990,35627,742,131,423,41,13964,68.7,1.4,0.3,0.8,0.1,26.9,31.3,21403,15136,6267,70.72,29.28,1028,14108,824,5443,1852,19551,6.8,13.1,8.7,"25% - 50% P.O.C.","$52000 - $60000"
"48267","Kimble County, Texas",4373,43328,3309,48,0,0,0,953,75.7,1.1,0,0,0,21.8,24.3,1783,1359,424,76.22,23.78,92,1267,48,376,140,1643,6.8,11.3,7.9,"Less than 25% P.O.C.","Less than $44000"
"48269","King County, Texas",237,52083,159,0,0,0,0,78,67.1,0,0,0,0,32.9,32.9,77,26,51,33.77,66.23,0,26,3,48,3,74,0,5.9,3.9,"25% - 50% P.O.C.","$52000 - $60000"
"48271","Kinney County, Texas",3659,26738,1485,5,0,0,0,2169,40.6,0.1,0,0,0,59.3,59.4,1337,1024,313,76.59,23.41,9,1015,13,300,22,1315,0.9,4.2,1.6,"50% - 75% P.O.C.","Less than $44000"
"48273","Kleberg County, Texas",30974,43730,6255,910,12,695,0,22574,20.2,2.9,0,2.2,0,72.9,79.8,10955,5781,5174,52.77,47.23,631,5150,399,4775,1030,9925,10.9,7.7,9.4,"75% or more P.O.C.","Less than $44000"
"48275","Knox County, Texas",3705,48798,2157,174,0,40,0,1272,58.2,4.7,0,1.1,0,34.3,41.8,1375,1140,235,82.91,17.09,112,1028,25,210,137,1238,9.8,10.6,10,"25% - 50% P.O.C.","$44000 - $52000"
"48277","Lamar County, Texas",49611,45117,36920,6324,271,382,56,3902,74.4,12.7,0.5,0.8,0.1,7.9,25.6,19793,12760,7033,64.47,35.53,1175,11585,638,6395,1813,17980,9.2,9.1,9.2,"25% - 50% P.O.C.","$44000 - $52000"
"48279","Lamb County, Texas",13123,45111,5158,392,47,68,0,7291,39.3,3,0.4,0.5,0,55.6,60.7,4728,3380,1348,71.49,28.51,550,2830,177,1171,727,4001,16.3,13.1,15.4,"50% - 75% P.O.C.","$44000 - $52000"
"48281","Lampasas County, Texas",20862,60772,15143,904,72,240,72,4052,72.6,4.3,0.3,1.2,0.3,19.4,27.4,7807,6039,1768,77.35,22.65,491,5548,121,1647,612,7195,8.1,6.8,7.8,"25% - 50% P.O.C.","$60000 or more"
"48283","La Salle County, Texas",7416,50151,982,108,0,12,0,6236,13.2,1.5,0,0.2,0,84.1,86.8,2269,1559,710,68.71,31.29,184,1375,54,656,238,2031,11.8,7.6,10.5,"75% or more P.O.C.","$44000 - $52000"
"48285","Lavaca County, Texas",20021,54403,14717,1234,7,94,0,3785,73.5,6.2,0,0.5,0,18.9,26.5,7826,5811,2015,74.25,25.75,484,5327,274,1741,758,7068,8.3,13.6,9.7,"25% - 50% P.O.C.","$52000 - $60000"
"48287","Lee County, Texas",17058,54744,10804,1899,0,169,0,4040,63.3,11.1,0,1,0,23.7,36.7,6036,4862,1174,80.55,19.45,462,4400,130,1044,592,5444,9.5,11.1,9.8,"25% - 50% P.O.C.","$52000 - $60000"
"48289","Leon County, Texas",17225,43045,13113,1155,103,138,55,2509,76.1,6.7,0.6,0.8,0.3,14.6,23.9,6443,4985,1458,77.37,22.63,317,4668,169,1289,486,5957,6.4,11.6,7.5,"Less than 25% P.O.C.","Less than $44000"
"48291","Liberty County, Texas",83702,51494,52983,8239,411,439,8,20788,63.3,9.8,0.5,0.5,0,24.8,36.7,26873,20302,6571,75.55,24.45,2716,17586,601,5970,3317,23556,13.4,9.1,12.3,"25% - 50% P.O.C.","$44000 - $52000"
"48293","Limestone County, Texas",23417,44418,13735,3945,108,177,67,5130,58.7,16.8,0.5,0.8,0.3,21.9,41.3,8377,6204,2173,74.06,25.94,883,5321,218,1955,1101,7276,14.2,10,13.1,"25% - 50% P.O.C.","$44000 - $52000"
"48295","Lipscomb County, Texas",3398,59091,2124,18,65,21,0,1086,62.5,0.5,1.9,0.6,0,32,37.5,1192,880,312,73.83,26.17,131,749,19,293,150,1042,14.9,6.1,12.6,"25% - 50% P.O.C.","$52000 - $60000"
"48297","Live Oak County, Texas",12139,53848,6804,269,0,173,0,4854,56.1,2.2,0,1.4,0,40,43.9,3752,3075,677,81.96,18.04,220,2855,66,611,286,3466,7.2,9.7,7.6,"25% - 50% P.O.C.","$52000 - $60000"
"48299","Llano County, Texas",21047,53411,18192,140,126,61,0,2187,86.4,0.7,0.6,0.3,0,10.4,13.6,8678,6775,1903,78.07,21.93,243,6532,214,1689,457,8221,3.6,11.2,5.3,"Less than 25% P.O.C.","$52000 - $60000"
"48301","Loving County, Texas",98,83750,83,0,3,0,0,12,84.7,0,3.1,0,0,12.2,15.3,30,19,11,63.33,36.67,5,14,0,11,5,25,26.3,0,16.7,"Less than 25% P.O.C.","$60000 or more"
"48303","Lubbock County, Texas",304808,52429,162989,20125,1110,6494,200,107993,53.5,6.6,0.4,2.1,0.1,35.4,46.5,113488,62673,50815,55.22,44.78,6626,56047,4951,45864,11577,101911,10.6,9.7,10.2,"25% - 50% P.O.C.","$52000 - $60000"
"48305","Lynn County, Texas",5830,43382,2874,41,4,46,6,2753,49.3,0.7,0.1,0.8,0.1,47.2,50.7,2154,1471,683,68.29,31.71,173,1298,97,586,270,1884,11.8,14.2,12.5,"50% - 75% P.O.C.","Less than $44000"
"48307","McCulloch County, Texas",8057,47707,4875,87,4,60,0,2603,60.5,1.1,0,0.7,0,32.3,39.5,3143,2270,873,72.22,27.78,127,2143,52,821,179,2964,5.6,6,5.7,"25% - 50% P.O.C.","$44000 - $52000"
"48309","McLennan County, Texas",251089,49778,140429,35807,455,3961,62,66148,55.9,14.3,0.2,1.6,0,26.3,44.1,90054,53341,36713,59.23,40.77,6197,47144,2882,33831,9079,80975,11.6,7.9,10.1,"25% - 50% P.O.C.","$44000 - $52000"
"48311","McMullen County, Texas",774,62000,380,0,9,0,0,385,49.1,0,1.2,0,0,49.7,50.9,270,205,65,75.93,24.07,4,201,20,45,24,246,2,30.8,8.9,"50% - 75% P.O.C.","$60000 or more"
"48313","Madison County, Texas",14197,52664,7809,2310,16,477,10,3290,55,16.3,0.1,3.4,0.1,23.2,45,4269,3166,1103,74.16,25.84,309,2857,142,961,451,3818,9.8,12.9,10.6,"25% - 50% P.O.C.","$52000 - $60000"
"48315","Marion County, Texas",10017,37662,7097,2294,11,32,41,415,70.8,22.9,0.1,0.3,0.4,4.1,29.2,4715,3645,1070,77.31,22.69,224,3421,164,906,388,4327,6.1,15.3,8.2,"25% - 50% P.O.C.","Less than $44000"
"48317","Martin County, Texas",5649,66610,3047,48,10,4,0,2540,53.9,0.8,0.2,0.1,0,45,46.1,1694,1251,443,73.85,26.15,80,1171,118,325,198,1496,6.4,26.6,11.7,"25% - 50% P.O.C.","$60000 or more"
"48319","Mason County, Texas",4186,42276,3105,2,0,101,0,929,74.2,0,0,2.4,0,22.2,25.8,1696,1198,498,70.64,29.36,59,1139,37,461,96,1600,4.9,7.4,5.7,"25% - 50% P.O.C.","Less than $44000"
"48321","Matagorda County, Texas",36774,48913,16045,3785,99,710,120,15612,43.6,10.3,0.3,1.9,0.3,42.5,56.4,13848,9787,4061,70.67,29.33,1046,8741,577,3484,1623,12225,10.7,14.2,11.7,"50% - 75% P.O.C.","$44000 - $52000"
"48323","Maverick County, Texas",58174,39625,1452,187,697,318,24,55368,2.5,0.3,1.2,0.5,0,95.2,97.5,16286,10702,5584,65.71,34.29,2593,8109,993,4591,3586,12700,24.2,17.8,22,"75% or more P.O.C.","Less than $44000"
"48325","Medina County, Texas",50057,62599,21808,1237,84,343,21,26016,43.6,2.5,0.2,0.7,0,52,56.4,15682,12608,3074,80.4,19.6,1695,10913,516,2558,2211,13471,13.4,16.8,14.1,"50% - 75% P.O.C.","$60000 or more"
"48327","Menard County, Texas",2119,36395,1162,0,3,0,0,883,54.8,0,0.1,0,0,41.7,45.2,1014,701,313,69.13,30.87,41,660,7,306,48,966,5.8,2.2,4.7,"25% - 50% P.O.C.","Less than $44000"
"48329","Midland County, Texas",168167,79421,76360,10456,550,3219,79,75224,45.4,6.2,0.3,1.9,0,44.7,54.6,56998,38145,18853,66.92,33.08,5342,32803,1726,17127,7068,49930,14,9.2,12.4,"50% - 75% P.O.C.","$60000 or more"
"48331","Milam County, Texas",24770,47902,15447,2279,66,129,0,6546,62.4,9.2,0.3,0.5,0,26.4,37.6,9228,6591,2637,71.42,28.58,642,5949,321,2316,963,8265,9.7,12.2,10.4,"25% - 50% P.O.C.","$44000 - $52000"
"48333","Mills County, Texas",4889,49306,3824,19,9,11,0,1026,78.2,0.4,0.2,0.2,0,21,21.8,1790,1523,267,85.08,14.92,75,1448,9,258,84,1706,4.9,3.4,4.7,"Less than 25% P.O.C.","$44000 - $52000"
"48335","Mitchell County, Texas",8523,51492,4082,769,153,37,0,3399,47.9,9,1.8,0.4,0,39.9,52.1,2382,1881,501,78.97,21.03,250,1631,48,453,298,2084,13.3,9.6,12.5,"50% - 75% P.O.C.","$44000 - $52000"
"48337","Montague County, Texas",19489,51765,16720,131,159,0,0,2138,85.8,0.7,0.8,0,0,11,14.2,7800,5647,2153,72.4,27.6,493,5154,227,1926,720,7080,8.7,10.5,9.2,"Less than 25% P.O.C.","$44000 - $52000"
"48339","Montgomery County, Texas",571949,80902,377623,27435,1085,16677,207,138081,66,4.8,0.2,2.9,0,24.1,34,198649,141137,57512,71.05,28.95,17971,123166,5952,51560,23923,174726,12.7,10.3,12,"25% - 50% P.O.C.","$60000 or more"
"48341","Moore County, Texas",21399,54871,6946,687,81,1463,0,11996,32.5,3.2,0.4,6.8,0,56.1,67.5,6733,4433,2300,65.84,34.16,657,3776,385,1915,1042,5691,14.8,16.7,15.5,"50% - 75% P.O.C.","$52000 - $60000"
"48343","Morris County, Texas",12373,41359,7968,2857,38,20,8,1220,64.4,23.1,0.3,0.2,0.1,9.9,35.6,5117,3734,1383,72.97,27.03,292,3442,159,1224,451,4666,7.8,11.5,8.8,"25% - 50% P.O.C.","Less than $44000"
"48345","Motley County, Texas",1252,43859,932,19,0,0,0,246,74.4,1.5,0,0,0,19.6,25.6,489,334,155,68.3,31.7,37,297,6,149,43,446,11.1,3.9,8.8,"25% - 50% P.O.C.","Less than $44000"
"48347","Nacogdoches County, Texas",65339,44847,38888,11279,266,917,14,12690,59.5,17.3,0.4,1.4,0,19.4,40.5,23757,13439,10318,56.57,43.43,1358,12081,1018,9300,2376,21381,10.1,9.9,10,"25% - 50% P.O.C.","$44000 - $52000"
"48349","Navarro County, Texas",48995,48529,27461,5977,123,333,657,13354,56,12.2,0.3,0.7,1.3,27.3,44,17338,11947,5391,68.91,31.09,1600,10347,487,4904,2087,15251,13.4,9,12,"25% - 50% P.O.C.","$44000 - $52000"
"48351","Newton County, Texas",13914,40101,10223,2823,46,77,0,504,73.5,20.3,0.3,0.6,0,3.6,26.5,5315,4497,818,84.61,15.39,195,4302,134,684,329,4986,4.3,16.4,6.2,"25% - 50% P.O.C.","Less than $44000"
"48353","Nolan County, Texas",14904,45537,8276,829,25,43,0,5616,55.5,5.6,0.2,0.3,0,37.7,44.5,5407,3635,1772,67.23,32.77,279,3356,328,1444,607,4800,7.7,18.5,11.2,"25% - 50% P.O.C.","$44000 - $52000"
"48355","Nueces County, Texas",361540,55919,106563,13101,907,7247,213,230450,29.5,3.6,0.3,2,0.1,63.7,70.5,129451,75017,54434,57.95,42.05,9137,65880,5849,48585,14986,114465,12.2,10.7,11.6,"50% - 75% P.O.C.","$52000 - $60000"
"48357","Ochiltree County, Texas",10131,50464,4367,9,32,23,0,5489,43.1,0.1,0.3,0.2,0,54.2,56.9,3483,2556,927,73.39,26.61,611,1945,208,719,819,2664,23.9,22.4,23.5,"50% - 75% P.O.C.","$44000 - $52000"
"48359","Oldham County, Texas",2094,64545,1615,64,0,39,0,319,77.1,3.1,0,1.9,0,15.2,22.9,594,466,128,78.45,21.55,46,420,14,114,60,534,9.9,10.9,10.1,"Less than 25% P.O.C.","$60000 or more"
"48361","Orange County, Texas",84069,59399,67807,7302,244,980,0,6456,80.7,8.7,0.3,1.2,0,7.7,19.3,31694,23864,7830,75.3,24.7,2197,21667,843,6987,3040,28654,9.2,10.8,9.6,"Less than 25% P.O.C.","$52000 - $60000"
"48363","Palo Pinto County, Texas",28540,50154,21419,715,159,226,29,5674,75,2.5,0.6,0.8,0.1,19.9,25,10255,7456,2799,72.71,27.29,512,6944,333,2466,845,9410,6.9,11.9,8.2,"25% - 50% P.O.C.","$44000 - $52000"
"48365","Panola County, Texas",23327,52982,17071,4032,36,17,0,2034,73.2,17.3,0.2,0.1,0,8.7,26.8,8637,6626,2011,76.72,23.28,544,6082,264,1747,808,7829,8.2,13.1,9.4,"25% - 50% P.O.C.","$52000 - $60000"
"48367","Parker County, Texas",133811,77503,111688,1663,690,724,58,16443,83.5,1.2,0.5,0.5,0,12.3,16.5,44263,34897,9366,78.84,21.16,3800,31097,1079,8287,4879,39384,10.9,11.5,11,"Less than 25% P.O.C.","$60000 or more"
"48369","Parmer County, Texas",9718,55359,3314,116,12,33,0,6151,34.1,1.2,0.1,0.3,0,63.3,65.9,3203,2144,1059,66.94,33.06,412,1732,200,859,612,2591,19.2,18.9,19.1,"50% - 75% P.O.C.","$52000 - $60000"
"48371","Pecos County, Texas",15815,52397,3983,543,160,96,24,10877,25.2,3.4,1,0.6,0.2,68.8,74.8,4656,3363,1293,72.23,27.77,557,2806,124,1169,681,3975,16.6,9.6,14.6,"50% - 75% P.O.C.","$52000 - $60000"
"48373","Polk County, Texas",48913,49279,34672,4742,710,375,70,7471,70.9,9.7,1.5,0.8,0.1,15.3,29.1,18033,13711,4322,76.03,23.97,1341,12370,521,3801,1862,16171,9.8,12.1,10.3,"25% - 50% P.O.C.","$44000 - $52000"
"48375","Potter County, Texas",119674,42528,52742,11718,485,6456,242,45859,44.1,9.8,0.4,5.4,0.2,38.3,55.9,44380,24484,19896,55.17,44.83,3261,21223,2370,17526,5631,38749,13.3,11.9,12.7,"50% - 75% P.O.C.","Less than $44000"
"48377","Presidio County, Texas",6975,25098,904,0,136,94,0,5841,13,0,1.9,1.3,0,83.7,87,2543,1471,1072,57.85,42.15,47,1424,96,976,143,2400,3.2,9,5.6,"75% or more P.O.C.","Less than $44000"
"48379","Rains County, Texas",11766,51579,10040,415,65,42,0,1073,85.3,3.5,0.6,0.4,0,9.1,14.7,4330,3366,964,77.74,22.26,209,3157,38,926,247,4083,6.2,3.9,5.7,"Less than 25% P.O.C.","$44000 - $52000"
"48381","Randall County, Texas",134026,68261,96033,3374,456,2319,349,28991,71.7,2.5,0.3,1.7,0.3,21.6,28.3,49389,34978,14411,70.82,29.18,2896,32082,937,13474,3833,45556,8.3,6.5,7.8,"25% - 50% P.O.C.","$60000 or more"
"48383","Reagan County, Texas",3766,74868,1121,32,0,6,0,2592,29.8,0.8,0,0.2,0,68.8,70.2,1084,731,353,67.44,32.56,135,596,5,348,140,944,18.5,1.4,12.9,"50% - 75% P.O.C.","$60000 or more"
"48385","Real County, Texas",3408,35862,2491,19,0,2,0,895,73.1,0.6,0,0.1,0,26.3,26.9,1126,861,265,76.47,23.53,31,830,11,254,42,1084,3.6,4.2,3.7,"25% - 50% P.O.C.","Less than $44000"
"48387","Red River County, Texas",12171,39142,8932,2039,39,10,0,886,73.4,16.8,0.3,0.1,0,7.3,26.6,4963,3800,1163,76.57,23.43,183,3617,91,1072,274,4689,4.8,7.8,5.5,"25% - 50% P.O.C.","Less than $44000"
"48389","Reeves County, Texas",15492,53311,3451,208,0,204,21,11571,22.3,1.3,0,1.3,0.1,74.7,77.7,3518,2549,969,72.46,27.54,251,2298,64,905,315,3203,9.8,6.6,9,"75% or more P.O.C.","$52000 - $60000"
"48391","Refugio County, Texas",7145,50076,2975,463,7,21,0,3604,41.6,6.5,0.1,0.3,0,50.4,58.4,2547,1853,694,72.75,27.25,147,1706,37,657,184,2363,7.9,5.3,7.2,"50% - 75% P.O.C.","$44000 - $52000"
"48393","Roberts County, Texas",805,68750,675,0,0,0,0,107,83.9,0,0,0,0,13.3,16.1,301,240,61,79.73,20.27,20,220,0,61,20,281,8.3,0,6.6,"Less than 25% P.O.C.","$60000 or more"
"48395","Robertson County, Texas",16990,52928,9718,3437,39,29,18,3564,57.2,20.2,0.2,0.2,0.1,21,42.8,6444,4902,1542,76.07,23.93,712,4190,133,1409,845,5599,14.5,8.6,13.1,"25% - 50% P.O.C.","$52000 - $60000"
"48397","Rockwall County, Texas",97175,100920,68827,6042,293,2580,48,17138,70.8,6.2,0.3,2.7,0,17.6,29.2,33032,27016,6016,81.79,18.21,3698,23318,618,5398,4316,28716,13.7,10.3,13.1,"25% - 50% P.O.C.","$60000 or more"
"48399","Runnels County, Texas",10277,44940,6317,309,13,11,0,3511,61.5,3,0.1,0.1,0,34.2,38.5,3896,2772,1124,71.15,28.85,320,2452,83,1041,403,3493,11.5,7.4,10.3,"25% - 50% P.O.C.","$44000 - $52000"
"48401","Rusk County, Texas",53755,55234,34267,9015,71,279,30,9042,63.7,16.8,0.1,0.5,0.1,16.8,36.3,18108,14097,4011,77.85,22.15,1437,12660,411,3600,1848,16260,10.2,10.2,10.2,"25% - 50% P.O.C.","$52000 - $60000"
"48403","Sabine County, Texas",10471,34992,8956,591,23,7,30,477,85.5,5.6,0.2,0.1,0.3,4.6,14.5,4311,3804,507,88.24,11.76,279,3525,34,473,313,3998,7.3,6.7,7.3,"Less than 25% P.O.C.","Less than $44000"
"48405","San Augustine County, Texas",8286,40353,5725,1768,132,0,0,597,69.1,21.3,1.6,0,0,7.2,30.9,3451,2674,777,77.48,22.52,74,2600,58,719,132,3319,2.8,7.5,3.8,"25% - 50% P.O.C.","Less than $44000"
"48407","San Jacinto County, Texas",28180,41614,21043,2517,218,9,10,3693,74.7,8.9,0.8,0,0,13.1,25.3,10043,8098,1945,80.63,19.37,838,7260,294,1651,1132,8911,10.3,15.1,11.3,"25% - 50% P.O.C.","Less than $44000"
"48409","San Patricio County, Texas",67008,56556,25725,975,123,666,31,38724,38.4,1.5,0.2,1,0,57.8,61.6,22898,15645,7253,68.32,31.68,2169,13476,1333,5920,3502,19396,13.9,18.4,15.3,"50% - 75% P.O.C.","$52000 - $60000"
"48411","San Saba County, Texas",5991,45083,3847,121,0,9,0,1803,64.2,2,0,0.2,0,30.1,35.8,2082,1425,657,68.44,31.56,89,1336,103,554,192,1890,6.2,15.7,9.2,"25% - 50% P.O.C.","$44000 - $52000"
"48413","Schleicher County, Texas",2983,53229,1376,16,0,0,11,1580,46.1,0.5,0,0,0.4,53,53.9,1075,848,227,78.88,21.12,101,747,10,217,111,964,11.9,4.4,10.3,"50% - 75% P.O.C.","$52000 - $60000"
"48415","Scurry County, Texas",17096,54326,9020,792,4,51,0,6904,52.8,4.6,0,0.3,0,40.4,47.2,5941,4467,1474,75.19,24.81,456,4011,148,1326,604,5337,10.2,10,10.2,"25% - 50% P.O.C.","$52000 - $60000"
"48417","Shackelford County, Texas",3296,46935,2816,7,10,8,0,380,85.4,0.2,0.3,0.2,0,11.5,14.6,1317,1048,269,79.57,20.43,78,970,24,245,102,1215,7.4,8.9,7.7,"Less than 25% P.O.C.","$44000 - $52000"
"48419","Shelby County, Texas",25349,42522,15611,4803,35,114,0,4644,61.6,18.9,0.1,0.4,0,18.3,38.4,9293,6844,2449,73.65,26.35,979,5865,346,2103,1325,7968,14.3,14.1,14.3,"25% - 50% P.O.C.","Less than $44000"
"48421","Sherman County, Texas",3059,51926,1635,35,12,0,0,1364,53.4,1.1,0.4,0,0,44.6,46.6,1019,740,279,72.62,27.38,83,657,74,205,157,862,11.2,26.5,15.4,"25% - 50% P.O.C.","$44000 - $52000"
"48423","Smith County, Texas",227449,56810,135850,39165,681,3825,212,44360,59.7,17.2,0.3,1.7,0.1,19.5,40.3,77678,51589,26089,66.41,33.59,5897,45692,2366,23723,8263,69415,11.4,9.1,10.6,"25% - 50% P.O.C.","$52000 - $60000"
"48425","Somervell County, Texas",8860,60632,7010,105,0,24,68,1646,79.1,1.2,0,0.3,0.8,18.6,20.9,3123,2508,615,80.31,19.69,307,2201,0,615,307,2816,12.2,0,9.8,"Less than 25% P.O.C.","$60000 or more"
"48427","Starr County, Texas",64078,30387,444,24,7,10,0,63549,0.7,0,0,0,0,99.2,99.3,16188,12160,4028,75.12,24.88,2459,9701,693,3335,3152,13036,20.2,17.2,19.5,"75% or more P.O.C.","Less than $44000"
"48429","Stephens County, Texas",9364,46232,6657,265,0,31,0,2223,71.1,2.8,0,0.3,0,23.7,28.9,3247,2665,582,82.08,17.92,238,2427,55,527,293,2954,8.9,9.5,9,"25% - 50% P.O.C.","$44000 - $52000"
"48431","Sterling County, Texas",1231,59868,578,0,0,0,0,641,47,0,0,0,0,52.1,53,458,392,66,85.59,14.41,54,338,18,48,72,386,13.8,27.3,15.7,"50% - 75% P.O.C.","$52000 - $60000"
"48433","Stonewall County, Texas",1476,51250,1120,30,0,0,0,314,75.9,2,0,0,0,21.3,24.1,580,438,142,75.52,24.48,32,406,13,129,45,535,7.3,9.2,7.8,"Less than 25% P.O.C.","$44000 - $52000"
"48435","Sutton County, Texas",3824,54306,1304,3,1,0,6,2510,34.1,0.1,0,0,0.2,65.6,65.9,1412,977,435,69.19,30.81,159,818,29,406,188,1224,16.3,6.7,13.3,"50% - 75% P.O.C.","$52000 - $60000"
"48437","Swisher County, Texas",7432,39771,3432,438,45,12,5,3272,46.2,5.9,0.6,0.2,0.1,44,53.8,2505,1778,727,70.98,29.02,202,1576,170,557,372,2133,11.4,23.4,14.9,"50% - 75% P.O.C.","Less than $44000"
"48439","Tarrant County, Texas",2049770,67700,957676,330853,6154,110144,3802,590485,46.7,16.1,0.3,5.4,0.2,28.8,53.3,708252,428630,279622,60.52,39.48,57498,371132,29992,249630,87490,620762,13.4,10.7,12.4,"50% - 75% P.O.C.","$60000 or more"
"48441","Taylor County, Texas",136870,53143,86841,10576,616,2886,40,33404,63.4,7.7,0.5,2.1,0,24.4,36.6,49868,29101,20767,58.36,41.64,2910,26191,2168,18599,5078,44790,10,10.4,10.2,"25% - 50% P.O.C.","$52000 - $60000"
"48443","Terrell County, Texas",896,43208,353,10,3,0,0,508,39.4,1.1,0.3,0,0,56.7,60.6,418,389,29,93.06,6.94,22,367,0,29,22,396,5.7,0,5.3,"50% - 75% P.O.C.","Less than $44000"
"48445","Terry County, Texas",12528,44627,4947,578,15,0,0,6891,39.5,4.6,0.1,0,0,55,60.5,4061,2828,1233,69.64,30.36,478,2350,113,1120,591,3470,16.9,9.2,14.6,"50% - 75% P.O.C.","$44000 - $52000"
"48447","Throckmorton County, Texas",1436,40000,1218,14,0,0,0,190,84.8,1,0,0,0,13.2,15.2,668,487,181,72.9,27.1,22,465,7,174,29,639,4.5,3.9,4.3,"Less than 25% P.O.C.","Less than $44000"
"48449","Titus County, Texas",32640,50196,14745,2914,57,323,0,14048,45.2,8.9,0.2,1,0,43,54.8,10893,7296,3597,66.98,33.02,1293,6003,652,2945,1945,8948,17.7,18.1,17.9,"50% - 75% P.O.C.","$44000 - $52000"
"48451","Tom Green County, Texas",117986,53903,62852,4706,240,1420,79,47064,53.3,4,0.2,1.2,0.1,39.9,46.7,43314,27500,15814,63.49,36.51,2448,25052,1170,14644,3618,39696,8.9,7.4,8.4,"25% - 50% P.O.C.","$52000 - $60000"
"48453","Travis County, Texas",1226805,75887,600694,96367,2042,81212,338,414745,49,7.9,0.2,6.6,0,33.8,51,472361,247351,225010,52.36,47.64,24845,222506,14925,210085,39770,432591,10,6.6,8.4,"50% - 75% P.O.C.","$60000 or more"
"48455","Trinity County, Texas",14620,41357,11457,1454,18,5,0,1460,78.4,9.9,0.1,0,0,10,21.6,6030,4666,1364,77.38,22.62,285,4381,161,1203,446,5584,6.1,11.8,7.4,"Less than 25% P.O.C.","Less than $44000"
"48457","Tyler County, Texas",21518,44497,17004,2289,23,70,0,1656,79,10.6,0.1,0.3,0,7.7,21,7100,5961,1139,83.96,16.04,492,5469,114,1025,606,6494,8.3,10,8.5,"Less than 25% P.O.C.","$44000 - $52000"
"48459","Upshur County, Texas",41018,52162,32971,3337,210,128,0,3524,80.4,8.1,0.5,0.3,0,8.6,19.6,14108,11115,2993,78.79,21.21,1245,9870,494,2499,1739,12369,11.2,16.5,12.3,"Less than 25% P.O.C.","$52000 - $60000"
"48461","Upton County, Texas",3659,52171,1432,214,21,26,0,1966,39.1,5.8,0.6,0.7,0,53.7,60.9,1332,973,359,73.05,26.95,82,891,53,306,135,1197,8.4,14.8,10.1,"50% - 75% P.O.C.","$52000 - $60000"
"48463","Uvalde County, Texas",26920,41679,7042,88,58,253,0,19306,26.2,0.3,0.2,0.9,0,71.7,73.8,8841,6482,2359,73.32,26.68,752,5730,348,2011,1100,7741,11.6,14.8,12.4,"50% - 75% P.O.C.","Less than $44000"
"48465","Val Verde County, Texas",48969,46147,7469,635,68,343,12,40131,15.3,1.3,0.1,0.7,0,82,84.7,15779,10021,5758,63.51,36.49,1802,8219,919,4839,2721,13058,18,16,17.2,"75% or more P.O.C.","$44000 - $52000"
"48467","Van Zandt County, Texas",55103,54654,46127,1543,259,271,48,6010,83.7,2.8,0.5,0.5,0.1,10.9,16.3,20156,15722,4434,78,22,1718,14004,492,3942,2210,17946,10.9,11.1,11,"Less than 25% P.O.C.","$52000 - $60000"
"48469","Victoria County, Texas",92109,56834,41147,5163,109,1046,18,43175,44.7,5.6,0.1,1.1,0,46.9,55.3,32255,21347,10908,66.18,33.82,2544,18803,1141,9767,3685,28570,11.9,10.5,11.4,"50% - 75% P.O.C.","$52000 - $60000"
"48471","Walker County, Texas",72321,43742,40789,16656,315,912,9,12973,56.4,23,0.4,1.3,0,17.9,43.6,21963,11290,10673,51.4,48.6,1110,10180,714,9959,1824,20139,9.8,6.7,8.3,"25% - 50% P.O.C.","Less than $44000"
"48473","Waller County, Texas",51832,59642,22222,12831,97,486,25,15581,42.9,24.8,0.2,0.9,0,30.1,57.1,15171,10367,4804,68.33,31.67,1389,8978,805,3999,2194,12977,13.4,16.8,14.5,"50% - 75% P.O.C.","$52000 - $60000"
"48475","Ward County, Texas",11658,62986,4663,469,50,111,0,6256,40,4,0.4,1,0,53.7,60,3978,2846,1132,71.54,28.46,442,2404,166,966,608,3370,15.5,14.7,15.3,"50% - 75% P.O.C.","$60000 or more"
"48477","Washington County, Texas",35163,54971,22508,5763,88,582,38,5646,64,16.4,0.3,1.7,0.1,16.1,36,12625,9358,3267,74.12,25.88,609,8749,464,2803,1073,11552,6.5,14.2,8.5,"25% - 50% P.O.C.","$52000 - $60000"
"48479","Webb County, Texas",273526,46475,9657,787,102,1313,31,261132,3.5,0.3,0,0.5,0,95.5,96.5,74789,46513,28276,62.19,37.81,11802,34711,6305,21971,18107,56682,25.4,22.3,24.2,"75% or more P.O.C.","$44000 - $52000"
"48481","Wharton County, Texas",41577,48310,18484,5623,25,142,0,17208,44.5,13.5,0.1,0.3,0,41.4,55.5,15199,10178,5021,66.96,33.04,1379,8799,588,4433,1967,13232,13.5,11.7,12.9,"50% - 75% P.O.C.","$44000 - $52000"
"48483","Wheeler County, Texas",5338,49315,3655,158,9,3,0,1388,68.5,3,0.2,0.1,0,26,31.5,2183,1454,729,66.61,33.39,133,1321,131,598,264,1919,9.1,18,12.1,"25% - 50% P.O.C.","$44000 - $52000"
"48485","Wichita County, Texas",131596,48650,85899,13104,975,2864,99,25258,65.3,10,0.7,2.2,0.1,19.2,34.7,48356,29164,19192,60.31,39.69,2411,26753,1584,17608,3995,44361,8.3,8.3,8.3,"25% - 50% P.O.C.","$44000 - $52000"
"48487","Wilbarger County, Texas",12833,45302,7460,1231,118,121,0,3736,58.1,9.6,0.9,0.9,0,29.1,41.9,5180,3146,2034,60.73,39.27,324,2822,347,1687,671,4509,10.3,17.1,13,"25% - 50% P.O.C.","$44000 - $52000"
"48489","Willacy County, Texas",21588,35521,2427,119,0,0,0,19039,11.2,0.6,0,0,0,88.2,88.8,5782,4078,1704,70.53,29.47,804,3274,257,1447,1061,4721,19.7,15.1,18.4,"75% or more P.O.C.","Less than $44000"
"48491","Williamson County, Texas",547604,87337,325160,33561,935,37170,377,133872,59.4,6.1,0.2,6.8,0.1,24.4,40.6,180160,123208,56952,68.39,31.61,14096,109112,5209,51743,19305,160855,11.4,9.1,10.7,"25% - 50% P.O.C.","$60000 or more"
"48493","Wilson County, Texas",49173,76692,28045,600,43,152,40,19513,57,1.2,0.1,0.3,0.1,39.7,43,15733,13275,2458,84.38,15.62,1900,11375,455,2003,2355,13378,14.3,18.5,15,"25% - 50% P.O.C.","$60000 or more"
"48495","Winkler County, Texas",7867,60366,2763,177,75,0,0,4796,35.1,2.2,1,0,0,61,64.9,2619,2085,534,79.61,20.39,200,1885,98,436,298,2321,9.6,18.4,11.4,"50% - 75% P.O.C.","$60000 or more"
"48497","Wise County, Texas",66290,64536,50878,845,236,338,121,12822,76.8,1.3,0.4,0.5,0.2,19.3,23.2,22369,17434,4935,77.94,22.06,2268,15166,599,4336,2867,19502,13,12.1,12.8,"Less than 25% P.O.C.","$60000 or more"
"48499","Wood County, Texas",44366,53394,36584,2184,323,286,37,4435,82.5,4.9,0.7,0.6,0.1,10,17.5,16510,13243,3267,80.21,19.79,819,12424,155,3112,974,15536,6.2,4.7,5.9,"Less than 25% P.O.C.","$52000 - $60000"
"48501","Yoakum County, Texas",8631,70005,2741,38,15,4,0,5736,31.8,0.4,0.2,0,0,66.5,68.2,2617,2042,575,78.03,21.97,453,1589,128,447,581,2036,22.2,22.3,22.2,"50% - 75% P.O.C.","$60000 or more"
"48503","Young County, Texas",18036,50635,14052,379,102,48,0,3366,77.9,2.1,0.6,0.3,0,18.7,22.1,7307,5521,1786,75.56,24.44,323,5198,119,1667,442,6865,5.9,6.7,6,"Less than 25% P.O.C.","$44000 - $52000"
"48505","Zapata County, Texas",14304,33952,658,0,0,112,0,13501,4.6,0,0,0.8,0,94.4,95.4,4503,3366,1137,74.75,25.25,475,2891,245,892,720,3783,14.1,21.5,16,"75% or more P.O.C.","Less than $44000"
"48507","Zavala County, Texas",12039,34459,611,40,0,3,0,11304,5.1,0.3,0,0,0,93.9,94.9,3571,2570,1001,71.97,28.03,468,2102,182,819,650,2921,18.2,18.2,18.2,"75% or more P.O.C.","Less than $44000"
"49001","Beaver County, Utah",6517,55221,5496,0,63,19,0,780,84.3,0,1,0.3,0,12,15.7,2282,1692,590,74.15,25.85,334,1358,148,442,482,1800,19.7,25.1,21.1,"Less than 25% P.O.C.","$52000 - $60000"
"49003","Box Elder County, Utah",53946,62233,46930,311,527,422,59,5093,87,0.6,1,0.8,0.1,9.4,13,17569,13665,3904,77.78,22.22,2801,10864,678,3226,3479,14090,20.5,17.4,19.8,"Less than 25% P.O.C.","$60000 or more"
"49005","Cache County, Utah",124165,59038,103848,920,458,2535,435,13316,83.6,0.7,0.4,2,0.4,10.7,16.4,38393,24180,14213,62.98,37.02,5922,18258,1584,12629,7506,30887,24.5,11.1,19.6,"Less than 25% P.O.C.","$52000 - $60000"
"49007","Carbon County, Utah",20308,51158,17365,86,77,10,16,2700,85.5,0.4,0.4,0,0.1,13.3,14.5,7829,5773,2056,73.74,26.26,682,5091,90,1966,772,7057,11.8,4.4,9.9,"Less than 25% P.O.C.","$44000 - $52000"
"49009","Daggett County, Utah",613,75417,597,1,2,0,0,13,97.4,0.2,0.3,0,0,2.1,2.6,163,142,21,87.12,12.88,27,115,5,16,32,131,19,23.8,19.6,"Less than 25% P.O.C.","$60000 or more"
"49011","Davis County, Utah",345767,83310,289872,4353,1172,6026,2302,33434,83.8,1.3,0.3,1.7,0.7,9.7,16.2,104551,80518,24033,77.01,22.99,19690,60828,3650,20383,23340,81211,24.5,15.2,22.3,"Less than 25% P.O.C.","$60000 or more"
"49013","Duchesne County, Utah",20148,63224,17162,83,709,107,64,1650,85.2,0.4,3.5,0.5,0.3,8.2,14.8,6868,5161,1707,75.15,24.85,1094,4067,330,1377,1424,5444,21.2,19.3,20.7,"Less than 25% P.O.C.","$60000 or more"
"49015","Emery County, Utah",10117,55554,9212,2,71,68,27,642,91.1,0,0.7,0.7,0.3,6.3,8.9,3665,2818,847,76.89,23.11,536,2282,149,698,685,2980,19,17.6,18.7,"Less than 25% P.O.C.","$52000 - $60000"
"49017","Garfield County, Utah",4998,54565,4436,3,227,4,7,306,88.8,0.1,4.5,0.1,0.1,6.1,11.2,1760,1399,361,79.49,20.51,158,1241,44,317,202,1558,11.3,12.2,11.5,"Less than 25% P.O.C.","$52000 - $60000"
"49019","Grand County, Utah",9640,51557,7941,31,338,155,54,994,82.4,0.3,3.5,1.6,0.6,10.3,17.6,4191,2730,1461,65.14,34.86,272,2458,133,1328,405,3786,10,9.1,9.7,"Less than 25% P.O.C.","$44000 - $52000"
"49021","Iron County, Utah",51213,51807,43966,269,1012,407,68,4463,85.8,0.5,2,0.8,0.1,8.7,14.2,17015,10884,6131,63.97,36.03,2243,8641,718,5413,2961,14054,20.6,11.7,17.4,"Less than 25% P.O.C.","$44000 - $52000"
"49023","Juab County, Utah",11301,61463,10348,26,120,0,10,590,91.6,0.2,1.1,0,0.1,5.2,8.4,3464,2721,743,78.55,21.45,638,2083,236,507,874,2590,23.4,31.8,25.2,"Less than 25% P.O.C.","$60000 or more"
"49025","Kane County, Utah",7484,47044,6827,1,119,24,8,350,91.2,0,1.6,0.3,0.1,4.7,8.8,2643,2046,597,77.41,22.59,220,1826,56,541,276,2367,10.8,9.4,10.4,"Less than 25% P.O.C.","$44000 - $52000"
"49027","Millard County, Utah",12854,62242,10669,21,143,148,16,1662,83,0.2,1.1,1.2,0.1,12.9,17,4337,3231,1106,74.5,25.5,687,2544,280,826,967,3370,21.3,25.3,22.3,"Less than 25% P.O.C.","$60000 or more"
"49029","Morgan County, Utah",11664,91341,11076,90,4,11,17,338,95,0.8,0,0.1,0.1,2.9,5,3365,2871,494,85.32,14.68,879,1992,114,380,993,2372,30.6,23.1,29.5,"Less than 25% P.O.C.","$60000 or more"
"49031","Piute County, Utah",1866,42813,1805,3,3,0,0,47,96.7,0.2,0.2,0,0,2.5,3.3,532,445,87,83.65,16.35,62,383,9,78,71,461,13.9,10.3,13.3,"Less than 25% P.O.C.","Less than $44000"
"49033","Rich County, Utah",2389,57902,2133,0,0,0,0,256,89.3,0,0,0,0,10.7,10.7,635,455,180,71.65,28.35,46,409,53,127,99,536,10.1,29.4,15.6,"Less than 25% P.O.C.","$52000 - $60000"
"49035","Salt Lake County, Utah",1133646,74865,805475,20448,6888,45725,16034,208061,71.1,1.8,0.6,4,1.4,18.4,28.9,374820,251555,123265,67.11,32.89,46755,204800,14701,108564,61456,313364,18.6,11.9,16.4,"25% - 50% P.O.C.","$60000 or more"
"49037","San Juan County, Utah",15302,45394,6705,23,7201,77,43,870,43.8,0.2,47.1,0.5,0.3,5.7,56.2,4311,3476,835,80.63,19.37,668,2808,194,641,862,3449,19.2,23.2,20,"50% - 75% P.O.C.","$44000 - $52000"
"49039","Sanpete County, Utah",29850,53838,25657,215,292,306,158,2854,86,0.7,1,1,0.5,9.6,14,8643,6716,1927,77.7,22.3,1438,5278,588,1339,2026,6617,21.4,30.5,23.4,"Less than 25% P.O.C.","$52000 - $60000"
"49041","Sevier County, Utah",21280,54799,19514,129,403,10,13,1100,91.7,0.6,1.9,0,0.1,5.2,8.3,7364,5754,1610,78.14,21.86,956,4798,270,1340,1226,6138,16.6,16.8,16.6,"Less than 25% P.O.C.","$52000 - $60000"
"49043","Summit County, Utah",41103,102958,34656,326,94,724,13,4705,84.3,0.8,0.2,1.8,0,11.4,15.7,14220,11004,3216,77.38,22.62,981,10023,374,2842,1355,12865,8.9,11.6,9.5,"Less than 25% P.O.C.","$60000 or more"
"49045","Tooele County, Utah",67397,74562,56030,286,381,519,420,8332,83.1,0.4,0.6,0.8,0.6,12.4,16.9,20478,16576,3902,80.95,19.05,4250,12326,425,3477,4675,15803,25.6,10.9,22.8,"Less than 25% P.O.C.","$60000 or more"
"49047","Uintah County, Utah",36084,65264,29455,143,2564,165,26,3038,81.6,0.4,7.1,0.5,0.1,8.4,18.4,10569,8023,2546,75.91,24.09,1641,6382,328,2218,1969,8600,20.5,12.9,18.6,"Less than 25% P.O.C.","$60000 or more"
"49049","Utah County, Utah",605490,74665,498471,3195,2253,9025,5244,71315,82.3,0.5,0.4,1.5,0.9,11.8,17.7,165991,112291,53700,67.65,32.35,37420,74871,9228,44472,46648,119343,33.3,17.2,28.1,"Less than 25% P.O.C.","$60000 or more"
"49051","Wasatch County, Utah",31708,85166,26495,45,80,368,5,4232,83.6,0.1,0.3,1.2,0,13.3,16.4,9879,7209,2670,72.97,27.03,1709,5500,531,2139,2240,7639,23.7,19.9,22.7,"Less than 25% P.O.C.","$60000 or more"
"49053","Washington County, Utah",165811,59839,139792,1081,1942,1306,1314,17364,84.3,0.7,1.2,0.8,0.8,10.5,15.7,57144,40230,16914,70.4,29.6,6185,34045,3159,13755,9344,47800,15.4,18.7,16.4,"Less than 25% P.O.C.","$52000 - $60000"
"49055","Wayne County, Utah",2689,44245,2440,6,6,8,42,168,90.7,0.2,0.2,0.3,1.6,6.2,9.3,1000,739,261,73.9,26.1,105,634,15,246,120,880,14.2,5.7,12,"Less than 25% P.O.C.","$44000 - $52000"
"49057","Weber County, Utah",251498,67244,191274,2474,1366,2831,566,46159,76.1,1,0.5,1.1,0.2,18.4,23.9,83632,61395,22237,73.41,26.59,11142,50253,2415,19822,13557,70075,18.1,10.9,16.2,"Less than 25% P.O.C.","$60000 or more"
"50001","Addison County, Vermont",36882,68825,34133,446,114,646,14,852,92.5,1.2,0.3,1.8,0,2.3,7.5,14584,11084,3500,76,24,650,10434,145,3355,795,13789,5.9,4.1,5.5,"Less than 25% P.O.C.","$60000 or more"
"50003","Bennington County, Vermont",35746,56183,33643,198,61,360,92,717,94.1,0.6,0.2,1,0.3,2,5.9,14581,10794,3787,74.03,25.97,698,10096,157,3630,855,13726,6.5,4.1,5.9,"Less than 25% P.O.C.","$52000 - $60000"
"50005","Caledonia County, Vermont",30234,50563,28674,240,90,124,0,483,94.8,0.8,0.3,0.4,0,1.6,5.2,12434,9086,3348,73.07,26.93,614,8472,122,3226,736,11698,6.8,3.6,5.9,"Less than 25% P.O.C.","$44000 - $52000"
"50007","Chittenden County, Vermont",162646,73647,143961,4206,346,6509,83,3813,88.5,2.6,0.2,4,0.1,2.3,11.5,66160,41263,24897,62.37,37.63,2637,38626,1120,23777,3757,62403,6.4,4.5,5.7,"Less than 25% P.O.C.","$60000 or more"
"50009","Essex County, Vermont",6200,44349,5912,61,20,30,0,86,95.4,1,0.3,0.5,0,1.4,4.6,2740,2226,514,81.24,18.76,88,2138,35,479,123,2617,4,6.8,4.5,"Less than 25% P.O.C.","$44000 - $52000"
"50011","Franklin County, Vermont",49116,65485,46109,261,315,271,0,774,93.9,0.5,0.6,0.6,0,1.6,6.1,18563,13998,4565,75.41,24.59,1051,12947,487,4078,1538,17025,7.5,10.7,8.3,"Less than 25% P.O.C.","$60000 or more"
"50013","Grand Isle County, Vermont",7022,71587,6517,58,37,36,0,140,92.8,0.8,0.5,0.5,0,2,7.2,2956,2484,472,84.03,15.97,144,2340,32,440,176,2780,5.8,6.8,6,"Less than 25% P.O.C.","$60000 or more"
"50015","Lamoille County, Vermont",25318,64003,23931,221,209,205,0,455,94.5,0.9,0.8,0.8,0,1.8,5.5,10546,7715,2831,73.16,26.84,478,7237,126,2705,604,9942,6.2,4.5,5.7,"Less than 25% P.O.C.","$60000 or more"
"50017","Orange County, Vermont",28908,60925,27627,200,103,66,28,386,95.6,0.7,0.4,0.2,0.1,1.3,4.4,12279,9882,2397,80.48,19.52,647,9235,230,2167,877,11402,6.5,9.6,7.1,"Less than 25% P.O.C.","$60000 or more"
"50019","Orleans County, Vermont",26901,49168,25575,150,118,77,8,405,95.1,0.6,0.4,0.3,0,1.5,4.9,11779,9209,2570,78.18,21.82,591,8618,119,2451,710,11069,6.4,4.6,6,"Less than 25% P.O.C.","$44000 - $52000"
"50021","Rutland County, Vermont",58892,56139,56122,504,74,672,0,864,95.3,0.9,0.1,1.1,0,1.5,4.7,25338,18100,7238,71.43,28.57,894,17206,231,7007,1125,24213,4.9,3.2,4.4,"Less than 25% P.O.C.","$52000 - $60000"
"50023","Washington County, Vermont",58350,62791,54957,494,112,483,35,1135,94.2,0.8,0.2,0.8,0.1,1.9,5.8,24828,17489,7339,70.44,29.56,973,16516,314,7025,1287,23541,5.6,4.3,5.2,"Less than 25% P.O.C.","$60000 or more"
"50025","Windham County, Vermont",42823,51985,39863,467,117,432,13,999,93.1,1.1,0.3,1,0,2.3,6.9,18943,12742,6201,67.26,32.74,640,12102,212,5989,852,18091,5,3.4,4.5,"Less than 25% P.O.C.","$44000 - $52000"
"50027","Windsor County, Vermont",55275,60987,52316,395,91,482,23,929,94.6,0.7,0.2,0.9,0,1.7,5.4,24298,17927,6371,73.78,26.22,845,17082,316,6055,1161,23137,4.7,5,4.8,"Less than 25% P.O.C.","$60000 or more"
"51001","Accomack County, Virginia",32673,46073,19613,9331,175,265,0,2929,60,28.6,0.5,0.8,0,9,40,13438,8977,4461,66.8,33.2,473,8504,559,3902,1032,12406,5.3,12.5,7.7,"25% - 50% P.O.C.","$44000 - $52000"
"51003","Albemarle County, Virginia",107405,79880,82656,10170,222,5544,41,6200,77,9.5,0.2,5.2,0,5.8,23,41496,26265,15231,63.3,36.7,2171,24094,674,14557,2845,38651,8.3,4.4,6.9,"Less than 25% P.O.C.","$60000 or more"
"51005","Alleghany County, Virginia",15157,47673,13863,881,0,16,0,225,91.5,5.8,0,0.1,0,1.5,8.5,6600,5032,1568,76.24,23.76,335,4697,134,1434,469,6131,6.7,8.5,7.1,"Less than 25% P.O.C.","$44000 - $52000"
"51007","Amelia County, Virginia",12953,57946,9533,2745,24,0,0,390,73.6,21.2,0.2,0,0,3,26.4,4954,4181,773,84.4,15.6,346,3835,123,650,469,4485,8.3,15.9,9.5,"25% - 50% P.O.C.","$52000 - $60000"
"51009","Amherst County, Virginia",31775,52888,23733,5692,212,162,19,766,74.7,17.9,0.7,0.5,0.1,2.4,25.3,12160,9378,2782,77.12,22.88,625,8753,205,2577,830,11330,6.7,7.4,6.8,"25% - 50% P.O.C.","$52000 - $60000"
"51011","Appomattox County, Virginia",15707,58696,12052,3095,5,12,0,260,76.7,19.7,0,0.1,0,1.7,23.3,6091,4737,1354,77.77,22.23,431,4306,105,1249,536,5555,9.1,7.8,8.8,"Less than 25% P.O.C.","$52000 - $60000"
"51013","Arlington County, Virginia",233464,120071,143563,20740,554,23824,199,36375,61.5,8.9,0.2,10.2,0.1,15.6,38.5,107032,45752,61280,42.75,57.25,3044,42708,1963,59317,5007,102025,6.7,3.2,4.7,"25% - 50% P.O.C.","$60000 or more"
"51015","Augusta County, Virginia",75079,62711,68122,3107,176,460,93,2118,90.7,4.1,0.2,0.6,0.1,2.8,9.3,29539,23430,6109,79.32,20.68,1904,21526,600,5509,2504,27035,8.1,9.8,8.5,"Less than 25% P.O.C.","$60000 or more"
"51017","Bath County, Virginia",4307,49738,3841,130,6,15,0,159,89.2,3,0.1,0.3,0,3.7,10.8,1801,1357,444,75.35,24.65,77,1280,59,385,136,1665,5.7,13.3,7.6,"Less than 25% P.O.C.","$44000 - $52000"
"51019","Bedford County, Virginia",78376,64199,68746,5384,28,905,10,1720,87.7,6.9,0,1.2,0,2.2,12.3,31317,25712,5605,82.1,17.9,1663,24049,475,5130,2138,29179,6.5,8.5,6.8,"Less than 25% P.O.C.","$60000 or more"
"51021","Bland County, Virginia",6388,48531,5996,238,0,10,0,81,93.9,3.7,0,0.2,0,1.3,6.1,2367,1927,440,81.41,18.59,98,1829,52,388,150,2217,5.1,11.8,6.3,"Less than 25% P.O.C.","$44000 - $52000"
"51023","Botetourt County, Virginia",33343,71110,30970,988,50,223,0,568,92.9,3,0.1,0.7,0,1.7,7.1,13264,11447,1817,86.3,13.7,737,10710,94,1723,831,12433,6.4,5.2,6.3,"Less than 25% P.O.C.","$60000 or more"
"51025","Brunswick County, Virginia",16520,44434,6731,8945,0,85,0,370,40.7,54.1,0,0.5,0,2.2,59.3,6037,4268,1769,70.7,29.3,186,4082,215,1554,401,5636,4.4,12.2,6.6,"50% - 75% P.O.C.","$44000 - $52000"
"51027","Buchanan County, Virginia",21788,31956,20666,588,40,225,0,106,94.9,2.7,0.2,1,0,0.5,5.1,8569,6625,1944,77.31,22.69,305,6320,123,1821,428,8141,4.6,6.3,5,"Less than 25% P.O.C.","Less than $44000"
"51029","Buckingham County, Virginia",17059,49025,10438,5829,96,28,0,411,61.2,34.2,0.6,0.2,0,2.4,38.8,5826,4381,1445,75.2,24.8,311,4070,189,1256,500,5326,7.1,13.1,8.6,"25% - 50% P.O.C.","$44000 - $52000"
"51031","Campbell County, Virginia",55225,49664,43941,7728,106,486,9,1394,79.6,14,0.2,0.9,0,2.5,20.4,23071,17242,5829,74.73,25.27,1492,15750,483,5346,1975,21096,8.7,8.3,8.6,"Less than 25% P.O.C.","$44000 - $52000"
"51033","Caroline County, Virginia",30381,65103,19206,8138,78,273,0,1466,63.2,26.8,0.3,0.9,0,4.8,36.8,10946,8669,2277,79.2,20.8,739,7930,279,1998,1018,9928,8.5,12.3,9.3,"25% - 50% P.O.C.","$60000 or more"
"51035","Carroll County, Virginia",29801,44835,28163,163,76,17,0,1053,94.5,0.5,0.3,0.1,0,3.5,5.5,12357,9674,2683,78.29,21.71,441,9233,108,2575,549,11808,4.6,4,4.4,"Less than 25% P.O.C.","$44000 - $52000"
"51036","Charles City County, Virginia",7014,57198,2970,3166,457,60,0,131,42.3,45.1,6.5,0.9,0,1.9,57.7,2896,2430,466,83.91,16.09,107,2323,49,417,156,2740,4.4,10.5,5.4,"50% - 75% P.O.C.","$52000 - $60000"
"51037","Charlotte County, Virginia",12040,40573,8172,3371,6,48,0,260,67.9,28,0,0.4,0,2.2,32.1,4661,3322,1339,71.27,28.73,121,3201,133,1206,254,4407,3.6,9.9,5.4,"25% - 50% P.O.C.","Less than $44000"
"51041","Chesterfield County, Virginia",343551,82599,212269,78119,930,11769,149,30350,61.8,22.7,0.3,3.4,0,8.8,38.2,124971,94698,30273,75.78,24.22,9734,84964,3423,26850,13157,111814,10.3,11.3,10.5,"25% - 50% P.O.C.","$60000 or more"
"51043","Clarke County, Virginia",14423,80026,12422,774,0,95,0,803,86.1,5.4,0,0.7,0,5.6,13.9,5612,4209,1403,75,25,366,3843,166,1237,532,5080,8.7,11.8,9.5,"Less than 25% P.O.C.","$60000 or more"
"51045","Craig County, Virginia",5110,55708,5040,5,0,0,0,2,98.6,0.1,0,0,0,0,1.4,2297,1756,541,76.45,23.55,104,1652,28,513,132,2165,5.9,5.2,5.7,"Less than 25% P.O.C.","$52000 - $60000"
"51047","Culpeper County, Virginia",51101,77935,35903,7084,179,847,60,5476,70.3,13.9,0.4,1.7,0.1,10.7,29.7,17071,12412,4659,72.71,27.29,1917,10495,644,4015,2561,14510,15.4,13.8,15,"25% - 50% P.O.C.","$60000 or more"
"51049","Cumberland County, Virginia",9824,47469,6223,2945,13,122,0,92,63.3,30,0.1,1.2,0,0.9,36.7,3975,2936,1039,73.86,26.14,153,2783,78,961,231,3744,5.2,7.5,5.8,"25% - 50% P.O.C.","$44000 - $52000"
"51051","Dickenson County, Virginia",14756,29932,14401,84,8,18,0,134,97.6,0.6,0.1,0.1,0,0.9,2.4,5778,4374,1404,75.7,24.3,193,4181,83,1321,276,5502,4.4,5.9,4.8,"Less than 25% P.O.C.","Less than $44000"
"51053","Dinwiddie County, Virginia",28485,60346,17619,9064,0,252,20,991,61.9,31.8,0,0.9,0.1,3.5,38.1,10401,8027,2374,77.18,22.82,763,7264,331,2043,1094,9307,9.5,13.9,10.5,"25% - 50% P.O.C.","$60000 or more"
"51057","Essex County, Virginia",10998,51954,6032,4319,0,68,0,396,54.8,39.3,0,0.6,0,3.6,45.2,4555,3056,1499,67.09,32.91,129,2927,151,1348,280,4275,4.2,10.1,6.1,"25% - 50% P.O.C.","$44000 - $52000"
"51059","Fairfax County, Virginia",1145862,124831,581418,108685,1487,218484,684,187160,50.7,9.5,0.1,19.1,0.1,16.3,49.3,396501,269528,126973,67.98,32.02,28833,240695,14358,112615,43191,353310,10.7,11.3,10.9,"25% - 50% P.O.C.","$60000 or more"
"51061","Fauquier County, Virginia",69728,100783,55749,5125,230,1169,29,5791,80,7.3,0.3,1.7,0,8.3,20,24562,19229,5333,78.29,21.71,2379,16850,663,4670,3042,21520,12.4,12.4,12.4,"Less than 25% P.O.C.","$60000 or more"
"51063","Floyd County, Virginia",15704,51521,14640,240,73,21,0,462,93.2,1.5,0.5,0.1,0,2.9,6.8,6493,5267,1226,81.12,18.88,317,4950,60,1166,377,6116,6,4.9,5.8,"Less than 25% P.O.C.","$44000 - $52000"
"51065","Fluvanna County, Virginia",26594,76873,20789,3780,41,191,30,937,78.2,14.2,0.2,0.7,0.1,3.5,21.8,9923,8432,1491,84.97,15.03,862,7570,64,1427,926,8997,10.2,4.3,9.3,"Less than 25% P.O.C.","$60000 or more"
"51067","Franklin County, Virginia",56187,56254,48995,4184,147,298,0,1566,87.2,7.4,0.3,0.5,0,2.8,12.8,22997,18798,4199,81.74,18.26,1116,17682,448,3751,1564,21433,5.9,10.7,6.8,"Less than 25% P.O.C.","$52000 - $60000"
"51069","Frederick County, Virginia",86415,78002,72104,3348,227,1153,85,7428,83.4,3.9,0.3,1.3,0.1,8.6,16.6,31503,24450,7053,77.61,22.39,2659,21791,418,6635,3077,28426,10.9,5.9,9.8,"Less than 25% P.O.C.","$60000 or more"
"51071","Giles County, Virginia",16772,54520,15921,361,0,22,28,293,94.9,2.2,0,0.1,0.2,1.7,5.1,6910,5187,1723,75.07,24.93,294,4893,125,1598,419,6491,5.7,7.3,6.1,"Less than 25% P.O.C.","$52000 - $60000"
"51073","Gloucester County, Virginia",37222,70537,31586,3280,11,275,0,1330,84.9,8.8,0,0.7,0,3.6,15.1,14786,11569,3217,78.24,21.76,814,10755,342,2875,1156,13630,7,10.6,7.8,"Less than 25% P.O.C.","$60000 or more"
"51075","Goochland County, Virginia",22865,93994,17776,3627,4,297,0,651,77.7,15.9,0,1.3,0,2.8,22.3,8506,7220,1286,84.88,15.12,449,6771,138,1148,587,7919,6.2,10.7,6.9,"Less than 25% P.O.C.","$60000 or more"
"51077","Grayson County, Virginia",15742,36544,14117,866,27,55,0,543,89.7,5.5,0.2,0.3,0,3.4,10.3,6498,5282,1216,81.29,18.71,190,5092,150,1066,340,6158,3.6,12.3,5.2,"Less than 25% P.O.C.","Less than $44000"
"51079","Greene County, Virginia",19519,67398,16130,1022,40,332,0,1142,82.6,5.2,0.2,1.7,0,5.9,17.4,7548,5857,1691,77.6,22.4,597,5260,107,1584,704,6844,10.2,6.3,9.3,"Less than 25% P.O.C.","$60000 or more"
"51081","Greensville County, Virginia",11525,50300,4192,6765,6,7,0,292,36.4,58.7,0.1,0.1,0,2.5,63.6,3647,2673,974,73.29,26.71,150,2523,201,773,351,3296,5.6,20.6,9.6,"50% - 75% P.O.C.","$44000 - $52000"
"51083","Halifax County, Virginia",34552,42669,20637,11942,90,276,0,714,59.7,34.6,0.3,0.8,0,2.1,40.3,14158,10494,3664,74.12,25.88,555,9939,174,3490,729,13429,5.3,4.7,5.1,"25% - 50% P.O.C.","Less than $44000"
"51085","Hanover County, Virginia",105537,89390,88462,9424,296,1624,42,3144,83.8,8.9,0.3,1.5,0,3,16.2,38987,32174,6813,82.52,17.48,2432,29742,388,6425,2820,36167,7.6,5.7,7.2,"Less than 25% P.O.C.","$60000 or more"
"51087","Henrico County, Virginia",327535,70307,173865,96465,504,27114,131,18496,53.1,29.5,0.2,8.3,0,5.6,46.9,128464,80489,47975,62.65,37.35,6090,74399,3190,44785,9280,119184,7.6,6.6,7.2,"25% - 50% P.O.C.","$60000 or more"
"51089","Henry County, Virginia",51308,37952,35831,11395,30,322,0,2823,69.8,22.2,0.1,0.6,0,5.5,30.2,21218,15262,5956,71.93,28.07,780,14482,342,5614,1122,20096,5.1,5.7,5.3,"25% - 50% P.O.C.","Less than $44000"
"51091","Highland County, Virginia",2204,48587,2189,0,3,0,0,0,99.3,0,0.1,0,0,0,0.7,1078,894,184,82.93,17.07,16,878,10,174,26,1052,1.8,5.4,2.4,"Less than 25% P.O.C.","$44000 - $52000"
"51093","Isle of Wight County, Virginia",36627,73991,25885,8126,130,334,25,1118,70.7,22.2,0.4,0.9,0.1,3.1,29.3,14587,11055,3532,75.79,24.21,857,10198,284,3248,1141,13446,7.8,8,7.8,"25% - 50% P.O.C.","$60000 or more"
"51095","James City County, Virginia",74916,87678,56627,9664,52,1816,6,4316,75.6,12.9,0.1,2.4,0,5.8,24.4,28920,22093,6827,76.39,23.61,1204,20889,561,6266,1765,27155,5.4,8.2,6.1,"Less than 25% P.O.C.","$60000 or more"
"51097","King and Queen County, Virginia",7042,63982,4659,1843,3,0,0,226,66.2,26.2,0,0,0,3.2,33.8,2707,2261,446,83.52,16.48,159,2102,10,436,169,2538,7,2.2,6.2,"25% - 50% P.O.C.","$60000 or more"
"51099","King George County, Virginia",26229,94274,19258,4261,38,351,0,1406,73.4,16.2,0.1,1.3,0,5.4,26.6,9202,7247,1955,78.75,21.25,784,6463,235,1720,1019,8183,10.8,12,11.1,"25% - 50% P.O.C.","$60000 or more"
"51101","King William County, Virginia",16688,66987,12811,2682,135,201,0,442,76.8,16.1,0.8,1.2,0,2.6,23.2,6078,5310,768,87.36,12.64,345,4965,78,690,423,5655,6.5,10.2,7,"Less than 25% P.O.C.","$60000 or more"
"51103","Lancaster County, Virginia",10724,53711,7237,3305,0,90,0,67,67.5,30.8,0,0.8,0,0.6,32.5,5062,3840,1222,75.86,24.14,139,3701,40,1182,179,4883,3.6,3.3,3.5,"25% - 50% P.O.C.","$52000 - $60000"
"51105","Lee County, Virginia",23948,32888,22247,933,41,63,0,473,92.9,3.9,0.2,0.3,0,2,7.1,9149,6477,2672,70.79,29.21,398,6079,216,2456,614,8535,6.1,8.1,6.7,"Less than 25% P.O.C.","Less than $44000"
"51107","Loudoun County, Virginia",395134,142299,221708,28667,882,72940,301,53812,56.1,7.3,0.2,18.5,0.1,13.6,43.9,128637,100400,28237,78.05,21.95,14868,85532,3230,25007,18098,110539,14.8,11.4,14.1,"25% - 50% P.O.C.","$60000 or more"
"51109","Louisa County, Virginia",36040,60975,28126,5304,89,208,0,1059,78,14.7,0.2,0.6,0,2.9,22,13871,11103,2768,80.04,19.96,908,10195,343,2425,1251,12620,8.2,12.4,9,"Less than 25% P.O.C.","$60000 or more"
"51111","Lunenburg County, Virginia",12282,44303,7296,3820,0,340,0,609,59.4,31.1,0,2.8,0,5,40.6,4293,3082,1211,71.79,28.21,140,2942,40,1171,180,4113,4.5,3.3,4.2,"25% - 50% P.O.C.","$44000 - $52000"
"51113","Madison County, Virginia",13170,57895,11148,1087,0,111,0,381,84.6,8.3,0,0.8,0,2.9,15.4,4949,3685,1264,74.46,25.54,353,3332,156,1108,509,4440,9.6,12.3,10.3,"Less than 25% P.O.C.","$52000 - $60000"
"51115","Mathews County, Virginia",8788,64237,7532,777,0,53,3,222,85.7,8.8,0,0.6,0,2.5,14.3,3920,3331,589,84.97,15.03,113,3218,92,497,205,3715,3.4,15.6,5.2,"Less than 25% P.O.C.","$60000 or more"
"51117","Mecklenburg County, Virginia",30728,43207,18439,10869,175,29,4,911,60,35.4,0.6,0.1,0,3,40,12075,8580,3495,71.06,28.94,505,8075,230,3265,735,11340,5.9,6.6,6.1,"25% - 50% P.O.C.","Less than $44000"
"51119","Middlesex County, Virginia",10675,57438,8278,1485,49,9,31,133,77.5,13.9,0.5,0.1,0.3,1.2,22.5,4603,3621,982,78.67,21.33,79,3542,111,871,190,4413,2.2,11.3,4.1,"Less than 25% P.O.C.","$52000 - $60000"
"51121","Montgomery County, Virginia",98140,57977,81718,4286,376,6494,23,3182,83.3,4.4,0.4,6.6,0,3.2,16.7,35685,19758,15927,55.37,44.63,1157,18601,433,15494,1590,34095,5.9,2.7,4.5,"Less than 25% P.O.C.","$52000 - $60000"
"51125","Nelson County, Virginia",14831,64313,12025,1902,0,33,0,618,81.1,12.8,0,0.2,0,4.2,18.9,6419,4904,1515,76.4,23.6,392,4512,184,1331,576,5843,8,12.1,9,"Less than 25% P.O.C.","$60000 or more"
"51127","New Kent County, Virginia",21686,87904,17121,2598,176,243,0,716,78.9,12,0.8,1.1,0,3.3,21.1,7961,6886,1075,86.5,13.5,808,6078,154,921,962,6999,11.7,14.3,12.1,"Less than 25% P.O.C.","$60000 or more"
"51131","Northampton County, Virginia",11885,47227,6445,3932,4,123,0,1043,54.2,33.1,0,1,0,8.8,45.8,5148,3356,1792,65.19,34.81,173,3183,161,1631,334,4814,5.2,9,6.5,"25% - 50% P.O.C.","$44000 - $52000"
"51133","Northumberland County, Virginia",12190,62632,8499,3331,19,16,0,106,69.7,27.3,0.2,0.1,0,0.9,30.3,5584,4981,603,89.2,10.8,184,4797,53,550,237,5347,3.7,8.8,4.2,"25% - 50% P.O.C.","$60000 or more"
"51135","Nottoway County, Virginia",15433,45535,8383,6185,13,46,29,681,54.3,40.1,0.1,0.3,0.2,4.4,45.7,5446,3522,1924,64.67,35.33,271,3251,218,1706,489,4957,7.7,11.3,9,"25% - 50% P.O.C.","$44000 - $52000"
"51137","Orange County, Virginia",36010,71548,28117,4577,105,317,0,1801,78.1,12.7,0.3,0.9,0,5,21.9,13679,10777,2902,78.78,21.22,809,9968,404,2498,1213,12466,7.5,13.9,8.9,"Less than 25% P.O.C.","$60000 or more"
"51139","Page County, Virginia",23788,51792,22376,327,25,103,0,479,94.1,1.4,0.1,0.4,0,2,5.9,9286,6600,2686,71.07,28.93,397,6203,323,2363,720,8566,6,12,7.8,"Less than 25% P.O.C.","$44000 - $52000"
"51141","Patrick County, Virginia",17748,43073,15921,1051,11,72,0,542,89.7,5.9,0.1,0.4,0,3.1,10.3,7755,6124,1631,78.97,21.03,299,5825,111,1520,410,7345,4.9,6.8,5.3,"Less than 25% P.O.C.","Less than $44000"
"51143","Pittsylvania County, Virginia",61256,47690,45367,12244,37,275,22,1612,74.1,20,0.1,0.4,0,2.6,25.9,26267,19800,6467,75.38,24.62,1268,18532,620,5847,1888,24379,6.4,9.6,7.2,"25% - 50% P.O.C.","$44000 - $52000"
"51145","Powhatan County, Virginia",28815,89090,24704,2895,42,73,46,631,85.7,10,0.1,0.3,0.2,2.2,14.3,10265,9253,1012,90.14,9.86,796,8457,171,841,967,9298,8.6,16.9,9.4,"Less than 25% P.O.C.","$60000 or more"
"51147","Prince Edward County, Virginia",22905,47202,14074,7046,74,189,0,954,61.4,30.8,0.3,0.8,0,4.2,38.6,7185,4625,2560,64.37,35.63,271,4354,115,2445,386,6799,5.9,4.5,5.4,"25% - 50% P.O.C.","$44000 - $52000"
"51149","Prince George County, Virginia",38114,71912,20912,11821,231,551,158,3096,54.9,31,0.6,1.4,0.4,8.1,45.1,11507,7774,3733,67.56,32.44,600,7174,705,3028,1305,10202,7.7,18.9,11.3,"25% - 50% P.O.C.","$60000 or more"
"51153","Prince William County, Virginia",461423,107132,198161,93876,1324,38166,394,108408,42.9,20.3,0.3,8.3,0.1,23.5,57.1,142000,104061,37939,73.28,26.72,17786,86275,6163,31776,23949,118051,17.1,16.2,16.9,"50% - 75% P.O.C.","$60000 or more"
"51155","Pulaski County, Virginia",34182,53866,31029,1485,0,255,42,604,90.8,4.3,0,0.7,0.1,1.8,9.2,14533,10370,4163,71.35,28.65,662,9708,376,3787,1038,13495,6.4,9,7.1,"Less than 25% P.O.C.","$52000 - $60000"
"51157","Rappahannock County, Virginia",7378,74284,6525,335,88,38,0,287,88.4,4.5,1.2,0.5,0,3.9,11.6,2913,2162,751,74.22,25.78,133,2029,111,640,244,2669,6.2,14.8,8.4,"Less than 25% P.O.C.","$60000 or more"
"51159","Richmond County, Virginia",8884,49517,5380,2356,20,30,0,633,60.6,26.5,0.2,0.3,0,7.1,39.4,3069,2146,923,69.93,30.07,154,1992,64,859,218,2851,7.2,6.9,7.1,"25% - 50% P.O.C.","$44000 - $52000"
"51161","Roanoke County, Virginia",93823,68948,80507,5553,162,2897,11,2907,85.8,5.9,0.2,3.1,0,3.1,14.2,38222,28591,9631,74.8,25.2,2068,26523,709,8922,2777,35445,7.2,7.4,7.3,"Less than 25% P.O.C.","$60000 or more"
"51163","Rockbridge County, Virginia",22570,54600,20805,737,85,149,0,430,92.2,3.3,0.4,0.7,0,1.9,7.8,9248,6958,2290,75.24,24.76,436,6522,384,1906,820,8428,6.3,16.8,8.9,"Less than 25% P.O.C.","$52000 - $60000"
"51165","Rockingham County, Virginia",80284,61864,71197,1869,230,563,54,5567,88.7,2.3,0.3,0.7,0.1,6.9,11.3,30994,23080,7914,74.47,25.53,2149,20931,704,7210,2853,28141,9.3,8.9,9.2,"Less than 25% P.O.C.","$60000 or more"
"51167","Russell County, Virginia",27141,39758,26248,274,66,0,0,317,96.7,1,0.2,0,0,1.2,3.3,10812,8232,2580,76.14,23.86,377,7855,139,2441,516,10296,4.6,5.4,4.8,"Less than 25% P.O.C.","Less than $44000"
"51169","Scott County, Virginia",21902,39820,21163,127,87,68,0,302,96.6,0.6,0.4,0.3,0,1.4,3.4,8773,6787,1986,77.36,22.64,517,6270,87,1899,604,8169,7.6,4.4,6.9,"Less than 25% P.O.C.","Less than $44000"
"51171","Shenandoah County, Virginia",43224,57252,37870,770,57,406,0,3120,87.6,1.8,0.1,0.9,0,7.2,12.4,17402,12344,5058,70.93,29.07,1064,11280,553,4505,1617,15785,8.6,10.9,9.3,"Less than 25% P.O.C.","$52000 - $60000"
"51173","Smyth County, Virginia",30767,40932,28960,645,108,212,46,612,94.1,2.1,0.4,0.7,0.1,2,5.9,12686,9070,3616,71.5,28.5,581,8489,320,3296,901,11785,6.4,8.8,7.1,"Less than 25% P.O.C.","Less than $44000"
"51175","Southampton County, Virginia",17880,61348,10913,5703,103,44,0,301,61,31.9,0.6,0.2,0,1.7,39,6562,4910,1652,74.82,25.18,288,4622,191,1461,479,6083,5.9,11.6,7.3,"25% - 50% P.O.C.","$60000 or more"
"51177","Spotsylvania County, Virginia",132833,88628,90457,20816,336,3050,151,12965,68.1,15.7,0.3,2.3,0.1,9.8,31.9,44436,34700,9736,78.09,21.91,4350,30350,1475,8261,5825,38611,12.5,15.1,13.1,"25% - 50% P.O.C.","$60000 or more"
"51179","Stafford County, Virginia",146773,111108,90361,25263,456,4726,118,19008,61.6,17.2,0.3,3.2,0.1,13,38.4,47075,36427,10648,77.38,22.62,5990,30437,1674,8974,7664,39411,16.4,15.7,16.3,"25% - 50% P.O.C.","$60000 or more"
"51181","Surry County, Virginia",6523,57962,3432,2897,3,11,0,41,52.6,44.4,0,0.2,0,0.6,47.4,2730,2028,702,74.29,25.71,88,1940,54,648,142,2588,4.3,7.7,5.2,"25% - 50% P.O.C.","$52000 - $60000"
"51183","Sussex County, Virginia",11377,49487,4360,6248,0,146,0,344,38.3,54.9,0,1.3,0,3,61.7,3794,2624,1170,69.16,30.84,110,2514,116,1054,226,3568,4.2,9.9,6,"50% - 75% P.O.C.","$44000 - $52000"
"51185","Tazewell County, Virginia",41603,42099,39081,1286,95,255,32,424,93.9,3.1,0.2,0.6,0.1,1,6.1,16531,12320,4211,74.53,25.47,581,11739,306,3905,887,15644,4.7,7.3,5.4,"Less than 25% P.O.C.","Less than $44000"
"51187","Warren County, Virginia",39492,69116,34266,1669,51,444,0,1811,86.8,4.2,0.1,1.1,0,4.6,13.2,14651,11243,3408,76.74,23.26,1046,10197,514,2894,1560,13091,9.3,15.1,10.6,"Less than 25% P.O.C.","$60000 or more"
"51191","Washington County, Virginia",54071,48495,51546,700,16,305,12,821,95.3,1.3,0,0.6,0,1.5,4.7,22321,16780,5541,75.18,24.82,873,15907,311,5230,1184,21137,5.2,5.6,5.3,"Less than 25% P.O.C.","$44000 - $52000"
"51193","Westmoreland County, Virginia",17751,53853,11346,4598,91,115,1,1147,63.9,25.9,0.5,0.6,0,6.5,36.1,7923,5796,2127,73.15,26.85,486,5310,149,1978,635,7288,8.4,7,8,"25% - 50% P.O.C.","$52000 - $60000"
"51195","Wise County, Virginia",38486,38888,35201,2035,43,156,19,477,91.5,5.3,0.1,0.4,0,1.2,8.5,14925,9946,4979,66.64,33.36,651,9295,362,4617,1013,13912,6.5,7.3,6.8,"Less than 25% P.O.C.","Less than $44000"
"51197","Wythe County, Virginia",28844,49364,27055,837,63,129,0,361,93.8,2.9,0.2,0.4,0,1.3,6.2,11983,9343,2640,77.97,22.03,723,8620,154,2486,877,11106,7.7,5.8,7.3,"Less than 25% P.O.C.","$44000 - $52000"
"51199","York County, Virginia",67982,92069,48071,8735,141,3751,156,4372,70.7,12.8,0.2,5.5,0.2,6.4,29.3,25103,17896,7207,71.29,28.71,1350,16546,788,6419,2138,22965,7.5,10.9,8.5,"25% - 50% P.O.C.","$60000 or more"
"51510","Alexandria city, Virginia",157613,100939,81852,33334,140,9116,46,26309,51.9,21.1,0.1,5.8,0,16.7,48.1,70598,30553,40045,43.28,56.72,1197,29356,2353,37692,3550,67048,3.9,5.9,5,"25% - 50% P.O.C.","$60000 or more"
"51520","Bristol city, Virginia",16912,37500,14908,964,0,38,0,391,88.2,5.7,0,0.2,0,2.3,11.8,7334,4429,2905,60.39,39.61,182,4247,261,2644,443,6891,4.1,9,6,"Less than 25% P.O.C.","Less than $44000"
"51530","Buena Vista city, Virginia",6484,32455,5714,472,6,123,16,117,88.1,7.3,0.1,1.9,0.2,1.8,11.9,2517,1711,806,67.98,32.02,157,1554,57,749,214,2303,9.2,7.1,8.5,"Less than 25% P.O.C.","Less than $44000"
"51540","Charlottesville city, Virginia",47096,59471,30961,8793,102,3327,31,2589,65.7,18.7,0.2,7.1,0.1,5.5,34.3,18617,7977,10640,42.85,57.15,346,7631,626,10014,972,17645,4.3,5.9,5.2,"25% - 50% P.O.C.","$52000 - $60000"
"51550","Chesapeake city, Virginia",239982,78640,137813,70328,358,7350,140,14824,57.4,29.3,0.1,3.1,0.1,6.2,42.6,84849,60540,24309,71.35,28.65,6034,54506,2373,21936,8407,76442,10,9.8,9.9,"25% - 50% P.O.C.","$60000 or more"
"51570","Colonial Heights city, Virginia",17428,54550,12604,2552,50,724,0,1023,72.3,14.6,0.3,4.2,0,5.9,27.7,7036,4426,2610,62.91,37.09,263,4163,318,2292,581,6455,5.9,12.2,8.3,"25% - 50% P.O.C.","$52000 - $60000"
"51580","Covington city, Virginia",5598,40655,4534,699,0,65,11,133,81,12.5,0,1.2,0.2,2.4,19,2384,1775,609,74.45,25.55,108,1667,71,538,179,2205,6.1,11.7,7.5,"Less than 25% P.O.C.","Less than $44000"
"51590","Danville city, Virginia",41070,37203,17409,20026,34,483,33,1773,42.4,48.8,0.1,1.2,0.1,4.3,57.6,18293,9420,8873,51.5,48.5,485,8935,589,8284,1074,17219,5.1,6.6,5.9,"50% - 75% P.O.C.","Less than $44000"
"51595","Emporia city, Virginia",5442,27063,1331,3420,4,14,0,370,24.5,62.8,0.1,0.3,0,6.8,75.5,2086,837,1249,40.12,59.88,77,760,60,1189,137,1949,9.2,4.8,6.6,"75% or more P.O.C.","Less than $44000"
"51600","Fairfax city, Virginia",23531,116979,13228,1157,0,4040,0,4043,56.2,4.9,0,17.2,0,17.2,43.8,8577,6004,2573,70,30,689,5315,189,2384,878,7699,11.5,7.3,10.2,"25% - 50% P.O.C.","$60000 or more"
"51610","Falls Church city, Virginia",14128,127610,10135,656,0,1396,0,1507,71.7,4.6,0,9.9,0,10.7,28.3,5493,3204,2289,58.33,41.67,378,2826,159,2130,537,4956,11.8,6.9,9.8,"25% - 50% P.O.C.","$60000 or more"
"51620","Franklin city, Virginia",8147,40417,3003,4618,0,103,0,90,36.9,56.7,0,1.3,0,1.1,63.1,3522,1816,1706,51.56,48.44,51,1765,151,1555,202,3320,2.8,8.9,5.7,"50% - 75% P.O.C.","Less than $44000"
"51630","Fredericksburg city, Virginia",28622,65641,17006,5911,62,764,41,3056,59.4,20.7,0.2,2.7,0.1,10.7,40.6,10762,3817,6945,35.47,64.53,369,3448,384,6561,753,10009,9.7,5.5,7,"25% - 50% P.O.C.","$60000 or more"
"51640","Galax city, Virginia",6517,33575,5154,324,0,42,16,945,79.1,5,0,0.6,0.2,14.5,20.9,2663,1814,849,68.12,31.88,111,1703,27,822,138,2525,6.1,3.2,5.2,"Less than 25% P.O.C.","Less than $44000"
"51650","Hampton city, Virginia",135041,56287,51544,66430,539,3274,165,7783,38.2,49.2,0.4,2.4,0.1,5.8,61.8,54050,30123,23927,55.73,44.27,1823,28300,1366,22561,3189,50861,6.1,5.7,5.9,"50% - 75% P.O.C.","$52000 - $60000"
"51660","Harrisonburg city, Virginia",53273,46679,35233,3453,0,2034,0,10518,66.1,6.5,0,3.8,0,19.7,33.9,16723,6621,10102,39.59,60.41,685,5936,811,9291,1496,15227,10.3,8,8.9,"25% - 50% P.O.C.","$44000 - $52000"
"51670","Hopewell city, Virginia",22456,39030,10434,9478,32,307,0,1781,46.5,42.2,0.1,1.4,0,7.9,53.5,9224,4312,4912,46.75,53.25,371,3941,570,4342,941,8283,8.6,11.6,10.2,"50% - 75% P.O.C.","Less than $44000"
"51678","Lexington city, Virginia",7241,42632,5729,628,0,250,0,443,79.1,8.7,0,3.5,0,6.1,20.9,2158,1131,1027,52.41,47.59,48,1083,68,959,116,2042,4.2,6.6,5.4,"Less than 25% P.O.C.","Less than $44000"
"51680","Lynchburg city, Virginia",80569,46409,50230,22848,173,1966,8,3361,62.3,28.4,0.2,2.4,0,4.2,37.7,28273,13774,14499,48.72,51.28,1210,12564,1203,13296,2413,25860,8.8,8.3,8.5,"25% - 50% P.O.C.","$44000 - $52000"
"51683","Manassas city, Virginia",41174,81493,16810,5438,153,2118,34,15086,40.8,13.2,0.4,5.1,0.1,36.6,59.2,12898,8530,4368,66.13,33.87,1151,7379,689,3679,1840,11058,13.5,15.8,14.3,"50% - 75% P.O.C.","$60000 or more"
"51685","Manassas Park city, Virginia",16986,88046,5621,2170,0,1884,0,6749,33.1,12.8,0,11.1,0,39.7,66.9,4641,3059,1582,65.91,34.09,751,2308,246,1336,997,3644,24.6,15.5,21.5,"50% - 75% P.O.C.","$60000 or more"
"51690","Martinsville city, Virginia",12852,34371,5654,5714,46,131,15,727,44,44.5,0.4,1,0.1,5.7,56,5532,3093,2439,55.91,44.09,165,2928,61,2378,226,5306,5.3,2.5,4.1,"50% - 75% P.O.C.","Less than $44000"
"51700","Newport News city, Virginia",179673,53215,77111,71803,343,5677,318,16142,42.9,40,0.2,3.2,0.2,9,57.1,69835,34160,35675,48.92,51.08,2555,31605,2797,32878,5352,64483,7.5,7.8,7.7,"50% - 75% P.O.C.","$52000 - $60000"
"51710","Norfolk city, Virginia",244601,51590,106261,99087,726,8529,115,19672,43.4,40.5,0.3,3.5,0,8,56.6,88353,38339,50014,43.39,56.61,2768,35571,4069,45945,6837,81516,7.2,8.1,7.7,"50% - 75% P.O.C.","$44000 - $52000"
"51720","Norton city, Virginia",3970,29000,3517,122,0,184,0,48,88.6,3.1,0,4.6,0,1.2,11.4,1628,815,813,50.06,49.94,22,793,9,804,31,1597,2.7,1.1,1.9,"Less than 25% P.O.C.","Less than $44000"
"51730","Petersburg city, Virginia",31362,38679,4726,23926,74,281,26,1536,15.1,76.3,0.2,0.9,0.1,4.9,84.9,13165,5112,8053,38.83,61.17,341,4771,459,7594,800,12365,6.7,5.7,6.1,"75% or more P.O.C.","Less than $44000"
"51735","Poquoson city, Virginia",12090,97118,11055,136,10,299,0,338,91.4,1.1,0.1,2.5,0,2.8,8.6,4593,3740,853,81.43,18.57,235,3505,35,818,270,4323,6.3,4.1,5.9,"Less than 25% P.O.C.","$60000 or more"
"51740","Portsmouth city, Virginia",95097,52175,35818,49678,356,1305,265,4242,37.7,52.2,0.4,1.4,0.3,4.5,62.3,36370,19999,16371,54.99,45.01,1137,18862,1156,15215,2293,34077,5.7,7.1,6.3,"50% - 75% P.O.C.","$52000 - $60000"
"51750","Radford city, Virginia",17691,36297,14735,1734,4,275,4,513,83.3,9.8,0,1.6,0,2.9,16.7,5573,2596,2977,46.58,53.42,227,2369,116,2861,343,5230,8.7,3.9,6.2,"Less than 25% P.O.C.","Less than $44000"
"51760","Richmond city, Virginia",226622,47250,92454,105557,280,4732,25,15661,40.8,46.6,0.1,2.1,0,6.9,59.2,90301,38494,51807,42.63,57.37,1745,36749,2673,49134,4418,85883,4.5,5.2,4.9,"50% - 75% P.O.C.","$44000 - $52000"
"51770","Roanoke city, Virginia",99229,44230,58052,27844,208,2922,20,6223,58.5,28.1,0.2,2.9,0,6.3,41.5,41740,21479,20261,51.46,48.54,1306,20173,1719,18542,3025,38715,6.1,8.5,7.2,"25% - 50% P.O.C.","$44000 - $52000"
"51775","Salem city, Virginia",25317,57165,21593,1661,34,424,24,834,85.3,6.6,0.1,1.7,0.1,3.3,14.7,9912,6302,3610,63.58,36.42,549,5753,226,3384,775,9137,8.7,6.3,7.8,"Less than 25% P.O.C.","$52000 - $60000"
"51790","Staunton city, Virginia",24432,52611,19805,2677,75,337,32,760,81.1,11,0.3,1.4,0.1,3.1,18.9,10597,6072,4525,57.3,42.7,292,5780,210,4315,502,10095,4.8,4.6,4.7,"Less than 25% P.O.C.","$52000 - $60000"
"51800","Suffolk city, Virginia",90093,74884,44415,36981,154,1711,15,3937,49.3,41,0.2,1.9,0,4.4,50.7,33774,23218,10556,68.75,31.25,2294,20924,1048,9508,3342,30432,9.9,9.9,9.9,"50% - 75% P.O.C.","$60000 or more"
"51810","Virginia Beach city, Virginia",450201,76610,277823,82934,957,29610,361,36785,61.7,18.4,0.2,6.6,0.1,8.2,38.3,170798,108815,61983,63.71,36.29,9654,99161,5103,56880,14757,156041,8.9,8.2,8.6,"25% - 50% P.O.C.","$60000 or more"
"51820","Waynesboro city, Virginia",22140,45011,16635,2970,91,239,72,1788,75.1,13.4,0.4,1.1,0.3,8.1,24.9,9193,5304,3889,57.7,42.3,531,4773,414,3475,945,8248,10,10.6,10.3,"Less than 25% P.O.C.","$44000 - $52000"
"51830","Williamsburg city, Virginia",14927,57463,10109,2246,41,963,0,1053,67.7,15,0.3,6.5,0,7.1,32.3,4706,2320,2386,49.3,50.7,102,2218,50,2336,152,4554,4.4,2.1,3.2,"25% - 50% P.O.C.","$52000 - $60000"
"51840","Winchester city, Virginia",27897,58818,18421,2793,51,574,0,4958,66,10,0.2,2.1,0,17.8,34,10490,4642,5848,44.25,55.75,317,4325,539,5309,856,9634,6.8,9.2,8.2,"25% - 50% P.O.C.","$52000 - $60000"
"53001","Adams County, Washington",19594,48294,6626,83,72,138,41,12458,33.8,0.4,0.4,0.7,0.2,63.6,66.2,5973,3771,2202,63.13,36.87,733,3038,598,1604,1331,4642,19.4,27.2,22.3,"50% - 75% P.O.C.","$44000 - $52000"
"53003","Asotin County, Washington",22421,53715,20262,113,123,192,51,900,90.4,0.5,0.5,0.9,0.2,4,9.6,9101,6433,2668,70.68,29.32,432,6001,161,2507,593,8508,6.7,6,6.5,"Less than 25% P.O.C.","$52000 - $60000"
"53005","Benton County, Washington",197518,69023,139090,2808,1203,4919,137,42849,70.4,1.4,0.6,2.5,0.1,21.7,29.6,72121,49637,22484,68.82,31.18,5282,44355,2491,19993,7773,64348,10.6,11.1,10.8,"25% - 50% P.O.C.","$60000 or more"
"53007","Chelan County, Washington",76229,58795,51816,418,618,579,31,21297,68,0.5,0.8,0.8,0,27.9,32,28384,18286,10098,64.42,35.58,1851,16435,950,9148,2801,25583,10.1,9.4,9.9,"25% - 50% P.O.C.","$52000 - $60000"
"53009","Clallam County, Washington",75392,52192,62409,739,3500,1265,21,4781,82.8,1,4.6,1.7,0,6.3,17.2,32958,23198,9760,70.39,29.61,1219,21979,791,8969,2010,30948,5.3,8.1,6.1,"Less than 25% P.O.C.","$52000 - $60000"
"53011","Clark County, Washington",473252,75253,371450,7874,2342,21337,3658,45528,78.5,1.7,0.5,4.5,0.8,9.6,21.5,174661,116975,57686,66.97,33.03,12894,104081,6239,51447,19133,155528,11,10.8,11,"Less than 25% P.O.C.","$60000 or more"
"53013","Columbia County, Washington",3992,53423,3409,36,7,72,42,311,85.4,0.9,0.2,1.8,1.1,7.8,14.6,1795,1219,576,67.91,32.09,98,1121,37,539,135,1660,8,6.4,7.5,"Less than 25% P.O.C.","$52000 - $60000"
"53015","Cowlitz County, Washington",106778,54506,89301,758,1160,1356,209,9583,83.6,0.7,1.1,1.3,0.2,9,16.4,41952,27719,14233,66.07,33.93,2742,24977,1165,13068,3907,38045,9.9,8.2,9.3,"Less than 25% P.O.C.","$52000 - $60000"
"53017","Douglas County, Washington",42023,62951,26961,189,248,290,112,13281,64.2,0.4,0.6,0.7,0.3,31.6,35.8,15263,10486,4777,68.7,31.3,1368,9118,728,4049,2096,13167,13,15.2,13.7,"25% - 50% P.O.C.","$60000 or more"
"53019","Ferry County, Washington",7578,41939,5548,10,945,49,20,359,73.2,0.1,12.5,0.6,0.3,4.7,26.8,3060,2203,857,71.99,28.01,163,2040,68,789,231,2829,7.4,7.9,7.5,"25% - 50% P.O.C.","Less than $44000"
"53021","Franklin County, Washington",92009,63584,37140,1693,291,1869,140,48843,40.4,1.8,0.3,2,0.2,53.1,59.6,26723,18295,8428,68.46,31.54,3419,14876,2057,6371,5476,21247,18.7,24.4,20.5,"50% - 75% P.O.C.","$60000 or more"
"53023","Garfield County, Washington",2230,55900,1995,0,0,71,0,42,89.5,0,0,3.2,0,1.9,10.5,984,704,280,71.54,28.46,69,635,9,271,78,906,9.8,3.2,7.9,"Less than 25% P.O.C.","$52000 - $60000"
"53025","Grant County, Washington",95502,55556,51547,806,827,852,28,39700,54,0.8,0.9,0.9,0,41.6,46,30818,19264,11554,62.51,37.49,3392,15872,2352,9202,5744,25074,17.6,20.4,18.6,"25% - 50% P.O.C.","$52000 - $60000"
"53027","Grays Harbor County, Washington",72779,51240,57795,813,2795,1096,200,7246,79.4,1.1,3.8,1.5,0.3,10,20.6,28722,19254,9468,67.04,32.96,1678,17576,808,8660,2486,26236,8.7,8.5,8.7,"Less than 25% P.O.C.","$44000 - $52000"
"53029","Island County, Washington",82866,68604,65595,2520,733,4041,316,6413,79.2,3,0.9,4.9,0.4,7.7,20.8,34768,24847,9921,71.47,28.53,1814,23033,662,9259,2476,32292,7.3,6.7,7.1,"Less than 25% P.O.C.","$60000 or more"
"53031","Jefferson County, Washington",31285,55127,27651,178,598,516,17,1147,88.4,0.6,1.9,1.6,0.1,3.7,11.6,14705,10919,3786,74.25,25.75,233,10686,237,3549,470,14235,2.1,6.3,3.2,"Less than 25% P.O.C.","$52000 - $60000"
"53033","King County, Washington",2195502,94974,1308660,137919,10965,384359,16608,212241,59.6,6.3,0.5,17.5,0.8,9.7,40.4,882028,502293,379735,56.95,43.05,43661,458632,24836,354899,68497,813531,8.7,6.5,7.8,"25% - 50% P.O.C.","$60000 or more"
"53035","Kitsap County, Washington",265882,75411,203899,6821,2255,12580,2128,20652,76.7,2.6,0.8,4.7,0.8,7.8,23.3,103913,70456,33457,67.8,32.2,5916,64540,2418,31039,8334,95579,8.4,7.2,8,"Less than 25% P.O.C.","$60000 or more"
"53037","Kittitas County, Washington",45897,56004,38591,410,259,729,389,4045,84.1,0.9,0.6,1.6,0.8,8.8,15.9,18347,10849,7498,59.13,40.87,779,10070,361,7137,1140,17207,7.2,4.8,6.2,"Less than 25% P.O.C.","$52000 - $60000"
"53039","Klickitat County, Washington",21721,55773,17847,159,527,135,0,2605,82.2,0.7,2.4,0.6,0,12,17.8,8877,6037,2840,68.01,31.99,413,5624,242,2598,655,8222,6.8,8.5,7.4,"Less than 25% P.O.C.","$52000 - $60000"
"53041","Lewis County, Washington",78145,53484,65164,349,441,958,141,8000,83.4,0.4,0.6,1.2,0.2,10.2,16.6,30618,21630,8988,70.64,29.36,2096,19534,954,8034,3050,27568,9.7,10.6,10,"Less than 25% P.O.C.","$52000 - $60000"
"53043","Lincoln County, Washington",10574,54631,9657,78,146,69,27,357,91.3,0.7,1.4,0.7,0.3,3.4,8.7,4525,3528,997,77.97,22.03,267,3261,115,882,382,4143,7.6,11.5,8.4,"Less than 25% P.O.C.","$52000 - $60000"
"53045","Mason County, Washington",63804,57634,51382,660,1176,745,271,6365,80.5,1,1.8,1.2,0.4,10,19.5,24278,18787,5491,77.38,22.62,1486,17301,585,4906,2071,22207,7.9,10.7,8.5,"Less than 25% P.O.C.","$52000 - $60000"
"53047","Okanogan County, Washington",41842,47240,27152,170,3839,355,106,8413,64.9,0.4,9.2,0.8,0.3,20.1,35.1,17675,11623,6052,65.76,34.24,925,10698,794,5258,1719,15956,8,13.1,9.7,"25% - 50% P.O.C.","$44000 - $52000"
"53049","Pacific County, Washington",21688,46733,17754,76,486,365,86,2122,81.9,0.4,2.2,1.7,0.4,9.8,18.1,9279,7420,1859,79.97,20.03,504,6916,177,1682,681,8598,6.8,9.5,7.3,"Less than 25% P.O.C.","$44000 - $52000"
"53051","Pend Oreille County, Washington",13377,50591,11832,49,521,130,0,515,88.5,0.4,3.9,1,0,3.8,11.5,5727,4461,1266,77.89,22.11,445,4016,133,1133,578,5149,10,10.5,10.1,"Less than 25% P.O.C.","$44000 - $52000"
"53053","Pierce County, Washington",877013,72113,585478,57136,9221,54504,12208,95327,66.8,6.5,1.1,6.2,1.4,10.9,33.2,323296,200836,122460,62.12,37.88,20989,179847,11046,111414,32035,291261,10.5,9,9.9,"25% - 50% P.O.C.","$60000 or more"
"53055","San Juan County, Washington",16788,63622,14848,119,147,219,33,1082,88.4,0.7,0.9,1.3,0.2,6.4,11.6,8252,6154,2098,74.58,25.42,231,5923,132,1966,363,7889,3.8,6.3,4.4,"Less than 25% P.O.C.","$60000 or more"
"53057","Skagit County, Washington",125612,67028,93444,874,1897,2356,291,23097,74.4,0.7,1.5,1.9,0.2,18.4,25.6,48493,33255,15238,68.58,31.42,3046,30209,2150,13088,5196,43297,9.2,14.1,10.7,"25% - 50% P.O.C.","$60000 or more"
"53059","Skamania County, Washington",11753,65181,10307,58,213,131,14,745,87.7,0.5,1.8,1.1,0.1,6.3,12.3,4816,3588,1228,74.5,25.5,234,3354,100,1128,334,4482,6.5,8.1,6.9,"Less than 25% P.O.C.","$60000 or more"
"53061","Snohomish County, Washington",798808,86691,555736,23452,6196,85452,4107,81495,69.6,2.9,0.8,10.7,0.5,10.2,30.4,293823,197136,96687,67.09,32.91,20558,176578,9109,87578,29667,264156,10.4,9.4,10.1,"25% - 50% P.O.C.","$60000 or more"
"53063","Spokane County, Washington",505505,56904,427467,8207,5610,11336,2746,28970,84.6,1.6,1.1,2.2,0.5,5.7,15.4,202811,126536,76275,62.39,37.61,11467,115069,6910,69365,18377,184434,9.1,9.1,9.1,"Less than 25% P.O.C.","$52000 - $60000"
"53065","Stevens County, Washington",44655,51775,38672,182,2153,290,49,1658,86.6,0.4,4.8,0.6,0.1,3.7,13.4,17554,13715,3839,78.13,21.87,1379,12336,387,3452,1766,15788,10.1,10.1,10.1,"Less than 25% P.O.C.","$44000 - $52000"
"53067","Thurston County, Washington",279711,72003,209670,8418,3433,15712,2259,25004,75,3,1.2,5.6,0.8,8.9,25,109983,71908,38075,65.38,34.62,6278,65630,3009,35066,9287,100696,8.7,7.9,8.4,"25% - 50% P.O.C.","$60000 or more"
"53069","Wahkiakum County, Washington",4268,53227,3702,54,31,79,1,294,86.7,1.3,0.7,1.9,0,6.9,13.3,1897,1645,252,86.72,13.28,92,1553,52,200,144,1753,5.6,20.6,7.6,"Less than 25% P.O.C.","$52000 - $60000"
"53071","Walla Walla County, Washington",60365,57858,43265,1028,156,976,81,12874,71.7,1.7,0.3,1.6,0.1,21.3,28.3,22646,14677,7969,64.81,35.19,1627,13050,678,7291,2305,20341,11.1,8.5,10.2,"25% - 50% P.O.C.","$52000 - $60000"
"53073","Whatcom County, Washington",220821,62984,174278,2051,5795,9049,600,20805,78.9,0.9,2.6,4.1,0.3,9.4,21.1,86523,53580,32943,61.93,38.07,5062,48518,2307,30636,7369,79154,9.4,7,8.5,"Less than 25% P.O.C.","$60000 or more"
"53075","Whitman County, Washington",49231,42745,38688,1052,137,4156,81,3106,78.6,2.1,0.3,8.4,0.2,6.3,21.4,17999,7853,10146,43.63,56.37,544,7309,428,9718,972,17027,6.9,4.2,5.4,"Less than 25% P.O.C.","Less than $44000"
"53077","Yakima County, Washington",249697,51637,107857,2344,8628,2355,283,123069,43.2,0.9,3.5,0.9,0.1,49.3,56.8,83048,52062,30986,62.69,37.31,9099,42963,5966,25020,15065,67983,17.5,19.3,18.1,"50% - 75% P.O.C.","$44000 - $52000"
"54001","Barbour County, West Virginia",16633,38459,15879,146,48,128,0,155,95.5,0.9,0.3,0.8,0,0.9,4.5,6324,4556,1768,72.04,27.96,251,4305,169,1599,420,5904,5.5,9.6,6.6,"Less than 25% P.O.C.","Less than $44000"
"54003","Berkeley County, West Virginia",115329,62515,96756,8533,89,1242,0,5078,83.9,7.4,0.1,1.1,0,4.4,16.1,44221,33000,11221,74.63,25.37,2978,30022,1443,9778,4421,39800,9,12.9,10,"Less than 25% P.O.C.","$60000 or more"
"54005","Boone County, West Virginia",22368,40739,21841,218,10,26,0,89,97.6,1,0,0.1,0,0.4,2.4,8932,6841,2091,76.59,23.41,463,6378,143,1948,606,8326,6.8,6.8,6.8,"Less than 25% P.O.C.","Less than $44000"
"54007","Braxton County, West Virginia",14190,41466,13742,106,48,0,19,31,96.8,0.7,0.3,0,0.1,0.2,3.2,5624,4537,1087,80.67,19.33,127,4410,39,1048,166,5458,2.8,3.6,3,"Less than 25% P.O.C.","Less than $44000"
"54009","Brooke County, West Virginia",22459,51496,21467,372,22,108,52,201,95.6,1.7,0.1,0.5,0.2,0.9,4.4,9805,7469,2336,76.18,23.82,367,7102,123,2213,490,9315,4.9,5.3,5,"Less than 25% P.O.C.","$44000 - $52000"
"54011","Cabell County, West Virginia",94339,40028,84759,4587,170,1224,16,1324,89.8,4.9,0.2,1.3,0,1.4,10.2,39064,24143,14921,61.8,38.2,1444,22699,445,14476,1889,37175,6,3,4.8,"Less than 25% P.O.C.","Less than $44000"
"54013","Calhoun County, West Virginia",7295,38382,7087,3,21,0,0,136,97.1,0,0.3,0,0,1.9,2.9,2826,2229,597,78.87,21.13,170,2059,122,475,292,2534,7.6,20.4,10.3,"Less than 25% P.O.C.","Less than $44000"
"54015","Clay County, West Virginia",8709,35024,8643,1,11,0,9,15,99.2,0,0.1,0,0.1,0.2,0.8,3274,2666,608,81.43,18.57,273,2393,75,533,348,2926,10.2,12.3,10.6,"Less than 25% P.O.C.","Less than $44000"
"54017","Doddridge County, West Virginia",8560,45545,8148,126,45,45,0,49,95.2,1.5,0.5,0.5,0,0.6,4.8,2685,2354,331,87.67,12.33,112,2242,54,277,166,2519,4.8,16.3,6.2,"Less than 25% P.O.C.","$44000 - $52000"
"54019","Fayette County, West Virginia",43576,41394,40285,2274,146,24,25,505,92.4,5.2,0.3,0.1,0.1,1.2,7.6,17441,13476,3965,77.27,22.73,1041,12435,152,3813,1193,16248,7.7,3.8,6.8,"Less than 25% P.O.C.","Less than $44000"
"54021","Gilmer County, West Virginia",8041,42636,6553,966,10,75,0,330,81.5,12,0.1,0.9,0,4.1,18.5,2587,1783,804,68.92,31.08,94,1689,17,787,111,2476,5.3,2.1,4.3,"Less than 25% P.O.C.","Less than $44000"
"54023","Grant County, West Virginia",11616,42216,11215,181,0,23,22,86,96.5,1.6,0,0.2,0.2,0.7,3.5,4607,3757,850,81.55,18.45,327,3430,59,791,386,4221,8.7,6.9,8.4,"Less than 25% P.O.C.","Less than $44000"
"54025","Greenbrier County, West Virginia",35155,40200,32426,991,10,217,0,697,92.2,2.8,0,0.6,0,2,7.8,15188,11010,4178,72.49,27.51,594,10416,172,4006,766,14422,5.4,4.1,5,"Less than 25% P.O.C.","Less than $44000"
"54027","Hampshire County, West Virginia",23309,47857,22313,245,71,104,0,340,95.7,1.1,0.3,0.4,0,1.5,4.3,9288,7087,2201,76.3,23.7,369,6718,206,1995,575,8713,5.2,9.4,6.2,"Less than 25% P.O.C.","$44000 - $52000"
"54029","Hancock County, West Virginia",29383,45763,27548,548,6,136,6,460,93.8,1.9,0,0.5,0,1.6,6.2,12678,9216,3462,72.69,27.31,377,8839,364,3098,741,11937,4.1,10.5,5.8,"Less than 25% P.O.C.","$44000 - $52000"
"54031","Hardy County, West Virginia",13805,47438,12420,768,84,227,0,216,90,5.6,0.6,1.6,0,1.6,10,5674,4189,1485,73.83,26.17,323,3866,101,1384,424,5250,7.7,6.8,7.5,"Less than 25% P.O.C.","$44000 - $52000"
"54033","Harrison County, West Virginia",67908,53022,63951,1047,0,396,22,1123,94.2,1.5,0,0.6,0,1.7,5.8,27098,20035,7063,73.94,26.06,1548,18487,440,6623,1988,25110,7.7,6.2,7.3,"Less than 25% P.O.C.","$52000 - $60000"
"54035","Jackson County, West Virginia",28907,47837,28022,109,219,97,0,197,96.9,0.4,0.8,0.3,0,0.7,3.1,11334,8697,2637,76.73,23.27,694,8003,325,2312,1019,10315,8,12.3,9,"Less than 25% P.O.C.","$44000 - $52000"
"54037","Jefferson County, West Virginia",56506,80430,47020,3460,136,769,0,3242,83.2,6.1,0.2,1.4,0,5.7,16.8,20891,15968,4923,76.43,23.57,1905,14063,412,4511,2317,18574,11.9,8.4,11.1,"Less than 25% P.O.C.","$60000 or more"
"54039","Kanawha County, West Virginia",183279,46639,160768,13069,364,2137,0,2037,87.7,7.1,0.2,1.2,0,1.1,12.3,79070,54611,24459,69.07,30.93,3132,51479,1419,23040,4551,74519,5.7,5.8,5.8,"Less than 25% P.O.C.","$44000 - $52000"
"54041","Lewis County, West Virginia",16166,39908,15571,29,87,81,0,200,96.3,0.2,0.5,0.5,0,1.2,3.7,6574,4701,1873,71.51,28.49,279,4422,167,1706,446,6128,5.9,8.9,6.8,"Less than 25% P.O.C.","Less than $44000"
"54043","Lincoln County, West Virginia",20850,42345,20383,39,0,24,8,145,97.8,0.2,0,0.1,0,0.7,2.2,8208,6387,1821,77.81,22.19,360,6027,201,1620,561,7647,5.6,11,6.8,"Less than 25% P.O.C.","Less than $44000"
"54045","Logan County, West Virginia",33154,36168,31805,556,56,29,3,311,95.9,1.7,0.2,0.1,0,0.9,4.1,13816,10037,3779,72.65,27.35,584,9453,349,3430,933,12883,5.8,9.2,6.8,"Less than 25% P.O.C.","Less than $44000"
"54047","McDowell County, West Virginia",18661,27682,16552,1551,47,13,0,271,88.7,8.3,0.3,0.1,0,1.5,11.3,7607,5985,1622,78.68,21.32,516,5469,185,1437,701,6906,8.6,11.4,9.2,"Less than 25% P.O.C.","Less than $44000"
"54049","Marion County, West Virginia",56355,50305,52118,1968,203,268,0,733,92.5,3.5,0.4,0.5,0,1.3,7.5,22926,17108,5818,74.62,25.38,958,16150,423,5395,1381,21545,5.6,7.3,6,"Less than 25% P.O.C.","$44000 - $52000"
"54051","Marshall County, West Virginia",31308,48557,30266,270,46,79,92,312,96.7,0.9,0.1,0.3,0.3,1,3.3,12308,9860,2448,80.11,19.89,802,9058,163,2285,965,11343,8.1,6.7,7.8,"Less than 25% P.O.C.","$44000 - $52000"
"54053","Mason County, West Virginia",26820,46078,25912,112,35,172,0,194,96.6,0.4,0.1,0.6,0,0.7,3.4,11034,8768,2266,79.46,20.54,516,8252,202,2064,718,10316,5.9,8.9,6.5,"Less than 25% P.O.C.","$44000 - $52000"
"54055","Mercer County, West Virginia",59919,40784,54103,3710,102,352,0,706,90.3,6.2,0.2,0.6,0,1.2,9.7,25216,17529,7687,69.52,30.48,1155,16374,594,7093,1749,23467,6.6,7.7,6.9,"Less than 25% P.O.C.","Less than $44000"
"54057","Mineral County, West Virginia",27167,49936,25534,907,4,116,0,250,94,3.3,0,0.4,0,0.9,6,10916,8299,2617,76.03,23.97,511,7788,45,2572,556,10360,6.2,1.7,5.1,"Less than 25% P.O.C.","$44000 - $52000"
"54059","Mingo County, West Virginia",24290,32764,23258,568,21,19,0,0,95.8,2.3,0.1,0.1,0,0,4.2,10501,7723,2778,73.55,26.45,511,7212,329,2449,840,9661,6.6,11.8,8,"Less than 25% P.O.C.","Less than $44000"
"54061","Monongalia County, West Virginia",105474,52455,92744,3781,80,3639,0,2246,87.9,3.6,0.1,3.5,0,2.1,12.1,39466,22404,17062,56.77,43.23,1372,21032,457,16605,1829,37637,6.1,2.7,4.6,"Less than 25% P.O.C.","$52000 - $60000"
"54063","Monroe County, West Virginia",13401,38540,12903,125,66,0,0,124,96.3,0.9,0.5,0,0,0.9,3.7,5718,4499,1219,78.68,21.32,190,4309,78,1141,268,5450,4.2,6.4,4.7,"Less than 25% P.O.C.","Less than $44000"
"54065","Morgan County, West Virginia",17709,51745,16871,193,120,0,0,69,95.3,1.1,0.7,0,0,0.4,4.7,7185,5983,1202,83.27,16.73,372,5611,147,1055,519,6666,6.2,12.2,7.2,"Less than 25% P.O.C.","$44000 - $52000"
"54067","Nicholas County, West Virginia",25078,40086,24311,170,92,56,0,205,96.9,0.7,0.4,0.2,0,0.8,3.1,10069,7998,2071,79.43,20.57,449,7549,202,1869,651,9418,5.6,9.8,6.5,"Less than 25% P.O.C.","Less than $44000"
"54069","Ohio County, West Virginia",42143,50584,38819,1641,81,300,0,487,92.1,3.9,0.2,0.7,0,1.2,7.9,17193,12002,5191,69.81,30.19,804,11198,223,4968,1027,16166,6.7,4.3,6,"Less than 25% P.O.C.","$44000 - $52000"
"54071","Pendleton County, West Virginia",7001,42312,6632,233,6,0,0,57,94.7,3.3,0.1,0,0,0.8,5.3,3174,2555,619,80.5,19.5,125,2430,53,566,178,2996,4.9,8.6,5.6,"Less than 25% P.O.C.","Less than $44000"
"54073","Pleasants County, West Virginia",7482,56838,7171,21,0,0,0,220,95.8,0.3,0,0,0,2.9,4.2,2835,2339,496,82.5,17.5,156,2183,38,458,194,2641,6.7,7.7,6.8,"Less than 25% P.O.C.","$52000 - $60000"
"54075","Pocahontas County, West Virginia",8450,41882,8290,37,0,9,0,49,98.1,0.4,0,0.1,0,0.6,1.9,3530,2881,649,81.61,18.39,72,2809,61,588,133,3397,2.5,9.4,3.8,"Less than 25% P.O.C.","Less than $44000"
"54077","Preston County, West Virginia",33683,51888,30509,1675,240,85,8,849,90.6,5,0.7,0.3,0,2.5,9.4,12429,10301,2128,82.88,17.12,765,9536,224,1904,989,11440,7.4,10.5,8,"Less than 25% P.O.C.","$44000 - $52000"
"54079","Putnam County, West Virginia",56610,60097,54038,789,22,425,58,662,95.5,1.4,0,0.8,0.1,1.2,4.5,21613,17690,3923,81.85,18.15,1420,16270,298,3625,1718,19895,8,7.6,7.9,"Less than 25% P.O.C.","$60000 or more"
"54081","Raleigh County, West Virginia",75252,43748,65521,5772,220,693,10,1235,87.1,7.7,0.3,0.9,0,1.6,12.9,31203,22893,8310,73.37,26.63,1801,21092,678,7632,2479,28724,7.9,8.2,7.9,"Less than 25% P.O.C.","Less than $44000"
"54083","Randolph County, West Virginia",28930,43320,27710,616,67,160,0,279,95.8,2.1,0.2,0.6,0,1,4.2,11135,7965,3170,71.53,28.47,431,7534,211,2959,642,10493,5.4,6.7,5.8,"Less than 25% P.O.C.","Less than $44000"
"54085","Ritchie County, West Virginia",9844,43577,9535,27,0,0,0,70,96.9,0.3,0,0,0,0.7,3.1,4049,3232,817,79.82,20.18,143,3089,107,710,250,3799,4.4,13.1,6.2,"Less than 25% P.O.C.","Less than $44000"
"54087","Roane County, West Virginia",14020,37373,13577,9,15,22,0,160,96.8,0.1,0.1,0.2,0,1.1,3.2,5562,4409,1153,79.27,20.73,453,3956,67,1086,520,5042,10.3,5.8,9.3,"Less than 25% P.O.C.","Less than $44000"
"54089","Summers County, West Virginia",12848,38187,11805,576,0,0,0,190,91.9,4.5,0,0,0,1.5,8.1,5566,4243,1323,76.23,23.77,197,4046,86,1237,283,5283,4.6,6.5,5.1,"Less than 25% P.O.C.","Less than $44000"
"54091","Taylor County, West Virginia",16864,48578,16102,217,0,52,0,171,95.5,1.3,0,0.3,0,1,4.5,6614,5156,1458,77.96,22.04,247,4909,100,1358,347,6267,4.8,6.9,5.2,"Less than 25% P.O.C.","$44000 - $52000"
"54093","Tucker County, West Virginia",6982,49118,6791,17,0,38,0,24,97.3,0.2,0,0.5,0,0.3,2.7,3142,2467,675,78.52,21.48,172,2295,33,642,205,2937,7,4.9,6.5,"Less than 25% P.O.C.","$44000 - $52000"
"54095","Tyler County, West Virginia",8811,43087,8588,32,18,62,0,31,97.5,0.4,0.2,0.7,0,0.4,2.5,3207,2653,554,82.73,17.27,208,2445,26,528,234,2973,7.8,4.7,7.3,"Less than 25% P.O.C.","Less than $44000"
"54097","Upshur County, West Virginia",24502,40322,23500,452,15,43,0,334,95.9,1.8,0.1,0.2,0,1.4,4.1,9713,7157,2556,73.68,26.32,499,6658,283,2273,782,8931,7,11.1,8.1,"Less than 25% P.O.C.","Less than $44000"
"54099","Wayne County, West Virginia",40303,37988,39218,347,62,113,0,264,97.3,0.9,0.2,0.3,0,0.7,2.7,15124,11110,4014,73.46,26.54,816,10294,260,3754,1076,14048,7.3,6.5,7.1,"Less than 25% P.O.C.","Less than $44000"
"54101","Webster County, West Virginia",8386,34927,8352,2,0,0,3,5,99.6,0,0,0,0,0.1,0.4,3781,2744,1037,72.57,27.43,200,2544,166,871,366,3415,7.3,16,9.7,"Less than 25% P.O.C.","Less than $44000"
"54103","Wetzel County, West Virginia",15436,43107,14961,164,0,0,0,132,96.9,1.1,0,0,0,0.9,3.1,5762,4577,1185,79.43,20.57,236,4341,96,1089,332,5430,5.2,8.1,5.8,"Less than 25% P.O.C.","Less than $44000"
"54105","Wirt County, West Virginia",5798,46048,5735,26,0,0,0,27,98.9,0.4,0,0,0,0.5,1.1,2505,2096,409,83.67,16.33,108,1988,11,398,119,2386,5.2,2.7,4.8,"Less than 25% P.O.C.","$44000 - $52000"
"54107","Wood County, West Virginia",84960,47321,80844,1204,378,437,51,978,95.2,1.4,0.4,0.5,0.1,1.2,4.8,35488,25366,10122,71.48,28.52,1522,23844,586,9536,2108,33380,6,5.8,5.9,"Less than 25% P.O.C.","$44000 - $52000"
"54109","Wyoming County, West Virginia",21281,42332,20674,262,0,54,0,67,97.1,1.2,0,0.3,0,0.3,2.9,8805,7412,1393,84.18,15.82,411,7001,149,1244,560,8245,5.5,10.7,6.4,"Less than 25% P.O.C.","Less than $44000"
"55001","Adams County, Wisconsin",20094,46369,18174,552,138,132,3,791,90.4,2.7,0.7,0.7,0,3.9,9.6,9062,7548,1514,83.29,16.71,347,7201,176,1338,523,8539,4.6,11.6,5.8,"Less than 25% P.O.C.","$44000 - $52000"
"55003","Ashland County, Wisconsin",15617,42510,12863,116,1702,73,6,450,82.4,0.7,10.9,0.5,0,2.9,17.6,6565,4483,2082,68.29,31.71,344,4139,151,1931,495,6070,7.7,7.3,7.5,"Less than 25% P.O.C.","Less than $44000"
"55005","Barron County, Wisconsin",45229,52703,42199,688,332,314,0,1129,93.3,1.5,0.7,0.7,0,2.5,6.7,18907,14130,4777,74.73,25.27,1124,13006,364,4413,1488,17419,8,7.6,7.9,"Less than 25% P.O.C.","$52000 - $60000"
"55007","Bayfield County, Wisconsin",14993,56096,12679,124,1487,72,0,300,84.6,0.8,9.9,0.5,0,2,15.4,7057,5872,1185,83.21,16.79,337,5535,94,1091,431,6626,5.7,7.9,6.1,"Less than 25% P.O.C.","$52000 - $60000"
"55009","Brown County, Wisconsin",261368,62340,211283,6193,5928,8403,29,22502,80.8,2.4,2.3,3.2,0,8.6,19.2,105271,68260,37011,64.84,35.16,6383,61877,2516,34495,8899,96372,9.4,6.8,8.5,"Less than 25% P.O.C.","$60000 or more"
"55011","Buffalo County, Wisconsin",13126,57829,12562,95,55,10,0,283,95.7,0.7,0.4,0.1,0,2.2,4.3,5772,4407,1365,76.35,23.65,318,4089,74,1291,392,5380,7.2,5.4,6.8,"Less than 25% P.O.C.","$52000 - $60000"
"55013","Burnett County, Wisconsin",15289,52672,13816,85,612,52,1,285,90.4,0.6,4,0.3,0,1.9,9.6,7305,6005,1300,82.2,17.8,355,5650,112,1188,467,6838,5.9,8.6,6.4,"Less than 25% P.O.C.","$52000 - $60000"
"55015","Calumet County, Wisconsin",49928,75814,45391,420,271,1203,1,2144,90.9,0.8,0.5,2.4,0,4.3,9.1,19807,15973,3834,80.64,19.36,1653,14320,217,3617,1870,17937,10.3,5.7,9.4,"Less than 25% P.O.C.","$60000 or more"
"55017","Chippewa County, Wisconsin",63892,59742,59777,1001,89,860,0,1140,93.6,1.6,0.1,1.3,0,1.8,6.4,25601,18717,6884,73.11,26.89,1584,17133,587,6297,2171,23430,8.5,8.5,8.5,"Less than 25% P.O.C.","$52000 - $60000"
"55019","Clark County, Wisconsin",34579,54012,32179,98,78,136,0,1622,93.1,0.3,0.2,0.4,0,4.7,6.9,12791,10030,2761,78.41,21.59,1432,8598,299,2462,1731,11060,14.3,10.8,13.5,"Less than 25% P.O.C.","$52000 - $60000"
"55021","Columbia County, Wisconsin",57133,68005,52927,763,258,437,17,1941,92.6,1.3,0.5,0.8,0,3.4,7.4,24112,17933,6179,74.37,25.63,1385,16548,467,5712,1852,22260,7.7,7.6,7.7,"Less than 25% P.O.C.","$60000 or more"
"55023","Crawford County, Wisconsin",16235,50595,15322,310,57,87,0,250,94.4,1.9,0.4,0.5,0,1.5,5.6,6654,5038,1616,75.71,24.29,485,4553,103,1513,588,6066,9.6,6.4,8.8,"Less than 25% P.O.C.","$44000 - $52000"
"55025","Dane County, Wisconsin",536078,73893,426331,27162,1590,31659,211,34059,79.5,5.1,0.3,5.9,0,6.4,20.5,222929,129740,93189,58.2,41.8,10102,119638,4573,88616,14675,208254,7.8,4.9,6.6,"Less than 25% P.O.C.","$60000 or more"
"55027","Dodge County, Wisconsin",87715,60652,78853,2441,310,525,25,4202,89.9,2.8,0.4,0.6,0,4.8,10.1,34980,24396,10584,69.74,30.26,1880,22516,697,9887,2577,32403,7.7,6.6,7.4,"Less than 25% P.O.C.","$60000 or more"
"55029","Door County, Wisconsin",27472,61560,25777,177,248,137,0,859,93.8,0.6,0.9,0.5,0,3.1,6.2,13191,10538,2653,79.89,20.11,631,9907,137,2516,768,12423,6,5.2,5.8,"Less than 25% P.O.C.","$60000 or more"
"55031","Douglas County, Wisconsin",43295,53986,39667,605,788,538,0,697,91.6,1.4,1.8,1.2,0,1.6,8.4,19011,12837,6174,67.52,32.48,749,12088,261,5913,1010,18001,5.8,4.2,5.3,"Less than 25% P.O.C.","$52000 - $60000"
"55033","Dunn County, Wisconsin",44759,58783,41508,278,93,1165,34,848,92.7,0.6,0.2,2.6,0.1,1.9,7.3,16859,11491,5368,68.16,31.84,906,10585,466,4902,1372,15487,7.9,8.7,8.1,"Less than 25% P.O.C.","$52000 - $60000"
"55035","Eau Claire County, Wisconsin",103514,59476,93151,1228,419,4222,374,2572,90,1.2,0.4,4.1,0.4,2.5,10,40981,26419,14562,64.47,35.53,2369,24050,1008,13554,3377,37604,9,6.9,8.2,"Less than 25% P.O.C.","$52000 - $60000"
"55037","Florence County, Wisconsin",4314,52181,4187,13,6,0,0,59,97.1,0.3,0.1,0,0,1.4,2.9,1948,1680,268,86.24,13.76,85,1595,2,266,87,1861,5.1,0.7,4.5,"Less than 25% P.O.C.","$52000 - $60000"
"55039","Fond du Lac County, Wisconsin",102597,62391,91936,1441,472,1272,26,5284,89.6,1.4,0.5,1.2,0,5.2,10.4,41542,29192,12350,70.27,29.73,2398,26794,684,11666,3082,38460,8.2,5.5,7.4,"Less than 25% P.O.C.","$60000 or more"
"55041","Forest County, Wisconsin",8995,45536,7107,77,1360,55,5,225,79,0.9,15.1,0.6,0.1,2.5,21,4008,3053,955,76.17,23.83,206,2847,63,892,269,3739,6.7,6.6,6.7,"Less than 25% P.O.C.","$44000 - $52000"
"55043","Grant County, Wisconsin",51733,54800,49170,766,75,504,0,868,95,1.5,0.1,1,0,1.7,5,19583,13779,5804,70.36,29.64,1414,12365,297,5507,1711,17872,10.3,5.1,8.7,"Less than 25% P.O.C.","$52000 - $60000"
"55045","Green County, Wisconsin",36896,64502,34795,214,86,236,18,1127,94.3,0.6,0.2,0.6,0,3.1,5.7,15047,11300,3747,75.1,24.9,896,10404,212,3535,1108,13939,7.9,5.7,7.4,"Less than 25% P.O.C.","$60000 or more"
"55047","Green Lake County, Wisconsin",18755,55075,17305,107,60,137,0,923,92.3,0.6,0.3,0.7,0,4.9,7.7,7979,6073,1906,76.11,23.89,524,5549,114,1792,638,7341,8.6,6,8,"Less than 25% P.O.C.","$52000 - $60000"
"55049","Iowa County, Wisconsin",23618,64124,22503,211,46,160,21,424,95.3,0.9,0.2,0.7,0.1,1.8,4.7,9850,7274,2576,73.85,26.15,746,6528,234,2342,980,8870,10.3,9.1,9.9,"Less than 25% P.O.C.","$60000 or more"
"55051","Iron County, Wisconsin",5687,43798,5426,7,96,28,0,78,95.4,0.1,1.7,0.5,0,1.4,4.6,2898,2247,651,77.54,22.46,79,2168,37,614,116,2782,3.5,5.7,4,"Less than 25% P.O.C.","Less than $44000"
"55053","Jackson County, Wisconsin",20522,53650,17666,417,1100,83,0,709,86.1,2,5.4,0.4,0,3.5,13.9,8199,6059,2140,73.9,26.1,582,5477,242,1898,824,7375,9.6,11.3,10.1,"Less than 25% P.O.C.","$52000 - $60000"
"55055","Jefferson County, Wisconsin",84701,66291,75897,621,61,530,0,5992,89.6,0.7,0.1,0.6,0,7.1,10.4,32965,23126,9839,70.15,29.85,2103,21023,732,9107,2835,30130,9.1,7.4,8.6,"Less than 25% P.O.C.","$60000 or more"
"55057","Juneau County, Wisconsin",26478,53490,24244,600,295,147,6,817,91.6,2.3,1.1,0.6,0,3.1,8.4,10752,8197,2555,76.24,23.76,692,7505,219,2336,911,9841,8.4,8.6,8.5,"Less than 25% P.O.C.","$52000 - $60000"
"55059","Kenosha County, Wisconsin",168524,63733,127788,12174,589,2621,56,22028,75.8,7.2,0.3,1.6,0,13.1,24.2,64111,42370,21741,66.09,33.91,3955,38415,1776,19965,5731,58380,9.3,8.2,8.9,"Less than 25% P.O.C.","$60000 or more"
"55061","Kewaunee County, Wisconsin",20387,66192,19255,148,54,62,0,618,94.4,0.7,0.3,0.3,0,3,5.6,8341,6615,1726,79.31,20.69,584,6031,80,1646,664,7677,8.8,4.6,8,"Less than 25% P.O.C.","$60000 or more"
"55063","La Crosse County, Wisconsin",117894,57882,105928,1803,461,5168,12,2265,89.9,1.5,0.4,4.4,0,1.9,10.1,47518,29949,17569,63.03,36.97,2773,27176,957,16612,3730,43788,9.3,5.4,7.8,"Less than 25% P.O.C.","$52000 - $60000"
"55065","Lafayette County, Wisconsin",16715,60691,15728,101,35,89,0,652,94.1,0.6,0.2,0.5,0,3.9,5.9,6722,5138,1584,76.44,23.56,584,4554,166,1418,750,5972,11.4,10.5,11.2,"Less than 25% P.O.C.","$60000 or more"
"55067","Langlade County, Wisconsin",19146,49491,17965,240,132,42,4,378,93.8,1.3,0.7,0.2,0,2,6.2,8612,6639,1973,77.09,22.91,344,6295,204,1769,548,8064,5.2,10.3,6.4,"Less than 25% P.O.C.","$44000 - $52000"
"55069","Lincoln County, Wisconsin",27744,58541,26467,200,116,109,0,439,95.4,0.7,0.4,0.4,0,1.6,4.6,12625,9858,2767,78.08,21.92,626,9232,198,2569,824,11801,6.4,7.2,6.5,"Less than 25% P.O.C.","$52000 - $60000"
"55071","Manitowoc County, Wisconsin",79185,56612,71684,772,375,2158,0,3178,90.5,1,0.5,2.7,0,4,9.5,34563,26046,8517,75.36,24.64,2043,24003,705,7812,2748,31815,7.8,8.3,8,"Less than 25% P.O.C.","$52000 - $60000"
"55073","Marathon County, Wisconsin",135396,62633,120059,769,314,7828,90,3777,88.7,0.6,0.2,5.8,0.1,2.8,11.3,55466,40048,15418,72.2,27.8,3807,36241,818,14600,4625,50841,9.5,5.3,8.3,"Less than 25% P.O.C.","$60000 or more"
"55075","Marinette County, Wisconsin",40391,50330,38477,297,217,128,16,706,95.3,0.7,0.5,0.3,0,1.7,4.7,18473,13800,4673,74.7,25.3,864,12936,292,4381,1156,17317,6.3,6.2,6.3,"Less than 25% P.O.C.","$44000 - $52000"
"55077","Marquette County, Wisconsin",15304,52288,14276,104,74,84,0,520,93.3,0.7,0.5,0.5,0,3.4,6.7,6648,5412,1236,81.41,18.59,335,5077,102,1134,437,6211,6.2,8.3,6.6,"Less than 25% P.O.C.","$52000 - $60000"
"55078","Menominee County, Wisconsin",4558,40921,459,13,3610,7,0,276,10.1,0.3,79.2,0.2,0,6.1,89.9,1408,958,450,68.04,31.96,63,895,133,317,196,1212,6.6,29.6,13.9,"75% or more P.O.C.","Less than $44000"
"55079","Milwaukee County, Wisconsin",951226,50606,487394,247854,4497,40743,226,142731,51.2,26.1,0.5,4.3,0,15,48.8,382175,189054,193121,49.47,50.53,17272,171782,14927,178194,32199,349976,9.1,7.7,8.4,"25% - 50% P.O.C.","$44000 - $52000"
"55081","Monroe County, Wisconsin",45771,59587,41425,802,470,416,9,2102,90.5,1.8,1,0.9,0,4.6,9.5,17915,12487,5428,69.7,30.3,1480,11007,273,5155,1753,16162,11.9,5,9.8,"Less than 25% P.O.C.","$52000 - $60000"
"55083","Oconto County, Wisconsin",37646,60908,35748,161,352,146,0,673,95,0.4,0.9,0.4,0,1.8,5,16036,13263,2773,82.71,17.29,994,12269,238,2535,1232,14804,7.5,8.6,7.7,"Less than 25% P.O.C.","$60000 or more"
"55085","Oneida County, Wisconsin",35381,56852,33560,227,460,137,14,546,94.9,0.6,1.3,0.4,0,1.5,5.1,15421,12831,2590,83.2,16.8,549,12282,110,2480,659,14762,4.3,4.2,4.3,"Less than 25% P.O.C.","$52000 - $60000"
"55087","Outagamie County, Wisconsin",185700,65572,162546,2589,2756,6412,59,7997,87.5,1.4,1.5,3.5,0,4.3,12.5,73648,52389,21259,71.13,28.87,4891,47498,1189,20070,6080,67568,9.3,5.6,8.3,"Less than 25% P.O.C.","$60000 or more"
"55089","Ozaukee County, Wisconsin",88597,85215,81042,1068,164,1853,70,2606,91.5,1.2,0.2,2.1,0.1,2.9,8.5,35807,27162,8645,75.86,24.14,2202,24960,305,8340,2507,33300,8.1,3.5,7,"Less than 25% P.O.C.","$60000 or more"
"55091","Pepin County, Wisconsin",7265,54583,7003,21,17,22,8,135,96.4,0.3,0.2,0.3,0.1,1.9,3.6,3070,2450,620,79.8,20.2,177,2273,45,575,222,2848,7.2,7.3,7.2,"Less than 25% P.O.C.","$52000 - $60000"
"55093","Pierce County, Wisconsin",41977,72323,39502,212,87,531,7,902,94.1,0.5,0.2,1.3,0,2.1,5.9,15593,11260,4333,72.21,27.79,1266,9994,398,3935,1664,13929,11.2,9.2,10.7,"Less than 25% P.O.C.","$60000 or more"
"55095","Polk County, Wisconsin",43438,59994,41263,176,380,223,40,825,95,0.4,0.9,0.5,0.1,1.9,5,18450,14556,3894,78.89,21.11,1154,13402,286,3608,1440,17010,7.9,7.3,7.8,"Less than 25% P.O.C.","$52000 - $60000"
"55097","Portage County, Wisconsin",70632,58853,64303,562,232,2093,5,2272,91,0.8,0.3,3,0,3.2,9,28675,19794,8881,69.03,30.97,1744,18050,444,8437,2188,26487,8.8,5,7.6,"Less than 25% P.O.C.","$52000 - $60000"
"55099","Price County, Wisconsin",13416,47956,12620,112,129,81,114,238,94.1,0.8,1,0.6,0.8,1.8,5.9,6688,5206,1482,77.84,22.16,286,4920,133,1349,419,6269,5.5,9,6.3,"Less than 25% P.O.C.","$44000 - $52000"
"55101","Racine County, Wisconsin",195602,61336,140742,21610,766,2503,95,25637,72,11,0.4,1.3,0,13.1,28,76974,52019,24955,67.58,32.42,3931,48088,2659,22296,6590,70384,7.6,10.7,8.6,"25% - 50% P.O.C.","$60000 or more"
"55103","Richland County, Wisconsin",17459,51947,16515,153,66,124,0,405,94.6,0.9,0.4,0.7,0,2.3,5.4,7538,5633,1905,74.73,25.27,454,5179,125,1780,579,6959,8.1,6.6,7.7,"Less than 25% P.O.C.","$44000 - $52000"
"55105","Rock County, Wisconsin",162152,57875,134318,6996,390,2018,17,14107,82.8,4.3,0.2,1.2,0,8.7,17.2,64739,44254,20485,68.36,31.64,3784,40470,1634,18851,5418,59321,8.6,8,8.4,"Less than 25% P.O.C.","$52000 - $60000"
"55107","Rusk County, Wisconsin",14132,47532,13386,90,64,2,18,270,94.7,0.6,0.5,0,0.1,1.9,5.3,6376,5046,1330,79.14,20.86,403,4643,99,1231,502,5874,8,7.4,7.9,"Less than 25% P.O.C.","$44000 - $52000"
"55109","St. Croix County, Wisconsin",88732,84756,83326,710,172,863,0,2134,93.9,0.8,0.2,1,0,2.4,6.1,34182,26243,7939,76.77,23.23,2770,23473,507,7432,3277,30905,10.6,6.4,9.6,"Less than 25% P.O.C.","$60000 or more"
"55111","Sauk County, Wisconsin",63922,59943,58075,522,693,387,0,3281,90.9,0.8,1.1,0.6,0,5.1,9.1,26222,18063,8159,68.88,31.12,1695,16368,400,7759,2095,24127,9.4,4.9,8,"Less than 25% P.O.C.","$52000 - $60000"
"55113","Sawyer County, Wisconsin",16399,47714,12576,42,2831,92,7,449,76.7,0.3,17.3,0.6,0,2.7,23.3,7796,5769,2027,74,26,337,5432,149,1878,486,7310,5.8,7.4,6.2,"Less than 25% P.O.C.","$44000 - $52000"
"55115","Shawano County, Wisconsin",40904,56531,35442,164,2976,164,7,1146,86.6,0.4,7.3,0.4,0,2.8,13.4,17004,13137,3867,77.26,22.74,1114,12023,252,3615,1366,15638,8.5,6.5,8,"Less than 25% P.O.C.","$52000 - $60000"
"55117","Sheboygan County, Wisconsin",115178,60696,97016,2216,303,6581,0,7334,84.2,1.9,0.3,5.7,0,6.4,15.8,47738,33398,14340,69.96,30.04,2981,30417,860,13480,3841,43897,8.9,6,8,"Less than 25% P.O.C.","$60000 or more"
"55119","Taylor County, Wisconsin",20325,53020,19486,50,40,46,0,422,95.9,0.2,0.2,0.2,0,2.1,4.1,8614,6601,2013,76.63,23.37,650,5951,107,1906,757,7857,9.8,5.3,8.8,"Less than 25% P.O.C.","$52000 - $60000"
"55121","Trempealeau County, Wisconsin",29499,58548,26409,150,101,128,0,2479,89.5,0.5,0.3,0.4,0,8.4,10.5,12005,8762,3243,72.99,27.01,794,7968,236,3007,1030,10975,9.1,7.3,8.6,"Less than 25% P.O.C.","$52000 - $60000"
"55123","Vernon County, Wisconsin",30633,52459,29485,96,34,139,11,484,96.3,0.3,0.1,0.5,0,1.6,3.7,12071,9387,2684,77.76,22.24,1049,8338,134,2550,1183,10888,11.2,5,9.8,"Less than 25% P.O.C.","$52000 - $60000"
"55125","Vilas County, Wisconsin",21751,47072,18445,70,1738,131,11,566,84.8,0.3,8,0.6,0.1,2.6,15.2,10921,8482,2439,77.67,22.33,348,8134,111,2328,459,10462,4.1,4.6,4.2,"Less than 25% P.O.C.","$44000 - $52000"
"55127","Walworth County, Wisconsin",103074,63776,88064,908,235,944,55,11431,85.4,0.9,0.2,0.9,0.1,11.1,14.6,40874,28044,12830,68.61,31.39,2586,25458,1232,11598,3818,37056,9.2,9.6,9.3,"Less than 25% P.O.C.","$60000 or more"
"55129","Washburn County, Wisconsin",15688,50280,14774,45,171,100,46,289,94.2,0.3,1.1,0.6,0.3,1.8,5.8,7236,5791,1445,80.03,19.97,351,5440,125,1320,476,6760,6.1,8.7,6.6,"Less than 25% P.O.C.","$44000 - $52000"
"55131","Washington County, Wisconsin",134925,77663,125286,1766,210,1753,36,4270,92.9,1.3,0.2,1.3,0,3.2,7.1,54302,42104,12198,77.54,22.46,3473,38631,540,11658,4013,50289,8.2,4.4,7.4,"Less than 25% P.O.C.","$60000 or more"
"55133","Waukesha County, Wisconsin",400475,87277,354614,6286,736,14062,142,18901,88.5,1.6,0.2,3.5,0,4.7,11.5,158808,121146,37662,76.28,23.72,10817,110329,1678,35984,12495,146313,8.9,4.5,7.9,"Less than 25% P.O.C.","$60000 or more"
"55135","Waupaca County, Wisconsin",51245,58693,48307,307,278,215,3,1606,94.3,0.6,0.5,0.4,0,3.1,5.7,22305,16430,5875,73.66,26.34,1174,15256,294,5581,1468,20837,7.1,5,6.6,"Less than 25% P.O.C.","$52000 - $60000"
"55137","Waushara County, Wisconsin",24193,52810,21631,342,154,85,6,1541,89.4,1.4,0.6,0.4,0,6.4,10.6,9934,8110,1824,81.64,18.36,622,7488,189,1635,811,9123,7.7,10.4,8.2,"Less than 25% P.O.C.","$52000 - $60000"
"55139","Winnebago County, Wisconsin",170411,58543,151076,3809,1000,4748,129,7017,88.7,2.2,0.6,2.8,0.1,4.1,11.3,70594,46039,24555,65.22,34.78,3186,42853,1294,23261,4480,66114,6.9,5.3,6.3,"Less than 25% P.O.C.","$52000 - $60000"
"55141","Wood County, Wisconsin",73112,54913,67439,513,345,1491,17,2179,92.2,0.7,0.5,2,0,3,7.8,32332,23399,8933,72.37,27.63,1830,21569,513,8420,2343,29989,7.8,5.7,7.2,"Less than 25% P.O.C.","$52000 - $60000"
"56001","Albany County, Wyoming",38390,49322,31665,575,351,1256,10,3658,82.5,1.5,0.9,3.3,0,9.5,17.5,15944,8138,7806,51.04,48.96,599,7539,316,7490,915,15029,7.4,4,5.7,"Less than 25% P.O.C.","$44000 - $52000"
"56003","Big Horn County, Wyoming",11882,52804,10426,52,82,58,5,1066,87.7,0.4,0.7,0.5,0,9,12.3,4475,3276,1199,73.21,26.79,440,2836,152,1047,592,3883,13.4,12.7,13.2,"Less than 25% P.O.C.","$52000 - $60000"
"56005","Campbell County, Wyoming",47409,82659,41384,169,296,246,76,4110,87.3,0.4,0.6,0.5,0.2,8.7,12.7,17574,12900,4674,73.4,26.6,1295,11605,383,4291,1678,15896,10,8.2,9.5,"Less than 25% P.O.C.","$60000 or more"
"56007","Carbon County, Wyoming",15247,60161,11774,163,242,141,8,2778,77.2,1.1,1.6,0.9,0.1,18.2,22.8,6204,4317,1887,69.58,30.42,327,3990,223,1664,550,5654,7.6,11.8,8.9,"Less than 25% P.O.C.","$60000 or more"
"56009","Converse County, Wyoming",13921,69647,12346,0,23,32,0,1128,88.7,0,0.2,0.2,0,8.1,11.3,5378,3964,1414,73.71,26.29,420,3544,117,1297,537,4841,10.6,8.3,10,"Less than 25% P.O.C.","$60000 or more"
"56011","Crook County, Wyoming",7472,65132,7045,10,99,51,0,105,94.3,0.1,1.3,0.7,0,1.4,5.7,2919,2387,532,81.77,18.23,278,2109,66,466,344,2575,11.6,12.4,11.8,"Less than 25% P.O.C.","$60000 or more"
"56013","Fremont County, Wyoming",39812,55896,27759,213,7753,166,7,2758,69.7,0.5,19.5,0.4,0,6.9,30.3,14907,10503,4404,70.46,29.54,949,9554,644,3760,1593,13314,9,14.6,10.7,"25% - 50% P.O.C.","$52000 - $60000"
"56015","Goshen County, Wyoming",13342,54289,11453,41,108,112,30,1413,85.8,0.3,0.8,0.8,0.2,10.6,14.2,5207,3836,1371,73.67,26.33,262,3574,132,1239,394,4813,6.8,9.6,7.6,"Less than 25% P.O.C.","$52000 - $60000"
"56017","Hot Springs County, Wyoming",4607,51413,4265,0,120,0,0,175,92.6,0,2.6,0,0,3.8,7.4,2118,1593,525,75.21,24.79,102,1491,132,393,234,1884,6.4,25.1,11,"Less than 25% P.O.C.","$44000 - $52000"
"56019","Johnson County, Wyoming",8487,58132,7762,49,364,0,0,232,91.5,0.6,4.3,0,0,2.7,8.5,3845,2687,1158,69.88,30.12,244,2443,62,1096,306,3539,9.1,5.4,8,"Less than 25% P.O.C.","$52000 - $60000"
"56021","Laramie County, Wyoming",98320,66910,77521,1953,765,1161,111,14379,78.8,2,0.8,1.2,0.1,14.6,21.2,39683,27692,11991,69.78,30.22,2575,25117,901,11090,3476,36207,9.3,7.5,8.8,"Less than 25% P.O.C.","$60000 or more"
"56023","Lincoln County, Wyoming",19274,66964,17766,9,59,54,0,881,92.2,0,0.3,0.3,0,4.6,7.8,6908,5693,1215,82.41,17.59,922,4771,133,1082,1055,5853,16.2,10.9,15.3,"Less than 25% P.O.C.","$60000 or more"
"56025","Natrona County, Wyoming",80333,62772,69640,864,789,466,138,6787,86.7,1.1,1,0.6,0.2,8.4,13.3,32799,22363,10436,68.18,31.82,1755,20608,736,9700,2491,30308,7.8,7.1,7.6,"Less than 25% P.O.C.","$60000 or more"
"56027","Niobrara County, Wyoming",2422,39150,2195,14,80,0,25,95,90.6,0.6,3.3,0,1,3.9,9.4,964,747,217,77.49,22.51,43,704,44,173,87,877,5.8,20.3,9,"Less than 25% P.O.C.","Less than $44000"
"56029","Park County, Wyoming",29148,63582,26539,196,134,155,0,1586,91,0.7,0.5,0.5,0,5.4,9,12160,8897,3263,73.17,26.83,630,8267,187,3076,817,11343,7.1,5.7,6.7,"Less than 25% P.O.C.","$60000 or more"
"56031","Platte County, Wyoming",8582,50903,7595,1,1,100,0,698,88.5,0,0,1.2,0,8.1,11.5,4030,3013,1017,74.76,25.24,203,2810,150,867,353,3677,6.7,14.7,8.8,"Less than 25% P.O.C.","$44000 - $52000"
"56033","Sheridan County, Wyoming",30140,60807,27633,65,541,203,0,1272,91.7,0.2,1.8,0.7,0,4.2,8.3,13251,9117,4134,68.8,31.2,825,8292,170,3964,995,12256,9,4.1,7.5,"Less than 25% P.O.C.","$60000 or more"
"56035","Sublette County, Wyoming",9880,77403,8820,0,33,7,0,721,89.3,0,0.3,0.1,0,7.3,10.7,3340,2741,599,82.07,17.93,273,2468,32,567,305,3035,10,5.3,9.1,"Less than 25% P.O.C.","$60000 or more"
"56037","Sweetwater County, Wyoming",43521,74843,34624,488,442,322,13,6913,79.6,1.1,1,0.7,0,15.9,20.4,15523,11832,3691,76.22,23.78,1306,10526,398,3293,1704,13819,11,10.8,11,"Less than 25% P.O.C.","$60000 or more"
"56039","Teton County, Wyoming",23280,84678,18935,289,77,291,29,3498,81.3,1.2,0.3,1.2,0.1,15,18.7,9019,5448,3571,60.41,39.59,285,5163,198,3373,483,8536,5.2,5.5,5.4,"Less than 25% P.O.C.","$60000 or more"
"56041","Uinta County, Wyoming",20479,63403,17923,23,134,32,0,1870,87.5,0.1,0.7,0.2,0,9.1,12.5,7597,5854,1743,77.06,22.94,896,4958,184,1559,1080,6517,15.3,10.6,14.2,"Less than 25% P.O.C.","$60000 or more"
"56043","Washakie County, Wyoming",8027,54158,6574,3,42,0,0,1142,81.9,0,0.5,0,0,14.2,18.1,3365,2574,791,76.49,23.51,184,2390,65,726,249,3116,7.1,8.2,7.4,"Less than 25% P.O.C.","$52000 - $60000"
"56045","Weston County, Wyoming",7049,57031,6793,16,12,54,8,76,96.4,0.2,0.2,0.8,0.1,1.1,3.6,2891,2400,491,83.02,16.98,74,2326,29,462,103,2788,3.1,5.9,3.6,"Less than 25% P.O.C.","$52000 - $60000"
"72001","Adjuntas Municipio, Puerto Rico",17891,14012,53,0,8,0,0,17830,0.3,0,0,0,0,99.7,99.7,5771,3425,2346,59.35,40.65,180,3245,72,2274,252,5519,5.3,3.1,4.4,"75% or more P.O.C.","Less than $44000"
"72003","Aguada Municipio, Puerto Rico",37954,16738,2551,18,46,0,0,35100,6.7,0,0.1,0,0,92.5,93.3,12830,9593,3237,74.77,25.23,700,8893,119,3118,819,12011,7.3,3.7,6.4,"75% or more P.O.C.","Less than $44000"
"72005","Aguadilla Municipio, Puerto Rico",52803,16269,825,87,0,60,11,51527,1.6,0.2,0,0.1,0,97.6,98.4,21635,12933,8702,59.78,40.22,667,12266,600,8102,1267,20368,5.2,6.9,5.9,"75% or more P.O.C.","Less than $44000"
"72007","Aguas Buenas Municipio, Puerto Rico",25748,19279,89,0,0,0,0,25659,0.3,0,0,0,0,99.7,99.7,8488,5600,2888,65.98,34.02,509,5091,190,2698,699,7789,9.1,6.6,8.2,"75% or more P.O.C.","Less than $44000"
"72009","Aibonito Municipio, Puerto Rico",22988,20521,41,0,0,19,0,22904,0.2,0,0,0.1,0,99.6,99.8,8592,6710,1882,78.1,21.9,374,6336,108,1774,482,8110,5.6,5.7,5.6,"75% or more P.O.C.","Less than $44000"
"72011","Añasco Municipio, Puerto Rico",26934,19919,1173,0,0,0,1,25616,4.4,0,0,0,0,95.1,95.6,8848,6811,2037,76.98,23.02,462,6349,79,1958,541,8307,6.8,3.9,6.1,"75% or more P.O.C.","Less than $44000"
"72013","Arecibo Municipio, Puerto Rico",85390,18647,516,40,10,0,0,84707,0.6,0,0,0,0,99.2,99.4,31910,21134,10776,66.23,33.77,1265,19869,460,10316,1725,30185,6,4.3,5.4,"75% or more P.O.C.","Less than $44000"
"72015","Arroyo Municipio, Puerto Rico",17805,17570,27,0,0,0,0,17778,0.2,0,0,0,0,99.8,99.8,5908,4640,1268,78.54,21.46,289,4351,122,1146,411,5497,6.2,9.6,7,"75% or more P.O.C.","Less than $44000"
"72017","Barceloneta Municipio, Puerto Rico",24079,17154,65,0,0,0,0,23959,0.3,0,0,0,0,99.5,99.7,7989,5721,2268,71.61,28.39,214,5507,273,1995,487,7502,3.7,12,6.1,"75% or more P.O.C.","Less than $44000"
"72019","Barranquitas Municipio, Puerto Rico",28393,17036,34,0,0,0,0,28359,0.1,0,0,0,0,99.9,99.9,8720,6411,2309,73.52,26.48,615,5796,264,2045,879,7841,9.6,11.4,10.1,"75% or more P.O.C.","Less than $44000"
"72021","Bayamón Municipio, Puerto Rico",178192,26420,1193,253,0,142,0,176310,0.7,0.1,0,0.1,0,98.9,99.3,67476,45993,21483,68.16,31.84,2696,43297,1593,19890,4289,63187,5.9,7.4,6.4,"75% or more P.O.C.","Less than $44000"
"72023","Cabo Rojo Municipio, Puerto Rico",48487,16708,136,0,0,35,0,48301,0.3,0,0,0.1,0,99.6,99.7,15473,10007,5466,64.67,35.33,707,9300,397,5069,1104,14369,7.1,7.3,7.1,"75% or more P.O.C.","Less than $44000"
"72025","Caguas Municipio, Puerto Rico",128937,25136,1381,87,0,21,0,127119,1.1,0.1,0,0,0,98.6,98.9,48184,32936,15248,68.35,31.65,1859,31077,1000,14248,2859,45325,5.6,6.6,5.9,"75% or more P.O.C.","Less than $44000"
"72027","Camuy Municipio, Puerto Rico",31598,17000,326,23,0,0,0,31249,1,0.1,0,0,0,98.9,99,11394,8254,3140,72.44,27.56,499,7755,167,2973,666,10728,6,5.3,5.8,"75% or more P.O.C.","Less than $44000"
"72029","Canóvanas Municipio, Puerto Rico",45588,21267,30,16,0,36,0,45490,0.1,0,0,0.1,0,99.8,99.9,14643,10792,3851,73.7,26.3,794,9998,406,3445,1200,13443,7.4,10.5,8.2,"75% or more P.O.C.","Less than $44000"
"72031","Carolina Municipio, Puerto Rico",153779,29059,1080,250,0,261,0,151965,0.7,0.2,0,0.2,0,98.8,99.3,61909,43391,18518,70.09,29.91,2509,40882,1283,17235,3792,58117,5.8,6.9,6.1,"75% or more P.O.C.","Less than $44000"
"72033","Cataño Municipio, Puerto Rico",24271,17448,218,0,0,9,0,24026,0.9,0,0,0,0,99,99.1,8706,5243,3463,60.22,39.78,375,4868,271,3192,646,8060,7.2,7.8,7.4,"75% or more P.O.C.","Less than $44000"
"72035","Cayey Municipio, Puerto Rico",43785,22518,148,0,0,89,0,43521,0.3,0,0,0.2,0,99.4,99.7,16213,10290,5923,63.47,36.53,646,9644,280,5643,926,15287,6.3,4.7,5.7,"75% or more P.O.C.","Less than $44000"
"72037","Ceiba Municipio, Puerto Rico",11515,18309,136,13,0,0,0,11330,1.2,0.1,0,0,0,98.4,98.8,4224,3027,1197,71.66,28.34,127,2900,56,1141,183,4041,4.2,4.7,4.3,"75% or more P.O.C.","Less than $44000"
"72039","Ciales Municipio, Puerto Rico",16513,16867,142,0,0,0,0,16371,0.9,0,0,0,0,99.1,99.1,5831,4075,1756,69.89,30.11,419,3656,81,1675,500,5331,10.3,4.6,8.6,"75% or more P.O.C.","Less than $44000"
"72041","Cidra Municipio, Puerto Rico",39607,19726,136,61,0,64,0,39346,0.3,0.2,0,0.2,0,99.3,99.7,12942,8596,4346,66.42,33.58,427,8169,149,4197,576,12366,5,3.4,4.5,"75% or more P.O.C.","Less than $44000"
"72043","Coamo Municipio, Puerto Rico",38906,19692,244,11,0,0,0,38650,0.6,0,0,0,0,99.3,99.4,13104,10121,2983,77.24,22.76,732,9389,310,2673,1042,12062,7.2,10.4,8,"75% or more P.O.C.","Less than $44000"
"72045","Comerío Municipio, Puerto Rico",19224,13733,100,0,0,0,0,19109,0.5,0,0,0,0,99.4,99.5,5565,3106,2459,55.81,44.19,222,2884,126,2333,348,5217,7.1,5.1,6.3,"75% or more P.O.C.","Less than $44000"
"72047","Corozal Municipio, Puerto Rico",33500,15140,315,0,0,0,0,33153,0.9,0,0,0,0,99,99.1,10535,7992,2543,75.86,24.14,702,7290,399,2144,1101,9434,8.8,15.7,10.5,"75% or more P.O.C.","Less than $44000"
"72049","Culebra Municipio, Puerto Rico",1311,23333,97,0,5,11,0,1198,7.4,0,0.4,0.8,0,91.4,92.6,482,295,187,61.2,38.8,42,253,12,175,54,428,14.2,6.4,11.2,"75% or more P.O.C.","Less than $44000"
"72051","Dorado Municipio, Puerto Rico",36803,30732,773,0,0,36,0,35994,2.1,0,0,0.1,0,97.8,97.9,11602,8973,2629,77.34,22.66,586,8387,106,2523,692,10910,6.5,4,6,"75% or more P.O.C.","Less than $44000"
"72053","Fajardo Municipio, Puerto Rico",31111,19430,108,61,0,69,0,30812,0.3,0.2,0,0.2,0,99,99.7,12298,8080,4218,65.7,34.3,501,7579,331,3887,832,11466,6.2,7.8,6.8,"75% or more P.O.C.","Less than $44000"
"72054","Florida Municipio, Puerto Rico",11697,20442,133,0,0,0,0,11564,1.1,0,0,0,0,98.9,98.9,4271,3098,1173,72.54,27.46,270,2828,110,1063,380,3891,8.7,9.4,8.9,"75% or more P.O.C.","Less than $44000"
"72055","Guánica Municipio, Puerto Rico",16293,12995,133,0,0,0,0,16127,0.8,0,0,0,0,99,99.2,5515,3916,1599,71.01,28.99,310,3606,218,1381,528,4987,7.9,13.6,9.6,"75% or more P.O.C.","Less than $44000"
"72057","Guayama Municipio, Puerto Rico",40889,17261,315,79,0,0,0,40469,0.8,0.2,0,0,0,99,99.2,14022,10223,3799,72.91,27.09,609,9614,393,3406,1002,13020,6,10.3,7.1,"75% or more P.O.C.","Less than $44000"
"72059","Guayanilla Municipio, Puerto Rico",18514,17379,82,0,0,28,0,18403,0.4,0,0,0.2,0,99.4,99.6,6510,4676,1834,71.83,28.17,369,4307,232,1602,601,5909,7.9,12.6,9.2,"75% or more P.O.C.","Less than $44000"
"72061","Guaynabo Municipio, Puerto Rico",86937,35928,1104,111,0,29,0,85548,1.3,0.1,0,0,0,98.4,98.7,30758,22029,8729,71.62,28.38,1304,20725,367,8362,1671,29087,5.9,4.2,5.4,"75% or more P.O.C.","Less than $44000"
"72063","Gurabo Municipio, Puerto Rico",46910,35018,915,256,0,33,0,45436,2,0.5,0,0.1,0,96.9,98,14529,11952,2577,82.26,17.74,810,11142,223,2354,1033,13496,6.8,8.7,7.1,"75% or more P.O.C.","Less than $44000"
"72065","Hatillo Municipio, Puerto Rico",39950,17715,78,31,0,0,0,39803,0.2,0.1,0,0,0,99.6,99.8,14160,10516,3644,74.27,25.73,554,9962,190,3454,744,13416,5.3,5.2,5.3,"75% or more P.O.C.","Less than $44000"
"72067","Hormigueros Municipio, Puerto Rico",15943,19030,21,6,0,0,0,15916,0.1,0,0,0,0,99.8,99.9,6255,4580,1675,73.22,26.78,212,4368,45,1630,257,5998,4.6,2.7,4.1,"75% or more P.O.C.","Less than $44000"
"72069","Humacao Municipio, Puerto Rico",52507,20434,342,23,0,113,0,51960,0.7,0,0,0.2,0,99,99.3,17615,12709,4906,72.15,27.85,626,12083,435,4471,1061,16554,4.9,8.9,6,"75% or more P.O.C.","Less than $44000"
"72071","Isabela Municipio, Puerto Rico",41707,16540,355,77,17,0,0,41122,0.9,0.2,0,0,0,98.6,99.1,14670,9337,5333,63.65,36.35,549,8788,282,5051,831,13839,5.9,5.3,5.7,"75% or more P.O.C.","Less than $44000"
"72073","Jayuya Municipio, Puerto Rico",14539,14808,48,0,0,0,0,14491,0.3,0,0,0,0,99.7,99.7,4837,2798,2039,57.85,42.15,182,2616,217,1822,399,4438,6.5,10.6,8.2,"75% or more P.O.C.","Less than $44000"
"72075","Juana Díaz Municipio, Puerto Rico",46152,20657,81,6,8,0,0,46057,0.2,0,0,0,0,99.8,99.8,15408,11033,4375,71.61,28.39,1103,9930,406,3969,1509,13899,10,9.3,9.8,"75% or more P.O.C.","Less than $44000"
"72077","Juncos Municipio, Puerto Rico",38780,19605,240,0,0,0,0,38519,0.6,0,0,0,0,99.3,99.4,12558,8961,3597,71.36,28.64,540,8421,204,3393,744,11814,6,5.7,5.9,"75% or more P.O.C.","Less than $44000"
"72079","Lajas Municipio, Puerto Rico",22835,13992,121,0,0,0,0,22552,0.5,0,0,0,0,98.8,99.5,7665,4602,3063,60.04,39.96,215,4387,199,2864,414,7251,4.7,6.5,5.4,"75% or more P.O.C.","Less than $44000"
"72081","Lares Municipio, Puerto Rico",25696,16532,64,0,0,0,0,25560,0.2,0,0,0,0,99.5,99.8,9967,6318,3649,63.39,36.61,233,6085,423,3226,656,9311,3.7,11.6,6.6,"75% or more P.O.C.","Less than $44000"
"72083","Las Marías Municipio, Puerto Rico",8370,14135,35,0,0,0,0,8335,0.4,0,0,0,0,99.6,99.6,2708,1940,768,71.64,28.36,163,1777,14,754,177,2531,8.4,1.8,6.5,"75% or more P.O.C.","Less than $44000"
"72085","Las Piedras Municipio, Puerto Rico",37499,21667,25,43,0,0,0,37395,0.1,0.1,0,0,0,99.7,99.9,12376,9677,2699,78.19,21.81,653,9024,159,2540,812,11564,6.7,5.9,6.6,"75% or more P.O.C.","Less than $44000"
"72087","Loíza Municipio, Puerto Rico",25778,17852,14,20,0,40,0,25704,0.1,0.1,0,0.2,0,99.7,99.9,8508,6000,2508,70.52,29.48,554,5446,228,2280,782,7726,9.2,9.1,9.2,"75% or more P.O.C.","Less than $44000"
"72089","Luquillo Municipio, Puerto Rico",18224,21850,165,8,0,0,0,17992,0.9,0,0,0,0,98.7,99.1,6582,4684,1898,71.16,28.84,368,4316,104,1794,472,6110,7.9,5.5,7.2,"75% or more P.O.C.","Less than $44000"
"72091","Manatí Municipio, Puerto Rico",38836,18502,541,124,0,16,0,37985,1.4,0.3,0,0,0,97.8,98.6,14825,10877,3948,73.37,26.63,693,10184,250,3698,943,13882,6.4,6.3,6.4,"75% or more P.O.C.","Less than $44000"
"72093","Maricao Municipio, Puerto Rico",6075,12441,54,0,0,0,0,6021,0.9,0,0,0,0,99.1,99.1,1846,1370,476,74.21,25.79,103,1267,51,425,154,1692,7.5,10.7,8.3,"75% or more P.O.C.","Less than $44000"
"72095","Maunabo Municipio, Puerto Rico",10776,20844,125,0,0,0,0,10651,1.2,0,0,0,0,98.8,98.8,3833,2851,982,74.38,25.62,276,2575,98,884,374,3459,9.7,10,9.8,"75% or more P.O.C.","Less than $44000"
"72097","Mayagüez Municipio, Puerto Rico",75232,14236,406,67,0,34,2,74610,0.5,0.1,0,0,0,99.2,99.5,29682,16931,12751,57.04,42.96,861,16070,813,11938,1674,28008,5.1,6.4,5.6,"75% or more P.O.C.","Less than $44000"
"72099","Moca Municipio, Puerto Rico",36161,15037,113,51,0,29,0,35896,0.3,0.1,0,0.1,0,99.3,99.7,13374,8516,4858,63.68,36.32,520,7996,360,4498,880,12494,6.1,7.4,6.6,"75% or more P.O.C.","Less than $44000"
"72101","Morovis Municipio, Puerto Rico",30962,20941,94,18,17,0,0,30833,0.3,0.1,0.1,0,0,99.6,99.7,9645,6679,2966,69.25,30.75,458,6221,194,2772,652,8993,6.9,6.5,6.8,"75% or more P.O.C.","Less than $44000"
"72103","Naguabo Municipio, Puerto Rico",26075,19432,165,0,0,0,0,25875,0.6,0,0,0,0,99.2,99.4,8058,6246,1812,77.51,22.49,297,5949,117,1695,414,7644,4.8,6.5,5.1,"75% or more P.O.C.","Less than $44000"
"72105","Naranjito Municipio, Puerto Rico",28112,18883,7,0,0,0,0,28105,0,0,0,0,0,100,100,8424,6317,2107,74.99,25.01,520,5797,165,1942,685,7739,8.2,7.8,8.1,"75% or more P.O.C.","Less than $44000"
"72107","Orocovis Municipio, Puerto Rico",20982,15099,53,25,0,0,0,20904,0.3,0.1,0,0,0,99.6,99.7,6759,4479,2280,66.27,33.73,271,4208,131,2149,402,6357,6.1,5.7,5.9,"75% or more P.O.C.","Less than $44000"
"72109","Patillas Municipio, Puerto Rico",16929,16007,33,0,0,0,0,16896,0.2,0,0,0,0,99.8,99.8,6144,4025,2119,65.51,34.49,168,3857,170,1949,338,5806,4.2,8,5.5,"75% or more P.O.C.","Less than $44000"
"72111","Peñuelas Municipio, Puerto Rico",20383,16718,77,0,0,0,0,20281,0.4,0,0,0,0,99.5,99.6,6863,5093,1770,74.21,25.79,602,4491,91,1679,693,6170,11.8,5.1,10.1,"75% or more P.O.C.","Less than $44000"
"72113","Ponce Municipio, Puerto Rico",139671,17069,888,93,0,0,0,138570,0.6,0.1,0,0,0,99.2,99.4,52042,34454,17588,66.2,33.8,2397,32057,1109,16479,3506,48536,7,6.3,6.7,"75% or more P.O.C.","Less than $44000"
"72115","Quebradillas Municipio, Puerto Rico",23629,17473,216,93,0,0,0,23255,0.9,0.4,0,0,0,98.4,99.1,8083,5602,2481,69.31,30.69,325,5277,44,2437,369,7714,5.8,1.8,4.6,"75% or more P.O.C.","Less than $44000"
"72117","Rincón Municipio, Puerto Rico",14056,19907,1398,17,0,0,0,12417,9.9,0.1,0,0,0,88.3,90.1,5018,3562,1456,70.98,29.02,293,3269,77,1379,370,4648,8.2,5.3,7.4,"75% or more P.O.C.","Less than $44000"
"72119","Río Grande Municipio, Puerto Rico",49613,22669,334,46,0,0,0,49182,0.7,0.1,0,0,0,99.1,99.3,15635,11772,3863,75.29,24.71,848,10924,280,3583,1128,14507,7.2,7.2,7.2,"75% or more P.O.C.","Less than $44000"
"72121","Sabana Grande Municipio, Puerto Rico",22560,17319,58,2,0,0,0,22487,0.3,0,0,0,0,99.7,99.7,7061,5364,1697,75.97,24.03,244,5120,198,1499,442,6619,4.5,11.7,6.3,"75% or more P.O.C.","Less than $44000"
"72123","Salinas Municipio, Puerto Rico",28109,18189,16,18,2,35,0,28038,0.1,0.1,0,0.1,0,99.7,99.9,10036,8049,1987,80.2,19.8,572,7477,116,1871,688,9348,7.1,5.8,6.9,"75% or more P.O.C.","Less than $44000"
"72125","San Germán Municipio, Puerto Rico",31442,16486,151,0,5,0,0,31269,0.5,0,0,0,0,99.4,99.5,11722,8312,3410,70.91,29.09,419,7893,167,3243,586,11136,5,4.9,5,"75% or more P.O.C.","Less than $44000"
"72127","San Juan Municipio, Puerto Rico",335468,22710,5053,615,0,794,0,328580,1.5,0.2,0,0.2,0,97.9,98.5,142699,76855,65844,53.86,46.14,3886,72969,3079,62765,6965,135734,5.1,4.7,4.9,"75% or more P.O.C.","Less than $44000"
"72129","San Lorenzo Municipio, Puerto Rico",37209,19380,18,17,0,49,0,37125,0,0,0,0.1,0,99.8,100,13772,10395,3377,75.48,24.52,656,9739,170,3207,826,12946,6.3,5,6,"75% or more P.O.C.","Less than $44000"
"72131","San Sebastián Municipio, Puerto Rico",37120,15331,1005,0,0,13,0,35846,2.7,0,0,0,0,96.6,97.3,13313,8582,4731,64.46,35.54,312,8270,264,4467,576,12737,3.6,5.6,4.3,"75% or more P.O.C.","Less than $44000"
"72133","Santa Isabel Municipio, Puerto Rico",21757,19827,97,0,0,0,0,21660,0.4,0,0,0,0,99.6,99.6,7367,5714,1653,77.56,22.44,267,5447,62,1591,329,7038,4.7,3.8,4.5,"75% or more P.O.C.","Less than $44000"
"72135","Toa Alta Municipio, Puerto Rico",72864,28834,594,101,0,269,6,71860,0.8,0.1,0,0.4,0,98.6,99.2,22138,18421,3717,83.21,16.79,1550,16871,260,3457,1810,20328,8.4,7,8.2,"75% or more P.O.C.","Less than $44000"
"72137","Toa Baja Municipio, Puerto Rico",77810,25105,879,92,0,0,0,76770,1.1,0.1,0,0,0,98.7,98.9,27400,20235,7165,73.85,26.15,1556,18679,490,6675,2046,25354,7.7,6.8,7.5,"75% or more P.O.C.","Less than $44000"
"72139","Trujillo Alto Municipio, Puerto Rico",66338,32545,507,16,0,0,0,65772,0.8,0,0,0,0,99.1,99.2,23800,16131,7669,67.78,32.22,1262,14869,383,7286,1645,22155,7.8,5,6.9,"75% or more P.O.C.","Less than $44000"
"72141","Utuado Municipio, Puerto Rico",28676,15399,152,22,0,0,0,28458,0.5,0.1,0,0,0,99.2,99.5,9593,5810,3783,60.56,39.44,405,5405,180,3603,585,9008,7,4.8,6.1,"75% or more P.O.C.","Less than $44000"
"72143","Vega Alta Municipio, Puerto Rico",37106,20048,325,139,0,0,0,36521,0.9,0.4,0,0,0,98.4,99.1,11918,8192,3726,68.74,31.26,613,7579,388,3338,1001,10917,7.5,10.4,8.4,"75% or more P.O.C.","Less than $44000"
"72145","Vega Baja Municipio, Puerto Rico",52192,19617,1547,9,0,0,1,50491,3,0,0,0,0,96.7,97,18721,14917,3804,79.68,20.32,838,14079,216,3588,1054,17667,5.6,5.7,5.6,"75% or more P.O.C.","Less than $44000"
"72147","Vieques Municipio, Puerto Rico",8642,14936,438,0,0,0,0,8204,5.1,0,0,0,0,94.9,94.9,2258,1560,698,69.09,30.91,72,1488,125,573,197,2061,4.6,17.9,8.7,"75% or more P.O.C.","Less than $44000"
"72149","Villalba Municipio, Puerto Rico",22403,19877,38,18,0,0,0,22346,0.2,0.1,0,0,0,99.7,99.8,7908,5493,2415,69.46,30.54,482,5011,269,2146,751,7157,8.8,11.1,9.5,"75% or more P.O.C.","Less than $44000"
"72151","Yabucoa Municipio, Puerto Rico",33499,16295,16,0,0,11,0,33472,0,0,0,0,0,99.9,100,11541,8306,3235,71.97,28.03,419,7887,259,2976,678,10863,5,8,5.9,"75% or more P.O.C.","Less than $44000"
"72153","Yauco Municipio, Puerto Rico",35428,14743,117,16,0,6,0,35203,0.3,0,0,0,0,99.4,99.7,10990,8317,2673,75.68,24.32,479,7838,99,2574,578,10412,5.8,3.7,5.3,"75% or more P.O.C.","Less than $44000"
