"GEOID","NAME","total_pop","median_hh_income","white","black","ai_an","asian","hi_pi","hisp_lat","pct_white","pct_black","pct_ai_an","pct_asian","pct_hi_pi","pct_hisp_lat","pct_poc","total_hh","total_hh_owner","total_hh_renter","pct_owners","pct_renters","total_owner_more_than_4","total_owner_less_than_4","total_renter_more_than_4","total_renter_less_than_4","total_hh_more_than_4","total_hh_less_than_4","pct_owner_more_than_4","pct_renter_more_than_4","pct_total_hh_more_than_4","poc_bin","income_bin"
"06037101110","Census Tract 1011.10, Los Angeles County, California",4283,63534,2616,19,3,331,3,1188,61.1,0.4,0.1,7.7,0.1,27.7,38.9,1575,843,732,53.52,46.48,52,791,62,670,114,1461,6.2,8.5,7.2,"25% - 50% P.O.C.","$51000 - $70000"
"06037101122","Census Tract 1011.22, Los Angeles County, California",3405,90389,2882,74,15,220,0,147,84.6,2.2,0.4,6.5,0,4.3,15.4,1312,1072,240,81.71,18.29,38,1034,0,240,38,1274,3.5,0,2.9,"Less than 25% P.O.C.","$70000 - $95000"
"06037101210","Census Tract 1012.10, Los Angeles County, California",6347,44083,2986,198,0,486,0,2616,47,3.1,0,7.7,0,41.2,53,2297,401,1896,17.46,82.54,28,373,202,1694,230,2067,7,10.7,10,"50% - 75% P.O.C.","Less than $51000"
"06037101220","Census Tract 1012.20, Los Angeles County, California",3702,43713,1812,87,0,341,0,1364,48.9,2.4,0,9.2,0,36.8,51.1,1357,535,822,39.43,60.57,94,441,71,751,165,1192,17.6,8.6,12.2,"50% - 75% P.O.C.","Less than $51000"
"06037101300","Census Tract 1013, Los Angeles County, California",3884,81776,3126,205,0,194,0,297,80.5,5.3,0,5,0,7.6,19.5,1445,1255,190,86.85,13.15,73,1182,0,190,73,1372,5.8,0,5.1,"Less than 25% P.O.C.","$70000 - $95000"
"06037101400","Census Tract 1014, Los Angeles County, California",3458,75139,2271,9,13,409,0,591,65.7,0.3,0.4,11.8,0,17.1,34.3,1355,939,416,69.3,30.7,77,862,14,402,91,1264,8.2,3.4,6.7,"25% - 50% P.O.C.","$70000 - $95000"
"06037102103","Census Tract 1021.03, Los Angeles County, California",1763,76833,1106,25,0,224,0,355,62.7,1.4,0,12.7,0,20.1,37.3,692,461,231,66.62,33.38,33,428,5,226,38,654,7.2,2.2,5.5,"25% - 50% P.O.C.","$70000 - $95000"
"06037102104","Census Tract 1021.04, Los Angeles County, California",3721,80789,2568,73,0,351,8,512,69,2,0,9.4,0.2,13.8,31,1230,927,303,75.37,24.63,74,853,29,274,103,1127,8,9.6,8.4,"25% - 50% P.O.C.","$70000 - $95000"
"06037102105","Census Tract 1021.05, Los Angeles County, California",1905,57614,427,14,24,124,4,1283,22.4,0.7,1.3,6.5,0.2,67.3,77.6,559,302,257,54.03,45.97,88,214,17,240,105,454,29.1,6.6,18.8,"75% or more P.O.C.","$51000 - $70000"
"06037102107","Census Tract 1021.07, Los Angeles County, California",4349,109375,2605,69,6,398,0,1195,59.9,1.6,0.1,9.2,0,27.5,40.1,1345,957,388,71.15,28.85,115,842,74,314,189,1156,12,19.1,14.1,"25% - 50% P.O.C.","$95000 or more"
"06037103101","Census Tract 1031.01, Los Angeles County, California",2428,99875,1793,18,0,164,0,396,73.8,0.7,0,6.8,0,16.3,26.2,897,769,128,85.73,14.27,41,728,0,128,41,856,5.3,0,4.6,"25% - 50% P.O.C.","$95000 or more"
"06037103102","Census Tract 1031.02, Los Angeles County, California",4734,75276,2651,0,0,579,0,1322,56,0,0,12.2,0,27.9,44,1623,1195,428,73.63,26.37,121,1074,16,412,137,1486,10.1,3.7,8.4,"25% - 50% P.O.C.","$70000 - $95000"
"06037103200","Census Tract 1032, Los Angeles County, California",6349,84286,3865,105,0,437,0,1751,60.9,1.7,0,6.9,0,27.6,39.1,2226,1369,857,61.5,38.5,255,1114,17,840,272,1954,18.6,2,12.2,"25% - 50% P.O.C.","$70000 - $95000"
"06037103300","Census Tract 1033, Los Angeles County, California",3781,105909,2897,1,45,271,0,403,76.6,0,1.2,7.2,0,10.7,23.4,1288,1131,157,87.81,12.19,149,982,11,146,160,1128,13.2,7,12.4,"Less than 25% P.O.C.","$95000 or more"
"06037103400","Census Tract 1034, Los Angeles County, California",6416,89926,3472,154,0,1037,0,1573,54.1,2.4,0,16.2,0,24.5,45.9,2461,1562,899,63.47,36.53,73,1489,0,899,73,2388,4.7,0,3,"25% - 50% P.O.C.","$70000 - $95000"
"06037104103","Census Tract 1041.03, Los Angeles County, California",3431,97543,379,431,0,199,0,2401,11,12.6,0,5.8,0,70,89,849,695,154,81.86,18.14,165,530,46,108,211,638,23.7,29.9,24.9,"75% or more P.O.C.","$95000 or more"
"06037104105","Census Tract 1041.05, Los Angeles County, California",6054,54960,345,278,31,685,0,4482,5.7,4.6,0.5,11.3,0,74,94.3,1646,869,777,52.79,47.21,147,722,207,570,354,1292,16.9,26.6,21.5,"75% or more P.O.C.","$51000 - $70000"
"06037104108","Census Tract 1041.08, Los Angeles County, California",6001,51875,327,430,0,203,13,4982,5.4,7.2,0,3.4,0.2,83,94.6,1459,572,887,39.2,60.8,215,357,144,743,359,1100,37.6,16.2,24.6,"75% or more P.O.C.","$51000 - $70000"
"06037104124","Census Tract 1041.24, Los Angeles County, California",3875,77885,1224,491,22,323,0,1728,31.6,12.7,0.6,8.3,0,44.6,68.4,1232,948,284,76.95,23.05,108,840,10,274,118,1114,11.4,3.5,9.6,"50% - 75% P.O.C.","$70000 - $95000"
"06037104201","Census Tract 1042.01, Los Angeles County, California",4569,60129,56,401,31,0,0,4081,1.2,8.8,0.7,0,0,89.3,98.8,941,663,278,70.46,29.54,357,306,92,186,449,492,53.8,33.1,47.7,"75% or more P.O.C.","$51000 - $70000"
"06037104203","Census Tract 1042.03, Los Angeles County, California",5441,49609,82,446,0,68,0,4817,1.5,8.2,0,1.2,0,88.5,98.5,1169,578,591,49.44,50.56,281,297,203,388,484,685,48.6,34.3,41.4,"75% or more P.O.C.","Less than $51000"
"06037104204","Census Tract 1042.04, Los Angeles County, California",3679,59000,359,139,0,246,0,2870,9.8,3.8,0,6.7,0,78,90.2,764,496,268,64.92,35.08,171,325,111,157,282,482,34.5,41.4,36.9,"75% or more P.O.C.","$51000 - $70000"
"06037104310","Census Tract 1043.10, Los Angeles County, California",4962,74940,68,96,8,18,0,4744,1.4,1.9,0.2,0.4,0,95.6,98.6,849,635,214,74.79,25.21,268,367,132,82,400,449,42.2,61.7,47.1,"75% or more P.O.C.","$70000 - $95000"
"06037104320","Census Tract 1043.20, Los Angeles County, California",5292,56021,139,244,2,58,0,4718,2.6,4.6,0,1.1,0,89.2,97.4,1331,632,699,47.48,52.52,245,387,86,613,331,1000,38.8,12.3,24.9,"75% or more P.O.C.","$51000 - $70000"
"06037104401","Census Tract 1044.01, Los Angeles County, California",3270,69000,65,14,0,36,0,3155,2,0.4,0,1.1,0,96.5,98,664,410,254,61.75,38.25,221,189,98,156,319,345,53.9,38.6,48,"75% or more P.O.C.","$51000 - $70000"
"06037104403","Census Tract 1044.03, Los Angeles County, California",3341,60804,15,0,0,135,0,3191,0.4,0,0,4,0,95.5,99.6,665,415,250,62.41,37.59,200,215,157,93,357,308,48.2,62.8,53.7,"75% or more P.O.C.","$51000 - $70000"
"06037104404","Census Tract 1044.04, Los Angeles County, California",3084,56974,80,62,0,67,0,2867,2.6,2,0,2.2,0,93,97.4,678,309,369,45.58,54.42,132,177,115,254,247,431,42.7,31.2,36.4,"75% or more P.O.C.","$51000 - $70000"
"06037104500","Census Tract 1045, Los Angeles County, California",3025,64229,25,1,4,0,0,2991,0.8,0,0.1,0,0,98.9,99.2,625,465,160,74.4,25.6,169,296,77,83,246,379,36.3,48.1,39.4,"75% or more P.O.C.","$51000 - $70000"
"06037104610","Census Tract 1046.10, Los Angeles County, California",3386,61359,66,0,14,0,0,3291,1.9,0,0.4,0,0,97.2,98.1,703,452,251,64.3,35.7,232,220,67,184,299,404,51.3,26.7,42.5,"75% or more P.O.C.","$51000 - $70000"
"06037104620","Census Tract 1046.20, Los Angeles County, California",3528,64648,62,0,0,0,0,3466,1.8,0,0,0,0,98.2,98.2,661,406,255,61.42,38.58,200,206,168,87,368,293,49.3,65.9,55.7,"75% or more P.O.C.","$51000 - $70000"
"06037104701","Census Tract 1047.01, Los Angeles County, California",4402,35357,58,145,0,15,26,4158,1.3,3.3,0,0.3,0.6,94.5,98.7,926,201,725,21.71,78.29,85,116,373,352,458,468,42.3,51.4,49.5,"75% or more P.O.C.","Less than $51000"
"06037104703","Census Tract 1047.03, Los Angeles County, California",2174,41875,130,173,15,0,0,1856,6,8,0.7,0,0,85.4,94,572,213,359,37.24,62.76,63,150,96,263,159,413,29.6,26.7,27.8,"75% or more P.O.C.","Less than $51000"
"06037104704","Census Tract 1047.04, Los Angeles County, California",4321,43338,275,555,0,89,0,3377,6.4,12.8,0,2.1,0,78.2,93.6,1199,743,456,61.97,38.03,157,586,139,317,296,903,21.1,30.5,24.7,"75% or more P.O.C.","Less than $51000"
"06037104810","Census Tract 1048.10, Los Angeles County, California",5631,74149,188,12,23,47,0,5361,3.3,0.2,0.4,0.8,0,95.2,96.7,1095,797,298,72.79,27.21,349,448,160,138,509,586,43.8,53.7,46.5,"75% or more P.O.C.","$70000 - $95000"
"06037104821","Census Tract 1048.21, Los Angeles County, California",3551,70231,165,86,0,119,0,3170,4.6,2.4,0,3.4,0,89.3,95.4,795,422,373,53.08,46.92,189,233,107,266,296,499,44.8,28.7,37.2,"75% or more P.O.C.","$70000 - $95000"
"06037104822","Census Tract 1048.22, Los Angeles County, California",2839,60515,68,35,0,142,0,2573,2.4,1.2,0,5,0,90.6,97.6,625,209,416,33.44,66.56,108,101,152,264,260,365,51.7,36.5,41.6,"75% or more P.O.C.","$51000 - $70000"
"06037106010","Census Tract 1060.10, Los Angeles County, California",3093,89946,550,124,0,118,0,2227,17.8,4,0,3.8,0,72,82.2,959,729,230,76.02,23.98,151,578,9,221,160,799,20.7,3.9,16.7,"75% or more P.O.C.","$70000 - $95000"
"06037106020","Census Tract 1060.20, Los Angeles County, California",5420,79703,1056,54,0,71,0,4187,19.5,1,0,1.3,0,77.3,80.5,1451,1186,265,81.74,18.26,292,894,79,186,371,1080,24.6,29.8,25.6,"75% or more P.O.C.","$70000 - $95000"
"06037106111","Census Tract 1061.11, Los Angeles County, California",4191,95288,1136,185,22,422,0,2378,27.1,4.4,0.5,10.1,0,56.7,72.9,1298,1151,147,88.67,11.33,212,939,17,130,229,1069,18.4,11.6,17.6,"50% - 75% P.O.C.","$95000 or more"
"06037106112","Census Tract 1061.12, Los Angeles County, California",5611,95625,1030,158,0,432,19,3895,18.4,2.8,0,7.7,0.3,69.4,81.6,1447,1184,263,81.82,18.18,243,941,53,210,296,1151,20.5,20.2,20.5,"75% or more P.O.C.","$95000 or more"
"06037106113","Census Tract 1061.13, Los Angeles County, California",3697,96667,571,140,27,309,0,2650,15.4,3.8,0.7,8.4,0,71.7,84.6,982,784,198,79.84,20.16,134,650,50,148,184,798,17.1,25.3,18.7,"75% or more P.O.C.","$95000 or more"
"06037106114","Census Tract 1061.14, Los Angeles County, California",6324,58194,227,208,0,285,0,5583,3.6,3.3,0,4.5,0,88.3,96.4,1594,703,891,44.1,55.9,149,554,263,628,412,1182,21.2,29.5,25.8,"75% or more P.O.C.","$51000 - $70000"
"06037106403","Census Tract 1064.03, Los Angeles County, California",3667,72604,280,62,0,7,0,3318,7.6,1.7,0,0.2,0,90.5,92.4,828,664,164,80.19,19.81,254,410,47,117,301,527,38.3,28.7,36.4,"75% or more P.O.C.","$70000 - $95000"
"06037106405","Census Tract 1064.05, Los Angeles County, California",4758,59352,808,308,0,65,0,3540,17,6.5,0,1.4,0,74.4,83,1184,468,716,39.53,60.47,115,353,144,572,259,925,24.6,20.1,21.9,"75% or more P.O.C.","$51000 - $70000"
"06037106406","Census Tract 1064.06, Los Angeles County, California",5839,85115,1238,60,0,418,0,4014,21.2,1,0,7.2,0,68.7,78.8,1660,1268,392,76.39,23.61,337,931,89,303,426,1234,26.6,22.7,25.7,"75% or more P.O.C.","$70000 - $95000"
"06037106407","Census Tract 1064.07, Los Angeles County, California",3119,34327,388,492,0,133,0,2073,12.4,15.8,0,4.3,0,66.5,87.6,913,204,709,22.34,77.66,37,167,145,564,182,731,18.1,20.5,19.9,"75% or more P.O.C.","Less than $51000"
"06037106408","Census Tract 1064.08, Los Angeles County, California",3667,60199,149,92,0,119,0,3295,4.1,2.5,0,3.2,0,89.9,95.9,956,179,777,18.72,81.28,54,125,169,608,223,733,30.2,21.8,23.3,"75% or more P.O.C.","$51000 - $70000"
"06037106510","Census Tract 1065.10, Los Angeles County, California",5618,85521,778,269,0,438,0,4077,13.8,4.8,0,7.8,0,72.6,86.2,1635,1129,506,69.05,30.95,118,1011,115,391,233,1402,10.5,22.7,14.3,"75% or more P.O.C.","$70000 - $95000"
"06037106520","Census Tract 1065.20, Los Angeles County, California",5920,63924,502,16,0,126,0,5264,8.5,0.3,0,2.1,0,88.9,91.5,1433,983,450,68.6,31.4,265,718,172,278,437,996,27,38.2,30.5,"75% or more P.O.C.","$51000 - $70000"
"06037106603","Census Tract 1066.03, Los Angeles County, California",3156,112404,1663,70,0,731,37,548,52.7,2.2,0,23.2,1.2,17.4,47.3,990,867,123,87.58,12.42,114,753,38,85,152,838,13.1,30.9,15.4,"25% - 50% P.O.C.","$95000 or more"
"06037106604","Census Tract 1066.04, Los Angeles County, California",5068,60350,250,55,0,108,1,4623,4.9,1.1,0,2.1,0,91.2,95.1,1230,587,643,47.72,52.28,194,393,217,426,411,819,33,33.7,33.4,"75% or more P.O.C.","$51000 - $70000"
"06037106641","Census Tract 1066.41, Los Angeles County, California",2372,110357,1586,6,0,455,0,199,66.9,0.3,0,19.2,0,8.4,33.1,794,717,77,90.3,9.7,82,635,6,71,88,706,11.4,7.8,11.1,"25% - 50% P.O.C.","$95000 or more"
"06037106642","Census Tract 1066.42, Los Angeles County, California",2961,109063,1574,170,0,338,0,693,53.2,5.7,0,11.4,0,23.4,46.8,1034,933,101,90.23,9.77,68,865,26,75,94,940,7.3,25.7,9.1,"25% - 50% P.O.C.","$95000 or more"
"06037106643","Census Tract 1066.43, Los Angeles County, California",4577,164125,2796,82,20,978,0,618,61.1,1.8,0.4,21.4,0,13.5,38.9,1355,1229,126,90.7,9.3,144,1085,1,125,145,1210,11.7,0.8,10.7,"25% - 50% P.O.C.","$95000 or more"
"06037106645","Census Tract 1066.45, Los Angeles County, California",3650,113940,2245,56,14,659,0,624,61.5,1.5,0.4,18.1,0,17.1,38.5,1135,1036,99,91.28,8.72,183,853,34,65,217,918,17.7,34.3,19.1,"25% - 50% P.O.C.","$95000 or more"
"06037106646","Census Tract 1066.46, Los Angeles County, California",3161,110734,1401,157,4,575,16,899,44.3,5,0.1,18.2,0.5,28.4,55.7,967,870,97,89.97,10.03,115,755,10,87,125,842,13.2,10.3,12.9,"50% - 75% P.O.C.","$95000 or more"
"06037106648","Census Tract 1066.48, Los Angeles County, California",4546,68426,128,12,0,6,0,4394,2.8,0.3,0,0.1,0,96.7,97.2,1084,475,609,43.82,56.18,158,317,194,415,352,732,33.3,31.9,32.5,"75% or more P.O.C.","$51000 - $70000"
"06037106649","Census Tract 1066.49, Los Angeles County, California",2661,87039,221,70,7,501,5,1766,8.3,2.6,0.3,18.8,0.2,66.4,91.7,697,531,166,76.18,23.82,134,397,43,123,177,520,25.2,25.9,25.4,"75% or more P.O.C.","$70000 - $95000"
"06037107010","Census Tract 1070.10, Los Angeles County, California",3141,69934,88,14,8,20,0,2997,2.8,0.4,0.3,0.6,0,95.4,97.2,735,561,174,76.33,23.67,274,287,57,117,331,404,48.8,32.8,45,"75% or more P.O.C.","$51000 - $70000"
"06037107020","Census Tract 1070.20, Los Angeles County, California",5317,84289,217,18,0,418,0,4648,4.1,0.3,0,7.9,0,87.4,95.9,1229,904,325,73.56,26.44,277,627,137,188,414,815,30.6,42.2,33.7,"75% or more P.O.C.","$70000 - $95000"
"06037108101","Census Tract 1081.01, Los Angeles County, California",2327,121563,1328,83,0,513,0,323,57.1,3.6,0,22,0,13.9,42.9,777,645,132,83.01,16.99,35,610,34,98,69,708,5.4,25.8,8.9,"25% - 50% P.O.C.","$95000 or more"
"06037108102","Census Tract 1081.02, Los Angeles County, California",3552,100938,1932,130,0,1109,0,322,54.4,3.7,0,31.2,0,9.1,45.6,1217,1001,216,82.25,17.75,79,922,55,161,134,1083,7.9,25.5,11,"25% - 50% P.O.C.","$95000 or more"
"06037108103","Census Tract 1081.03, Los Angeles County, California",3099,146932,1789,0,10,824,20,356,57.7,0,0.3,26.6,0.6,11.5,42.3,1016,927,89,91.24,8.76,86,841,0,89,86,930,9.3,0,8.5,"25% - 50% P.O.C.","$95000 or more"
"06037108104","Census Tract 1081.04, Los Angeles County, California",1836,152321,930,96,0,644,0,136,50.7,5.2,0,35.1,0,7.4,49.3,570,480,90,84.21,15.79,61,419,41,49,102,468,12.7,45.6,17.9,"25% - 50% P.O.C.","$95000 or more"
"06037108201","Census Tract 1082.01, Los Angeles County, California",5460,129688,2001,357,0,2544,0,306,36.6,6.5,0,46.6,0,5.6,63.4,1847,1497,350,81.05,18.95,99,1398,16,334,115,1732,6.6,4.6,6.2,"50% - 75% P.O.C.","$95000 or more"
"06037108202","Census Tract 1082.02, Los Angeles County, California",7487,97188,2482,588,34,3566,0,505,33.2,7.9,0.5,47.6,0,6.7,66.8,2723,1897,826,69.67,30.33,265,1632,38,788,303,2420,14,4.6,11.1,"50% - 75% P.O.C.","$95000 or more"
"06037109100","Census Tract 1091, Los Angeles County, California",2797,67750,681,8,7,330,0,1771,24.3,0.3,0.3,11.8,0,63.3,75.7,772,576,196,74.61,25.39,153,423,42,154,195,577,26.6,21.4,25.3,"75% or more P.O.C.","$51000 - $70000"
"06037109200","Census Tract 1092, Los Angeles County, California",2846,117857,969,36,0,713,0,1082,34,1.3,0,25.1,0,38,66,944,748,196,79.24,20.76,133,615,0,196,133,811,17.8,0,14.1,"50% - 75% P.O.C.","$95000 or more"
"06037109300","Census Tract 1093, Los Angeles County, California",2962,86316,1054,26,0,503,0,1297,35.6,0.9,0,17,0,43.8,64.4,920,767,153,83.37,16.63,75,692,7,146,82,838,9.8,4.6,8.9,"50% - 75% P.O.C.","$70000 - $95000"
"06037109400","Census Tract 1094, Los Angeles County, California",3903,82215,539,33,0,127,253,2898,13.8,0.8,0,3.3,6.5,74.3,86.2,1113,794,319,71.34,28.66,196,598,54,265,250,863,24.7,16.9,22.5,"75% or more P.O.C.","$70000 - $95000"
"06037109500","Census Tract 1095, Los Angeles County, California",4832,33387,174,65,0,111,0,4482,3.6,1.3,0,2.3,0,92.8,96.4,1038,590,448,56.84,43.16,251,339,162,286,413,625,42.5,36.2,39.8,"75% or more P.O.C.","Less than $51000"
"06037109601","Census Tract 1096.01, Los Angeles County, California",4945,93778,784,50,0,525,0,3453,15.9,1,0,10.6,0,69.8,84.1,1281,1085,196,84.7,15.3,301,784,54,142,355,926,27.7,27.6,27.7,"75% or more P.O.C.","$70000 - $95000"
"06037109603","Census Tract 1096.03, Los Angeles County, California",4297,56970,500,40,0,622,0,3042,11.6,0.9,0,14.5,0,70.8,88.4,1314,736,578,56.01,43.99,174,562,101,477,275,1039,23.6,17.5,20.9,"75% or more P.O.C.","$51000 - $70000"
"06037109604","Census Tract 1096.04, Los Angeles County, California",3195,92500,531,27,28,381,0,2198,16.6,0.8,0.9,11.9,0,68.8,83.4,918,734,184,79.96,20.04,183,551,0,184,183,735,24.9,0,19.9,"75% or more P.O.C.","$70000 - $95000"
"06037109700","Census Tract 1097, Los Angeles County, California",4616,101709,1464,467,0,678,0,1949,31.7,10.1,0,14.7,0,42.2,68.3,1366,1147,219,83.97,16.03,171,976,54,165,225,1141,14.9,24.7,16.5,"50% - 75% P.O.C.","$95000 or more"
"06037109800","Census Tract 1098, Los Angeles County, California",5534,92356,1351,131,0,778,0,3209,24.4,2.4,0,14.1,0,58,75.6,1451,1066,385,73.47,26.53,259,807,105,280,364,1087,24.3,27.3,25.1,"75% or more P.O.C.","$70000 - $95000"
"06037111100","Census Tract 1111, Los Angeles County, California",3179,91648,986,85,5,457,0,1581,31,2.7,0.2,14.4,0,49.7,69,941,735,206,78.11,21.89,130,605,35,171,165,776,17.7,17,17.5,"50% - 75% P.O.C.","$70000 - $95000"
"06037111201","Census Tract 1112.01, Los Angeles County, California",3628,90341,1807,40,0,562,0,1201,49.8,1.1,0,15.5,0,33.1,50.2,1121,987,134,88.05,11.95,209,778,26,108,235,886,21.2,19.4,21,"50% - 75% P.O.C.","$70000 - $95000"
"06037111202","Census Tract 1112.02, Los Angeles County, California",5169,84240,2649,102,9,739,0,1574,51.2,2,0.2,14.3,0,30.5,48.8,1763,1243,520,70.5,29.5,168,1075,32,488,200,1563,13.5,6.2,11.3,"25% - 50% P.O.C.","$70000 - $95000"
"06037111204","Census Tract 1112.04, Los Angeles County, California",6114,154038,3160,207,10,1447,0,1063,51.7,3.4,0.2,23.7,0,17.4,48.3,1956,1878,78,96.01,3.99,308,1570,27,51,335,1621,16.4,34.6,17.1,"25% - 50% P.O.C.","$95000 or more"
"06037111205","Census Tract 1112.05, Los Angeles County, California",3869,77351,1070,263,0,1425,15,968,27.7,6.8,0,36.8,0.4,25,72.3,1327,706,621,53.2,46.8,33,673,162,459,195,1132,4.7,26.1,14.7,"50% - 75% P.O.C.","$70000 - $95000"
"06037111206","Census Tract 1112.06, Los Angeles County, California",4379,114275,2140,48,14,676,0,1285,48.9,1.1,0.3,15.4,0,29.3,51.1,1503,1412,91,93.95,6.05,206,1206,11,80,217,1286,14.6,12.1,14.4,"50% - 75% P.O.C.","$95000 or more"
"06037111301","Census Tract 1113.01, Los Angeles County, California",7552,66861,2468,443,0,2089,0,2240,32.7,5.9,0,27.7,0,29.7,67.3,2773,892,1881,32.17,67.83,81,811,194,1687,275,2498,9.1,10.3,9.9,"50% - 75% P.O.C.","$51000 - $70000"
"06037111302","Census Tract 1113.02, Los Angeles County, California",5163,62865,2145,477,0,1237,5,1236,41.5,9.2,0,24,0.1,23.9,58.5,1801,906,895,50.31,49.69,115,791,82,813,197,1604,12.7,9.2,10.9,"50% - 75% P.O.C.","$51000 - $70000"
"06037111400","Census Tract 1114, Los Angeles County, California",8735,61467,3376,390,0,1227,0,3724,38.6,4.5,0,14,0,42.6,61.4,2888,1087,1801,37.64,62.36,170,917,137,1664,307,2581,15.6,7.6,10.6,"50% - 75% P.O.C.","$51000 - $70000"
"06037113101","Census Tract 1131.01, Los Angeles County, California",3719,106000,2082,134,0,649,0,854,56,3.6,0,17.5,0,23,44,1112,898,214,80.76,19.24,145,753,65,149,210,902,16.1,30.4,18.9,"25% - 50% P.O.C.","$95000 or more"
"06037113102","Census Tract 1131.02, Los Angeles County, California",3021,163021,2133,63,0,321,11,472,70.6,2.1,0,10.6,0.4,15.6,29.4,981,937,44,95.51,4.49,180,757,0,44,180,801,19.2,0,18.3,"25% - 50% P.O.C.","$95000 or more"
"06037113211","Census Tract 1132.11, Los Angeles County, California",4109,91094,3069,106,0,569,0,323,74.7,2.6,0,13.8,0,7.9,25.3,1678,1382,296,82.36,17.64,91,1291,0,296,91,1587,6.6,0,5.4,"25% - 50% P.O.C.","$70000 - $95000"
"06037113212","Census Tract 1132.12, Los Angeles County, California",3494,84429,1306,131,8,906,0,1035,37.4,3.7,0.2,25.9,0,29.6,62.6,1084,626,458,57.75,42.25,25,601,38,420,63,1021,4,8.3,5.8,"50% - 75% P.O.C.","$70000 - $95000"
"06037113213","Census Tract 1132.13, Los Angeles County, California",5248,91544,1762,311,55,1115,0,1532,33.6,5.9,1,21.2,0,29.2,66.4,1695,1026,669,60.53,39.47,120,906,15,654,135,1560,11.7,2.2,8,"50% - 75% P.O.C.","$70000 - $95000"
"06037113231","Census Tract 1132.31, Los Angeles County, California",2303,112500,1449,60,0,253,0,293,62.9,2.6,0,11,0,12.7,37.1,816,665,151,81.5,18.5,63,602,20,131,83,733,9.5,13.2,10.2,"25% - 50% P.O.C.","$95000 or more"
"06037113232","Census Tract 1132.32, Los Angeles County, California",4315,113079,2625,128,0,692,0,663,60.8,3,0,16,0,15.4,39.2,1399,1202,197,85.92,14.08,58,1144,65,132,123,1276,4.8,33,8.8,"25% - 50% P.O.C.","$95000 or more"
"06037113233","Census Tract 1132.33, Los Angeles County, California",7345,46474,1405,482,0,1055,0,4299,19.1,6.6,0,14.4,0,58.5,80.9,2534,622,1912,24.55,75.45,99,523,123,1789,222,2312,15.9,6.4,8.8,"75% or more P.O.C.","Less than $51000"
"06037113234","Census Tract 1132.34, Los Angeles County, California",4823,59598,1485,209,0,865,0,2165,30.8,4.3,0,17.9,0,44.9,69.2,1508,746,762,49.47,50.53,72,674,201,561,273,1235,9.7,26.4,18.1,"50% - 75% P.O.C.","$51000 - $70000"
"06037113235","Census Tract 1132.35, Los Angeles County, California",1824,89792,982,116,39,63,0,391,53.8,6.4,2.1,3.5,0,21.4,46.2,711,473,238,66.53,33.47,8,465,37,201,45,666,1.7,15.5,6.3,"25% - 50% P.O.C.","$70000 - $95000"
"06037113237","Census Tract 1132.37, Los Angeles County, California",4194,82024,1756,646,0,478,0,1086,41.9,15.4,0,11.4,0,25.9,58.1,1458,940,518,64.47,35.53,113,827,31,487,144,1314,12,6,9.9,"50% - 75% P.O.C.","$70000 - $95000"
"06037113301","Census Tract 1133.01, Los Angeles County, California",3509,66793,1928,200,2,605,39,655,54.9,5.7,0.1,17.2,1.1,18.7,45.1,1287,605,682,47.01,52.99,53,552,74,608,127,1160,8.8,10.9,9.9,"25% - 50% P.O.C.","$51000 - $70000"
"06037113303","Census Tract 1133.03, Los Angeles County, California",4191,93656,2434,66,16,459,0,1128,58.1,1.6,0.4,11,0,26.9,41.9,1407,1234,173,87.7,12.3,83,1151,35,138,118,1289,6.7,20.2,8.4,"25% - 50% P.O.C.","$70000 - $95000"
"06037113321","Census Tract 1133.21, Los Angeles County, California",6180,76897,2427,540,0,887,84,2001,39.3,8.7,0,14.4,1.4,32.4,60.7,2544,563,1981,22.13,77.87,21,542,87,1894,108,2436,3.7,4.4,4.2,"50% - 75% P.O.C.","$70000 - $95000"
"06037113322","Census Tract 1133.22, Los Angeles County, California",4572,94983,2012,84,0,885,0,1453,44,1.8,0,19.4,0,31.8,56,1449,1150,299,79.37,20.63,150,1000,23,276,173,1276,13,7.7,11.9,"50% - 75% P.O.C.","$70000 - $95000"
"06037113401","Census Tract 1134.01, Los Angeles County, California",6550,86101,1799,132,0,1021,5,3161,27.5,2,0,15.6,0.1,48.3,72.5,1972,1372,600,69.57,30.43,177,1195,100,500,277,1695,12.9,16.7,14,"50% - 75% P.O.C.","$70000 - $95000"
"06037113421","Census Tract 1134.21, Los Angeles County, California",6879,65060,1386,398,0,969,31,3985,20.1,5.8,0,14.1,0.5,57.9,79.9,2127,398,1729,18.71,81.29,57,341,362,1367,419,1708,14.3,20.9,19.7,"75% or more P.O.C.","$51000 - $70000"
"06037113422","Census Tract 1134.22, Los Angeles County, California",6306,75109,2181,293,31,925,0,2672,34.6,4.6,0.5,14.7,0,42.4,65.4,2101,1135,966,54.02,45.98,141,994,73,893,214,1887,12.4,7.6,10.2,"50% - 75% P.O.C.","$70000 - $95000"
"06037115101","Census Tract 1151.01, Los Angeles County, California",5083,141711,2755,261,0,581,0,1351,54.2,5.1,0,11.4,0,26.6,45.8,1656,1542,114,93.12,6.88,297,1245,0,114,297,1359,19.3,0,17.9,"25% - 50% P.O.C.","$95000 or more"
"06037115103","Census Tract 1151.03, Los Angeles County, California",3381,43958,876,467,0,605,27,1243,25.9,13.8,0,17.9,0.8,36.8,74.1,28,0,28,0,100,0,0,0,28,0,28,NA,0,0,"50% - 75% P.O.C.","Less than $51000"
"06037115104","Census Tract 1151.04, Los Angeles County, California",4377,54861,1448,656,0,926,0,1229,33.1,15,0,21.2,0,28.1,66.9,1915,481,1434,25.12,74.88,30,451,61,1373,91,1824,6.2,4.3,4.8,"50% - 75% P.O.C.","$51000 - $70000"
"06037115201","Census Tract 1152.01, Los Angeles County, California",6647,65208,3427,156,0,951,0,1912,51.6,2.3,0,14.3,0,28.8,48.4,2681,761,1920,28.38,71.62,33,728,86,1834,119,2562,4.3,4.5,4.4,"25% - 50% P.O.C.","$51000 - $70000"
"06037115202","Census Tract 1152.02, Los Angeles County, California",5684,65125,1832,414,0,848,0,2275,32.2,7.3,0,14.9,0,40,67.8,1913,846,1067,44.22,55.78,142,704,136,931,278,1635,16.8,12.7,14.5,"50% - 75% P.O.C.","$51000 - $70000"
"06037115301","Census Tract 1153.01, Los Angeles County, California",4524,94279,2296,150,1,1096,0,881,50.8,3.3,0,24.2,0,19.5,49.2,1653,917,736,55.47,44.53,144,773,38,698,182,1471,15.7,5.2,11,"25% - 50% P.O.C.","$70000 - $95000"
"06037115302","Census Tract 1153.02, Los Angeles County, California",3957,45549,524,224,0,388,0,2791,13.2,5.7,0,9.8,0,70.5,86.8,1056,357,699,33.81,66.19,71,286,251,448,322,734,19.9,35.9,30.5,"75% or more P.O.C.","Less than $51000"
"06037115401","Census Tract 1154.01, Los Angeles County, California",6373,71646,2013,253,0,729,0,3219,31.6,4,0,11.4,0,50.5,68.4,1933,750,1183,38.8,61.2,102,648,183,1000,285,1648,13.6,15.5,14.7,"50% - 75% P.O.C.","$70000 - $95000"
"06037115403","Census Tract 1154.03, Los Angeles County, California",3583,54407,783,227,0,507,0,1975,21.9,6.3,0,14.2,0,55.1,78.1,1038,349,689,33.62,66.38,99,250,115,574,214,824,28.4,16.7,20.6,"75% or more P.O.C.","$51000 - $70000"
"06037115404","Census Tract 1154.04, Los Angeles County, California",2800,66136,688,197,0,474,35,1333,24.6,7,0,16.9,1.2,47.6,75.4,860,400,460,46.51,53.49,78,322,50,410,128,732,19.5,10.9,14.9,"75% or more P.O.C.","$51000 - $70000"
"06037117101","Census Tract 1171.01, Los Angeles County, California",5224,90750,433,434,0,2069,0,2049,8.3,8.3,0,39.6,0,39.2,91.7,1465,1012,453,69.08,30.92,126,886,142,311,268,1197,12.5,31.3,18.3,"75% or more P.O.C.","$70000 - $95000"
"06037117102","Census Tract 1171.02, Los Angeles County, California",2861,69500,637,59,5,331,0,1778,22.3,2.1,0.2,11.6,0,62.1,77.7,802,560,242,69.83,30.17,122,438,37,205,159,643,21.8,15.3,19.8,"75% or more P.O.C.","$51000 - $70000"
"06037117201","Census Tract 1172.01, Los Angeles County, California",5191,61335,456,290,0,673,0,3498,8.8,5.6,0,13,0,67.4,91.2,1239,393,846,31.72,68.28,165,228,309,537,474,765,42,36.5,38.3,"75% or more P.O.C.","$51000 - $70000"
"06037117202","Census Tract 1172.02, Los Angeles County, California",2633,100326,761,245,0,719,0,805,28.9,9.3,0,27.3,0,30.6,71.1,814,648,166,79.61,20.39,134,514,22,144,156,658,20.7,13.3,19.2,"50% - 75% P.O.C.","$95000 or more"
"06037117301","Census Tract 1173.01, Los Angeles County, California",3910,97634,1608,94,0,714,0,1356,41.1,2.4,0,18.3,0,34.7,58.9,1189,934,255,78.55,21.45,89,845,67,188,156,1033,9.5,26.3,13.1,"50% - 75% P.O.C.","$95000 or more"
"06037117302","Census Tract 1173.02, Los Angeles County, California",5229,102917,2161,583,13,850,113,1328,41.3,11.1,0.2,16.3,2.2,25.4,58.7,1728,1340,388,77.55,22.45,152,1188,56,332,208,1520,11.3,14.4,12,"50% - 75% P.O.C.","$95000 or more"
"06037117303","Census Tract 1173.03, Los Angeles County, California",3754,83931,1197,148,3,610,0,1696,31.9,3.9,0.1,16.2,0,45.2,68.1,1049,858,191,81.79,18.21,138,720,33,158,171,878,16.1,17.3,16.3,"50% - 75% P.O.C.","$70000 - $95000"
"06037117404","Census Tract 1174.04, Los Angeles County, California",5324,107981,1989,66,0,815,0,2241,37.4,1.2,0,15.3,0,42.1,62.6,1362,989,373,72.61,27.39,203,786,122,251,325,1037,20.5,32.7,23.9,"50% - 75% P.O.C.","$95000 or more"
"06037117405","Census Tract 1174.05, Los Angeles County, California",3574,36538,50,110,0,99,0,3315,1.4,3.1,0,2.8,0,92.8,98.6,876,43,833,4.91,95.09,0,43,277,556,277,599,0,33.3,31.6,"75% or more P.O.C.","Less than $51000"
"06037117407","Census Tract 1174.07, Los Angeles County, California",3836,33480,17,49,0,90,0,3662,0.4,1.3,0,2.3,0,95.5,99.6,959,13,946,1.36,98.64,0,13,318,628,318,641,0,33.6,33.2,"75% or more P.O.C.","Less than $51000"
"06037117408","Census Tract 1174.08, Los Angeles County, California",3073,36250,116,145,0,333,0,2455,3.8,4.7,0,10.8,0,79.9,96.2,858,114,744,13.29,86.71,23,91,152,592,175,683,20.2,20.4,20.4,"75% or more P.O.C.","Less than $51000"
"06037117510","Census Tract 1175.10, Los Angeles County, California",3687,46838,348,128,0,274,0,2937,9.4,3.5,0,7.4,0,79.7,90.6,968,143,825,14.77,85.23,32,111,309,516,341,627,22.4,37.5,35.2,"75% or more P.O.C.","Less than $51000"
"06037117520","Census Tract 1175.20, Los Angeles County, California",4168,36003,170,239,0,307,0,3430,4.1,5.7,0,7.4,0,82.3,95.9,1077,175,902,16.25,83.75,49,126,262,640,311,766,28,29,28.9,"75% or more P.O.C.","Less than $51000"
"06037117530","Census Tract 1175.30, Los Angeles County, California",6742,55483,377,125,0,740,21,5372,5.6,1.9,0,11,0.3,79.7,94.4,1649,387,1262,23.47,76.53,150,237,483,779,633,1016,38.8,38.3,38.4,"75% or more P.O.C.","$51000 - $70000"
"06037119001","Census Tract 1190.01, Los Angeles County, California",4435,85758,578,14,25,599,0,3160,13,0.3,0.6,13.5,0,71.3,87,994,729,265,73.34,26.66,234,495,129,136,363,631,32.1,48.7,36.5,"75% or more P.O.C.","$70000 - $95000"
"06037119002","Census Tract 1190.02, Los Angeles County, California",7976,80664,410,89,0,766,0,6644,5.1,1.1,0,9.6,0,83.3,94.9,1736,1169,567,67.34,32.66,613,556,167,400,780,956,52.4,29.5,44.9,"75% or more P.O.C.","$70000 - $95000"
"06037119201","Census Tract 1192.01, Los Angeles County, California",4547,91111,219,30,40,266,0,3986,4.8,0.7,0.9,5.9,0,87.7,95.2,882,678,204,76.87,23.13,346,332,97,107,443,439,51,47.5,50.2,"75% or more P.O.C.","$70000 - $95000"
"06037119202","Census Tract 1192.02, Los Angeles County, California",4759,67500,174,35,26,296,0,4226,3.7,0.7,0.5,6.2,0,88.8,96.3,1056,776,280,73.48,26.52,273,503,157,123,430,626,35.2,56.1,40.7,"75% or more P.O.C.","$51000 - $70000"
"06037119310","Census Tract 1193.10, Los Angeles County, California",4087,47959,573,174,6,648,0,2686,14,4.3,0.1,15.9,0,65.7,86,1234,592,642,47.97,52.03,185,407,106,536,291,943,31.2,16.5,23.6,"75% or more P.O.C.","Less than $51000"
"06037119320","Census Tract 1193.20, Los Angeles County, California",4906,72813,270,296,0,861,0,3426,5.5,6,0,17.5,0,69.8,94.5,1235,361,874,29.23,70.77,132,229,139,735,271,964,36.6,15.9,21.9,"75% or more P.O.C.","$70000 - $95000"
"06037119340","Census Tract 1193.40, Los Angeles County, California",4264,30817,4,158,0,103,0,3999,0.1,3.7,0,2.4,0,93.8,99.9,1027,12,1015,1.17,98.83,0,12,325,690,325,702,0,32,31.6,"75% or more P.O.C.","Less than $51000"
"06037119341","Census Tract 1193.41, Los Angeles County, California",2890,51083,401,137,0,772,0,1560,13.9,4.7,0,26.7,0,54,86.1,822,269,553,32.73,67.27,71,198,91,462,162,660,26.4,16.5,19.7,"75% or more P.O.C.","$51000 - $70000"
"06037119342","Census Tract 1193.42, Los Angeles County, California",2911,58611,203,58,19,378,0,2249,7,2,0.7,13,0,77.3,93,758,362,396,47.76,52.24,101,261,122,274,223,535,27.9,30.8,29.4,"75% or more P.O.C.","$51000 - $70000"
"06037119400","Census Tract 1194, Los Angeles County, California",5499,83333,397,74,0,485,0,4470,7.2,1.3,0,8.8,0,81.3,92.8,1160,938,222,80.86,19.14,383,555,90,132,473,687,40.8,40.5,40.8,"75% or more P.O.C.","$70000 - $95000"
"06037119700","Census Tract 1197, Los Angeles County, California",4913,81688,1257,179,0,1088,0,2291,25.6,3.6,0,22.1,0,46.6,74.4,1302,1075,227,82.57,17.43,305,770,11,216,316,986,28.4,4.8,24.3,"50% - 75% P.O.C.","$70000 - $95000"
"06037119800","Census Tract 1198, Los Angeles County, California",6054,82981,499,68,0,788,6,4599,8.2,1.1,0,13,0.1,76,91.8,1486,1084,402,72.95,27.05,421,663,123,279,544,942,38.8,30.6,36.6,"75% or more P.O.C.","$70000 - $95000"
"06037119900","Census Tract 1199, Los Angeles County, California",5245,78000,467,39,32,1122,0,3526,8.9,0.7,0.6,21.4,0,67.2,91.1,1242,1019,223,82.05,17.95,333,686,39,184,372,870,32.7,17.5,30,"75% or more P.O.C.","$70000 - $95000"
"06037120010","Census Tract 1200.10, Los Angeles County, California",2704,49432,225,75,0,419,0,1985,8.3,2.8,0,15.5,0,73.4,91.7,747,395,352,52.88,47.12,95,300,74,278,169,578,24.1,21,22.6,"75% or more P.O.C.","Less than $51000"
"06037120020","Census Tract 1200.20, Los Angeles County, California",3872,37045,85,283,0,634,0,2849,2.2,7.3,0,16.4,0,73.6,97.8,1168,182,986,15.58,84.42,24,158,123,863,147,1021,13.2,12.5,12.6,"75% or more P.O.C.","Less than $51000"
"06037120030","Census Tract 1200.30, Los Angeles County, California",2666,30625,84,72,0,168,0,2342,3.2,2.7,0,6.3,0,87.8,96.8,734,47,687,6.4,93.6,25,22,146,541,171,563,53.2,21.3,23.3,"75% or more P.O.C.","Less than $51000"
"06037120103","Census Tract 1201.03, Los Angeles County, California",3452,26875,63,53,0,100,0,3236,1.8,1.5,0,2.9,0,93.7,98.2,848,57,791,6.72,93.28,35,22,202,589,237,611,61.4,25.5,27.9,"75% or more P.O.C.","Less than $51000"
"06037120104","Census Tract 1201.04, Los Angeles County, California",2228,38672,239,146,0,344,9,1447,10.7,6.6,0,15.4,0.4,64.9,89.3,772,93,679,12.05,87.95,28,65,116,563,144,628,30.1,17.1,18.7,"75% or more P.O.C.","Less than $51000"
"06037120105","Census Tract 1201.05, Los Angeles County, California",2832,33984,161,35,0,483,0,2153,5.7,1.2,0,17.1,0,76,94.3,868,250,618,28.8,71.2,55,195,124,494,179,689,22,20.1,20.6,"75% or more P.O.C.","Less than $51000"
"06037120106","Census Tract 1201.06, Los Angeles County, California",4763,36217,129,73,0,727,0,3834,2.7,1.5,0,15.3,0,80.5,97.3,1205,143,1062,11.87,88.13,61,82,218,844,279,926,42.7,20.5,23.2,"75% or more P.O.C.","Less than $51000"
"06037120107","Census Tract 1201.07, Los Angeles County, California",3893,30481,128,71,0,275,4,3397,3.3,1.8,0,7.1,0.1,87.3,96.7,1108,66,1042,5.96,94.04,20,46,271,771,291,817,30.3,26,26.3,"75% or more P.O.C.","Less than $51000"
"06037120108","Census Tract 1201.08, Los Angeles County, California",4732,39032,387,126,0,243,23,3924,8.2,2.7,0,5.1,0.5,82.9,91.8,1356,347,1009,25.59,74.41,31,316,284,725,315,1041,8.9,28.1,23.2,"75% or more P.O.C.","Less than $51000"
"06037120300","Census Tract 1203, Los Angeles County, California",5238,70208,776,57,0,1018,12,3343,14.8,1.1,0,19.4,0.2,63.8,85.2,1349,964,385,71.46,28.54,233,731,37,348,270,1079,24.2,9.6,20,"75% or more P.O.C.","$70000 - $95000"
"06037120400","Census Tract 1204, Los Angeles County, California",6769,54733,1179,351,0,1265,0,3867,17.4,5.2,0,18.7,0,57.1,82.6,2057,711,1346,34.56,65.44,244,467,109,1237,353,1704,34.3,8.1,17.2,"75% or more P.O.C.","$51000 - $70000"
"06037121010","Census Tract 1210.10, Los Angeles County, California",4934,62903,1570,33,0,535,0,2796,31.8,0.7,0,10.8,0,56.7,68.2,1298,895,403,68.95,31.05,290,605,82,321,372,926,32.4,20.3,28.7,"50% - 75% P.O.C.","$51000 - $70000"
"06037121020","Census Tract 1210.20, Los Angeles County, California",3610,53345,941,88,0,437,0,2124,26.1,2.4,0,12.1,0,58.8,73.9,1085,551,534,50.78,49.22,134,417,80,454,214,871,24.3,15,19.7,"50% - 75% P.O.C.","$51000 - $70000"
"06037121101","Census Tract 1211.01, Los Angeles County, California",2862,59267,499,28,0,272,0,1996,17.4,1,0,9.5,0,69.7,82.6,927,365,562,39.37,60.63,88,277,51,511,139,788,24.1,9.1,15,"75% or more P.O.C.","$51000 - $70000"
"06037121102","Census Tract 1211.02, Los Angeles County, California",2479,48750,1139,0,0,101,0,1202,45.9,0,0,4.1,0,48.5,54.1,811,497,314,61.28,38.72,57,440,41,273,98,713,11.5,13.1,12.1,"50% - 75% P.O.C.","Less than $51000"
"06037121210","Census Tract 1212.10, Los Angeles County, California",2926,67375,281,49,0,353,6,2142,9.6,1.7,0,12.1,0.2,73.2,90.4,766,488,278,63.71,36.29,100,388,56,222,156,610,20.5,20.1,20.4,"75% or more P.O.C.","$51000 - $70000"
"06037121221","Census Tract 1212.21, Los Angeles County, California",2420,64335,288,13,0,68,0,2020,11.9,0.5,0,2.8,0,83.5,88.1,517,337,180,65.18,34.82,129,208,35,145,164,353,38.3,19.4,31.7,"75% or more P.O.C.","$51000 - $70000"
"06037121222","Census Tract 1212.22, Los Angeles County, California",5139,55192,280,53,8,129,0,4633,5.4,1,0.2,2.5,0,90.2,94.6,1218,408,810,33.5,66.5,101,307,259,551,360,858,24.8,32,29.6,"75% or more P.O.C.","$51000 - $70000"
"06037121600","Census Tract 1216, Los Angeles County, California",2735,79474,1068,37,0,641,0,910,39,1.4,0,23.4,0,33.3,61,856,660,196,77.1,22.9,105,555,46,150,151,705,15.9,23.5,17.6,"50% - 75% P.O.C.","$70000 - $95000"
"06037121801","Census Tract 1218.01, Los Angeles County, California",3127,42520,568,95,0,91,0,2320,18.2,3,0,2.9,0,74.2,81.8,1143,371,772,32.46,67.54,96,275,51,721,147,996,25.9,6.6,12.9,"75% or more P.O.C.","Less than $51000"
"06037121802","Census Tract 1218.02, Los Angeles County, California",3216,68083,849,196,0,207,1,1934,26.4,6.1,0,6.4,0,60.1,73.6,709,476,233,67.14,32.86,168,308,101,132,269,440,35.3,43.3,37.9,"50% - 75% P.O.C.","$51000 - $70000"
"06037121900","Census Tract 1219, Los Angeles County, California",3761,54702,653,89,0,91,0,2928,17.4,2.4,0,2.4,0,77.9,82.6,991,551,440,55.6,44.4,110,441,115,325,225,766,20,26.1,22.7,"75% or more P.O.C.","$51000 - $70000"
"06037122000","Census Tract 1220, Los Angeles County, California",5892,75486,2115,175,0,549,0,2863,35.9,3,0,9.3,0,48.6,64.1,1568,969,599,61.8,38.2,182,787,187,412,369,1199,18.8,31.2,23.5,"50% - 75% P.O.C.","$70000 - $95000"
"06037122120","Census Tract 1221.20, Los Angeles County, California",5011,61625,525,186,0,89,0,4053,10.5,3.7,0,1.8,0,80.9,89.5,1086,604,482,55.62,44.38,170,434,174,308,344,742,28.1,36.1,31.7,"75% or more P.O.C.","$51000 - $70000"
"06037122121","Census Tract 1221.21, Los Angeles County, California",2829,53125,253,122,7,162,0,2263,8.9,4.3,0.2,5.7,0,80,91.1,720,336,384,46.67,53.33,128,208,64,320,192,528,38.1,16.7,26.7,"75% or more P.O.C.","$51000 - $70000"
"06037122122","Census Tract 1221.22, Los Angeles County, California",2728,41811,109,0,0,21,0,2598,4,0,0,0.8,0,95.2,96,639,163,476,25.51,74.49,92,71,140,336,232,407,56.4,29.4,36.3,"75% or more P.O.C.","Less than $51000"
"06037122200","Census Tract 1222, Los Angeles County, California",3469,54250,675,12,0,84,0,2606,19.5,0.3,0,2.4,0,75.1,80.5,890,424,466,47.64,52.36,101,323,129,337,230,660,23.8,27.7,25.8,"75% or more P.O.C.","$51000 - $70000"
"06037122410","Census Tract 1224.10, Los Angeles County, California",3457,36222,427,98,0,151,0,2730,12.4,2.8,0,4.4,0,79,87.6,1171,142,1029,12.13,87.87,13,129,100,929,113,1058,9.2,9.7,9.6,"75% or more P.O.C.","Less than $51000"
"06037122420","Census Tract 1224.20, Los Angeles County, California",4503,44967,678,77,0,317,0,3425,15.1,1.7,0,7,0,76.1,84.9,1405,483,922,34.38,65.62,52,431,223,699,275,1130,10.8,24.2,19.6,"75% or more P.O.C.","Less than $51000"
"06037123010","Census Tract 1230.10, Los Angeles County, California",4027,36518,522,73,0,98,0,3324,13,1.8,0,2.4,0,82.5,87,1057,402,655,38.03,61.97,127,275,138,517,265,792,31.6,21.1,25.1,"75% or more P.O.C.","Less than $51000"
"06037123020","Census Tract 1230.20, Los Angeles County, California",3250,42056,273,50,0,95,0,2784,8.4,1.5,0,2.9,0,85.7,91.6,831,499,332,60.05,39.95,178,321,47,285,225,606,35.7,14.2,27.1,"75% or more P.O.C.","Less than $51000"
"06037123103","Census Tract 1231.03, Los Angeles County, California",3808,48902,1120,207,0,394,0,2071,29.4,5.4,0,10.3,0,54.4,70.6,1531,540,991,35.27,64.73,47,493,18,973,65,1466,8.7,1.8,4.2,"50% - 75% P.O.C.","Less than $51000"
"06037123104","Census Tract 1231.04, Los Angeles County, California",4416,41766,1168,145,0,310,0,2703,26.4,3.3,0,7,0,61.2,73.6,1525,406,1119,26.62,73.38,88,318,113,1006,201,1324,21.7,10.1,13.2,"50% - 75% P.O.C.","Less than $51000"
"06037123203","Census Tract 1232.03, Los Angeles County, California",4094,48850,524,440,0,4,0,3076,12.8,10.7,0,0.1,0,75.1,87.2,1165,178,987,15.28,84.72,19,159,216,771,235,930,10.7,21.9,20.2,"75% or more P.O.C.","Less than $51000"
"06037123204","Census Tract 1232.04, Los Angeles County, California",3129,41375,530,143,0,143,0,2287,16.9,4.6,0,4.6,0,73.1,83.1,1011,143,868,14.14,85.86,27,116,123,745,150,861,18.9,14.2,14.8,"75% or more P.O.C.","Less than $51000"
"06037123205","Census Tract 1232.05, Los Angeles County, California",2492,46083,458,96,0,46,0,1892,18.4,3.9,0,1.8,0,75.9,81.6,749,146,603,19.49,80.51,52,94,87,516,139,610,35.6,14.4,18.6,"75% or more P.O.C.","Less than $51000"
"06037123206","Census Tract 1232.06, Los Angeles County, California",2572,32266,277,19,0,60,0,2178,10.8,0.7,0,2.3,0,84.7,89.2,846,194,652,22.93,77.07,52,142,79,573,131,715,26.8,12.1,15.5,"75% or more P.O.C.","Less than $51000"
"06037123301","Census Tract 1233.01, Los Angeles County, California",4530,57031,1368,210,0,1241,0,1631,30.2,4.6,0,27.4,0,36,69.8,1548,598,950,38.63,61.37,140,458,170,780,310,1238,23.4,17.9,20,"50% - 75% P.O.C.","$51000 - $70000"
"06037123303","Census Tract 1233.03, Los Angeles County, California",3087,44477,1028,50,0,162,0,1763,33.3,1.6,0,5.2,0,57.1,66.7,937,265,672,28.28,71.72,27,238,68,604,95,842,10.2,10.1,10.1,"50% - 75% P.O.C.","Less than $51000"
"06037123304","Census Tract 1233.04, Los Angeles County, California",4362,39631,1948,55,0,289,0,1979,44.7,1.3,0,6.6,0,45.4,55.3,1701,333,1368,19.58,80.42,65,268,113,1255,178,1523,19.5,8.3,10.5,"50% - 75% P.O.C.","Less than $51000"
"06037123410","Census Tract 1234.10, Los Angeles County, California",4181,50481,1583,89,0,244,0,2258,37.9,2.1,0,5.8,0,54,62.1,1262,286,976,22.66,77.34,32,254,198,778,230,1032,11.2,20.3,18.2,"50% - 75% P.O.C.","Less than $51000"
"06037123420","Census Tract 1234.20, Los Angeles County, California",4408,44790,1526,203,0,281,0,2398,34.6,4.6,0,6.4,0,54.4,65.4,1450,504,946,34.76,65.24,62,442,156,790,218,1232,12.3,16.5,15,"50% - 75% P.O.C.","Less than $51000"
"06037123510","Census Tract 1235.10, Los Angeles County, California",4795,45338,1716,159,15,288,0,2349,35.8,3.3,0.3,6,0,49,64.2,1660,413,1247,24.88,75.12,111,302,161,1086,272,1388,26.9,12.9,16.4,"50% - 75% P.O.C.","Less than $51000"
"06037123520","Census Tract 1235.20, Los Angeles County, California",2816,45521,1082,5,0,51,0,1638,38.4,0.2,0,1.8,0,58.2,61.6,854,287,567,33.61,66.39,59,228,70,497,129,725,20.6,12.3,15.1,"50% - 75% P.O.C.","Less than $51000"
"06037123601","Census Tract 1236.01, Los Angeles County, California",4803,55241,2585,281,0,118,0,1694,53.8,5.9,0,2.5,0,35.3,46.2,1885,650,1235,34.48,65.52,46,604,84,1151,130,1755,7.1,6.8,6.9,"25% - 50% P.O.C.","$51000 - $70000"
"06037123602","Census Tract 1236.02, Los Angeles County, California",3659,50667,1918,261,0,160,0,1262,52.4,7.1,0,4.4,0,34.5,47.6,1350,528,822,39.11,60.89,22,506,87,735,109,1241,4.2,10.6,8.1,"25% - 50% P.O.C.","Less than $51000"
"06037123700","Census Tract 1237, Los Angeles County, California",4435,65278,2635,208,25,100,0,1359,59.4,4.7,0.6,2.3,0,30.6,40.6,1440,784,656,54.44,45.56,166,618,76,580,242,1198,21.2,11.6,16.8,"25% - 50% P.O.C.","$51000 - $70000"
"06037123800","Census Tract 1238, Los Angeles County, California",6018,75096,3791,369,19,202,0,1552,63,6.1,0.3,3.4,0,25.8,37,2396,773,1623,32.26,67.74,76,697,73,1550,149,2247,9.8,4.5,6.2,"25% - 50% P.O.C.","$70000 - $95000"
"06037123901","Census Tract 1239.01, Los Angeles County, California",4696,66771,1354,325,0,383,145,2417,28.8,6.9,0,8.2,3.1,51.5,71.2,1521,446,1075,29.32,70.68,20,426,251,824,271,1250,4.5,23.3,17.8,"50% - 75% P.O.C.","$51000 - $70000"
"06037123902","Census Tract 1239.02, Los Angeles County, California",2668,70592,1392,86,0,371,0,763,52.2,3.2,0,13.9,0,28.6,47.8,1074,381,693,35.47,64.53,0,381,60,633,60,1014,0,8.7,5.6,"25% - 50% P.O.C.","$70000 - $95000"
"06037124000","Census Tract 1240, Los Angeles County, California",5219,86881,3794,119,0,273,0,728,72.7,2.3,0,5.2,0,13.9,27.3,2117,975,1142,46.06,53.94,125,850,57,1085,182,1935,12.8,5,8.6,"25% - 50% P.O.C.","$70000 - $95000"
"06037124102","Census Tract 1241.02, Los Angeles County, California",3551,50064,1245,128,0,177,0,1804,35.1,3.6,0,5,0,50.8,64.9,1362,287,1075,21.07,78.93,15,272,30,1045,45,1317,5.2,2.8,3.3,"50% - 75% P.O.C.","Less than $51000"
"06037124103","Census Tract 1241.03, Los Angeles County, California",1950,43787,475,39,0,139,0,1274,24.4,2,0,7.1,0,65.3,75.6,611,210,401,34.37,65.63,38,172,61,340,99,512,18.1,15.2,16.2,"75% or more P.O.C.","Less than $51000"
"06037124104","Census Tract 1241.04, Los Angeles County, California",2492,43816,704,169,0,28,10,1473,28.3,6.8,0,1.1,0.4,59.1,71.7,996,157,839,15.76,84.24,15,142,71,768,86,910,9.6,8.5,8.6,"50% - 75% P.O.C.","Less than $51000"
"06037124105","Census Tract 1241.05, Los Angeles County, California",2538,45764,821,81,13,129,0,1435,32.3,3.2,0.5,5.1,0,56.5,67.7,929,161,768,17.33,82.67,14,147,62,706,76,853,8.7,8.1,8.2,"50% - 75% P.O.C.","Less than $51000"
"06037124201","Census Tract 1242.01, Los Angeles County, California",3348,64364,1007,9,0,234,0,2057,30.1,0.3,0,7,0,61.4,69.9,1141,531,610,46.54,53.46,91,440,45,565,136,1005,17.1,7.4,11.9,"50% - 75% P.O.C.","$51000 - $70000"
"06037124203","Census Tract 1242.03, Los Angeles County, California",2384,52561,792,46,0,132,7,1357,33.2,1.9,0,5.5,0.3,56.9,66.8,814,313,501,38.45,61.55,30,283,52,449,82,732,9.6,10.4,10.1,"50% - 75% P.O.C.","$51000 - $70000"
"06037124204","Census Tract 1242.04, Los Angeles County, California",2192,43385,663,70,0,112,0,1216,30.2,3.2,0,5.1,0,55.5,69.8,929,135,794,14.53,85.47,0,135,0,794,0,929,0,0,0,"50% - 75% P.O.C.","Less than $51000"
"06037124300","Census Tract 1243, Los Angeles County, California",2988,42826,984,54,0,155,0,1733,32.9,1.8,0,5.2,0,58,67.1,1150,297,853,25.83,74.17,42,255,41,812,83,1067,14.1,4.8,7.2,"50% - 75% P.O.C.","Less than $51000"
"06037124400","Census Tract 1244, Los Angeles County, California",4858,82500,3377,141,0,217,2,924,69.5,2.9,0,4.5,0,19,30.5,1768,642,1126,36.31,63.69,65,577,77,1049,142,1626,10.1,6.8,8,"25% - 50% P.O.C.","$70000 - $95000"
"06037124500","Census Tract 1245, Los Angeles County, California",2925,90565,1762,89,0,171,0,523,60.2,3,0,5.8,0,17.9,39.8,1168,586,582,50.17,49.83,53,533,18,564,71,1097,9,3.1,6.1,"25% - 50% P.O.C.","$70000 - $95000"
"06037124600","Census Tract 1246, Los Angeles County, California",2691,64712,1825,138,12,91,0,340,67.8,5.1,0.4,3.4,0,12.6,32.2,1310,510,800,38.93,61.07,0,510,0,800,0,1310,0,0,0,"25% - 50% P.O.C.","$51000 - $70000"
"06037124700","Census Tract 1247, Los Angeles County, California",5539,89674,3991,62,0,290,12,950,72.1,1.1,0,5.2,0.2,17.2,27.9,2474,1156,1318,46.73,53.27,44,1112,21,1297,65,2409,3.8,1.6,2.6,"25% - 50% P.O.C.","$70000 - $95000"
"06037124902","Census Tract 1249.02, Los Angeles County, California",2706,31852,1540,344,0,154,0,524,56.9,12.7,0,5.7,0,19.4,43.1,1534,161,1373,10.5,89.5,17,144,29,1344,46,1488,10.6,2.1,3,"25% - 50% P.O.C.","Less than $51000"
"06037124903","Census Tract 1249.03, Los Angeles County, California",3499,61429,1989,229,12,255,0,917,56.8,6.5,0.3,7.3,0,26.2,43.2,1508,328,1180,21.75,78.25,0,328,110,1070,110,1398,0,9.3,7.3,"25% - 50% P.O.C.","$51000 - $70000"
"06037125100","Census Tract 1251, Los Angeles County, California",5892,76595,3637,513,20,424,2,1189,61.7,8.7,0.3,7.2,0,20.2,38.3,2852,686,2166,24.05,75.95,22,664,35,2131,57,2795,3.2,1.6,2,"25% - 50% P.O.C.","$70000 - $95000"
"06037125200","Census Tract 1252, Los Angeles County, California",3907,75260,2037,87,0,213,26,1219,52.1,2.2,0,5.5,0.7,31.2,47.9,1653,575,1078,34.79,65.21,32,543,45,1033,77,1576,5.6,4.2,4.7,"25% - 50% P.O.C.","$70000 - $95000"
"06037125310","Census Tract 1253.10, Los Angeles County, California",4313,48958,1710,666,0,93,0,1758,39.6,15.4,0,2.2,0,40.8,60.4,1973,369,1604,18.7,81.3,49,320,27,1577,76,1897,13.3,1.7,3.9,"50% - 75% P.O.C.","Less than $51000"
"06037125320","Census Tract 1253.20, Los Angeles County, California",5106,39977,2526,316,47,597,0,1420,49.5,6.2,0.9,11.7,0,27.8,50.5,2753,95,2658,3.45,96.55,0,95,65,2593,65,2688,0,2.4,2.4,"50% - 75% P.O.C.","Less than $51000"
"06037125401","Census Tract 1254.01, Los Angeles County, California",4966,62934,2611,723,0,603,8,928,52.6,14.6,0,12.1,0.2,18.7,47.4,2558,125,2433,4.89,95.11,0,125,60,2373,60,2498,0,2.5,2.3,"25% - 50% P.O.C.","$51000 - $70000"
"06037125402","Census Tract 1254.02, Los Angeles County, California",4889,80299,3194,284,0,350,0,831,65.3,5.8,0,7.2,0,17,34.7,2040,624,1416,30.59,69.41,37,587,16,1400,53,1987,5.9,1.1,2.6,"25% - 50% P.O.C.","$70000 - $95000"
"06037125501","Census Tract 1255.01, Los Angeles County, California",3052,46767,1824,317,5,240,0,606,59.8,10.4,0.2,7.9,0,19.9,40.2,1627,161,1466,9.9,90.1,7,154,2,1464,9,1618,4.3,0.1,0.6,"25% - 50% P.O.C.","Less than $51000"
"06037125502","Census Tract 1255.02, Los Angeles County, California",3488,68700,2261,173,0,364,11,586,64.8,5,0,10.4,0.3,16.8,35.2,1843,442,1401,23.98,76.02,0,442,11,1390,11,1832,0,0.8,0.6,"25% - 50% P.O.C.","$51000 - $70000"
"06037125600","Census Tract 1256, Los Angeles County, California",2811,82401,1743,72,0,192,0,715,62,2.6,0,6.8,0,25.4,38,1185,600,585,50.63,49.37,37,563,36,549,73,1112,6.2,6.2,6.2,"25% - 50% P.O.C.","$70000 - $95000"
"06037127102","Census Tract 1271.02, Los Angeles County, California",5779,44955,779,311,0,380,0,4164,13.5,5.4,0,6.6,0,72.1,86.5,1666,602,1064,36.13,63.87,87,515,215,849,302,1364,14.5,20.2,18.1,"75% or more P.O.C.","Less than $51000"
"06037127103","Census Tract 1271.03, Los Angeles County, California",3109,52096,765,116,0,238,0,1820,24.6,3.7,0,7.7,0,58.5,75.4,1099,190,909,17.29,82.71,5,185,180,729,185,914,2.6,19.8,16.8,"75% or more P.O.C.","$51000 - $70000"
"06037127104","Census Tract 1271.04, Los Angeles County, California",3821,39067,1437,107,0,244,0,1976,37.6,2.8,0,6.4,0,51.7,62.4,1298,422,876,32.51,67.49,26,396,127,749,153,1145,6.2,14.5,11.8,"50% - 75% P.O.C.","Less than $51000"
"06037127210","Census Tract 1272.10, Los Angeles County, California",5838,55997,1038,625,0,567,0,3551,17.8,10.7,0,9.7,0,60.8,82.2,1905,598,1307,31.39,68.61,152,446,198,1109,350,1555,25.4,15.1,18.4,"75% or more P.O.C.","$51000 - $70000"
"06037127220","Census Tract 1272.20, Los Angeles County, California",5045,39645,1121,258,0,374,0,3171,22.2,5.1,0,7.4,0,62.9,77.8,1733,528,1205,30.47,69.53,74,454,96,1109,170,1563,14,8,9.8,"75% or more P.O.C.","Less than $51000"
"06037127300","Census Tract 1273, Los Angeles County, California",3809,49375,831,177,35,436,12,2215,21.8,4.6,0.9,11.4,0.3,58.2,78.2,1375,496,879,36.07,63.93,84,412,58,821,142,1233,16.9,6.6,10.3,"75% or more P.O.C.","Less than $51000"
"06037127400","Census Tract 1274, Los Angeles County, California",6558,53695,1069,75,16,268,0,5033,16.3,1.1,0.2,4.1,0,76.7,83.7,1865,477,1388,25.58,74.42,90,387,353,1035,443,1422,18.9,25.4,23.8,"75% or more P.O.C.","$51000 - $70000"
"06037127520","Census Tract 1275.20, Los Angeles County, California",4870,35728,488,254,8,346,0,3731,10,5.2,0.2,7.1,0,76.6,90,1499,92,1407,6.14,93.86,38,54,283,1124,321,1178,41.3,20.1,21.4,"75% or more P.O.C.","Less than $51000"
"06037127603","Census Tract 1276.03, Los Angeles County, California",3068,42292,460,48,0,62,7,2483,15,1.6,0,2,0.2,80.9,85,937,140,797,14.94,85.06,30,110,173,624,203,734,21.4,21.7,21.7,"75% or more P.O.C.","Less than $51000"
"06037127604","Census Tract 1276.04, Los Angeles County, California",3157,44798,754,28,0,294,0,1997,23.9,0.9,0,9.3,0,63.3,76.1,1203,200,1003,16.63,83.37,25,175,43,960,68,1135,12.5,4.3,5.7,"75% or more P.O.C.","Less than $51000"
"06037127605","Census Tract 1276.05, Los Angeles County, California",4329,46071,355,101,26,336,0,3358,8.2,2.3,0.6,7.8,0,77.6,91.8,1170,126,1044,10.77,89.23,23,103,251,793,274,896,18.3,24,23.4,"75% or more P.O.C.","Less than $51000"
"06037127606","Census Tract 1276.06, Los Angeles County, California",3322,60904,770,166,12,329,0,1989,23.2,5,0.4,9.9,0,59.9,76.8,1150,378,772,32.87,67.13,76,302,61,711,137,1013,20.1,7.9,11.9,"75% or more P.O.C.","$51000 - $70000"
"06037127711","Census Tract 1277.11, Los Angeles County, California",3588,64018,1117,292,0,247,0,1900,31.1,8.1,0,6.9,0,53,68.9,1188,438,750,36.87,63.13,24,414,156,594,180,1008,5.5,20.8,15.2,"50% - 75% P.O.C.","$51000 - $70000"
"06037127712","Census Tract 1277.12, Los Angeles County, California",3560,42662,1082,305,0,221,0,1916,30.4,8.6,0,6.2,0,53.8,69.6,1580,234,1346,14.81,85.19,48,186,66,1280,114,1466,20.5,4.9,7.2,"50% - 75% P.O.C.","Less than $51000"
"06037127803","Census Tract 1278.03, Los Angeles County, California",4790,43071,1317,151,13,273,0,2929,27.5,3.2,0.3,5.7,0,61.1,72.5,1670,353,1317,21.14,78.86,96,257,225,1092,321,1349,27.2,17.1,19.2,"50% - 75% P.O.C.","Less than $51000"
"06037127804","Census Tract 1278.04, Los Angeles County, California",4352,53792,1344,208,22,543,0,2115,30.9,4.8,0.5,12.5,0,48.6,69.1,1646,475,1171,28.86,71.14,43,432,97,1074,140,1506,9.1,8.3,8.5,"50% - 75% P.O.C.","$51000 - $70000"
"06037127805","Census Tract 1278.05, Los Angeles County, California",3627,49457,653,286,0,268,12,2396,18,7.9,0,7.4,0.3,66.1,82,1198,278,920,23.21,76.79,22,256,100,820,122,1076,7.9,10.9,10.2,"75% or more P.O.C.","Less than $51000"
"06037127806","Census Tract 1278.06, Los Angeles County, California",3293,42946,784,144,0,326,0,1986,23.8,4.4,0,9.9,0,60.3,76.2,1198,260,938,21.7,78.3,0,260,62,876,62,1136,0,6.6,5.2,"75% or more P.O.C.","Less than $51000"
"06037127910","Census Tract 1279.10, Los Angeles County, California",5097,46190,666,232,0,357,0,3839,13.1,4.6,0,7,0,75.3,86.9,1446,285,1161,19.71,80.29,36,249,234,927,270,1176,12.6,20.2,18.7,"75% or more P.O.C.","Less than $51000"
"06037127920","Census Tract 1279.20, Los Angeles County, California",4716,56458,1515,48,0,200,0,2789,32.1,1,0,4.2,0,59.1,67.9,1345,470,875,34.94,65.06,104,366,183,692,287,1058,22.1,20.9,21.3,"50% - 75% P.O.C.","$51000 - $70000"
"06037128101","Census Tract 1281.01, Los Angeles County, California",3735,56023,1447,126,8,178,0,1889,38.7,3.4,0.2,4.8,0,50.6,61.3,1271,422,849,33.2,66.8,21,401,127,722,148,1123,5,15,11.6,"50% - 75% P.O.C.","$51000 - $70000"
"06037128102","Census Tract 1281.02, Los Angeles County, California",4625,46699,964,336,0,377,0,2873,20.8,7.3,0,8.2,0,62.1,79.2,1485,247,1238,16.63,83.37,49,198,184,1054,233,1252,19.8,14.9,15.7,"75% or more P.O.C.","Less than $51000"
"06037128210","Census Tract 1282.10, Los Angeles County, California",5008,31168,508,329,0,203,0,3891,10.1,6.6,0,4.1,0,77.7,89.9,1555,46,1509,2.96,97.04,5,41,247,1262,252,1303,10.9,16.4,16.2,"75% or more P.O.C.","Less than $51000"
"06037128220","Census Tract 1282.20, Los Angeles County, California",2912,41570,1387,115,0,132,0,1232,47.6,3.9,0,4.5,0,42.3,52.4,1204,419,785,34.8,65.2,15,404,69,716,84,1120,3.6,8.8,7,"50% - 75% P.O.C.","Less than $51000"
"06037128302","Census Tract 1283.02, Los Angeles County, California",5000,46413,753,153,0,129,0,3896,15.1,3.1,0,2.6,0,77.9,84.9,1498,186,1312,12.42,87.58,24,162,258,1054,282,1216,12.9,19.7,18.8,"75% or more P.O.C.","Less than $51000"
"06037128303","Census Tract 1283.03, Los Angeles County, California",4176,39488,532,20,0,71,0,3553,12.7,0.5,0,1.7,0,85.1,87.3,1160,35,1125,3.02,96.98,0,35,209,916,209,951,0,18.6,18,"75% or more P.O.C.","Less than $51000"
"06037128400","Census Tract 1284, Los Angeles County, California",4502,72500,2189,369,0,374,0,1451,48.6,8.2,0,8.3,0,32.2,51.4,1724,894,830,51.86,48.14,92,802,50,780,142,1582,10.3,6,8.2,"50% - 75% P.O.C.","$70000 - $95000"
"06037128500","Census Tract 1285, Los Angeles County, California",4108,74375,2433,286,0,380,0,654,59.2,7,0,9.3,0,15.9,40.8,1992,697,1295,34.99,65.01,26,671,52,1243,78,1914,3.7,4,3.9,"25% - 50% P.O.C.","$70000 - $95000"
"06037128601","Census Tract 1286.01, Los Angeles County, California",4369,48173,1667,237,0,357,2,2003,38.2,5.4,0,8.2,0,45.8,61.8,1628,365,1263,22.42,77.58,6,359,143,1120,149,1479,1.6,11.3,9.2,"50% - 75% P.O.C.","Less than $51000"
"06037128602","Census Tract 1286.02, Los Angeles County, California",3472,85284,2626,100,0,115,0,567,75.6,2.9,0,3.3,0,16.3,24.4,1398,724,674,51.79,48.21,81,643,12,662,93,1305,11.2,1.8,6.7,"Less than 25% P.O.C.","$70000 - $95000"
"06037128702","Census Tract 1287.02, Los Angeles County, California",5810,76202,3290,550,0,461,0,1255,56.6,9.5,0,7.9,0,21.6,43.4,2731,981,1750,35.92,64.08,0,981,20,1730,20,2711,0,1.1,0.7,"25% - 50% P.O.C.","$70000 - $95000"
"06037128801","Census Tract 1288.01, Los Angeles County, California",3419,65449,1849,200,0,484,0,591,54.1,5.8,0,14.2,0,17.3,45.9,1818,501,1317,27.56,72.44,43,458,9,1308,52,1766,8.6,0.7,2.9,"25% - 50% P.O.C.","$51000 - $70000"
"06037128802","Census Tract 1288.02, Los Angeles County, California",4670,89735,2847,209,0,671,0,756,61,4.5,0,14.4,0,16.2,39,2022,702,1320,34.72,65.28,39,663,91,1229,130,1892,5.6,6.9,6.4,"25% - 50% P.O.C.","$70000 - $95000"
"06037128910","Census Tract 1289.10, Los Angeles County, California",4657,104392,2869,329,0,378,15,733,61.6,7.1,0,8.1,0.3,15.7,38.4,1954,884,1070,45.24,54.76,37,847,19,1051,56,1898,4.2,1.8,2.9,"25% - 50% P.O.C.","$95000 or more"
"06037131010","Census Tract 1310.10, Los Angeles County, California",6686,56487,1458,135,2,1060,0,3849,21.8,2,0,15.9,0,57.6,78.2,1999,422,1577,21.11,78.89,68,354,266,1311,334,1665,16.1,16.9,16.7,"75% or more P.O.C.","$51000 - $70000"
"06037131020","Census Tract 1310.20, Los Angeles County, California",6704,66875,1061,197,0,551,4,4668,15.8,2.9,0,8.2,0.1,69.6,84.2,1697,879,818,51.8,48.2,329,550,187,631,516,1181,37.4,22.9,30.4,"75% or more P.O.C.","$51000 - $70000"
"06037131100","Census Tract 1311, Los Angeles County, California",3197,81613,1324,22,0,311,0,1411,41.4,0.7,0,9.7,0,44.1,58.6,1040,961,79,92.4,7.6,149,812,31,48,180,860,15.5,39.2,17.3,"50% - 75% P.O.C.","$70000 - $95000"
"06037131200","Census Tract 1312, Los Angeles County, California",3417,81929,1554,134,0,212,0,1476,45.5,3.9,0,6.2,0,43.2,54.5,1212,879,333,72.52,27.48,55,824,61,272,116,1096,6.3,18.3,9.6,"50% - 75% P.O.C.","$70000 - $95000"
"06037131300","Census Tract 1313, Los Angeles County, California",5102,71848,996,128,0,687,39,3188,19.5,2.5,0,13.5,0.8,62.5,80.5,1216,870,346,71.55,28.45,234,636,196,150,430,786,26.9,56.6,35.4,"75% or more P.O.C.","$70000 - $95000"
"06037131400","Census Tract 1314, Los Angeles County, California",6367,67730,1814,281,0,1291,20,2756,28.5,4.4,0,20.3,0.3,43.3,71.5,1935,892,1043,46.1,53.9,138,754,146,897,284,1651,15.5,14,14.7,"50% - 75% P.O.C.","$51000 - $70000"
"06037131600","Census Tract 1316, Los Angeles County, California",5336,77222,1371,160,0,646,0,3026,25.7,3,0,12.1,0,56.7,74.3,1450,1045,405,72.07,27.93,223,822,117,288,340,1110,21.3,28.9,23.4,"50% - 75% P.O.C.","$70000 - $95000"
"06037131701","Census Tract 1317.01, Los Angeles County, California",5587,71595,1569,282,39,661,0,2831,28.1,5,0.7,11.8,0,50.7,71.9,1828,807,1021,44.15,55.85,101,706,148,873,249,1579,12.5,14.5,13.6,"50% - 75% P.O.C.","$70000 - $95000"
"06037131702","Census Tract 1317.02, Los Angeles County, California",3770,68083,609,587,61,625,0,1867,16.2,15.6,1.6,16.6,0,49.5,83.8,1123,786,337,69.99,30.01,127,659,69,268,196,927,16.2,20.5,17.5,"75% or more P.O.C.","$51000 - $70000"
"06037131800","Census Tract 1318, Los Angeles County, California",6157,66434,1096,483,0,699,0,3614,17.8,7.8,0,11.4,0,58.7,82.2,1638,614,1024,37.48,62.52,229,385,282,742,511,1127,37.3,27.5,31.2,"75% or more P.O.C.","$51000 - $70000"
"06037131900","Census Tract 1319, Los Angeles County, California",4597,86818,1773,233,0,426,0,1983,38.6,5.1,0,9.3,0,43.1,61.4,1386,1063,323,76.7,23.3,203,860,6,317,209,1177,19.1,1.9,15.1,"50% - 75% P.O.C.","$70000 - $95000"
"06037132001","Census Tract 1320.01, Los Angeles County, California",3463,83039,1404,153,0,430,0,1108,40.5,4.4,0,12.4,0,32,59.5,1162,726,436,62.48,37.52,99,627,31,405,130,1032,13.6,7.1,11.2,"50% - 75% P.O.C.","$70000 - $95000"
"06037132002","Census Tract 1320.02, Los Angeles County, California",3354,109891,1328,189,0,81,0,1504,39.6,5.6,0,2.4,0,44.8,60.4,1112,658,454,59.17,40.83,40,618,86,368,126,986,6.1,18.9,11.3,"50% - 75% P.O.C.","$95000 or more"
"06037132101","Census Tract 1321.01, Los Angeles County, California",4645,73550,1235,420,15,392,0,2246,26.6,9,0.3,8.4,0,48.4,73.4,1579,595,984,37.68,62.32,69,526,151,833,220,1359,11.6,15.3,13.9,"50% - 75% P.O.C.","$70000 - $95000"
"06037132102","Census Tract 1321.02, Los Angeles County, California",5401,49838,1559,325,0,967,0,2396,28.9,6,0,17.9,0,44.4,71.1,2157,931,1226,43.16,56.84,75,856,73,1153,148,2009,8.1,6,6.9,"50% - 75% P.O.C.","Less than $51000"
"06037132300","Census Tract 1323, Los Angeles County, California",7912,49741,1594,57,100,1211,0,4896,20.1,0.7,1.3,15.3,0,61.9,79.9,2506,696,1810,27.77,72.23,147,549,175,1635,322,2184,21.1,9.7,12.8,"75% or more P.O.C.","Less than $51000"
"06037132501","Census Tract 1325.01, Los Angeles County, California",4566,60156,1501,74,0,336,8,2524,32.9,1.6,0,7.4,0.2,55.3,67.1,1193,541,652,45.35,54.65,174,367,107,545,281,912,32.2,16.4,23.6,"50% - 75% P.O.C.","$51000 - $70000"
"06037132502","Census Tract 1325.02, Los Angeles County, California",3922,52712,1822,206,0,372,0,1433,46.5,5.3,0,9.5,0,36.5,53.5,1365,710,655,52.01,47.99,48,662,110,545,158,1207,6.8,16.8,11.6,"50% - 75% P.O.C.","$51000 - $70000"
"06037132700","Census Tract 1327, Los Angeles County, California",4873,64412,1276,34,0,377,0,3052,26.2,0.7,0,7.7,0,62.6,73.8,1592,857,735,53.83,46.17,116,741,73,662,189,1403,13.5,9.9,11.9,"50% - 75% P.O.C.","$51000 - $70000"
"06037132900","Census Tract 1329, Los Angeles County, California",3885,81042,2272,67,0,400,0,916,58.5,1.7,0,10.3,0,23.6,41.5,1343,775,568,57.71,42.29,63,712,43,525,106,1237,8.1,7.6,7.9,"25% - 50% P.O.C.","$70000 - $95000"
"06037133000","Census Tract 1330, Los Angeles County, California",4778,72864,1768,26,0,461,0,2468,37,0.5,0,9.6,0,51.7,63,1314,895,419,68.11,31.89,152,743,143,276,295,1019,17,34.1,22.5,"50% - 75% P.O.C.","$70000 - $95000"
"06037133100","Census Tract 1331, Los Angeles County, California",5609,52262,2854,273,28,578,0,1720,50.9,4.9,0.5,10.3,0,30.7,49.1,2024,846,1178,41.8,58.2,79,767,95,1083,174,1850,9.3,8.1,8.6,"25% - 50% P.O.C.","$51000 - $70000"
"06037134001","Census Tract 1340.01, Los Angeles County, California",3864,63846,459,11,0,503,0,2845,11.9,0.3,0,13,0,73.6,88.1,982,325,657,33.1,66.9,102,223,163,494,265,717,31.4,24.8,27,"75% or more P.O.C.","$51000 - $70000"
"06037134002","Census Tract 1340.02, Los Angeles County, California",3665,54138,1155,143,8,429,0,1888,31.5,3.9,0.2,11.7,0,51.5,68.5,1084,490,594,45.2,54.8,76,414,138,456,214,870,15.5,23.2,19.7,"50% - 75% P.O.C.","$51000 - $70000"
"06037134101","Census Tract 1341.01, Los Angeles County, California",5579,69476,1055,139,0,1154,0,2870,18.9,2.5,0,20.7,0,51.4,81.1,1450,890,560,61.38,38.62,143,747,302,258,445,1005,16.1,53.9,30.7,"75% or more P.O.C.","$51000 - $70000"
"06037134103","Census Tract 1341.03, Los Angeles County, California",4659,81833,1522,284,39,527,51,2172,32.7,6.1,0.8,11.3,1.1,46.6,67.3,1346,826,520,61.37,38.63,117,709,88,432,205,1141,14.2,16.9,15.2,"50% - 75% P.O.C.","$70000 - $95000"
"06037134104","Census Tract 1341.04, Los Angeles County, California",4618,60582,970,318,0,1275,20,1954,21,6.9,0,27.6,0.4,42.3,79,1440,595,845,41.32,58.68,74,521,131,714,205,1235,12.4,15.5,14.2,"75% or more P.O.C.","$51000 - $70000"
"06037134201","Census Tract 1342.01, Los Angeles County, California",4735,91758,1381,122,0,617,11,2459,29.2,2.6,0,13,0.2,51.9,70.8,1253,979,274,78.13,21.87,165,814,159,115,324,929,16.9,58,25.9,"50% - 75% P.O.C.","$70000 - $95000"
"06037134302","Census Tract 1343.02, Los Angeles County, California",4112,103750,1859,69,0,850,0,1236,45.2,1.7,0,20.7,0,30.1,54.8,1261,1028,233,81.52,18.48,140,888,48,185,188,1073,13.6,20.6,14.9,"50% - 75% P.O.C.","$95000 or more"
"06037134303","Census Tract 1343.03, Los Angeles County, California",5942,78864,2280,100,54,878,0,2373,38.4,1.7,0.9,14.8,0,39.9,61.6,1824,1356,468,74.34,25.66,206,1150,61,407,267,1557,15.2,13,14.6,"50% - 75% P.O.C.","$70000 - $95000"
"06037134304","Census Tract 1343.04, Los Angeles County, California",3042,64167,983,222,0,699,0,945,32.3,7.3,0,23,0,31.1,67.7,926,615,311,66.41,33.59,112,503,26,285,138,788,18.2,8.4,14.9,"50% - 75% P.O.C.","$51000 - $70000"
"06037134305","Census Tract 1343.05, Los Angeles County, California",4183,37606,260,60,0,361,4,3473,6.2,1.4,0,8.6,0.1,83,93.8,1130,5,1125,0.44,99.56,0,5,351,774,351,779,0,31.2,31.1,"75% or more P.O.C.","Less than $51000"
"06037134306","Census Tract 1343.06, Los Angeles County, California",4305,69286,1109,285,0,526,0,2305,25.8,6.6,0,12.2,0,53.5,74.2,1324,384,940,29,71,54,330,86,854,140,1184,14.1,9.1,10.6,"50% - 75% P.O.C.","$51000 - $70000"
"06037134421","Census Tract 1344.21, Los Angeles County, California",4234,140313,3227,114,16,383,0,321,76.2,2.7,0.4,9,0,7.6,23.8,1386,1298,88,93.65,6.35,101,1197,26,62,127,1259,7.8,29.5,9.2,"Less than 25% P.O.C.","$95000 or more"
"06037134422","Census Tract 1344.22, Los Angeles County, California",4924,121250,2720,187,0,1060,0,795,55.2,3.8,0,21.5,0,16.1,44.8,1590,1362,228,85.66,14.34,96,1266,25,203,121,1469,7,11,7.6,"25% - 50% P.O.C.","$95000 or more"
"06037134423","Census Tract 1344.23, Los Angeles County, California",3539,100950,2299,299,0,483,0,273,65,8.4,0,13.6,0,7.7,35,1297,1057,240,81.5,18.5,101,956,0,240,101,1196,9.6,0,7.8,"25% - 50% P.O.C.","$95000 or more"
"06037134424","Census Tract 1344.24, Los Angeles County, California",2916,147679,1978,51,0,538,0,181,67.8,1.7,0,18.4,0,6.2,32.2,967,939,28,97.1,2.9,79,860,0,28,79,888,8.4,0,8.2,"25% - 50% P.O.C.","$95000 or more"
"06037134520","Census Tract 1345.20, Los Angeles County, California",6065,46011,715,177,0,628,3,4452,11.8,2.9,0,10.4,0,73.4,88.2,1879,288,1591,15.33,84.67,58,230,294,1297,352,1527,20.1,18.5,18.7,"75% or more P.O.C.","Less than $51000"
"06037134521","Census Tract 1345.21, Los Angeles County, California",3691,57669,74,7,0,242,0,3327,2,0.2,0,6.6,0,90.1,98,791,148,643,18.71,81.29,36,112,215,428,251,540,24.3,33.4,31.7,"75% or more P.O.C.","$51000 - $70000"
"06037134522","Census Tract 1345.22, Los Angeles County, California",4167,37869,547,178,0,91,0,3228,13.1,4.3,0,2.2,0,77.5,86.9,1399,269,1130,19.23,80.77,15,254,158,972,173,1226,5.6,14,12.4,"75% or more P.O.C.","Less than $51000"
"06037134710","Census Tract 1347.10, Los Angeles County, California",5836,46050,850,119,2,841,59,3882,14.6,2,0,14.4,1,66.5,85.4,1645,340,1305,20.67,79.33,28,312,387,918,415,1230,8.2,29.7,25.2,"75% or more P.O.C.","Less than $51000"
"06037134720","Census Tract 1347.20, Los Angeles County, California",5074,66650,967,279,0,1090,0,2363,19.1,5.5,0,21.5,0,46.6,80.9,1657,837,820,50.51,49.49,136,701,123,697,259,1398,16.2,15,15.6,"75% or more P.O.C.","$51000 - $70000"
"06037134800","Census Tract 1348, Los Angeles County, California",6399,84038,2039,216,0,1380,0,2660,31.9,3.4,0,21.6,0,41.6,68.1,1884,1316,568,69.85,30.15,170,1146,153,415,323,1561,12.9,26.9,17.1,"50% - 75% P.O.C.","$70000 - $95000"
"06037134901","Census Tract 1349.01, Los Angeles County, California",3140,74125,1853,165,0,268,0,770,59,5.3,0,8.5,0,24.5,41,1121,681,440,60.75,39.25,42,639,59,381,101,1020,6.2,13.4,9,"25% - 50% P.O.C.","$70000 - $95000"
"06037134903","Census Tract 1349.03, Los Angeles County, California",6919,77353,1593,314,0,1229,0,3560,23,4.5,0,17.8,0,51.5,77,2764,0,2764,0,100,0,0,145,2619,145,2619,NA,5.2,5.2,"75% or more P.O.C.","$70000 - $95000"
"06037134904","Census Tract 1349.04, Los Angeles County, California",4043,49866,1269,231,11,279,0,2211,31.4,5.7,0.3,6.9,0,54.7,68.6,1369,638,731,46.6,53.4,105,533,66,665,171,1198,16.5,9,12.5,"50% - 75% P.O.C.","Less than $51000"
"06037134905","Census Tract 1349.05, Los Angeles County, California",4552,84224,2612,509,0,663,0,598,57.4,11.2,0,14.6,0,13.1,42.6,2434,377,2057,15.49,84.51,0,377,20,2037,20,2414,0,1,0.8,"25% - 50% P.O.C.","$70000 - $95000"
"06037135102","Census Tract 1351.02, Los Angeles County, California",3726,145313,2307,221,0,406,0,593,61.9,5.9,0,10.9,0,15.9,38.1,1210,982,228,81.16,18.84,61,921,23,205,84,1126,6.2,10.1,6.9,"25% - 50% P.O.C.","$95000 or more"
"06037135111","Census Tract 1351.11, Los Angeles County, California",3313,101554,1479,97,0,688,0,972,44.6,2.9,0,20.8,0,29.3,55.4,1134,610,524,53.79,46.21,100,510,78,446,178,956,16.4,14.9,15.7,"50% - 75% P.O.C.","$95000 or more"
"06037135113","Census Tract 1351.13, Los Angeles County, California",3485,85505,1663,162,12,726,41,652,47.7,4.6,0.3,20.8,1.2,18.7,52.3,1405,218,1187,15.52,84.48,0,218,92,1095,92,1313,0,7.8,6.5,"50% - 75% P.O.C.","$70000 - $95000"
"06037135114","Census Tract 1351.14, Los Angeles County, California",5106,58958,2523,158,28,1412,0,838,49.4,3.1,0.5,27.7,0,16.4,50.6,2746,397,2349,14.46,85.54,0,397,13,2336,13,2733,0,0.6,0.5,"50% - 75% P.O.C.","$51000 - $70000"
"06037135201","Census Tract 1352.01, Los Angeles County, California",2788,106550,1566,288,0,469,3,348,56.2,10.3,0,16.8,0.1,12.5,43.8,897,714,183,79.6,20.4,118,596,8,175,126,771,16.5,4.4,14,"25% - 50% P.O.C.","$95000 or more"
"06037135202","Census Tract 1352.02, Los Angeles County, California",4708,116321,2688,168,24,749,0,656,57.1,3.6,0.5,15.9,0,13.9,42.9,1483,1228,255,82.81,17.19,156,1072,29,226,185,1298,12.7,11.4,12.5,"25% - 50% P.O.C.","$95000 or more"
"06037135203","Census Tract 1352.03, Los Angeles County, California",7515,116518,5302,144,0,1097,0,620,70.6,1.9,0,14.6,0,8.3,29.4,2545,2186,359,85.89,14.11,178,2008,112,247,290,2255,8.1,31.2,11.4,"25% - 50% P.O.C.","$95000 or more"
"06037137000","Census Tract 1370, Los Angeles County, California",5067,123542,3801,254,23,436,6,386,75,5,0.5,8.6,0.1,7.6,25,1722,1380,342,80.14,19.86,136,1244,7,335,143,1579,9.9,2,8.3,"25% - 50% P.O.C.","$95000 or more"
"06037137103","Census Tract 1371.03, Los Angeles County, California",5382,89344,3400,76,25,995,0,850,63.2,1.4,0.5,18.5,0,15.8,36.8,2395,1274,1121,53.19,46.81,15,1259,69,1052,84,2311,1.2,6.2,3.5,"25% - 50% P.O.C.","$70000 - $95000"
"06037137104","Census Tract 1371.04, Los Angeles County, California",2754,106111,1897,64,0,229,0,404,68.9,2.3,0,8.3,0,14.7,31.1,1012,821,191,81.13,18.87,60,761,0,191,60,952,7.3,0,5.9,"25% - 50% P.O.C.","$95000 or more"
"06037137201","Census Tract 1372.01, Los Angeles County, California",6029,77146,3335,303,0,872,0,1178,55.3,5,0,14.5,0,19.5,44.7,2284,1069,1215,46.8,53.2,99,970,9,1206,108,2176,9.3,0.7,4.7,"25% - 50% P.O.C.","$70000 - $95000"
"06037137301","Census Tract 1373.01, Los Angeles County, California",2271,156250,1679,84,2,140,0,171,73.9,3.7,0.1,6.2,0,7.5,26.1,765,708,57,92.55,7.45,70,638,11,46,81,684,9.9,19.3,10.6,"25% - 50% P.O.C.","$95000 or more"
"06037137302","Census Tract 1373.02, Los Angeles County, California",4449,145286,3537,65,0,365,14,315,79.5,1.5,0,8.2,0.3,7.1,20.5,1602,1475,127,92.07,7.93,118,1357,0,127,118,1484,8,0,7.4,"Less than 25% P.O.C.","$95000 or more"
"06037137401","Census Tract 1374.01, Los Angeles County, California",4299,125781,3068,78,0,381,0,658,71.4,1.8,0,8.9,0,15.3,28.6,1612,1109,503,68.8,31.2,45,1064,43,460,88,1524,4.1,8.5,5.5,"25% - 50% P.O.C.","$95000 or more"
"06037137402","Census Tract 1374.02, Los Angeles County, California",5365,115978,4020,166,0,270,0,757,74.9,3.1,0,5,0,14.1,25.1,2073,1555,518,75.01,24.99,78,1477,65,453,143,1930,5,12.5,6.9,"25% - 50% P.O.C.","$95000 or more"
"06037137501","Census Tract 1375.01, Los Angeles County, California",4915,92156,3173,336,0,326,0,881,64.6,6.8,0,6.6,0,17.9,35.4,1932,755,1177,39.08,60.92,124,631,65,1112,189,1743,16.4,5.5,9.8,"25% - 50% P.O.C.","$70000 - $95000"
"06037137502","Census Tract 1375.02, Los Angeles County, California",4549,99688,3115,359,35,305,0,478,68.5,7.9,0.8,6.7,0,10.5,31.5,1813,1178,635,64.98,35.02,93,1085,16,619,109,1704,7.9,2.5,6,"25% - 50% P.O.C.","$95000 or more"
"06037137504","Census Tract 1375.04, Los Angeles County, California",2155,143875,1886,21,22,58,0,104,87.5,1,1,2.7,0,4.8,12.5,699,662,37,94.71,5.29,84,578,8,29,92,607,12.7,21.6,13.2,"Less than 25% P.O.C.","$95000 or more"
"06037138000","Census Tract 1380, Los Angeles County, California",4780,127983,3445,352,10,369,0,366,72.1,7.4,0.2,7.7,0,7.7,27.9,1799,1472,327,81.82,18.18,119,1353,17,310,136,1663,8.1,5.2,7.6,"25% - 50% P.O.C.","$95000 or more"
"06037139001","Census Tract 1390.01, Los Angeles County, California",5639,86488,4022,30,0,327,0,1043,71.3,0.5,0,5.8,0,18.5,28.7,2235,1130,1105,50.56,49.44,71,1059,19,1086,90,2145,6.3,1.7,4,"25% - 50% P.O.C.","$70000 - $95000"
"06037139200","Census Tract 1392, Los Angeles County, California",5662,70463,3824,73,0,661,0,981,67.5,1.3,0,11.7,0,17.3,32.5,2098,1166,932,55.58,44.42,148,1018,38,894,186,1912,12.7,4.1,8.9,"25% - 50% P.O.C.","$70000 - $95000"
"06037139301","Census Tract 1393.01, Los Angeles County, California",4445,126328,2887,324,0,345,0,632,64.9,7.3,0,7.8,0,14.2,35.1,1579,1289,290,81.63,18.37,88,1201,9,281,97,1482,6.8,3.1,6.1,"25% - 50% P.O.C.","$95000 or more"
"06037139302","Census Tract 1393.02, Los Angeles County, California",5000,46743,2365,380,5,432,0,1612,47.3,7.6,0.1,8.6,0,32.2,52.7,1976,343,1633,17.36,82.64,0,343,71,1562,71,1905,0,4.3,3.6,"50% - 75% P.O.C.","Less than $51000"
"06037139303","Census Tract 1393.03, Los Angeles County, California",4260,54470,2484,647,0,155,6,769,58.3,15.2,0,3.6,0.1,18.1,41.7,1972,680,1292,34.48,65.52,9,671,67,1225,76,1896,1.3,5.2,3.9,"25% - 50% P.O.C.","$51000 - $70000"
"06037139401","Census Tract 1394.01, Los Angeles County, California",2706,57440,1914,146,0,133,0,478,70.7,5.4,0,4.9,0,17.7,29.3,1313,301,1012,22.92,77.08,20,281,4,1008,24,1289,6.6,0.4,1.8,"25% - 50% P.O.C.","$51000 - $70000"
"06037139402","Census Tract 1394.02, Los Angeles County, California",2899,137578,2336,223,0,59,0,190,80.6,7.7,0,2,0,6.6,19.4,959,806,153,84.05,15.95,61,745,31,122,92,867,7.6,20.3,9.6,"Less than 25% P.O.C.","$95000 or more"
"06037139502","Census Tract 1395.02, Los Angeles County, California",2917,79500,2231,14,0,155,0,365,76.5,0.5,0,5.3,0,12.5,23.5,1090,687,403,63.03,36.97,97,590,50,353,147,943,14.1,12.4,13.5,"Less than 25% P.O.C.","$70000 - $95000"
"06037139503","Census Tract 1395.03, Los Angeles County, California",5946,57006,4274,157,0,250,0,1194,71.9,2.6,0,4.2,0,20.1,28.1,2749,995,1754,36.19,63.81,24,971,49,1705,73,2676,2.4,2.8,2.7,"25% - 50% P.O.C.","$51000 - $70000"
"06037139504","Census Tract 1395.04, Los Angeles County, California",3998,56212,3002,152,0,197,0,461,75.1,3.8,0,4.9,0,11.5,24.9,1801,441,1360,24.49,75.51,0,441,23,1337,23,1778,0,1.7,1.3,"Less than 25% P.O.C.","$51000 - $70000"
"06037139600","Census Tract 1396, Los Angeles County, California",5060,77000,3851,111,0,578,0,408,76.1,2.2,0,11.4,0,8.1,23.9,2202,1329,873,60.35,39.65,103,1226,38,835,141,2061,7.8,4.4,6.4,"Less than 25% P.O.C.","$70000 - $95000"
"06037139701","Census Tract 1397.01, Los Angeles County, California",5320,152833,3854,116,29,291,20,591,72.4,2.2,0.5,5.5,0.4,11.1,27.6,1948,1451,497,74.49,25.51,166,1285,0,497,166,1782,11.4,0,8.5,"25% - 50% P.O.C.","$95000 or more"
"06037139702","Census Tract 1397.02, Los Angeles County, California",6447,205964,5561,214,0,247,0,287,86.3,3.3,0,3.8,0,4.5,13.7,2229,2053,176,92.1,7.9,131,1922,55,121,186,2043,6.4,31.2,8.3,"Less than 25% P.O.C.","$95000 or more"
"06037139703","Census Tract 1397.03, Los Angeles County, California",2861,124830,2306,112,0,184,0,28,80.6,3.9,0,6.4,0,1,19.4,965,798,167,82.69,17.31,139,659,15,152,154,811,17.4,9,16,"Less than 25% P.O.C.","$95000 or more"
"06037139801","Census Tract 1398.01, Los Angeles County, California",3488,157557,2736,205,0,81,0,211,78.4,5.9,0,2.3,0,6,21.6,1291,1198,93,92.8,7.2,131,1067,0,93,131,1160,10.9,0,10.1,"Less than 25% P.O.C.","$95000 or more"
"06037139802","Census Tract 1398.02, Los Angeles County, California",4126,153523,3019,206,0,414,0,283,73.2,5,0,10,0,6.9,26.8,1393,1300,93,93.32,6.68,92,1208,0,93,92,1301,7.1,0,6.6,"25% - 50% P.O.C.","$95000 or more"
"06037141101","Census Tract 1411.01, Los Angeles County, California",4674,73333,2862,695,0,261,0,690,61.2,14.9,0,5.6,0,14.8,38.8,2166,560,1606,25.85,74.15,0,560,10,1596,10,2156,0,0.6,0.5,"25% - 50% P.O.C.","$70000 - $95000"
"06037141102","Census Tract 1411.02, Los Angeles County, California",3074,98125,2225,119,0,194,0,279,72.4,3.9,0,6.3,0,9.1,27.6,1357,526,831,38.76,61.24,37,489,44,787,81,1276,7,5.3,6,"25% - 50% P.O.C.","$95000 or more"
"06037141201","Census Tract 1412.01, Los Angeles County, California",4583,84205,3033,363,0,155,0,803,66.2,7.9,0,3.4,0,17.5,33.8,2123,275,1848,12.95,87.05,24,251,36,1812,60,2063,8.7,1.9,2.8,"25% - 50% P.O.C.","$70000 - $95000"
"06037141202","Census Tract 1412.02, Los Angeles County, California",2674,81250,1919,120,0,207,0,293,71.8,4.5,0,7.7,0,11,28.2,1398,565,833,40.41,59.59,15,550,0,833,15,1383,2.7,0,1.1,"25% - 50% P.O.C.","$70000 - $95000"
"06037141302","Census Tract 1413.02, Los Angeles County, California",6037,92769,3931,483,0,457,0,999,65.1,8,0,7.6,0,16.5,34.9,2978,781,2197,26.23,73.77,28,753,12,2185,40,2938,3.6,0.5,1.3,"25% - 50% P.O.C.","$70000 - $95000"
"06037141303","Census Tract 1413.03, Los Angeles County, California",3477,82448,2394,125,8,262,0,481,68.9,3.6,0.2,7.5,0,13.8,31.1,1779,432,1347,24.28,75.72,9,423,15,1332,24,1755,2.1,1.1,1.3,"25% - 50% P.O.C.","$70000 - $95000"
"06037141304","Census Tract 1413.04, Los Angeles County, California",2995,98375,2395,81,0,133,0,303,80,2.7,0,4.4,0,10.1,20,1419,622,797,43.83,56.17,9,613,31,766,40,1379,1.4,3.9,2.8,"Less than 25% P.O.C.","$95000 or more"
"06037141400","Census Tract 1414, Los Angeles County, California",5099,101327,3780,358,0,396,0,435,74.1,7,0,7.8,0,8.5,25.9,2016,983,1033,48.76,51.24,117,866,0,1033,117,1899,11.9,0,5.8,"25% - 50% P.O.C.","$95000 or more"
"06037141500","Census Tract 1415, Los Angeles County, California",2982,219698,2474,95,0,231,0,138,83,3.2,0,7.7,0,4.6,17,1087,1069,18,98.34,1.66,73,996,0,18,73,1014,6.8,0,6.7,"Less than 25% P.O.C.","$95000 or more"
"06037141600","Census Tract 1416, Los Angeles County, California",4178,196741,3157,165,0,316,0,382,75.6,3.9,0,7.6,0,9.1,24.4,1611,1443,168,89.57,10.43,30,1413,0,168,30,1581,2.1,0,1.9,"Less than 25% P.O.C.","$95000 or more"
"06037141700","Census Tract 1417, Los Angeles County, California",3161,250001,2604,48,0,217,0,187,82.4,1.5,0,6.9,0,5.9,17.6,1221,1136,85,93.04,6.96,40,1096,0,85,40,1181,3.5,0,3.3,"Less than 25% P.O.C.","$95000 or more"
"06037143100","Census Tract 1431, Los Angeles County, California",4389,100948,2713,135,0,400,0,970,61.8,3.1,0,9.1,0,22.1,38.2,2248,807,1441,35.9,64.1,19,788,0,1441,19,2229,2.4,0,0.8,"25% - 50% P.O.C.","$95000 or more"
"06037143200","Census Tract 1432, Los Angeles County, California",4085,75521,2689,141,0,254,26,689,65.8,3.5,0,6.2,0.6,16.9,34.2,2068,577,1491,27.9,72.1,56,521,0,1491,56,2012,9.7,0,2.7,"25% - 50% P.O.C.","$70000 - $95000"
"06037143300","Census Tract 1433, Los Angeles County, California",6643,85230,4318,535,29,482,0,1074,65,8.1,0.4,7.3,0,16.2,35,3165,1180,1985,37.28,62.72,0,1180,35,1950,35,3130,0,1.8,1.1,"25% - 50% P.O.C.","$70000 - $95000"
"06037143400","Census Tract 1434, Los Angeles County, California",7056,116222,5162,220,35,404,0,900,73.2,3.1,0.5,5.7,0,12.8,26.8,3036,1421,1615,46.81,53.19,36,1385,40,1575,76,2960,2.5,2.5,2.5,"25% - 50% P.O.C.","$95000 or more"
"06037143500","Census Tract 1435, Los Angeles County, California",5482,108542,4211,319,0,143,40,494,76.8,5.8,0,2.6,0.7,9,23.2,2297,978,1319,42.58,57.42,18,960,18,1301,36,2261,1.8,1.4,1.6,"Less than 25% P.O.C.","$95000 or more"
"06037143602","Census Tract 1436.02, Los Angeles County, California",4769,106442,3487,207,0,664,0,266,73.1,4.3,0,13.9,0,5.6,26.9,2182,1235,947,56.6,43.4,21,1214,18,929,39,2143,1.7,1.9,1.8,"25% - 50% P.O.C.","$95000 or more"
"06037143603","Census Tract 1436.03, Los Angeles County, California",2392,87000,1785,60,0,230,0,170,74.6,2.5,0,9.6,0,7.1,25.4,1354,395,959,29.17,70.83,0,395,0,959,0,1354,0,0,0,"25% - 50% P.O.C.","$70000 - $95000"
"06037143604","Census Tract 1436.04, Los Angeles County, California",3720,82199,2124,343,52,711,0,246,57.1,9.2,1.4,19.1,0,6.6,42.9,2087,101,1986,4.84,95.16,0,101,5,1981,5,2082,0,0.3,0.2,"25% - 50% P.O.C.","$70000 - $95000"
"06037143700","Census Tract 1437, Los Angeles County, California",3811,111985,3000,37,0,243,32,231,78.7,1,0,6.4,0.8,6.1,21.3,1825,1365,460,74.79,25.21,31,1334,0,460,31,1794,2.3,0,1.7,"Less than 25% P.O.C.","$95000 or more"
"06037143800","Census Tract 1438, Los Angeles County, California",5770,138151,4345,268,0,382,0,642,75.3,4.6,0,6.6,0,11.1,24.7,2395,1307,1088,54.57,45.43,81,1226,0,1088,81,2314,6.2,0,3.4,"Less than 25% P.O.C.","$95000 or more"
"06037143901","Census Tract 1439.01, Los Angeles County, California",4069,212188,3255,32,0,170,0,439,80,0.8,0,4.2,0,10.8,20,1506,1346,160,89.38,10.62,114,1232,10,150,124,1382,8.5,6.2,8.2,"Less than 25% P.O.C.","$95000 or more"
"06037143902","Census Tract 1439.02, Los Angeles County, California",2766,110508,2197,41,0,173,0,297,79.4,1.5,0,6.3,0,10.7,20.6,1295,717,578,55.37,44.63,36,681,8,570,44,1251,5,1.4,3.4,"Less than 25% P.O.C.","$95000 or more"
"06037181000","Census Tract 1810, Los Angeles County, California",6458,116958,2252,25,41,1581,0,2274,34.9,0.4,0.6,24.5,0,35.2,65.1,2183,1541,642,70.59,29.41,227,1314,16,626,243,1940,14.7,2.5,11.1,"50% - 75% P.O.C.","$95000 or more"
"06037181300","Census Tract 1813, Los Angeles County, California",4059,110508,1461,64,0,1266,0,1124,36,1.6,0,31.2,0,27.7,64,1327,869,458,65.49,34.51,105,764,84,374,189,1138,12.1,18.3,14.2,"50% - 75% P.O.C.","$95000 or more"
"06037181400","Census Tract 1814, Los Angeles County, California",4943,85262,1254,114,9,1727,0,1780,25.4,2.3,0.2,34.9,0,36,74.6,1645,507,1138,30.82,69.18,27,480,132,1006,159,1486,5.3,11.6,9.7,"50% - 75% P.O.C.","$70000 - $95000"
"06037181500","Census Tract 1815, Los Angeles County, California",3956,98250,1428,34,0,836,64,1528,36.1,0.9,0,21.1,1.6,38.6,63.9,1428,1035,393,72.48,27.52,81,954,67,326,148,1280,7.8,17,10.4,"50% - 75% P.O.C.","$95000 or more"
"06037181600","Census Tract 1816, Los Angeles County, California",4631,82443,1499,130,0,1079,58,1524,32.4,2.8,0,23.3,1.3,32.9,67.6,1029,458,571,44.51,55.49,88,370,58,513,146,883,19.2,10.2,14.2,"50% - 75% P.O.C.","$70000 - $95000"
"06037183101","Census Tract 1831.01, Los Angeles County, California",3323,54548,983,7,15,361,0,1877,29.6,0.2,0.5,10.9,0,56.5,70.4,1343,693,650,51.6,48.4,51,642,48,602,99,1244,7.4,7.4,7.4,"50% - 75% P.O.C.","$51000 - $70000"
"06037183103","Census Tract 1831.03, Los Angeles County, California",4355,61719,577,267,79,396,0,2914,13.2,6.1,1.8,9.1,0,66.9,86.8,1503,280,1223,18.63,81.37,69,211,130,1093,199,1304,24.6,10.6,13.2,"75% or more P.O.C.","$51000 - $70000"
"06037183104","Census Tract 1831.04, Los Angeles County, California",2146,92806,558,44,0,343,6,1152,26,2.1,0,16,0.3,53.7,74,767,521,246,67.93,32.07,71,450,17,229,88,679,13.6,6.9,11.5,"50% - 75% P.O.C.","$70000 - $95000"
"06037183220","Census Tract 1832.20, Los Angeles County, California",4155,63899,674,8,4,583,0,2682,16.2,0.2,0.1,14,0,64.5,83.8,1205,543,662,45.06,54.94,134,409,42,620,176,1029,24.7,6.3,14.6,"75% or more P.O.C.","$51000 - $70000"
"06037183221","Census Tract 1832.21, Los Angeles County, California",3522,60048,603,1,12,344,0,2522,17.1,0,0.3,9.8,0,71.6,82.9,1083,455,628,42.01,57.99,46,409,173,455,219,864,10.1,27.5,20.2,"75% or more P.O.C.","$51000 - $70000"
"06037183222","Census Tract 1832.22, Los Angeles County, California",3493,79861,1237,111,0,588,0,1394,35.4,3.2,0,16.8,0,39.9,64.6,1339,808,531,60.34,39.66,84,724,30,501,114,1225,10.4,5.6,8.5,"50% - 75% P.O.C.","$70000 - $95000"
"06037183300","Census Tract 1833, Los Angeles County, California",3487,75233,609,16,0,654,0,2177,17.5,0.5,0,18.8,0,62.4,82.5,1020,492,528,48.24,51.76,150,342,54,474,204,816,30.5,10.2,20,"75% or more P.O.C.","$70000 - $95000"
"06037183401","Census Tract 1834.01, Los Angeles County, California",2531,61875,583,6,0,432,11,1434,23,0.2,0,17.1,0.4,56.7,77,844,446,398,52.84,47.16,40,406,77,321,117,727,9,19.3,13.9,"75% or more P.O.C.","$51000 - $70000"
"06037183402","Census Tract 1834.02, Los Angeles County, California",3006,65568,690,82,6,935,0,1152,23,2.7,0.2,31.1,0,38.3,77,955,268,687,28.06,71.94,32,236,88,599,120,835,11.9,12.8,12.6,"75% or more P.O.C.","$51000 - $70000"
"06037183510","Census Tract 1835.10, Los Angeles County, California",2577,75486,549,0,0,214,0,1800,21.3,0,0,8.3,0,69.8,78.7,783,593,190,75.73,24.27,97,496,30,160,127,656,16.4,15.8,16.2,"75% or more P.O.C.","$70000 - $95000"
"06037183520","Census Tract 1835.20, Los Angeles County, California",3758,52232,553,9,1,76,0,2986,14.7,0.2,0,2,0,79.5,85.3,1137,328,809,28.85,71.15,106,222,70,739,176,961,32.3,8.7,15.5,"75% or more P.O.C.","$51000 - $70000"
"06037183610","Census Tract 1836.10, Los Angeles County, California",3215,57727,392,21,10,286,12,2382,12.2,0.7,0.3,8.9,0.4,74.1,87.8,994,327,667,32.9,67.1,104,223,111,556,215,779,31.8,16.6,21.6,"75% or more P.O.C.","$51000 - $70000"
"06037183620","Census Tract 1836.20, Los Angeles County, California",3111,55909,582,95,18,404,0,1947,18.7,3.1,0.6,13,0,62.6,81.3,994,468,526,47.08,52.92,57,411,94,432,151,843,12.2,17.9,15.2,"75% or more P.O.C.","$51000 - $70000"
"06037183701","Census Tract 1837.01, Los Angeles County, California",3720,48654,762,67,21,362,17,2397,20.5,1.8,0.6,9.7,0.5,64.4,79.5,1338,501,837,37.44,62.56,73,428,51,786,124,1214,14.6,6.1,9.3,"75% or more P.O.C.","Less than $51000"
"06037183702","Census Tract 1837.02, Los Angeles County, California",2775,62778,488,153,0,348,0,1635,17.6,5.5,0,12.5,0,58.9,82.4,1054,462,592,43.83,56.17,43,419,0,592,43,1011,9.3,0,4.1,"75% or more P.O.C.","$51000 - $70000"
"06037183810","Census Tract 1838.10, Los Angeles County, California",4163,59906,547,62,17,151,0,3353,13.1,1.5,0.4,3.6,0,80.5,86.9,1302,177,1125,13.59,86.41,42,135,208,917,250,1052,23.7,18.5,19.2,"75% or more P.O.C.","$51000 - $70000"
"06037183820","Census Tract 1838.20, Los Angeles County, California",3445,46477,344,94,14,320,0,2612,10,2.7,0.4,9.3,0,75.8,90,1140,257,883,22.54,77.46,22,235,127,756,149,991,8.6,14.4,13.1,"75% or more P.O.C.","Less than $51000"
"06037185100","Census Tract 1851, Los Angeles County, California",6070,109886,2217,217,0,803,0,2655,36.5,3.6,0,13.2,0,43.7,63.5,2233,1367,866,61.22,38.78,130,1237,20,846,150,2083,9.5,2.3,6.7,"50% - 75% P.O.C.","$95000 or more"
"06037185202","Census Tract 1852.02, Los Angeles County, California",3627,64623,1179,90,0,393,0,1942,32.5,2.5,0,10.8,0,53.5,67.5,1360,685,675,50.37,49.63,35,650,70,605,105,1255,5.1,10.4,7.7,"50% - 75% P.O.C.","$51000 - $70000"
"06037185203","Census Tract 1852.03, Los Angeles County, California",3566,49698,395,23,0,288,0,2762,11.1,0.6,0,8.1,0,77.5,88.9,989,366,623,37.01,62.99,65,301,137,486,202,787,17.8,22,20.4,"75% or more P.O.C.","Less than $51000"
"06037185204","Census Tract 1852.04, Los Angeles County, California",1921,86971,603,32,0,563,0,617,31.4,1.7,0,29.3,0,32.1,68.6,701,528,173,75.32,24.68,30,498,20,153,50,651,5.7,11.6,7.1,"50% - 75% P.O.C.","$70000 - $95000"
"06037185310","Census Tract 1853.10, Los Angeles County, California",3131,64671,187,41,0,272,4,2627,6,1.3,0,8.7,0.1,83.9,94,856,319,537,37.27,62.73,91,228,103,434,194,662,28.5,19.2,22.7,"75% or more P.O.C.","$51000 - $70000"
"06037185320","Census Tract 1853.20, Los Angeles County, California",2991,42202,297,18,0,154,0,2522,9.9,0.6,0,5.1,0,84.3,90.1,855,297,558,34.74,65.26,51,246,130,428,181,674,17.2,23.3,21.2,"75% or more P.O.C.","Less than $51000"
"06037186100","Census Tract 1861, Los Angeles County, California",4985,92569,1655,111,0,1340,0,1634,33.2,2.2,0,26.9,0,32.8,66.8,1853,1207,646,65.14,34.86,123,1084,0,646,123,1730,10.2,0,6.6,"50% - 75% P.O.C.","$70000 - $95000"
"06037186201","Census Tract 1862.01, Los Angeles County, California",3201,61733,368,134,0,1004,0,1629,11.5,4.2,0,31.4,0,50.9,88.5,1177,263,914,22.34,77.66,59,204,57,857,116,1061,22.4,6.2,9.9,"75% or more P.O.C.","$51000 - $70000"
"06037186202","Census Tract 1862.02, Los Angeles County, California",2007,95089,511,26,0,543,0,876,25.5,1.3,0,27.1,0,43.6,74.5,711,380,331,53.45,46.55,23,357,46,285,69,642,6.1,13.9,9.7,"50% - 75% P.O.C.","$95000 or more"
"06037186203","Census Tract 1862.03, Los Angeles County, California",3416,114461,1106,30,0,472,0,1569,32.4,0.9,0,13.8,0,45.9,67.6,1116,925,191,82.89,17.11,89,836,48,143,137,979,9.6,25.1,12.3,"50% - 75% P.O.C.","$95000 or more"
"06037186301","Census Tract 1863.01, Los Angeles County, California",2906,53125,514,193,0,130,0,2002,17.7,6.6,0,4.5,0,68.9,82.3,889,247,642,27.78,72.22,43,204,101,541,144,745,17.4,15.7,16.2,"75% or more P.O.C.","$51000 - $70000"
"06037186302","Census Tract 1863.02, Los Angeles County, California",5096,78264,1441,59,0,875,0,2502,28.3,1.2,0,17.2,0,49.1,71.7,1849,1067,782,57.71,42.29,108,959,39,743,147,1702,10.1,5,8,"50% - 75% P.O.C.","$70000 - $95000"
"06037186401","Census Tract 1864.01, Los Angeles County, California",3489,41450,215,0,0,491,0,2775,6.2,0,0,14.1,0,79.5,93.8,1001,122,879,12.19,87.81,14,108,215,664,229,772,11.5,24.5,22.9,"75% or more P.O.C.","Less than $51000"
"06037186403","Census Tract 1864.03, Los Angeles County, California",2698,59861,270,41,0,618,0,1747,10,1.5,0,22.9,0,64.8,90,835,377,458,45.15,54.85,67,310,72,386,139,696,17.8,15.7,16.6,"75% or more P.O.C.","$51000 - $70000"
"06037186404","Census Tract 1864.04, Los Angeles County, California",2631,62083,301,14,0,497,0,1819,11.4,0.5,0,18.9,0,69.1,88.6,772,248,524,32.12,67.88,52,196,83,441,135,637,21,15.8,17.5,"75% or more P.O.C.","$51000 - $70000"
"06037187101","Census Tract 1871.01, Los Angeles County, California",3438,76522,1240,24,0,689,0,1426,36.1,0.7,0,20,0,41.5,63.9,1228,559,669,45.52,54.48,46,513,30,639,76,1152,8.2,4.5,6.2,"50% - 75% P.O.C.","$70000 - $95000"
"06037187102","Census Tract 1871.02, Los Angeles County, California",3739,56683,740,80,15,715,28,2087,19.8,2.1,0.4,19.1,0.7,55.8,80.2,1379,516,863,37.42,62.58,47,469,62,801,109,1270,9.1,7.2,7.9,"75% or more P.O.C.","$51000 - $70000"
"06037187200","Census Tract 1872, Los Angeles County, California",2963,76042,373,6,0,283,17,2210,12.6,0.2,0,9.6,0.6,74.6,87.4,933,372,561,39.87,60.13,71,301,120,441,191,742,19.1,21.4,20.5,"75% or more P.O.C.","$70000 - $95000"
"06037187300","Census Tract 1873, Los Angeles County, California",3597,112250,2081,36,0,506,0,788,57.9,1,0,14.1,0,21.9,42.1,1515,676,839,44.62,55.38,35,641,40,799,75,1440,5.2,4.8,5,"25% - 50% P.O.C.","$95000 or more"
"06037188100","Census Tract 1881, Los Angeles County, California",3918,62500,1077,58,0,312,0,2221,27.5,1.5,0,8,0,56.7,72.5,1720,477,1243,27.73,72.27,28,449,80,1163,108,1612,5.9,6.4,6.3,"50% - 75% P.O.C.","$51000 - $70000"
"06037188201","Census Tract 1882.01, Los Angeles County, California",3473,81475,2213,136,105,432,0,460,63.7,3.9,3,12.4,0,13.2,36.3,1811,251,1560,13.86,86.14,21,230,16,1544,37,1774,8.4,1,2,"25% - 50% P.O.C.","$70000 - $95000"
"06037188202","Census Tract 1882.02, Los Angeles County, California",2426,113267,1572,88,0,350,0,277,64.8,3.6,0,14.4,0,11.4,35.2,1171,623,548,53.2,46.8,0,623,14,534,14,1157,0,2.6,1.2,"25% - 50% P.O.C.","$95000 or more"
"06037188300","Census Tract 1883, Los Angeles County, California",3800,114318,1337,13,126,1009,0,1122,35.2,0.3,3.3,26.6,0,29.5,64.8,1390,698,692,50.22,49.78,84,614,22,670,106,1284,12,3.2,7.6,"50% - 75% P.O.C.","$95000 or more"
"06037189101","Census Tract 1891.01, Los Angeles County, California",2521,81591,1750,11,0,478,10,201,69.4,0.4,0,19,0.4,8,30.6,1316,243,1073,18.47,81.53,16,227,9,1064,25,1291,6.6,0.8,1.9,"25% - 50% P.O.C.","$70000 - $95000"
"06037189102","Census Tract 1891.02, Los Angeles County, California",3356,85708,2331,25,0,205,38,598,69.5,0.7,0,6.1,1.1,17.8,30.5,1934,402,1532,20.79,79.21,38,364,26,1506,64,1870,9.5,1.7,3.3,"25% - 50% P.O.C.","$70000 - $95000"
"06037189201","Census Tract 1892.01, Los Angeles County, California",3216,41950,2321,145,0,278,0,356,72.2,4.5,0,8.6,0,11.1,27.8,1943,118,1825,6.07,93.93,23,95,2,1823,25,1918,19.5,0.1,1.3,"25% - 50% P.O.C.","Less than $51000"
"06037189202","Census Tract 1892.02, Los Angeles County, California",2396,118018,1882,20,0,194,0,184,78.5,0.8,0,8.1,0,7.7,21.5,1153,582,571,50.48,49.52,2,580,10,561,12,1141,0.3,1.8,1,"Less than 25% P.O.C.","$95000 or more"
"06037189300","Census Tract 1893, Los Angeles County, California",3117,174293,2421,93,0,349,0,204,77.7,3,0,11.2,0,6.5,22.3,1315,1168,147,88.82,11.18,91,1077,6,141,97,1218,7.8,4.1,7.4,"Less than 25% P.O.C.","$95000 or more"
"06037189400","Census Tract 1894, Los Angeles County, California",3164,156154,2390,188,0,139,0,247,75.5,5.9,0,4.4,0,7.8,24.5,1628,976,652,59.95,40.05,40,936,0,652,40,1588,4.1,0,2.5,"Less than 25% P.O.C.","$95000 or more"
"06037189500","Census Tract 1895, Los Angeles County, California",4180,54265,2949,66,0,268,11,731,70.6,1.6,0,6.4,0.3,17.5,29.4,2666,416,2250,15.6,84.4,0,416,0,2250,0,2666,0,0,0,"25% - 50% P.O.C.","$51000 - $70000"
"06037189600","Census Tract 1896, Los Angeles County, California",3939,74760,2814,121,14,194,0,581,71.4,3.1,0.4,4.9,0,14.7,28.6,1999,666,1333,33.32,66.68,14,652,18,1315,32,1967,2.1,1.4,1.6,"25% - 50% P.O.C.","$70000 - $95000"
"06037189701","Census Tract 1897.01, Los Angeles County, California",3228,100256,2300,172,0,315,0,324,71.3,5.3,0,9.8,0,10,28.7,1743,1032,711,59.21,40.79,61,971,17,694,78,1665,5.9,2.4,4.5,"25% - 50% P.O.C.","$95000 or more"
"06037189702","Census Tract 1897.02, Los Angeles County, California",2201,96793,1738,133,0,44,0,189,79,6,0,2,0,8.6,21,1301,728,573,55.96,44.04,0,728,0,573,0,1301,0,0,0,"Less than 25% P.O.C.","$95000 or more"
"06037189800","Census Tract 1898, Los Angeles County, California",3833,69616,2741,211,0,89,0,584,71.5,5.5,0,2.3,0,15.2,28.5,2286,538,1748,23.53,76.47,30,508,0,1748,30,2256,5.6,0,1.3,"25% - 50% P.O.C.","$51000 - $70000"
"06037189902","Census Tract 1899.02, Los Angeles County, California",5371,63214,3831,137,0,804,0,519,71.3,2.6,0,15,0,9.7,28.7,3048,135,2913,4.43,95.57,0,135,0,2913,0,3048,0,0,0,"25% - 50% P.O.C.","$51000 - $70000"
"06037189903","Census Tract 1899.03, Los Angeles County, California",2089,64975,1479,95,0,167,0,312,70.8,4.5,0,8,0,14.9,29.2,1513,446,1067,29.48,70.52,0,446,0,1067,0,1513,0,0,0,"25% - 50% P.O.C.","$51000 - $70000"
"06037189904","Census Tract 1899.04, Los Angeles County, California",2435,49960,1511,212,0,119,1,453,62.1,8.7,0,4.9,0,18.6,37.9,1505,27,1478,1.79,98.21,0,27,0,1478,0,1505,0,0,0,"25% - 50% P.O.C.","Less than $51000"
"06037189905","Census Tract 1899.05, Los Angeles County, California",2432,72837,1897,114,0,119,0,269,78,4.7,0,4.9,0,11.1,22,1465,318,1147,21.71,78.29,9,309,0,1147,9,1456,2.8,0,0.6,"Less than 25% P.O.C.","$70000 - $95000"
"06037190100","Census Tract 1901, Los Angeles County, California",4453,53778,2240,364,19,583,0,1034,50.3,8.2,0.4,13.1,0,23.2,49.7,2654,59,2595,2.22,97.78,0,59,0,2595,0,2654,0,0,0,"25% - 50% P.O.C.","$51000 - $70000"
"06037190201","Census Tract 1902.01, Los Angeles County, California",2632,30053,1147,230,37,97,0,996,43.6,8.7,1.4,3.7,0,37.8,56.4,1279,15,1264,1.17,98.83,0,15,21,1243,21,1258,0,1.7,1.6,"50% - 75% P.O.C.","Less than $51000"
"06037190202","Census Tract 1902.02, Los Angeles County, California",3225,32418,1508,404,0,318,0,682,46.8,12.5,0,9.9,0,21.1,53.2,2307,24,2283,1.04,98.96,0,24,0,2283,0,2307,0,0,0,"50% - 75% P.O.C.","Less than $51000"
"06037190301","Census Tract 1903.01, Los Angeles County, California",5569,44986,2781,621,27,635,0,1230,49.9,11.2,0.5,11.4,0,22.1,50.1,2803,175,2628,6.24,93.76,4,171,0,2628,4,2799,2.3,0,0.1,"50% - 75% P.O.C.","Less than $51000"
"06037190401","Census Tract 1904.01, Los Angeles County, California",2977,48188,1691,22,0,345,0,798,56.8,0.7,0,11.6,0,26.8,43.2,1756,23,1733,1.31,98.69,0,23,0,1733,0,1756,0,0,0,"25% - 50% P.O.C.","Less than $51000"
"06037190402","Census Tract 1904.02, Los Angeles County, California",2372,40000,1439,137,0,400,0,355,60.7,5.8,0,16.9,0,15,39.3,1366,11,1355,0.81,99.19,0,11,29,1326,29,1337,0,2.1,2.1,"25% - 50% P.O.C.","Less than $51000"
"06037190510","Census Tract 1905.10, Los Angeles County, California",4051,41950,1447,251,0,665,10,1609,35.7,6.2,0,16.4,0.2,39.7,64.3,1712,0,1712,0,100,0,0,136,1576,136,1576,NA,7.9,7.9,"50% - 75% P.O.C.","Less than $51000"
"06037190520","Census Tract 1905.20, Los Angeles County, California",3979,41011,1275,86,0,861,0,1710,32,2.2,0,21.6,0,43,68,1604,117,1487,7.29,92.71,0,117,99,1388,99,1505,0,6.7,6.2,"50% - 75% P.O.C.","Less than $51000"
"06037190700","Census Tract 1907, Los Angeles County, California",2685,43877,1496,156,8,185,0,604,55.7,5.8,0.3,6.9,0,22.5,44.3,1705,224,1481,13.14,86.86,0,224,40,1441,40,1665,0,2.7,2.3,"25% - 50% P.O.C.","Less than $51000"
"06037190801","Census Tract 1908.01, Los Angeles County, California",2682,25858,950,279,16,219,0,1168,35.4,10.4,0.6,8.2,0,43.5,64.6,1273,78,1195,6.13,93.87,18,60,8,1187,26,1247,23.1,0.7,2,"50% - 75% P.O.C.","Less than $51000"
"06037190802","Census Tract 1908.02, Los Angeles County, California",2982,50167,921,244,0,159,0,1328,30.9,8.2,0,5.3,0,44.5,69.1,1370,157,1213,11.46,88.54,0,157,35,1178,35,1335,0,2.9,2.6,"50% - 75% P.O.C.","Less than $51000"
"06037190901","Census Tract 1909.01, Los Angeles County, California",4587,38140,427,316,0,163,0,3568,9.3,6.9,0,3.6,0,77.8,90.7,1414,101,1313,7.14,92.86,23,78,226,1087,249,1165,22.8,17.2,17.6,"75% or more P.O.C.","Less than $51000"
"06037190902","Census Tract 1909.02, Los Angeles County, California",3518,46406,1100,188,0,115,0,2018,31.3,5.3,0,3.3,0,57.4,68.7,1518,83,1435,5.47,94.53,19,64,126,1309,145,1373,22.9,8.8,9.6,"50% - 75% P.O.C.","Less than $51000"
"06037191000","Census Tract 1910, Los Angeles County, California",4454,64816,1805,480,0,330,0,1709,40.5,10.8,0,7.4,0,38.4,59.5,2389,132,2257,5.53,94.47,0,132,70,2187,70,2319,0,3.1,2.9,"50% - 75% P.O.C.","$51000 - $70000"
"06037191110","Census Tract 1911.10, Los Angeles County, California",3478,37700,1896,103,0,398,0,1000,54.5,3,0,11.4,0,28.8,45.5,1032,40,992,3.88,96.12,6,34,49,943,55,977,15,4.9,5.3,"25% - 50% P.O.C.","Less than $51000"
"06037191120","Census Tract 1911.20, Los Angeles County, California",3900,40071,1256,56,34,663,25,1828,32.2,1.4,0.9,17,0.6,46.9,67.8,1571,160,1411,10.18,89.82,8,152,91,1320,99,1472,5,6.4,6.3,"50% - 75% P.O.C.","Less than $51000"
"06037191201","Census Tract 1912.01, Los Angeles County, California",4414,45332,2107,110,0,662,5,1381,47.7,2.5,0,15,0.1,31.3,52.3,1629,109,1520,6.69,93.31,0,109,54,1466,54,1575,0,3.6,3.3,"50% - 75% P.O.C.","Less than $51000"
"06037191203","Census Tract 1912.03, Los Angeles County, California",2383,26919,517,101,0,685,0,1029,21.7,4.2,0,28.7,0,43.2,78.3,1166,53,1113,4.55,95.45,0,53,68,1045,68,1098,0,6.1,5.8,"75% or more P.O.C.","Less than $51000"
"06037191204","Census Tract 1912.04, Los Angeles County, California",2033,41453,610,33,0,358,39,970,30,1.6,0,17.6,1.9,47.7,70,860,68,792,7.91,92.09,6,62,40,752,46,814,8.8,5.1,5.3,"50% - 75% P.O.C.","Less than $51000"
"06037191301","Census Tract 1913.01, Los Angeles County, California",2224,36875,424,114,0,402,0,1274,19.1,5.1,0,18.1,0,57.3,80.9,940,108,832,11.49,88.51,11,97,94,738,105,835,10.2,11.3,11.2,"75% or more P.O.C.","Less than $51000"
"06037191302","Census Tract 1913.02, Los Angeles County, California",1947,45982,511,20,0,364,0,1016,26.2,1,0,18.7,0,52.2,73.8,862,89,773,10.32,89.68,0,89,39,734,39,823,0,5,4.5,"50% - 75% P.O.C.","Less than $51000"
"06037191410","Census Tract 1914.10, Los Angeles County, California",4646,42538,778,300,0,750,0,2770,16.7,6.5,0,16.1,0,59.6,83.3,1627,72,1555,4.43,95.57,27,45,164,1391,191,1436,37.5,10.5,11.7,"75% or more P.O.C.","Less than $51000"
"06037191420","Census Tract 1914.20, Los Angeles County, California",3096,61190,611,35,0,431,0,1938,19.7,1.1,0,13.9,0,62.6,80.3,1184,54,1130,4.56,95.44,0,54,104,1026,104,1080,0,9.2,8.8,"75% or more P.O.C.","$51000 - $70000"
"06037191500","Census Tract 1915, Los Angeles County, California",5931,49726,888,49,11,1297,0,3559,15,0.8,0.2,21.9,0,60,85,1789,403,1386,22.53,77.47,140,263,171,1215,311,1478,34.7,12.3,17.4,"75% or more P.O.C.","Less than $51000"
"06037191610","Census Tract 1916.10, Los Angeles County, California",4237,48767,826,248,0,678,0,2432,19.5,5.9,0,16,0,57.4,80.5,1433,140,1293,9.77,90.23,57,83,134,1159,191,1242,40.7,10.4,13.3,"75% or more P.O.C.","Less than $51000"
"06037191620","Census Tract 1916.20, Los Angeles County, California",2532,27306,413,235,0,281,0,1603,16.3,9.3,0,11.1,0,63.3,83.7,1077,82,995,7.61,92.39,6,76,42,953,48,1029,7.3,4.2,4.5,"75% or more P.O.C.","Less than $51000"
"06037191710","Census Tract 1917.10, Los Angeles County, California",2937,30085,585,171,0,205,0,1901,19.9,5.8,0,7,0,64.7,80.1,1244,74,1170,5.95,94.05,12,62,101,1069,113,1131,16.2,8.6,9.1,"75% or more P.O.C.","Less than $51000"
"06037191720","Census Tract 1917.20, Los Angeles County, California",3224,32355,487,152,0,268,0,2275,15.1,4.7,0,8.3,0,70.6,84.9,1197,92,1105,7.69,92.31,0,92,120,985,120,1077,0,10.9,10,"75% or more P.O.C.","Less than $51000"
"06037191810","Census Tract 1918.10, Los Angeles County, California",3367,49491,756,210,0,40,0,2279,22.5,6.2,0,1.2,0,67.7,77.5,1259,57,1202,4.53,95.47,0,57,103,1099,103,1156,0,8.6,8.2,"75% or more P.O.C.","Less than $51000"
"06037191820","Census Tract 1918.20, Los Angeles County, California",3176,56996,1236,253,10,176,0,1347,38.9,8,0.3,5.5,0,42.4,61.1,1449,121,1328,8.35,91.65,0,121,93,1235,93,1356,0,7,6.4,"50% - 75% P.O.C.","$51000 - $70000"
"06037191901","Census Tract 1919.01, Los Angeles County, California",3060,57000,1731,234,0,147,0,813,56.6,7.6,0,4.8,0,26.6,43.4,1740,84,1656,4.83,95.17,0,84,35,1621,35,1705,0,2.1,2,"25% - 50% P.O.C.","$51000 - $70000"
"06037191902","Census Tract 1919.02, Los Angeles County, California",2788,94432,2200,18,1,179,0,255,78.9,0.6,0,6.4,0,9.1,21.1,1411,652,759,46.21,53.79,51,601,3,756,54,1357,7.8,0.4,3.8,"Less than 25% P.O.C.","$70000 - $95000"
"06037192001","Census Tract 1920.01, Los Angeles County, California",2370,74063,1691,156,28,210,0,216,71.4,6.6,1.2,8.9,0,9.1,28.6,1149,222,927,19.32,80.68,10,212,15,912,25,1124,4.5,1.6,2.2,"25% - 50% P.O.C.","$70000 - $95000"
"06037192002","Census Tract 1920.02, Los Angeles County, California",2597,111111,1877,72,0,179,29,183,72.3,2.8,0,6.9,1.1,7,27.7,1244,584,660,46.95,53.05,23,561,18,642,41,1203,3.9,2.7,3.3,"25% - 50% P.O.C.","$95000 or more"
"06037192300","Census Tract 1923, Los Angeles County, California",2463,88988,1504,27,0,461,0,272,61.1,1.1,0,18.7,0,11,38.9,1375,500,875,36.36,63.64,17,483,0,875,17,1358,3.4,0,1.2,"25% - 50% P.O.C.","$70000 - $95000"
"06037192410","Census Tract 1924.10, Los Angeles County, California",3700,73750,1682,168,0,832,0,780,45.5,4.5,0,22.5,0,21.1,54.5,1719,635,1084,36.94,63.06,76,559,38,1046,114,1605,12,3.5,6.6,"50% - 75% P.O.C.","$70000 - $95000"
"06037192420","Census Tract 1924.20, Los Angeles County, California",4280,56194,527,262,0,1188,6,2160,12.3,6.1,0,27.8,0.1,50.5,87.7,1393,148,1245,10.62,89.38,27,121,208,1037,235,1158,18.2,16.7,16.9,"75% or more P.O.C.","$51000 - $70000"
"06037192510","Census Tract 1925.10, Los Angeles County, California",3840,49464,231,14,0,1479,14,2009,6,0.4,0,38.5,0.4,52.3,94,1241,283,958,22.8,77.2,55,228,115,843,170,1071,19.4,12,13.7,"75% or more P.O.C.","Less than $51000"
"06037192520","Census Tract 1925.20, Los Angeles County, California",5269,45823,302,53,0,792,47,4052,5.7,1,0,15,0.9,76.9,94.3,1558,62,1496,3.98,96.02,12,50,352,1144,364,1194,19.4,23.5,23.4,"75% or more P.O.C.","Less than $51000"
"06037192610","Census Tract 1926.10, Los Angeles County, California",3703,35948,551,142,0,361,0,2572,14.9,3.8,0,9.7,0,69.5,85.1,1326,84,1242,6.33,93.67,0,84,171,1071,171,1155,0,13.8,12.9,"75% or more P.O.C.","Less than $51000"
"06037192620","Census Tract 1926.20, Los Angeles County, California",3542,40850,145,42,0,807,0,2520,4.1,1.2,0,22.8,0,71.1,95.9,1137,41,1096,3.61,96.39,14,27,152,944,166,971,34.1,13.9,14.6,"75% or more P.O.C.","Less than $51000"
"06037192700","Census Tract 1927, Los Angeles County, California",3449,52603,411,66,0,636,0,2146,11.9,1.9,0,18.4,0,62.2,88.1,1027,126,901,12.27,87.73,13,113,102,799,115,912,10.3,11.3,11.2,"75% or more P.O.C.","$51000 - $70000"
"06037194101","Census Tract 1941.01, Los Angeles County, California",3277,86417,2294,346,0,189,0,249,70,10.6,0,5.8,0,7.6,30,1631,580,1051,35.56,64.44,29,551,34,1017,63,1568,5,3.2,3.9,"25% - 50% P.O.C.","$70000 - $95000"
"06037194102","Census Tract 1941.02, Los Angeles County, California",3189,122829,2375,220,0,210,0,260,74.5,6.9,0,6.6,0,8.2,25.5,1531,1190,341,77.73,22.27,56,1134,14,327,70,1461,4.7,4.1,4.6,"25% - 50% P.O.C.","$95000 or more"
"06037194200","Census Tract 1942, Los Angeles County, California",3524,168227,2643,102,19,128,0,171,75,2.9,0.5,3.6,0,4.9,25,1463,1149,314,78.54,21.46,18,1131,55,259,73,1390,1.6,17.5,5,"25% - 50% P.O.C.","$95000 or more"
"06037194300","Census Tract 1943, Los Angeles County, California",3262,177383,2463,83,0,118,0,515,75.5,2.5,0,3.6,0,15.8,24.5,1451,1055,396,72.71,27.29,64,991,16,380,80,1371,6.1,4,5.5,"Less than 25% P.O.C.","$95000 or more"
"06037194401","Census Tract 1944.01, Los Angeles County, California",2391,86800,1538,180,11,149,0,405,64.3,7.5,0.5,6.2,0,16.9,35.7,1234,247,987,20.02,79.98,0,247,0,987,0,1234,0,0,0,"25% - 50% P.O.C.","$70000 - $95000"
"06037194402","Census Tract 1944.02, Los Angeles County, California",3579,100368,3037,22,0,373,0,84,84.9,0.6,0,10.4,0,2.3,15.1,2028,642,1386,31.66,68.34,0,642,0,1386,0,2028,0,0,0,"Less than 25% P.O.C.","$95000 or more"
"06037194500","Census Tract 1945, Los Angeles County, California",2019,113571,1597,94,0,142,0,133,79.1,4.7,0,7,0,6.6,20.9,944,476,468,50.42,49.58,46,430,11,457,57,887,9.7,2.4,6,"Less than 25% P.O.C.","$95000 or more"
"06037195100","Census Tract 1951, Los Angeles County, California",4978,127768,2974,123,24,692,0,907,59.7,2.5,0.5,13.9,0,18.2,40.3,2065,1290,775,62.47,37.53,129,1161,0,775,129,1936,10,0,6.2,"25% - 50% P.O.C.","$95000 or more"
"06037195201","Census Tract 1952.01, Los Angeles County, California",3128,85114,2056,21,0,340,0,648,65.7,0.7,0,10.9,0,20.7,34.3,1645,283,1362,17.2,82.8,10,273,7,1355,17,1628,3.5,0.5,1,"25% - 50% P.O.C.","$70000 - $95000"
"06037195202","Census Tract 1952.02, Los Angeles County, California",3304,117630,2385,45,0,387,23,311,72.2,1.4,0,11.7,0.7,9.4,27.8,1411,742,669,52.59,47.41,20,722,37,632,57,1354,2.7,5.5,4,"25% - 50% P.O.C.","$95000 or more"
"06037195300","Census Tract 1953, Los Angeles County, California",3089,75104,1736,48,0,295,0,937,56.2,1.6,0,9.6,0,30.3,43.8,1419,308,1111,21.71,78.29,0,308,58,1053,58,1361,0,5.2,4.1,"25% - 50% P.O.C.","$70000 - $95000"
"06037195400","Census Tract 1954, Los Angeles County, California",4451,98461,2703,63,0,477,0,1075,60.7,1.4,0,10.7,0,24.2,39.3,2229,782,1447,35.08,64.92,54,728,0,1447,54,2175,6.9,0,2.4,"25% - 50% P.O.C.","$95000 or more"
"06037195500","Census Tract 1955, Los Angeles County, California",5548,99660,2444,86,0,1058,24,1757,44.1,1.6,0,19.1,0.4,31.7,55.9,2400,1141,1259,47.54,52.46,141,1000,0,1259,141,2259,12.4,0,5.9,"50% - 75% P.O.C.","$95000 or more"
"06037195600","Census Tract 1956, Los Angeles County, California",2948,72035,969,25,0,414,0,1415,32.9,0.8,0,14,0,48,67.1,1256,375,881,29.86,70.14,26,349,94,787,120,1136,6.9,10.7,9.6,"50% - 75% P.O.C.","$70000 - $95000"
"06037195710","Census Tract 1957.10, Los Angeles County, California",4487,45398,798,183,0,487,19,2897,17.8,4.1,0,10.9,0.4,64.6,82.2,1367,234,1133,17.12,82.88,48,186,137,996,185,1182,20.5,12.1,13.5,"75% or more P.O.C.","Less than $51000"
"06037195720","Census Tract 1957.20, Los Angeles County, California",2000,41136,409,13,0,230,0,1262,20.4,0.7,0,11.5,0,63.1,79.6,858,196,662,22.84,77.16,25,171,33,629,58,800,12.8,5,6.8,"75% or more P.O.C.","Less than $51000"
"06037195802","Census Tract 1958.02, Los Angeles County, California",2691,53889,397,69,11,586,0,1596,14.8,2.6,0.4,21.8,0,59.3,85.2,938,222,716,23.67,76.33,47,175,69,647,116,822,21.2,9.6,12.4,"75% or more P.O.C.","$51000 - $70000"
"06037195803","Census Tract 1958.03, Los Angeles County, California",2634,83167,1020,96,6,408,0,969,38.7,3.6,0.2,15.5,0,36.8,61.3,1156,316,840,27.34,72.66,0,316,30,810,30,1126,0,3.6,2.6,"50% - 75% P.O.C.","$70000 - $95000"
"06037195804","Census Tract 1958.04, Los Angeles County, California",2533,71467,883,148,0,295,14,1091,34.9,5.8,0,11.6,0.6,43.1,65.1,1011,282,729,27.89,72.11,12,270,52,677,64,947,4.3,7.1,6.3,"50% - 75% P.O.C.","$70000 - $95000"
"06037195901","Census Tract 1959.01, Los Angeles County, California",2237,64138,987,42,12,370,0,808,44.1,1.9,0.5,16.5,0,36.1,55.9,1064,168,896,15.79,84.21,34,134,0,896,34,1030,20.2,0,3.2,"50% - 75% P.O.C.","$51000 - $70000"
"06037195902","Census Tract 1959.02, Los Angeles County, California",1864,68875,1018,45,0,251,0,470,54.6,2.4,0,13.5,0,25.2,45.4,1005,198,807,19.7,80.3,0,198,0,807,0,1005,0,0,0,"25% - 50% P.O.C.","$51000 - $70000"
"06037195903","Census Tract 1959.03, Los Angeles County, California",2008,52446,607,0,5,326,0,952,30.2,0,0.2,16.2,0,47.4,69.8,911,158,753,17.34,82.66,12,146,9,744,21,890,7.6,1.2,2.3,"50% - 75% P.O.C.","$51000 - $70000"
"06037197200","Census Tract 1972, Los Angeles County, California",3909,59719,424,128,15,1197,0,2101,10.8,3.3,0.4,30.6,0,53.7,89.2,1191,606,585,50.88,49.12,79,527,126,459,205,986,13,21.5,17.2,"75% or more P.O.C.","$51000 - $70000"
"06037197300","Census Tract 1973, Los Angeles County, California",4052,83843,1798,137,0,645,28,1331,44.4,3.4,0,15.9,0.7,32.8,55.6,1786,428,1358,23.96,76.04,51,377,46,1312,97,1689,11.9,3.4,5.4,"50% - 75% P.O.C.","$70000 - $95000"
"06037197410","Census Tract 1974.10, Los Angeles County, California",4331,100556,2058,94,24,465,10,1485,47.5,2.2,0.6,10.7,0.2,34.3,52.5,1722,901,821,52.32,47.68,41,860,44,777,85,1637,4.6,5.4,4.9,"50% - 75% P.O.C.","$95000 or more"
"06037197420","Census Tract 1974.20, Los Angeles County, California",3564,65438,1262,91,30,319,0,1782,35.4,2.6,0.8,9,0,50,64.6,1347,438,909,32.52,67.48,53,385,114,795,167,1180,12.1,12.5,12.4,"50% - 75% P.O.C.","$51000 - $70000"
"06037197500","Census Tract 1975, Los Angeles County, California",3914,75571,1285,145,0,683,0,1715,32.8,3.7,0,17.5,0,43.8,67.2,1567,360,1207,22.97,77.03,25,335,142,1065,167,1400,6.9,11.8,10.7,"50% - 75% P.O.C.","$70000 - $95000"
"06037197600","Census Tract 1976, Los Angeles County, California",2166,74038,711,7,16,368,0,952,32.8,0.3,0.7,17,0,44,67.2,910,186,724,20.44,79.56,7,179,36,688,43,867,3.8,5,4.7,"50% - 75% P.O.C.","$70000 - $95000"
"06037197700","Census Tract 1977, Los Angeles County, California",5332,54759,1212,160,118,2278,0,1347,22.7,3,2.2,42.7,0,25.3,77.3,2043,299,1744,14.64,85.36,15,284,112,1632,127,1916,5,6.4,6.2,"75% or more P.O.C.","$51000 - $70000"
"06037199000","Census Tract 1990, Los Angeles County, California",5391,57625,284,58,0,1405,0,3587,5.3,1.1,0,26.1,0,66.5,94.7,1640,400,1240,24.39,75.61,58,342,289,951,347,1293,14.5,23.3,21.2,"75% or more P.O.C.","$51000 - $70000"
"06037199110","Census Tract 1991.10, Los Angeles County, California",2705,59395,168,10,0,129,0,2393,6.2,0.4,0,4.8,0,88.5,93.8,737,460,277,62.42,37.58,98,362,89,188,187,550,21.3,32.1,25.4,"75% or more P.O.C.","$51000 - $70000"
"06037199120","Census Tract 1991.20, Los Angeles County, California",4511,38970,136,99,0,875,0,3334,3,2.2,0,19.4,0,73.9,97,1115,232,883,20.81,79.19,37,195,224,659,261,854,15.9,25.4,23.4,"75% or more P.O.C.","Less than $51000"
"06037199201","Census Tract 1992.01, Los Angeles County, California",3660,34277,61,0,0,1098,0,2501,1.7,0,0,30,0,68.3,98.3,1089,124,965,11.39,88.61,50,74,205,760,255,834,40.3,21.2,23.4,"75% or more P.O.C.","Less than $51000"
"06037199202","Census Tract 1992.02, Los Angeles County, California",3155,67257,337,32,0,377,0,2364,10.7,1,0,11.9,0,74.9,89.3,923,424,499,45.94,54.06,50,374,135,364,185,738,11.8,27.1,20,"75% or more P.O.C.","$51000 - $70000"
"06037199300","Census Tract 1993, Los Angeles County, California",4202,81172,1092,59,21,514,0,2486,26,1.4,0.5,12.2,0,59.2,74,1315,774,541,58.86,41.14,79,695,131,410,210,1105,10.2,24.2,16,"50% - 75% P.O.C.","$70000 - $95000"
"06037199400","Census Tract 1994, Los Angeles County, California",4759,44637,184,210,0,907,0,3352,3.9,4.4,0,19.1,0,70.4,96.1,1365,393,972,28.79,71.21,66,327,233,739,299,1066,16.8,24,21.9,"75% or more P.O.C.","Less than $51000"
"06037199700","Census Tract 1997, Los Angeles County, California",3063,42614,541,21,0,459,18,2002,17.7,0.7,0,15,0.6,65.4,82.3,1131,276,855,24.4,75.6,59,217,101,754,160,971,21.4,11.8,14.1,"75% or more P.O.C.","Less than $51000"
"06037199800","Census Tract 1998, Los Angeles County, California",5828,37755,76,1,0,2120,0,3631,1.3,0,0,36.4,0,62.3,98.7,1563,495,1068,31.67,68.33,159,336,268,800,427,1136,32.1,25.1,27.3,"75% or more P.O.C.","Less than $51000"
"06037199900","Census Tract 1999, Los Angeles County, California",2692,39184,51,42,0,381,0,2218,1.9,1.6,0,14.2,0,82.4,98.1,778,144,634,18.51,81.49,42,102,114,520,156,622,29.2,18,20.1,"75% or more P.O.C.","Less than $51000"
"06037201110","Census Tract 2011.10, Los Angeles County, California",2147,67059,232,14,0,269,0,1632,10.8,0.7,0,12.5,0,76,89.2,704,461,243,65.48,34.52,56,405,12,231,68,636,12.1,4.9,9.7,"75% or more P.O.C.","$51000 - $70000"
"06037201120","Census Tract 2011.20, Los Angeles County, California",4144,68667,362,54,0,331,0,3327,8.7,1.3,0,8,0,80.3,91.3,1288,448,840,34.78,65.22,81,367,152,688,233,1055,18.1,18.1,18.1,"75% or more P.O.C.","$51000 - $70000"
"06037201200","Census Tract 2012, Los Angeles County, California",2893,46976,207,0,0,311,0,2356,7.2,0,0,10.8,0,81.4,92.8,757,337,420,44.52,55.48,113,224,63,357,176,581,33.5,15,23.2,"75% or more P.O.C.","Less than $51000"
"06037201301","Census Tract 2013.01, Los Angeles County, California",4498,59955,225,102,0,710,0,3458,5,2.3,0,15.8,0,76.9,95,1109,552,557,49.77,50.23,199,353,136,421,335,774,36.1,24.4,30.2,"75% or more P.O.C.","$51000 - $70000"
"06037201302","Census Tract 2013.02, Los Angeles County, California",4341,91250,910,240,0,1825,0,1136,21,5.5,0,42,0,26.2,79,1885,1188,697,63.02,36.98,61,1127,9,688,70,1815,5.1,1.3,3.7,"75% or more P.O.C.","$70000 - $95000"
"06037201401","Census Tract 2014.01, Los Angeles County, California",4693,51212,325,47,152,470,0,3550,6.9,1,3.2,10,0,75.6,93.1,1374,644,730,46.87,53.13,78,566,238,492,316,1058,12.1,32.6,23,"75% or more P.O.C.","$51000 - $70000"
"06037201402","Census Tract 2014.02, Los Angeles County, California",4995,55352,190,42,0,948,0,3715,3.8,0.8,0,19,0,74.4,96.2,1450,980,470,67.59,32.41,242,738,88,382,330,1120,24.7,18.7,22.8,"75% or more P.O.C.","$51000 - $70000"
"06037201501","Census Tract 2015.01, Los Angeles County, California",5367,60088,502,55,0,340,0,4442,9.4,1,0,6.3,0,82.8,90.6,1514,625,889,41.28,58.72,111,514,176,713,287,1227,17.8,19.8,19,"75% or more P.O.C.","$51000 - $70000"
"06037201503","Census Tract 2015.03, Los Angeles County, California",3364,51433,178,36,0,241,0,2909,5.3,1.1,0,7.2,0,86.5,94.7,965,282,683,29.22,70.78,80,202,110,573,190,775,28.4,16.1,19.7,"75% or more P.O.C.","$51000 - $70000"
"06037201504","Census Tract 2015.04, Los Angeles County, California",2302,53750,242,23,0,125,0,1828,10.5,1,0,5.4,0,79.4,89.5,631,345,286,54.68,45.32,90,255,39,247,129,502,26.1,13.6,20.4,"75% or more P.O.C.","$51000 - $70000"
"06037201601","Census Tract 2016.01, Los Angeles County, California",2323,55795,109,59,0,222,0,1853,4.7,2.5,0,9.6,0,79.8,95.3,713,399,314,55.96,44.04,96,303,52,262,148,565,24.1,16.6,20.8,"75% or more P.O.C.","$51000 - $70000"
"06037201602","Census Tract 2016.02, Los Angeles County, California",2960,55909,103,3,25,330,0,2475,3.5,0.1,0.8,11.1,0,83.6,96.5,828,465,363,56.16,43.84,123,342,77,286,200,628,26.5,21.2,24.2,"75% or more P.O.C.","$51000 - $70000"
"06037201700","Census Tract 2017, Los Angeles County, California",5514,64769,785,300,0,770,7,3509,14.2,5.4,0,14,0.1,63.6,85.8,1366,741,625,54.25,45.75,148,593,61,564,209,1157,20,9.8,15.3,"75% or more P.O.C.","$51000 - $70000"
"06037203100","Census Tract 2031, Los Angeles County, California",4498,33179,40,58,0,95,0,4261,0.9,1.3,0,2.1,0,94.7,99.1,1239,168,1071,13.56,86.44,40,128,190,881,230,1009,23.8,17.7,18.6,"75% or more P.O.C.","Less than $51000"
"06037203200","Census Tract 2032, Los Angeles County, California",5695,56161,170,53,11,21,0,5407,3,0.9,0.2,0.4,0,94.9,97,1321,463,858,35.05,64.95,119,344,372,486,491,830,25.7,43.4,37.2,"75% or more P.O.C.","$51000 - $70000"
"06037203300","Census Tract 2033, Los Angeles County, California",2000,39750,57,209,0,134,5,1511,2.9,10.4,0,6.7,0.2,75.6,97.1,405,47,358,11.6,88.4,21,26,99,259,120,285,44.7,27.7,29.6,"75% or more P.O.C.","Less than $51000"
"06037203500","Census Tract 2035, Los Angeles County, California",2907,41444,142,95,0,417,8,2245,4.9,3.3,0,14.3,0.3,77.2,95.1,936,210,726,22.44,77.56,13,197,104,622,117,819,6.2,14.3,12.5,"75% or more P.O.C.","Less than $51000"
"06037203600","Census Tract 2036, Los Angeles County, California",5276,49922,90,48,19,56,0,5063,1.7,0.9,0.4,1.1,0,96,98.3,1391,335,1056,24.08,75.92,91,244,304,752,395,996,27.2,28.8,28.4,"75% or more P.O.C.","Less than $51000"
"06037203710","Census Tract 2037.10, Los Angeles County, California",3270,46840,36,17,0,22,0,3195,1.1,0.5,0,0.7,0,97.7,98.9,799,191,608,23.9,76.1,59,132,213,395,272,527,30.9,35,34,"75% or more P.O.C.","Less than $51000"
"06037203720","Census Tract 2037.20, Los Angeles County, California",4072,37917,62,0,0,22,0,3980,1.5,0,0,0.5,0,97.7,98.5,1054,195,859,18.5,81.5,39,156,210,649,249,805,20,24.4,23.6,"75% or more P.O.C.","Less than $51000"
"06037203800","Census Tract 2038, Los Angeles County, California",4829,45108,47,10,0,76,0,4690,1,0.2,0,1.6,0,97.1,99,1143,585,558,51.18,48.82,210,375,147,411,357,786,35.9,26.3,31.2,"75% or more P.O.C.","Less than $51000"
"06037203900","Census Tract 2039, Los Angeles County, California",3353,57054,70,26,0,0,0,3257,2.1,0.8,0,0,0,97.1,97.9,718,289,429,40.25,59.75,127,162,140,289,267,451,43.9,32.6,37.2,"75% or more P.O.C.","$51000 - $70000"
"06037204110","Census Tract 2041.10, Los Angeles County, California",3286,57417,119,0,0,0,0,3167,3.6,0,0,0,0,96.4,96.4,801,303,498,37.83,62.17,94,209,142,356,236,565,31,28.5,29.5,"75% or more P.O.C.","$51000 - $70000"
"06037204120","Census Tract 2041.20, Los Angeles County, California",2971,52813,91,33,10,25,0,2776,3.1,1.1,0.3,0.8,0,93.4,96.9,753,241,512,32.01,67.99,63,178,141,371,204,549,26.1,27.5,27.1,"75% or more P.O.C.","$51000 - $70000"
"06037204200","Census Tract 2042, Los Angeles County, California",3657,32946,38,12,0,63,0,3544,1,0.3,0,1.7,0,96.9,99,962,143,819,14.86,85.14,42,101,291,528,333,629,29.4,35.5,34.6,"75% or more P.O.C.","Less than $51000"
"06037204300","Census Tract 2043, Los Angeles County, California",5445,41912,137,22,0,75,0,5203,2.5,0.4,0,1.4,0,95.6,97.5,1302,391,911,30.03,69.97,75,316,320,591,395,907,19.2,35.1,30.3,"75% or more P.O.C.","Less than $51000"
"06037204410","Census Tract 2044.10, Los Angeles County, California",2575,47232,35,5,0,51,0,2484,1.4,0.2,0,2,0,96.5,98.6,627,99,528,15.79,84.21,12,87,165,363,177,450,12.1,31.2,28.2,"75% or more P.O.C.","Less than $51000"
"06037204420","Census Tract 2044.20, Los Angeles County, California",3154,29730,39,152,0,80,0,2863,1.2,4.8,0,2.5,0,90.8,98.8,944,82,862,8.69,91.31,10,72,143,719,153,791,12.2,16.6,16.2,"75% or more P.O.C.","Less than $51000"
"06037204600","Census Tract 2046, Los Angeles County, California",4080,31786,161,91,0,87,0,3716,3.9,2.2,0,2.1,0,91.1,96.1,1208,246,962,20.36,79.64,22,224,235,727,257,951,8.9,24.4,21.3,"75% or more P.O.C.","Less than $51000"
"06037204700","Census Tract 2047, Los Angeles County, California",5510,54809,70,59,0,63,0,5285,1.3,1.1,0,1.1,0,95.9,98.7,1267,663,604,52.33,47.67,173,490,175,429,348,919,26.1,29,27.5,"75% or more P.O.C.","$51000 - $70000"
"06037204810","Census Tract 2048.10, Los Angeles County, California",5277,46440,0,116,9,28,0,5100,0,2.2,0.2,0.5,0,96.6,100,1245,415,830,33.33,66.67,151,264,293,537,444,801,36.4,35.3,35.7,"75% or more P.O.C.","Less than $51000"
"06037204820","Census Tract 2048.20, Los Angeles County, California",2241,40000,58,51,0,5,0,2127,2.6,2.3,0,0.2,0,94.9,97.4,512,218,294,42.58,57.42,63,155,127,167,190,322,28.9,43.2,37.1,"75% or more P.O.C.","Less than $51000"
"06037204910","Census Tract 2049.10, Los Angeles County, California",3341,38523,83,29,0,8,0,3213,2.5,0.9,0,0.2,0,96.2,97.5,944,220,724,23.31,76.69,54,166,177,547,231,713,24.5,24.4,24.5,"75% or more P.O.C.","Less than $51000"
"06037204920","Census Tract 2049.20, Los Angeles County, California",2751,39904,47,23,0,0,0,2676,1.7,0.8,0,0,0,97.3,98.3,673,287,386,42.64,57.36,103,184,108,278,211,462,35.9,28,31.4,"75% or more P.O.C.","Less than $51000"
"06037205110","Census Tract 2051.10, Los Angeles County, California",3904,47219,59,18,0,87,0,3740,1.5,0.5,0,2.2,0,95.8,98.5,857,0,857,0,100,0,0,322,535,322,535,NA,37.6,37.6,"75% or more P.O.C.","Less than $51000"
"06037205120","Census Tract 2051.20, Los Angeles County, California",3548,26844,24,72,0,37,0,3415,0.7,2,0,1,0,96.3,99.3,977,109,868,11.16,88.84,16,93,219,649,235,742,14.7,25.2,24.1,"75% or more P.O.C.","Less than $51000"
"06037206010","Census Tract 2060.10, Los Angeles County, California",4121,42063,317,45,0,1519,0,2222,7.7,1.1,0,36.9,0,53.9,92.3,1258,86,1172,6.84,93.16,22,64,153,1019,175,1083,25.6,13.1,13.9,"75% or more P.O.C.","Less than $51000"
"06037206020","Census Tract 2060.20, Los Angeles County, California",8947,100809,1657,2773,51,328,49,3864,18.5,31,0.6,3.7,0.5,43.2,81.5,297,0,297,0,100,0,0,0,297,0,297,NA,0,0,"75% or more P.O.C.","$95000 or more"
"06037206031","Census Tract 2060.31, Los Angeles County, California",4131,99205,1690,224,12,1266,88,598,40.9,5.4,0.3,30.6,2.1,14.5,59.1,2469,627,1842,25.39,74.61,0,627,0,1842,0,2469,0,0,0,"50% - 75% P.O.C.","$95000 or more"
"06037206032","Census Tract 2060.32, Los Angeles County, California",5687,30625,362,125,46,894,0,4250,6.4,2.2,0.8,15.7,0,74.7,93.6,1768,225,1543,12.73,87.27,53,172,344,1199,397,1371,23.6,22.3,22.5,"75% or more P.O.C.","Less than $51000"
"06037206050","Census Tract 2060.50, Los Angeles County, California",2031,23380,129,86,5,158,0,1617,6.4,4.2,0.2,7.8,0,79.6,93.6,805,49,756,6.09,93.91,0,49,85,671,85,720,0,11.2,10.6,"75% or more P.O.C.","Less than $51000"
"06037206200","Census Tract 2062, Los Angeles County, California",4001,23515,600,734,3,1837,0,679,15,18.3,0.1,45.9,0,17,85,2407,269,2138,11.18,88.82,0,269,0,2138,0,2407,0,0,0,"75% or more P.O.C.","Less than $51000"
"06037206300","Census Tract 2063, Los Angeles County, California",6103,9191,1576,3097,117,135,12,955,25.8,50.7,1.9,2.2,0.2,15.6,74.2,2433,21,2412,0.86,99.14,0,21,0,2412,0,2433,0,0,0,"50% - 75% P.O.C.","Less than $51000"
"06037207101","Census Tract 2071.01, Los Angeles County, California",3717,39063,552,498,0,1935,0,528,14.9,13.4,0,52.1,0,14.2,85.1,1758,62,1696,3.53,96.47,0,62,48,1648,48,1710,0,2.8,2.7,"75% or more P.O.C.","Less than $51000"
"06037207102","Census Tract 2071.02, Los Angeles County, California",2926,30165,248,220,74,1695,0,667,8.5,7.5,2.5,57.9,0,22.8,91.5,1329,36,1293,2.71,97.29,0,36,72,1221,72,1257,0,5.6,5.4,"75% or more P.O.C.","Less than $51000"
"06037207103","Census Tract 2071.03, Los Angeles County, California",2393,29243,181,57,5,1938,0,180,7.6,2.4,0.2,81,0,7.5,92.4,961,40,921,4.16,95.84,0,40,65,856,65,896,0,7.1,6.8,"75% or more P.O.C.","Less than $51000"
"06037207301","Census Tract 2073.01, Los Angeles County, California",4911,51667,1898,959,0,718,0,929,38.6,19.5,0,14.6,0,18.9,61.4,3608,59,3549,1.64,98.36,0,59,0,3549,0,3608,0,0,0,"50% - 75% P.O.C.","$51000 - $70000"
"06037207302","Census Tract 2073.02, Los Angeles County, California",4806,39972,1838,983,36,714,0,873,38.2,20.5,0.7,14.9,0,18.2,61.8,3401,177,3224,5.2,94.8,0,177,0,3224,0,3401,0,0,0,"50% - 75% P.O.C.","Less than $51000"
"06037207400","Census Tract 2074, Los Angeles County, California",1539,87000,232,396,11,182,5,687,15.1,25.7,0.7,11.8,0.3,44.6,84.9,374,0,374,0,100,0,0,0,374,0,374,NA,0,0,"75% or more P.O.C.","$70000 - $95000"
"06037207501","Census Tract 2075.01, Los Angeles County, California",2193,60625,630,251,0,689,0,469,28.7,11.4,0,31.4,0,21.4,71.3,1395,275,1120,19.71,80.29,0,275,0,1120,0,1395,0,0,0,"50% - 75% P.O.C.","$51000 - $70000"
"06037207502","Census Tract 2075.02, Los Angeles County, California",2888,18594,677,280,0,1701,0,170,23.4,9.7,0,58.9,0,5.9,76.6,2196,0,2196,0,100,0,0,0,2196,0,2196,NA,0,0,"75% or more P.O.C.","Less than $51000"
"06037207710","Census Tract 2077.10, Los Angeles County, California",4667,100972,1618,565,0,1689,0,651,34.7,12.1,0,36.2,0,13.9,65.3,3259,356,2903,10.92,89.08,0,356,0,2903,0,3259,0,0,0,"50% - 75% P.O.C.","$95000 or more"
"06037207900","Census Tract 2079, Los Angeles County, California",7162,92104,1794,548,0,2359,0,2075,25,7.7,0,32.9,0,29,75,4204,760,3444,18.08,81.92,0,760,45,3399,45,4159,0,1.3,1.1,"75% or more P.O.C.","$70000 - $95000"
"06037208000","Census Tract 2080, Los Angeles County, California",7508,37330,728,764,0,1053,0,4767,9.7,10.2,0,14,0,63.5,90.3,2655,110,2545,4.14,95.86,0,110,365,2180,365,2290,0,14.3,13.7,"75% or more P.O.C.","Less than $51000"
"06037208301","Census Tract 2083.01, Los Angeles County, California",2148,50093,11,34,7,78,8,1989,0.5,1.6,0.3,3.6,0.4,92.6,99.5,556,0,556,0,100,0,0,177,379,177,379,NA,31.8,31.8,"75% or more P.O.C.","Less than $51000"
"06037208302","Census Tract 2083.02, Los Angeles County, California",5269,38365,308,427,0,525,0,3957,5.8,8.1,0,10,0,75.1,94.2,1661,103,1558,6.2,93.8,20,83,258,1300,278,1383,19.4,16.6,16.7,"75% or more P.O.C.","Less than $51000"
"06037208401","Census Tract 2084.01, Los Angeles County, California",4765,31218,110,75,0,1203,0,3377,2.3,1.6,0,25.2,0,70.9,97.7,1515,33,1482,2.18,97.82,0,33,307,1175,307,1208,0,20.7,20.3,"75% or more P.O.C.","Less than $51000"
"06037208402","Census Tract 2084.02, Los Angeles County, California",2896,45804,265,42,0,500,14,2033,9.2,1.5,0,17.3,0.5,70.2,90.8,827,148,679,17.9,82.1,56,92,167,512,223,604,37.8,24.6,27,"75% or more P.O.C.","Less than $51000"
"06037208501","Census Tract 2085.01, Los Angeles County, California",2267,56974,219,29,16,1035,0,916,9.7,1.3,0.7,45.7,0,40.4,90.3,814,83,731,10.2,89.8,13,70,82,649,95,719,15.7,11.2,11.7,"75% or more P.O.C.","$51000 - $70000"
"06037208502","Census Tract 2085.02, Los Angeles County, California",4364,41804,184,93,27,450,0,3579,4.2,2.1,0.6,10.3,0,82,95.8,1325,14,1311,1.06,98.94,0,14,218,1093,218,1107,0,16.6,16.5,"75% or more P.O.C.","Less than $51000"
"06037208610","Census Tract 2086.10, Los Angeles County, California",4351,52537,281,201,0,1510,18,2268,6.5,4.6,0,34.7,0.4,52.1,93.5,1470,122,1348,8.3,91.7,32,90,155,1193,187,1283,26.2,11.5,12.7,"75% or more P.O.C.","$51000 - $70000"
"06037208620","Census Tract 2086.20, Los Angeles County, California",4446,48910,337,353,0,1276,118,2239,7.6,7.9,0,28.7,2.7,50.4,92.4,1694,158,1536,9.33,90.67,33,125,137,1399,170,1524,20.9,8.9,10,"75% or more P.O.C.","Less than $51000"
"06037208710","Census Tract 2087.10, Los Angeles County, California",4858,69656,420,170,106,2485,0,1546,8.6,3.5,2.2,51.2,0,31.8,91.4,2043,327,1716,16.01,83.99,0,327,70,1646,70,1973,0,4.1,3.4,"75% or more P.O.C.","$51000 - $70000"
"06037208720","Census Tract 2087.20, Los Angeles County, California",4319,32727,643,120,0,203,0,3353,14.9,2.8,0,4.7,0,77.6,85.1,1590,30,1560,1.89,98.11,0,30,177,1383,177,1413,0,11.3,11.1,"75% or more P.O.C.","Less than $51000"
"06037208801","Census Tract 2088.01, Los Angeles County, California",3027,33211,397,282,0,663,0,1614,13.1,9.3,0,21.9,0,53.3,86.9,1313,0,1313,0,100,0,0,81,1232,81,1232,NA,6.2,6.2,"75% or more P.O.C.","Less than $51000"
"06037208802","Census Tract 2088.02, Los Angeles County, California",3069,34079,408,99,0,700,0,1772,13.3,3.2,0,22.8,0,57.7,86.7,1444,23,1421,1.59,98.41,2,21,56,1365,58,1386,8.7,3.9,4,"75% or more P.O.C.","Less than $51000"
"06037208902","Census Tract 2089.02, Los Angeles County, California",2692,34568,47,73,0,133,0,2439,1.7,2.7,0,4.9,0,90.6,98.3,685,0,685,0,100,0,0,136,549,136,549,NA,19.9,19.9,"75% or more P.O.C.","Less than $51000"
"06037208903","Census Tract 2089.03, Los Angeles County, California",4345,31731,205,295,6,138,0,3593,4.7,6.8,0.1,3.2,0,82.7,95.3,1164,9,1155,0.77,99.23,0,9,172,983,172,992,0,14.9,14.8,"75% or more P.O.C.","Less than $51000"
"06037208904","Census Tract 2089.04, Los Angeles County, California",3978,27250,103,60,0,291,0,3524,2.6,1.5,0,7.3,0,88.6,97.4,1291,21,1270,1.63,98.37,0,21,219,1051,219,1072,0,17.2,17,"75% or more P.O.C.","Less than $51000"
"06037209102","Census Tract 2091.02, Los Angeles County, California",5950,29190,287,600,0,737,0,4250,4.8,10.1,0,12.4,0,71.4,95.2,2155,41,2114,1.9,98.1,0,41,283,1831,283,1872,0,13.4,13.1,"75% or more P.O.C.","Less than $51000"
"06037209103","Census Tract 2091.03, Los Angeles County, California",3679,29509,64,188,0,37,0,3378,1.7,5.1,0,1,0,91.8,98.3,1104,9,1095,0.82,99.18,0,9,239,856,239,865,0,21.8,21.6,"75% or more P.O.C.","Less than $51000"
"06037209104","Census Tract 2091.04, Los Angeles County, California",2560,30078,114,242,0,98,0,2079,4.5,9.5,0,3.8,0,81.2,95.5,937,0,937,0,100,0,0,128,809,128,809,NA,13.7,13.7,"75% or more P.O.C.","Less than $51000"
"06037209200","Census Tract 2092, Los Angeles County, California",4545,54894,1033,355,0,1271,68,1561,22.7,7.8,0,28,1.5,34.3,77.3,2212,187,2025,8.45,91.55,0,187,95,1930,95,2117,0,4.7,4.3,"75% or more P.O.C.","$51000 - $70000"
"06037209300","Census Tract 2093, Los Angeles County, California",4885,30092,340,302,0,544,0,3608,7,6.2,0,11.1,0,73.9,93,1992,39,1953,1.96,98.04,13,26,199,1754,212,1780,33.3,10.2,10.6,"75% or more P.O.C.","Less than $51000"
"06037209401","Census Tract 2094.01, Los Angeles County, California",4472,30926,306,297,0,588,6,3226,6.8,6.6,0,13.1,0.1,72.1,93.2,1589,8,1581,0.5,99.5,0,8,216,1365,216,1373,0,13.7,13.6,"75% or more P.O.C.","Less than $51000"
"06037209402","Census Tract 2094.02, Los Angeles County, California",3963,32879,278,22,0,134,0,3529,7,0.6,0,3.4,0,89,93,1230,37,1193,3.01,96.99,9,28,191,1002,200,1030,24.3,16,16.3,"75% or more P.O.C.","Less than $51000"
"06037209403","Census Tract 2094.03, Los Angeles County, California",4148,27188,234,200,0,766,5,2938,5.6,4.8,0,18.5,0.1,70.8,94.4,1404,14,1390,1,99,14,0,141,1249,155,1249,100,10.1,11,"75% or more P.O.C.","Less than $51000"
"06037209510","Census Tract 2095.10, Los Angeles County, California",3076,30722,100,49,0,718,0,2107,3.3,1.6,0,23.3,0,68.5,96.7,1000,23,977,2.3,97.7,0,23,162,815,162,838,0,16.6,16.2,"75% or more P.O.C.","Less than $51000"
"06037209520","Census Tract 2095.20, Los Angeles County, California",2797,33168,81,60,21,159,0,2476,2.9,2.1,0.8,5.7,0,88.5,97.1,939,9,930,0.96,99.04,0,9,168,762,168,771,0,18.1,17.9,"75% or more P.O.C.","Less than $51000"
"06037209810","Census Tract 2098.10, Los Angeles County, California",2594,30373,305,131,0,300,5,1843,11.8,5.1,0,11.6,0.2,71,88.2,713,21,692,2.95,97.05,0,21,103,589,103,610,0,14.9,14.4,"75% or more P.O.C.","Less than $51000"
"06037209820","Census Tract 2098.20, Los Angeles County, California",3073,31289,76,62,0,117,0,2804,2.5,2,0,3.8,0,91.2,97.5,823,86,737,10.45,89.55,48,38,175,562,223,600,55.8,23.7,27.1,"75% or more P.O.C.","Less than $51000"
"06037210010","Census Tract 2100.10, Los Angeles County, California",3561,31712,67,48,0,396,0,3050,1.9,1.3,0,11.1,0,85.7,98.1,1227,134,1093,10.92,89.08,25,109,156,937,181,1046,18.7,14.3,14.8,"75% or more P.O.C.","Less than $51000"
"06037211000","Census Tract 2110, Los Angeles County, California",5124,127197,2768,166,2,1453,0,424,54,3.2,0,28.4,0,8.3,46,1948,1213,735,62.27,37.73,154,1059,39,696,193,1755,12.7,5.3,9.9,"25% - 50% P.O.C.","$95000 or more"
"06037211120","Census Tract 2111.20, Los Angeles County, California",5635,52342,340,226,9,3403,15,1618,6,4,0.2,60.4,0.3,28.7,94,2547,161,2386,6.32,93.68,12,149,113,2273,125,2422,7.5,4.7,4.9,"75% or more P.O.C.","$51000 - $70000"
"06037211121","Census Tract 2111.21, Los Angeles County, California",2253,48846,350,158,0,848,0,792,15.5,7,0,37.6,0,35.2,84.5,844,48,796,5.69,94.31,0,48,105,691,105,739,0,13.2,12.4,"75% or more P.O.C.","Less than $51000"
"06037211122","Census Tract 2111.22, Los Angeles County, California",3163,50175,669,173,3,1279,0,1004,21.2,5.5,0.1,40.4,0,31.7,78.8,1233,34,1199,2.76,97.24,0,34,55,1144,55,1178,0,4.6,4.5,"75% or more P.O.C.","Less than $51000"
"06037211201","Census Tract 2112.01, Los Angeles County, California",2562,44353,208,126,0,403,40,1743,8.1,4.9,0,15.7,1.6,68,91.9,869,62,807,7.13,92.87,4,58,85,722,89,780,6.5,10.5,10.2,"75% or more P.O.C.","Less than $51000"
"06037211202","Census Tract 2112.02, Los Angeles County, California",2239,41280,201,99,0,358,0,1555,9,4.4,0,16,0,69.5,91,880,26,854,2.95,97.05,7,19,47,807,54,826,26.9,5.5,6.1,"75% or more P.O.C.","Less than $51000"
"06037211310","Census Tract 2113.10, Los Angeles County, California",3873,42637,252,96,0,614,22,2872,6.5,2.5,0,15.9,0.6,74.2,93.5,1220,58,1162,4.75,95.25,0,58,223,939,223,997,0,19.2,18.3,"75% or more P.O.C.","Less than $51000"
"06037211320","Census Tract 2113.20, Los Angeles County, California",3337,31250,437,154,17,686,0,2043,13.1,4.6,0.5,20.6,0,61.2,86.9,1286,13,1273,1.01,98.99,0,13,155,1118,155,1131,0,12.2,12.1,"75% or more P.O.C.","Less than $51000"
"06037211410","Census Tract 2114.10, Los Angeles County, California",2736,43011,335,41,24,1376,0,856,12.2,1.5,0.9,50.3,0,31.3,87.8,1107,64,1043,5.78,94.22,13,51,14,1029,27,1080,20.3,1.3,2.4,"75% or more P.O.C.","Less than $51000"
"06037211420","Census Tract 2114.20, Los Angeles County, California",3573,44330,486,292,0,919,0,1823,13.6,8.2,0,25.7,0,51,86.4,1337,186,1151,13.91,86.09,27,159,116,1035,143,1194,14.5,10.1,10.7,"75% or more P.O.C.","Less than $51000"
"06037211500","Census Tract 2115, Los Angeles County, California",4175,66042,1108,191,0,1805,0,894,26.5,4.6,0,43.2,0,21.4,73.5,1661,585,1076,35.22,64.78,32,553,34,1042,66,1595,5.5,3.2,4,"50% - 75% P.O.C.","$51000 - $70000"
"06037211701","Census Tract 2117.01, Los Angeles County, California",2596,75469,916,148,0,1169,0,201,35.3,5.7,0,45,0,7.7,64.7,1025,303,722,29.56,70.44,22,281,20,702,42,983,7.3,2.8,4.1,"50% - 75% P.O.C.","$70000 - $95000"
"06037211703","Census Tract 2117.03, Los Angeles County, California",4841,52352,551,353,0,1764,0,2069,11.4,7.3,0,36.4,0,42.7,88.6,2114,186,1928,8.8,91.2,0,186,49,1879,49,2065,0,2.5,2.3,"75% or more P.O.C.","$51000 - $70000"
"06037211704","Census Tract 2117.04, Los Angeles County, California",2796,43462,455,235,0,1469,0,564,16.3,8.4,0,52.5,0,20.2,83.7,1612,192,1420,11.91,88.09,0,192,20,1400,20,1592,0,1.4,1.2,"75% or more P.O.C.","Less than $51000"
"06037211802","Census Tract 2118.02, Los Angeles County, California",4682,43720,631,281,12,2122,180,1408,13.5,6,0.3,45.3,3.8,30.1,86.5,2140,257,1883,12.01,87.99,0,257,108,1775,108,2032,0,5.7,5,"75% or more P.O.C.","Less than $51000"
"06037211803","Census Tract 2118.03, Los Angeles County, California",3701,53301,191,64,0,2563,27,754,5.2,1.7,0,69.3,0.7,20.4,94.8,1500,132,1368,8.8,91.2,19,113,86,1282,105,1395,14.4,6.3,7,"75% or more P.O.C.","$51000 - $70000"
"06037211804","Census Tract 2118.04, Los Angeles County, California",3221,41635,211,77,71,2298,0,393,6.6,2.4,2.2,71.3,0,12.2,93.4,1320,88,1232,6.67,93.33,22,66,39,1193,61,1259,25,3.2,4.6,"75% or more P.O.C.","Less than $51000"
"06037211910","Census Tract 2119.10, Los Angeles County, California",4371,46941,383,161,0,1154,0,2580,8.8,3.7,0,26.4,0,59,91.2,1735,52,1683,3,97,0,52,234,1449,234,1501,0,13.9,13.5,"75% or more P.O.C.","Less than $51000"
"06037211921","Census Tract 2119.21, Los Angeles County, California",2521,35993,220,89,12,951,0,1062,8.7,3.5,0.5,37.7,0,42.1,91.3,1011,14,997,1.38,98.62,0,14,50,947,50,961,0,5,4.9,"75% or more P.O.C.","Less than $51000"
"06037211922","Census Tract 2119.22, Los Angeles County, California",3269,49554,188,231,41,1450,9,1342,5.8,7.1,1.3,44.4,0.3,41.1,94.2,1301,18,1283,1.38,98.62,0,18,71,1212,71,1230,0,5.5,5.5,"75% or more P.O.C.","Less than $51000"
"06037212101","Census Tract 2121.01, Los Angeles County, California",3187,51370,433,606,0,1204,0,803,13.6,19,0,37.8,0,25.2,86.4,1467,84,1383,5.73,94.27,0,84,125,1258,125,1342,0,9,8.5,"75% or more P.O.C.","$51000 - $70000"
"06037212102","Census Tract 2121.02, Los Angeles County, California",2291,27167,269,364,19,946,39,628,11.7,15.9,0.8,41.3,1.7,27.4,88.3,1196,17,1179,1.42,98.58,0,17,44,1135,44,1152,0,3.7,3.7,"75% or more P.O.C.","Less than $51000"
"06037212202","Census Tract 2122.02, Los Angeles County, California",3424,39229,156,161,0,715,0,2392,4.6,4.7,0,20.9,0,69.9,95.4,1191,23,1168,1.93,98.07,0,23,94,1074,94,1097,0,8,7.9,"75% or more P.O.C.","Less than $51000"
"06037212203","Census Tract 2122.03, Los Angeles County, California",2914,27092,153,166,0,720,19,1767,5.3,5.7,0,24.7,0.7,60.6,94.7,1564,0,1564,0,100,0,0,31,1533,31,1533,NA,2,2,"75% or more P.O.C.","Less than $51000"
"06037212204","Census Tract 2122.04, Los Angeles County, California",3584,34196,165,305,17,630,0,2441,4.6,8.5,0.5,17.6,0,68.1,95.4,1317,25,1292,1.9,98.1,11,14,92,1200,103,1214,44,7.1,7.8,"75% or more P.O.C.","Less than $51000"
"06037212303","Census Tract 2123.03, Los Angeles County, California",3837,41797,194,268,17,831,0,2436,5.1,7,0.4,21.7,0,63.5,94.9,1529,7,1522,0.46,99.54,0,7,178,1344,178,1351,0,11.7,11.6,"75% or more P.O.C.","Less than $51000"
"06037212304","Census Tract 2123.04, Los Angeles County, California",1832,30265,330,84,7,247,7,1144,18,4.6,0.4,13.5,0.4,62.4,82,807,0,807,0,100,0,0,40,767,40,767,NA,5,5,"75% or more P.O.C.","Less than $51000"
"06037212305","Census Tract 2123.05, Los Angeles County, California",3025,37550,130,99,44,592,0,2120,4.3,3.3,1.5,19.6,0,70.1,95.7,1048,7,1041,0.67,99.33,0,7,151,890,151,897,0,14.5,14.4,"75% or more P.O.C.","Less than $51000"
"06037212306","Census Tract 2123.06, Los Angeles County, California",3413,40590,125,35,35,1304,0,1908,3.7,1,1,38.2,0,55.9,96.3,1212,44,1168,3.63,96.37,0,44,181,987,181,1031,0,15.5,14.9,"75% or more P.O.C.","Less than $51000"
"06037212410","Census Tract 2124.10, Los Angeles County, California",4318,46424,294,168,0,1763,0,1956,6.8,3.9,0,40.8,0,45.3,93.2,1676,25,1651,1.49,98.51,0,25,141,1510,141,1535,0,8.5,8.4,"75% or more P.O.C.","Less than $51000"
"06037212420","Census Tract 2124.20, Los Angeles County, California",3517,40809,182,240,41,1045,0,1905,5.2,6.8,1.2,29.7,0,54.2,94.8,1239,86,1153,6.94,93.06,0,86,163,990,163,1076,0,14.1,13.2,"75% or more P.O.C.","Less than $51000"
"06037212501","Census Tract 2125.01, Los Angeles County, California",1940,39093,338,89,7,432,0,1046,17.4,4.6,0.4,22.3,0,53.9,82.6,975,37,938,3.79,96.21,0,37,39,899,39,936,0,4.2,4,"75% or more P.O.C.","Less than $51000"
"06037212502","Census Tract 2125.02, Los Angeles County, California",2810,47731,362,188,0,1203,0,947,12.9,6.7,0,42.8,0,33.7,87.1,1289,81,1208,6.28,93.72,4,77,67,1141,71,1218,4.9,5.5,5.5,"75% or more P.O.C.","Less than $51000"
"06037212610","Census Tract 2126.10, Los Angeles County, California",4447,43608,358,115,0,2332,0,1606,8.1,2.6,0,52.4,0,36.1,91.9,1823,301,1522,16.51,83.49,39,262,92,1430,131,1692,13,6,7.2,"75% or more P.O.C.","Less than $51000"
"06037212620","Census Tract 2126.20, Los Angeles County, California",4087,43212,381,113,0,1637,0,1805,9.3,2.8,0,40.1,0,44.2,90.7,1807,119,1688,6.59,93.41,0,119,89,1599,89,1718,0,5.3,4.9,"75% or more P.O.C.","Less than $51000"
"06037212701","Census Tract 2127.01, Los Angeles County, California",2276,47000,158,229,0,1354,0,506,6.9,10.1,0,59.5,0,22.2,93.1,812,315,497,38.79,61.21,40,275,48,449,88,724,12.7,9.7,10.8,"75% or more P.O.C.","Less than $51000"
"06037212702","Census Tract 2127.02, Los Angeles County, California",3632,73028,828,309,5,1754,0,567,22.8,8.5,0.1,48.3,0,15.6,77.2,1461,743,718,50.86,49.14,80,663,18,700,98,1363,10.8,2.5,6.7,"75% or more P.O.C.","$70000 - $95000"
"06037212800","Census Tract 2128, Los Angeles County, California",3543,49867,689,500,12,967,0,1135,19.4,14.1,0.3,27.3,0,32,80.6,1429,537,892,37.58,62.42,18,519,23,869,41,1388,3.4,2.6,2.9,"75% or more P.O.C.","Less than $51000"
"06037212900","Census Tract 2129, Los Angeles County, California",4067,43167,390,459,19,1039,0,2088,9.6,11.3,0.5,25.5,0,51.3,90.4,1548,186,1362,12.02,87.98,11,175,121,1241,132,1416,5.9,8.9,8.5,"75% or more P.O.C.","Less than $51000"
"06037213100","Census Tract 2131, Los Angeles County, California",3014,44167,229,346,0,1443,0,990,7.6,11.5,0,47.9,0,32.8,92.4,954,297,657,31.13,68.87,53,244,50,607,103,851,17.8,7.6,10.8,"75% or more P.O.C.","Less than $51000"
"06037213201","Census Tract 2132.01, Los Angeles County, California",3932,32819,202,47,0,1935,0,1720,5.1,1.2,0,49.2,0,43.7,94.9,1507,124,1383,8.23,91.77,0,124,134,1249,134,1373,0,9.7,8.9,"75% or more P.O.C.","Less than $51000"
"06037213202","Census Tract 2132.02, Los Angeles County, California",3942,38899,129,26,0,1016,0,2694,3.3,0.7,0,25.8,0,68.3,96.7,1287,236,1051,18.34,81.66,27,209,112,939,139,1148,11.4,10.7,10.8,"75% or more P.O.C.","Less than $51000"
"06037213310","Census Tract 2133.10, Los Angeles County, California",3015,48333,61,67,23,924,0,1940,2,2.2,0.8,30.6,0,64.3,98,1058,141,917,13.33,86.67,33,108,145,772,178,880,23.4,15.8,16.8,"75% or more P.O.C.","Less than $51000"
"06037213320","Census Tract 2133.20, Los Angeles County, California",2469,26759,33,62,0,775,5,1594,1.3,2.5,0,31.4,0.2,64.6,98.7,1060,100,960,9.43,90.57,13,87,59,901,72,988,13,6.1,6.8,"75% or more P.O.C.","Less than $51000"
"06037213401","Census Tract 2134.01, Los Angeles County, California",4859,33607,268,132,0,1016,0,3434,5.5,2.7,0,20.9,0,70.7,94.5,1696,0,1696,0,100,0,0,165,1531,165,1531,NA,9.7,9.7,"75% or more P.O.C.","Less than $51000"
"06037213402","Census Tract 2134.02, Los Angeles County, California",4857,42766,243,253,0,1005,1,3315,5,5.2,0,20.7,0,68.3,95,1619,108,1511,6.67,93.33,18,90,218,1293,236,1383,16.7,14.4,14.6,"75% or more P.O.C.","Less than $51000"
"06037214000","Census Tract 2140, Los Angeles County, California",4277,120625,3676,15,0,132,0,313,85.9,0.4,0,3.1,0,7.3,14.1,1364,937,427,68.7,31.3,237,700,50,377,287,1077,25.3,11.7,21,"Less than 25% P.O.C.","$95000 or more"
"06037214100","Census Tract 2141, Los Angeles County, California",3668,100824,3098,59,0,137,4,324,84.5,1.6,0,3.7,0.1,8.8,15.5,1627,643,984,39.52,60.48,33,610,58,926,91,1536,5.1,5.9,5.6,"Less than 25% P.O.C.","$95000 or more"
"06037214400","Census Tract 2144, Los Angeles County, California",2916,77708,2328,73,0,152,0,332,79.8,2.5,0,5.2,0,11.4,20.2,1667,47,1620,2.82,97.18,0,47,0,1620,0,1667,0,0,0,"Less than 25% P.O.C.","$70000 - $95000"
"06037214501","Census Tract 2145.01, Los Angeles County, California",2702,87364,1438,200,0,623,0,300,53.2,7.4,0,23.1,0,11.1,46.8,1404,53,1351,3.77,96.23,0,53,33,1318,33,1371,0,2.4,2.4,"25% - 50% P.O.C.","$70000 - $95000"
"06037214502","Census Tract 2145.02, Los Angeles County, California",5285,60093,2518,636,0,1499,0,395,47.6,12,0,28.4,0,7.5,52.4,2518,45,2473,1.79,98.21,0,45,132,2341,132,2386,0,5.3,5.2,"50% - 75% P.O.C.","$51000 - $70000"
"06037214503","Census Tract 2145.03, Los Angeles County, California",3422,75294,1554,284,1,1094,0,172,45.4,8.3,0,32,0,5,54.6,1516,13,1503,0.86,99.14,0,13,15,1488,15,1501,0,1,1,"50% - 75% P.O.C.","$70000 - $95000"
"06037214600","Census Tract 2146, Los Angeles County, California",2383,102868,1760,19,0,108,0,344,73.9,0.8,0,4.5,0,14.4,26.1,1319,275,1044,20.85,79.15,7,268,0,1044,7,1312,2.5,0,0.5,"25% - 50% P.O.C.","$95000 or more"
"06037214700","Census Tract 2147, Los Angeles County, California",2414,96579,1698,170,11,157,13,276,70.3,7,0.5,6.5,0.5,11.4,29.7,1160,432,728,37.24,62.76,14,418,11,717,25,1135,3.2,1.5,2.2,"25% - 50% P.O.C.","$95000 or more"
"06037214800","Census Tract 2148, Los Angeles County, California",2813,108648,2212,140,8,164,0,174,78.6,5,0.3,5.8,0,6.2,21.4,1396,385,1011,27.58,72.42,16,369,7,1004,23,1373,4.2,0.7,1.6,"Less than 25% P.O.C.","$95000 or more"
"06037214901","Census Tract 2149.01, Los Angeles County, California",3250,71844,2212,62,61,373,0,339,68.1,1.9,1.9,11.5,0,10.4,31.9,2022,474,1548,23.44,76.56,0,474,0,1548,0,2022,0,0,0,"25% - 50% P.O.C.","$70000 - $95000"
"06037214902","Census Tract 2149.02, Los Angeles County, California",2550,84840,1748,126,0,356,0,121,68.5,4.9,0,14,0,4.7,31.5,1534,288,1246,18.77,81.23,0,288,0,1246,0,1534,0,0,0,"25% - 50% P.O.C.","$70000 - $95000"
"06037215101","Census Tract 2151.01, Los Angeles County, California",3015,67888,1748,302,0,415,33,348,58,10,0,13.8,1.1,11.5,42,1708,130,1578,7.61,92.39,0,130,19,1559,19,1689,0,1.2,1.1,"25% - 50% P.O.C.","$51000 - $70000"
"06037215102","Census Tract 2151.02, Los Angeles County, California",3059,69979,1941,76,0,321,0,612,63.5,2.5,0,10.5,0,20,36.5,1995,28,1967,1.4,98.6,0,28,0,1967,0,1995,0,0,0,"25% - 50% P.O.C.","$51000 - $70000"
"06037216100","Census Tract 2161, Los Angeles County, California",2151,104604,1049,294,0,413,0,324,48.8,13.7,0,19.2,0,15.1,51.2,977,545,432,55.78,44.22,28,517,18,414,46,931,5.1,4.2,4.7,"50% - 75% P.O.C.","$95000 or more"
"06037216200","Census Tract 2162, Los Angeles County, California",5778,88854,2228,1028,0,1001,21,1051,38.6,17.8,0,17.3,0.4,18.2,61.4,2811,658,2153,23.41,76.59,16,642,47,2106,63,2748,2.4,2.2,2.2,"50% - 75% P.O.C.","$70000 - $95000"
"06037216300","Census Tract 2163, Los Angeles County, California",4367,94620,2609,389,17,569,29,558,59.7,8.9,0.4,13,0.7,12.8,40.3,2101,614,1487,29.22,70.78,47,567,62,1425,109,1992,7.7,4.2,5.2,"25% - 50% P.O.C.","$70000 - $95000"
"06037216401","Census Tract 2164.01, Los Angeles County, California",3772,75597,2937,252,0,247,0,244,77.9,6.7,0,6.5,0,6.5,22.1,1807,180,1627,9.96,90.04,15,165,47,1580,62,1745,8.3,2.9,3.4,"Less than 25% P.O.C.","$70000 - $95000"
"06037216402","Census Tract 2164.02, Los Angeles County, California",2521,75000,1762,34,8,357,0,185,69.9,1.3,0.3,14.2,0,7.3,30.1,1266,106,1160,8.37,91.63,0,106,0,1160,0,1266,0,0,0,"25% - 50% P.O.C.","$70000 - $95000"
"06037216700","Census Tract 2167, Los Angeles County, California",3835,79730,1293,1102,0,334,0,856,33.7,28.7,0,8.7,0,22.3,66.3,1628,628,1000,38.57,61.43,76,552,15,985,91,1537,12.1,1.5,5.6,"50% - 75% P.O.C.","$70000 - $95000"
"06037216800","Census Tract 2168, Los Angeles County, California",3203,91821,1850,225,0,266,10,636,57.8,7,0,8.3,0.3,19.9,42.2,1327,446,881,33.61,66.39,49,397,54,827,103,1224,11,6.1,7.8,"25% - 50% P.O.C.","$70000 - $95000"
"06037216900","Census Tract 2169, Los Angeles County, California",4886,89547,2155,1396,8,308,0,823,44.1,28.6,0.2,6.3,0,16.8,55.9,2471,1169,1302,47.31,52.69,21,1148,0,1302,21,2450,1.8,0,0.8,"50% - 75% P.O.C.","$70000 - $95000"
"06037217001","Census Tract 2170.01, Los Angeles County, California",2724,87250,2340,67,0,89,0,54,85.9,2.5,0,3.3,0,2,14.1,944,440,504,46.61,53.39,138,302,61,443,199,745,31.4,12.1,21.1,"Less than 25% P.O.C.","$70000 - $95000"
"06037217002","Census Tract 2170.02, Los Angeles County, California",4639,87934,3499,73,0,341,0,558,75.4,1.6,0,7.4,0,12,24.6,2025,586,1439,28.94,71.06,80,506,122,1317,202,1823,13.7,8.5,10,"Less than 25% P.O.C.","$70000 - $95000"
"06037217100","Census Tract 2171, Los Angeles County, California",6219,67414,1734,1317,0,253,0,2329,27.9,21.2,0,4.1,0,37.4,72.1,2433,682,1751,28.03,71.97,112,570,31,1720,143,2290,16.4,1.8,5.9,"50% - 75% P.O.C.","$51000 - $70000"
"06037217200","Census Tract 2172, Los Angeles County, California",4156,69817,1022,939,36,223,0,1798,24.6,22.6,0.9,5.4,0,43.3,75.4,1608,399,1209,24.81,75.19,50,349,112,1097,162,1446,12.5,9.3,10.1,"75% or more P.O.C.","$51000 - $70000"
"06037218110","Census Tract 2181.10, Los Angeles County, California",3195,44009,213,596,17,484,0,1845,6.7,18.7,0.5,15.1,0,57.7,93.3,1094,310,784,28.34,71.66,33,277,101,683,134,960,10.6,12.9,12.2,"75% or more P.O.C.","Less than $51000"
"06037218120","Census Tract 2181.20, Los Angeles County, California",4638,36488,102,514,0,587,11,3326,2.2,11.1,0,12.7,0.2,71.7,97.8,1363,285,1078,20.91,79.09,73,212,183,895,256,1107,25.6,17,18.8,"75% or more P.O.C.","Less than $51000"
"06037218210","Census Tract 2182.10, Los Angeles County, California",3721,35436,437,535,0,192,0,2557,11.7,14.4,0,5.2,0,68.7,88.3,1193,253,940,21.21,78.79,65,188,113,827,178,1015,25.7,12,14.9,"75% or more P.O.C.","Less than $51000"
"06037218220","Census Tract 2182.20, Los Angeles County, California",3859,49632,697,900,0,258,0,1968,18.1,23.3,0,6.7,0,51,81.9,1461,515,946,35.25,64.75,43,472,97,849,140,1321,8.3,10.3,9.6,"75% or more P.O.C.","Less than $51000"
"06037218300","Census Tract 2183, Los Angeles County, California",5290,53621,436,1401,0,256,0,2737,8.2,26.5,0,4.8,0,51.7,91.8,2127,593,1534,27.88,72.12,145,448,80,1454,225,1902,24.5,5.2,10.6,"75% or more P.O.C.","$51000 - $70000"
"06037218400","Census Tract 2184, Los Angeles County, California",4737,64018,652,896,0,130,0,2957,13.8,18.9,0,2.7,0,62.4,86.2,1405,419,986,29.82,70.18,58,361,145,841,203,1202,13.8,14.7,14.4,"75% or more P.O.C.","$51000 - $70000"
"06037218500","Census Tract 2185, Los Angeles County, California",2641,44872,223,648,0,106,0,1509,8.4,24.5,0,4,0,57.1,91.6,991,330,661,33.3,66.7,50,280,34,627,84,907,15.2,5.1,8.5,"75% or more P.O.C.","Less than $51000"
"06037218600","Census Tract 2186, Los Angeles County, California",3148,51604,337,816,0,76,0,1784,10.7,25.9,0,2.4,0,56.7,89.3,1098,264,834,24.04,75.96,34,230,72,762,106,992,12.9,8.6,9.7,"75% or more P.O.C.","$51000 - $70000"
"06037218701","Census Tract 2187.01, Los Angeles County, California",2324,49316,216,841,0,480,0,730,9.3,36.2,0,20.7,0,31.4,90.7,879,332,547,37.77,62.23,45,287,35,512,80,799,13.6,6.4,9.1,"75% or more P.O.C.","Less than $51000"
"06037218702","Census Tract 2187.02, Los Angeles County, California",2056,38827,143,808,0,60,0,1016,7,39.3,0,2.9,0,49.4,93,836,189,647,22.61,77.39,27,162,49,598,76,760,14.3,7.6,9.1,"75% or more P.O.C.","Less than $51000"
"06037218800","Census Tract 2188, Los Angeles County, California",2752,46140,123,648,0,430,0,1497,4.5,23.5,0,15.6,0,54.4,95.5,967,200,767,20.68,79.32,58,142,64,703,122,845,29,8.3,12.6,"75% or more P.O.C.","Less than $51000"
"06037218900","Census Tract 2189, Los Angeles County, California",6149,41019,448,2385,0,191,0,2915,7.3,38.8,0,3.1,0,47.4,92.7,2140,267,1873,12.48,87.52,20,247,194,1679,214,1926,7.5,10.4,10,"75% or more P.O.C.","Less than $51000"
"06037219010","Census Tract 2190.10, Los Angeles County, California",3027,54708,101,938,7,63,0,1881,3.3,31,0.2,2.1,0,62.1,96.7,919,429,490,46.68,53.32,109,320,67,423,176,743,25.4,13.7,19.2,"75% or more P.O.C.","$51000 - $70000"
"06037219020","Census Tract 2190.20, Los Angeles County, California",5411,59180,326,1463,0,163,0,3352,6,27,0,3,0,61.9,94,1462,690,772,47.2,52.8,169,521,108,664,277,1185,24.5,14,18.9,"75% or more P.O.C.","$51000 - $70000"
"06037219300","Census Tract 2193, Los Angeles County, California",4239,43103,216,1148,0,230,52,2532,5.1,27.1,0,5.4,1.2,59.7,94.9,1480,348,1132,23.51,76.49,56,292,201,931,257,1223,16.1,17.8,17.4,"75% or more P.O.C.","Less than $51000"
"06037219500","Census Tract 2195, Los Angeles County, California",2084,77147,252,1029,0,287,0,483,12.1,49.4,0,13.8,0,23.2,87.9,779,573,206,73.56,26.44,56,517,18,188,74,705,9.8,8.7,9.5,"75% or more P.O.C.","$70000 - $95000"
"06037219700","Census Tract 2197, Los Angeles County, California",4507,50220,122,1190,0,112,0,3029,2.7,26.4,0,2.5,0,67.2,97.3,1377,673,704,48.87,51.13,177,496,83,621,260,1117,26.3,11.8,18.9,"75% or more P.O.C.","Less than $51000"
"06037219800","Census Tract 2198, Los Angeles County, California",2861,43214,145,460,0,78,0,2149,5.1,16.1,0,2.7,0,75.1,94.9,982,293,689,29.84,70.16,26,267,110,579,136,846,8.9,16,13.8,"75% or more P.O.C.","Less than $51000"
"06037219901","Census Tract 2199.01, Los Angeles County, California",4150,39006,187,898,0,59,0,2943,4.5,21.6,0,1.4,0,70.9,95.5,1430,367,1063,25.66,74.34,67,300,100,963,167,1263,18.3,9.4,11.7,"75% or more P.O.C.","Less than $51000"
"06037219902","Census Tract 2199.02, Los Angeles County, California",3809,49531,350,592,16,130,26,2567,9.2,15.5,0.4,3.4,0.7,67.4,90.8,1219,574,645,47.09,52.91,123,451,69,576,192,1027,21.4,10.7,15.8,"75% or more P.O.C.","Less than $51000"
"06037220000","Census Tract 2200, Los Angeles County, California",4711,42500,373,1535,0,340,23,2429,7.9,32.6,0,7.2,0.5,51.6,92.1,1982,660,1322,33.3,66.7,53,607,84,1238,137,1845,8,6.4,6.9,"75% or more P.O.C.","Less than $51000"
"06037220100","Census Tract 2201, Los Angeles County, California",2415,40091,94,1271,0,160,0,798,3.9,52.6,0,6.6,0,33,96.1,989,494,495,49.95,50.05,21,473,46,449,67,922,4.3,9.3,6.8,"75% or more P.O.C.","Less than $51000"
"06037221110","Census Tract 2211.10, Los Angeles County, California",3705,34868,78,51,0,138,0,3438,2.1,1.4,0,3.7,0,92.8,97.9,1014,117,897,11.54,88.46,8,109,97,800,105,909,6.8,10.8,10.4,"75% or more P.O.C.","Less than $51000"
"06037221120","Census Tract 2211.20, Los Angeles County, California",3197,38060,52,5,0,70,0,3070,1.6,0.2,0,2.2,0,96,98.4,837,77,760,9.2,90.8,20,57,198,562,218,619,26,26.1,26,"75% or more P.O.C.","Less than $51000"
"06037221210","Census Tract 2212.10, Los Angeles County, California",3165,50035,144,197,0,295,0,2499,4.5,6.2,0,9.3,0,79,95.5,874,232,642,26.54,73.46,77,155,156,486,233,641,33.2,24.3,26.7,"75% or more P.O.C.","Less than $51000"
"06037221220","Census Tract 2212.20, Los Angeles County, California",3376,43611,111,13,0,271,0,2981,3.3,0.4,0,8,0,88.3,96.7,1008,167,841,16.57,83.43,34,133,142,699,176,832,20.4,16.9,17.5,"75% or more P.O.C.","Less than $51000"
"06037221302","Census Tract 2213.02, Los Angeles County, California",4373,37500,146,566,0,417,102,3086,3.3,12.9,0,9.5,2.3,70.6,96.7,1318,130,1188,9.86,90.14,45,85,138,1050,183,1135,34.6,11.6,13.9,"75% or more P.O.C.","Less than $51000"
"06037221303","Census Tract 2213.03, Los Angeles County, California",2806,39244,196,111,0,345,0,2134,7,4,0,12.3,0,76.1,93,754,112,642,14.85,85.15,8,104,181,461,189,565,7.1,28.2,25.1,"75% or more P.O.C.","Less than $51000"
"06037221304","Census Tract 2213.04, Los Angeles County, California",3656,43125,110,416,0,884,0,2225,3,11.4,0,24.2,0,60.9,97,1139,37,1102,3.25,96.75,0,37,202,900,202,937,0,18.3,17.7,"75% or more P.O.C.","Less than $51000"
"06037221401","Census Tract 2214.01, Los Angeles County, California",3628,24904,296,1371,0,391,0,1464,8.2,37.8,0,10.8,0,40.4,91.8,1237,219,1018,17.7,82.3,10,209,89,929,99,1138,4.6,8.7,8,"75% or more P.O.C.","Less than $51000"
"06037221402","Census Tract 2214.02, Los Angeles County, California",2851,37976,344,680,0,435,0,1324,12.1,23.9,0,15.3,0,46.4,87.9,896,225,671,25.11,74.89,78,147,48,623,126,770,34.7,7.2,14.1,"75% or more P.O.C.","Less than $51000"
"06037221500","Census Tract 2215, Los Angeles County, California",3875,29420,124,927,0,99,58,2667,3.2,23.9,0,2.6,1.5,68.8,96.8,1137,171,966,15.04,84.96,45,126,183,783,228,909,26.3,18.9,20.1,"75% or more P.O.C.","Less than $51000"
"06037221601","Census Tract 2216.01, Los Angeles County, California",3141,45288,293,454,0,178,0,2137,9.3,14.5,0,5.7,0,68,90.7,954,179,775,18.76,81.24,64,115,98,677,162,792,35.8,12.6,17,"75% or more P.O.C.","Less than $51000"
"06037221602","Census Tract 2216.02, Los Angeles County, California",3030,36008,54,152,0,254,0,2548,1.8,5,0,8.4,0,84.1,98.2,942,117,825,12.42,87.58,35,82,128,697,163,779,29.9,15.5,17.3,"75% or more P.O.C.","Less than $51000"
"06037221710","Census Tract 2217.10, Los Angeles County, California",2833,39212,190,133,0,606,0,1894,6.7,4.7,0,21.4,0,66.9,93.3,959,185,774,19.29,80.71,30,155,70,704,100,859,16.2,9,10.4,"75% or more P.O.C.","Less than $51000"
"06037221810","Census Tract 2218.10, Los Angeles County, California",2892,25357,381,275,0,668,6,1501,13.2,9.5,0,23.1,0.2,51.9,86.8,920,83,837,9.02,90.98,32,51,126,711,158,762,38.6,15.1,17.2,"75% or more P.O.C.","Less than $51000"
"06037221820","Census Tract 2218.20, Los Angeles County, California",2363,12235,814,231,9,828,8,400,34.4,9.8,0.4,35,0.3,16.9,65.6,914,33,881,3.61,96.39,25,8,50,831,75,839,75.8,5.7,8.2,"50% - 75% P.O.C.","Less than $51000"
"06037221900","Census Tract 2219, Los Angeles County, California",4248,17237,1117,387,17,1274,0,1123,26.3,9.1,0.4,30,0,26.4,73.7,902,37,865,4.1,95.9,0,37,149,716,149,753,0,17.2,16.5,"50% - 75% P.O.C.","Less than $51000"
"06037222001","Census Tract 2220.01, Los Angeles County, California",3142,71000,367,760,0,13,0,1945,11.7,24.2,0,0.4,0,61.9,88.3,928,486,442,52.37,47.63,108,378,77,365,185,743,22.2,17.4,19.9,"75% or more P.O.C.","$70000 - $95000"
"06037222002","Census Tract 2220.02, Los Angeles County, California",5243,48641,133,1162,0,39,0,3902,2.5,22.2,0,0.7,0,74.4,97.5,1351,521,830,38.56,61.44,134,387,209,621,343,1008,25.7,25.2,25.4,"75% or more P.O.C.","Less than $51000"
"06037222100","Census Tract 2221, Los Angeles County, California",4331,53864,236,1213,0,293,0,2558,5.4,28,0,6.8,0,59.1,94.6,1208,451,757,37.33,62.67,86,365,158,599,244,964,19.1,20.9,20.2,"75% or more P.O.C.","$51000 - $70000"
"06037222200","Census Tract 2222, Los Angeles County, California",4016,40227,160,681,0,170,0,2967,4,17,0,4.2,0,73.9,96,1196,249,947,20.82,79.18,39,210,261,686,300,896,15.7,27.6,25.1,"75% or more P.O.C.","Less than $51000"
"06037222500","Census Tract 2225, Los Angeles County, California",5120,56548,169,1128,0,166,7,3541,3.3,22,0,3.2,0.1,69.2,96.7,1260,488,772,38.73,61.27,158,330,225,547,383,877,32.4,29.1,30.4,"75% or more P.O.C.","$51000 - $70000"
"06037222600","Census Tract 2226, Los Angeles County, California",5549,28581,452,997,25,1041,0,2889,8.1,18,0.5,18.8,0,52.1,91.9,1684,258,1426,15.32,84.68,68,190,252,1174,320,1364,26.4,17.7,19,"75% or more P.O.C.","Less than $51000"
"06037222700","Census Tract 2227, Los Angeles County, California",4071,9632,1714,288,0,1328,30,574,42.1,7.1,0,32.6,0.7,14.1,57.9,135,0,135,0,100,0,0,3,132,3,132,NA,2.2,2.2,"50% - 75% P.O.C.","Less than $51000"
"06037224010","Census Tract 2240.10, Los Angeles County, California",2845,28082,394,502,0,266,0,1639,13.8,17.6,0,9.3,0,57.6,86.2,1533,10,1523,0.65,99.35,0,10,36,1487,36,1497,0,2.4,2.3,"75% or more P.O.C.","Less than $51000"
"06037224020","Census Tract 2240.20, Los Angeles County, California",2733,27332,168,75,4,55,0,2415,6.1,2.7,0.1,2,0,88.4,93.9,943,49,894,5.2,94.8,26,23,142,752,168,775,53.1,15.9,17.8,"75% or more P.O.C.","Less than $51000"
"06037224200","Census Tract 2242, Los Angeles County, California",2557,31996,105,62,8,47,0,2309,4.1,2.4,0.3,1.8,0,90.3,95.9,737,60,677,8.14,91.86,8,52,155,522,163,574,13.3,22.9,22.1,"75% or more P.O.C.","Less than $51000"
"06037224310","Census Tract 2243.10, Los Angeles County, California",2422,36932,91,32,0,121,0,2172,3.8,1.3,0,5,0,89.7,96.2,660,81,579,12.27,87.73,6,75,149,430,155,505,7.4,25.7,23.5,"75% or more P.O.C.","Less than $51000"
"06037224320","Census Tract 2243.20, Los Angeles County, California",2972,28616,81,240,24,116,0,2490,2.7,8.1,0.8,3.9,0,83.8,97.3,1125,79,1046,7.02,92.98,26,53,112,934,138,987,32.9,10.7,12.3,"75% or more P.O.C.","Less than $51000"
"06037224410","Census Tract 2244.10, Los Angeles County, California",3194,26773,474,200,0,348,12,2033,14.8,6.3,0,10.9,0.4,63.7,85.2,1090,229,861,21.01,78.99,52,177,121,740,173,917,22.7,14.1,15.9,"75% or more P.O.C.","Less than $51000"
"06037224420","Census Tract 2244.20, Los Angeles County, California",2637,24878,119,170,0,142,0,2181,4.5,6.4,0,5.4,0,82.7,95.5,753,62,691,8.23,91.77,16,46,95,596,111,642,25.8,13.7,14.7,"75% or more P.O.C.","Less than $51000"
"06037224600","Census Tract 2246, Los Angeles County, California",3385,46162,75,250,0,98,0,2962,2.2,7.4,0,2.9,0,87.5,97.8,819,104,715,12.7,87.3,35,69,251,464,286,533,33.7,35.1,34.9,"75% or more P.O.C.","Less than $51000"
"06037224700","Census Tract 2247, Los Angeles County, California",6238,11576,2530,332,4,2239,24,879,40.6,5.3,0.1,35.9,0.4,14.1,59.4,949,18,931,1.9,98.1,0,18,50,881,50,899,0,5.4,5.3,"50% - 75% P.O.C.","Less than $51000"
"06037226001","Census Tract 2260.01, Los Angeles County, California",2615,34808,10,407,9,0,0,2189,0.4,15.6,0.3,0,0,83.7,99.6,604,95,509,15.73,84.27,21,74,187,322,208,396,22.1,36.7,34.4,"75% or more P.O.C.","Less than $51000"
"06037226002","Census Tract 2260.02, Los Angeles County, California",1820,37643,609,208,0,151,0,793,33.5,11.4,0,8.3,0,43.6,66.5,1108,134,974,12.09,87.91,14,120,33,941,47,1061,10.4,3.4,4.2,"50% - 75% P.O.C.","Less than $51000"
"06037226410","Census Tract 2264.10, Los Angeles County, California",3665,40147,7,34,0,16,4,3592,0.2,0.9,0,0.4,0.1,98,99.8,884,123,761,13.91,86.09,35,88,265,496,300,584,28.5,34.8,33.9,"75% or more P.O.C.","Less than $51000"
"06037226420","Census Tract 2264.20, Los Angeles County, California",5531,44209,36,396,0,237,33,4829,0.7,7.2,0,4.3,0.6,87.3,99.3,1284,305,979,23.75,76.25,122,183,346,633,468,816,40,35.3,36.4,"75% or more P.O.C.","Less than $51000"
"06037226700","Census Tract 2267, Los Angeles County, California",7661,40140,0,210,0,9,0,7433,0,2.7,0,0.1,0,97,100,1517,316,1201,20.83,79.17,133,183,495,706,628,889,42.1,41.2,41.4,"75% or more P.O.C.","Less than $51000"
"06037227010","Census Tract 2270.10, Los Angeles County, California",5705,48200,32,304,68,0,0,5301,0.6,5.3,1.2,0,0,92.9,99.4,1128,241,887,21.37,78.63,124,117,439,448,563,565,51.5,49.5,49.9,"75% or more P.O.C.","Less than $51000"
"06037227020","Census Tract 2270.20, Los Angeles County, California",3623,47361,14,93,0,15,0,3501,0.4,2.6,0,0.4,0,96.6,99.6,770,207,563,26.88,73.12,72,135,232,331,304,466,34.8,41.2,39.5,"75% or more P.O.C.","Less than $51000"
"06037228100","Census Tract 2281, Los Angeles County, California",5505,47444,0,326,0,15,0,5150,0,5.9,0,0.3,0,93.6,100,1016,302,714,29.72,70.28,143,159,328,386,471,545,47.4,45.9,46.4,"75% or more P.O.C.","Less than $51000"
"06037228210","Census Tract 2282.10, Los Angeles County, California",4233,35969,14,261,42,78,0,3838,0.3,6.2,1,1.8,0,90.7,99.7,1003,272,731,27.12,72.88,169,103,199,532,368,635,62.1,27.2,36.7,"75% or more P.O.C.","Less than $51000"
"06037228220","Census Tract 2282.20, Los Angeles County, California",4375,43482,41,298,8,0,0,3974,0.9,6.8,0.2,0,0,90.8,99.1,922,314,608,34.06,65.94,173,141,191,417,364,558,55.1,31.4,39.5,"75% or more P.O.C.","Less than $51000"
"06037228310","Census Tract 2283.10, Los Angeles County, California",4523,44375,31,213,5,0,0,4263,0.7,4.7,0.1,0,0,94.3,99.3,1044,226,818,21.65,78.35,100,126,274,544,374,670,44.2,33.5,35.8,"75% or more P.O.C.","Less than $51000"
"06037228320","Census Tract 2283.20, Los Angeles County, California",3122,43272,0,103,0,0,0,3019,0,3.3,0,0,0,96.7,100,709,200,509,28.21,71.79,66,134,232,277,298,411,33,45.6,42,"75% or more P.O.C.","Less than $51000"
"06037228410","Census Tract 2284.10, Los Angeles County, California",3600,41012,80,124,0,49,12,3335,2.2,3.4,0,1.4,0.3,92.6,97.8,723,186,537,25.73,74.27,110,76,249,288,359,364,59.1,46.4,49.7,"75% or more P.O.C.","Less than $51000"
"06037228420","Census Tract 2284.20, Los Angeles County, California",3304,38094,14,242,0,0,0,3043,0.4,7.3,0,0,0,92.1,99.6,715,152,563,21.26,78.74,69,83,187,376,256,459,45.4,33.2,35.8,"75% or more P.O.C.","Less than $51000"
"06037228500","Census Tract 2285, Los Angeles County, California",4869,33125,0,748,0,0,0,4121,0,15.4,0,0,0,84.6,100,1188,267,921,22.47,77.53,109,158,253,668,362,826,40.8,27.5,30.5,"75% or more P.O.C.","Less than $51000"
"06037228600","Census Tract 2286, Los Angeles County, California",5301,48393,26,339,15,4,0,4881,0.5,6.4,0.3,0.1,0,92.1,99.5,1159,350,809,30.2,69.8,109,241,247,562,356,803,31.1,30.5,30.7,"75% or more P.O.C.","Less than $51000"
"06037228710","Census Tract 2287.10, Los Angeles County, California",3982,31849,23,374,6,39,0,3519,0.6,9.4,0.2,1,0,88.4,99.4,995,185,810,18.59,81.41,83,102,284,526,367,628,44.9,35.1,36.9,"75% or more P.O.C.","Less than $51000"
"06037228720","Census Tract 2287.20, Los Angeles County, California",4825,38933,31,525,0,0,0,4257,0.6,10.9,0,0,0,88.2,99.4,1044,318,726,30.46,69.54,145,173,270,456,415,629,45.6,37.2,39.8,"75% or more P.O.C.","Less than $51000"
"06037228800","Census Tract 2288, Los Angeles County, California",5353,41250,0,445,0,0,7,4892,0,8.3,0,0,0.1,91.4,100,1189,457,732,38.44,61.56,195,262,231,501,426,763,42.7,31.6,35.8,"75% or more P.O.C.","Less than $51000"
"06037228900","Census Tract 2289, Los Angeles County, California",2918,23750,5,366,0,0,0,2547,0.2,12.5,0,0,0,87.3,99.8,714,101,613,14.15,85.85,52,49,154,459,206,508,51.5,25.1,28.9,"75% or more P.O.C.","Less than $51000"
"06037229100","Census Tract 2291, Los Angeles County, California",5146,46678,15,425,0,0,0,4691,0.3,8.3,0,0,0,91.2,99.7,1021,356,665,34.87,65.13,161,195,347,318,508,513,45.2,52.2,49.8,"75% or more P.O.C.","Less than $51000"
"06037229200","Census Tract 2292, Los Angeles County, California",5072,41250,11,687,0,57,0,4317,0.2,13.5,0,1.1,0,85.1,99.8,1184,316,868,26.69,73.31,170,146,225,643,395,789,53.8,25.9,33.4,"75% or more P.O.C.","Less than $51000"
"06037229300","Census Tract 2293, Los Angeles County, California",5715,37468,43,553,25,0,7,5007,0.8,9.7,0.4,0,0.1,87.6,99.2,1370,406,964,29.64,70.36,113,293,289,675,402,968,27.8,30,29.3,"75% or more P.O.C.","Less than $51000"
"06037229410","Census Tract 2294.10, Los Angeles County, California",3697,34403,29,193,0,34,0,3414,0.8,5.2,0,0.9,0,92.3,99.2,813,196,617,24.11,75.89,103,93,211,406,314,499,52.6,34.2,38.6,"75% or more P.O.C.","Less than $51000"
"06037229420","Census Tract 2294.20, Los Angeles County, California",4759,42250,18,383,0,14,0,4332,0.4,8,0,0.3,0,91,99.6,1118,396,722,35.42,64.58,148,248,250,472,398,720,37.4,34.6,35.6,"75% or more P.O.C.","Less than $51000"
"06037231100","Census Tract 2311, Los Angeles County, California",3474,31494,249,568,0,67,0,2518,7.2,16.4,0,1.9,0,72.5,92.8,692,64,628,9.25,90.75,15,49,179,449,194,498,23.4,28.5,28,"75% or more P.O.C.","Less than $51000"
"06037231210","Census Tract 2312.10, Los Angeles County, California",4040,32258,71,463,27,32,0,3388,1.8,11.5,0.7,0.8,0,83.9,98.2,1156,157,999,13.58,86.42,100,57,208,791,308,848,63.7,20.8,26.6,"75% or more P.O.C.","Less than $51000"
"06037231220","Census Tract 2312.20, Los Angeles County, California",4653,29741,80,1058,0,277,0,3189,1.7,22.7,0,6,0,68.5,98.3,1284,155,1129,12.07,87.93,94,61,241,888,335,949,60.6,21.3,26.1,"75% or more P.O.C.","Less than $51000"
"06037231300","Census Tract 2313, Los Angeles County, California",5754,49803,241,1062,0,241,0,4079,4.2,18.5,0,4.2,0,70.9,95.8,1714,597,1117,34.83,65.17,144,453,87,1030,231,1483,24.1,7.8,13.5,"75% or more P.O.C.","Less than $51000"
"06037231400","Census Tract 2314, Los Angeles County, California",4745,41774,171,1348,0,75,0,3103,3.6,28.4,0,1.6,0,65.4,96.4,1554,621,933,39.96,60.04,123,498,110,823,233,1321,19.8,11.8,15,"75% or more P.O.C.","Less than $51000"
"06037231500","Census Tract 2315, Los Angeles County, California",5396,48912,38,1728,0,240,0,3311,0.7,32,0,4.4,0,61.4,99.3,1443,805,638,55.79,44.21,168,637,181,457,349,1094,20.9,28.4,24.2,"75% or more P.O.C.","Less than $51000"
"06037231600","Census Tract 2316, Los Angeles County, California",7420,45123,418,2032,0,83,0,4650,5.6,27.4,0,1.1,0,62.7,94.4,2072,637,1435,30.74,69.26,135,502,313,1122,448,1624,21.2,21.8,21.6,"75% or more P.O.C.","Less than $51000"
"06037231710","Census Tract 2317.10, Los Angeles County, California",4165,26444,26,642,7,0,0,3422,0.6,15.4,0.2,0,0,82.2,99.4,1323,124,1199,9.37,90.63,38,86,265,934,303,1020,30.6,22.1,22.9,"75% or more P.O.C.","Less than $51000"
"06037231720","Census Tract 2317.20, Los Angeles County, California",4934,36528,105,807,0,94,0,3855,2.1,16.4,0,1.9,0,78.1,97.9,1524,262,1262,17.19,82.81,85,177,159,1103,244,1280,32.4,12.6,16,"75% or more P.O.C.","Less than $51000"
"06037231800","Census Tract 2318, Los Angeles County, California",5436,36765,0,238,0,0,0,5049,0,4.4,0,0,0,92.9,100,1410,185,1225,13.12,86.88,65,120,336,889,401,1009,35.1,27.4,28.4,"75% or more P.O.C.","Less than $51000"
"06037231900","Census Tract 2319, Los Angeles County, California",6162,33958,24,645,31,16,0,5308,0.4,10.5,0.5,0.3,0,86.1,99.6,1541,482,1059,31.28,68.72,197,285,268,791,465,1076,40.9,25.3,30.2,"75% or more P.O.C.","Less than $51000"
"06037232110","Census Tract 2321.10, Los Angeles County, California",3038,33203,7,463,12,20,0,2527,0.2,15.2,0.4,0.7,0,83.2,99.8,886,184,702,20.77,79.23,51,133,144,558,195,691,27.7,20.5,22,"75% or more P.O.C.","Less than $51000"
"06037232120","Census Tract 2321.20, Los Angeles County, California",5567,37555,36,1048,23,97,0,4362,0.6,18.8,0.4,1.7,0,78.4,99.4,1357,254,1103,18.72,81.28,133,121,289,814,422,935,52.4,26.2,31.1,"75% or more P.O.C.","Less than $51000"
"06037232200","Census Tract 2322, Los Angeles County, California",3487,43911,40,1212,0,17,0,2202,1.1,34.8,0,0.5,0,63.1,98.9,909,339,570,37.29,62.71,135,204,120,450,255,654,39.8,21.1,28.1,"75% or more P.O.C.","Less than $51000"
"06037232300","Census Tract 2323, Los Angeles County, California",6006,58576,63,1408,0,1,0,4464,1,23.4,0,0,0,74.3,99,1143,611,532,53.46,46.54,291,320,174,358,465,678,47.6,32.7,40.7,"75% or more P.O.C.","$51000 - $70000"
"06037232400","Census Tract 2324, Los Angeles County, California",7361,46883,209,2868,0,116,0,3975,2.8,39,0,1.6,0,54,97.2,1943,965,978,49.67,50.33,280,685,192,786,472,1471,29,19.6,24.3,"75% or more P.O.C.","Less than $51000"
"06037232500","Census Tract 2325, Los Angeles County, California",4940,55841,6,1563,0,50,0,3272,0.1,31.6,0,1,0,66.2,99.9,1471,717,754,48.74,51.26,214,503,135,619,349,1122,29.8,17.9,23.7,"75% or more P.O.C.","$51000 - $70000"
"06037232600","Census Tract 2326, Los Angeles County, California",6833,42734,56,1366,43,68,0,5300,0.8,20,0.6,1,0,77.6,99.2,1909,865,1044,45.31,54.69,253,612,159,885,412,1497,29.2,15.2,21.6,"75% or more P.O.C.","Less than $51000"
"06037232700","Census Tract 2327, Los Angeles County, California",6568,38341,74,1071,0,64,0,5247,1.1,16.3,0,1,0,79.9,98.9,1642,574,1068,34.96,65.04,117,457,305,763,422,1220,20.4,28.6,25.7,"75% or more P.O.C.","Less than $51000"
"06037232800","Census Tract 2328, Los Angeles County, California",4489,33438,27,525,3,0,0,3887,0.6,11.7,0.1,0,0,86.6,99.4,995,315,680,31.66,68.34,151,164,198,482,349,646,47.9,29.1,35.1,"75% or more P.O.C.","Less than $51000"
"06037234000","Census Tract 2340, Los Angeles County, California",5417,54722,305,2979,0,26,0,2027,5.6,55,0,0.5,0,37.4,94.4,2032,1265,767,62.25,37.75,84,1181,118,649,202,1830,6.6,15.4,9.9,"75% or more P.O.C.","$51000 - $70000"
"06037234200","Census Tract 2342, Los Angeles County, California",2424,76761,291,1694,0,184,10,163,12,69.9,0,7.6,0.4,6.7,88,1167,842,325,72.15,27.85,57,785,0,325,57,1110,6.8,0,4.9,"75% or more P.O.C.","$70000 - $95000"
"06037234300","Census Tract 2343, Los Angeles County, California",3805,45815,207,2970,0,96,0,374,5.4,78.1,0,2.5,0,9.8,94.6,2276,420,1856,18.45,81.55,22,398,29,1827,51,2225,5.2,1.6,2.2,"75% or more P.O.C.","Less than $51000"
"06037234501","Census Tract 2345.01, Los Angeles County, California",2845,54622,139,1562,0,27,0,1023,4.9,54.9,0,0.9,0,36,95.1,929,681,248,73.3,26.7,128,553,0,248,128,801,18.8,0,13.8,"75% or more P.O.C.","$51000 - $70000"
"06037234502","Census Tract 2345.02, Los Angeles County, California",3017,33500,77,1824,0,35,0,1046,2.6,60.5,0,1.2,0,34.7,97.4,1196,342,854,28.6,71.4,5,337,87,767,92,1104,1.5,10.2,7.7,"75% or more P.O.C.","Less than $51000"
"06037234600","Census Tract 2346, Los Angeles County, California",4908,55887,268,2484,0,88,0,1728,5.5,50.6,0,1.8,0,35.2,94.5,1706,1184,522,69.4,30.6,258,926,67,455,325,1381,21.8,12.8,19.1,"75% or more P.O.C.","$51000 - $70000"
"06037234700","Census Tract 2347, Los Angeles County, California",3690,40375,56,2003,0,1,0,1608,1.5,54.3,0,0,0,43.6,98.5,1447,691,756,47.75,52.25,119,572,82,674,201,1246,17.2,10.8,13.9,"75% or more P.O.C.","Less than $51000"
"06037234800","Census Tract 2348, Los Angeles County, California",3317,58736,93,1727,0,0,46,1377,2.8,52.1,0,0,1.4,41.5,97.2,1207,721,486,59.73,40.27,89,632,27,459,116,1091,12.3,5.6,9.6,"75% or more P.O.C.","$51000 - $70000"
"06037234901","Census Tract 2349.01, Los Angeles County, California",3321,22693,23,1734,0,0,0,1557,0.7,52.2,0,0,0,46.9,99.3,1125,32,1093,2.84,97.16,7,25,212,881,219,906,21.9,19.4,19.5,"75% or more P.O.C.","Less than $51000"
"06037234902","Census Tract 2349.02, Los Angeles County, California",4088,23981,198,1689,19,143,20,1932,4.8,41.3,0.5,3.5,0.5,47.3,95.2,1570,350,1220,22.29,77.71,32,318,80,1140,112,1458,9.1,6.6,7.1,"75% or more P.O.C.","Less than $51000"
"06037235100","Census Tract 2351, Los Angeles County, California",4401,87246,511,2883,0,176,0,717,11.6,65.5,0,4,0,16.3,88.4,1674,1299,375,77.6,22.4,118,1181,41,334,159,1515,9.1,10.9,9.5,"75% or more P.O.C.","$70000 - $95000"
"06037235201","Census Tract 2352.01, Los Angeles County, California",2682,45341,84,1592,0,6,5,905,3.1,59.4,0,0.2,0.2,33.7,96.9,979,671,308,68.54,31.46,67,604,35,273,102,877,10,11.4,10.4,"75% or more P.O.C.","Less than $51000"
"06037235202","Census Tract 2352.02, Los Angeles County, California",4331,31732,46,2832,0,6,0,1286,1.1,65.4,0,0.1,0,29.7,98.9,1941,648,1293,33.38,66.62,32,616,29,1264,61,1880,4.9,2.2,3.1,"75% or more P.O.C.","Less than $51000"
"06037236000","Census Tract 2360, Los Angeles County, California",4181,90790,1120,1965,37,156,0,642,26.8,47,0.9,3.7,0,15.4,73.2,2189,1724,465,78.76,21.24,15,1709,30,435,45,2144,0.9,6.5,2.1,"50% - 75% P.O.C.","$70000 - $95000"
"06037236100","Census Tract 2361, Los Angeles County, California",6170,30380,97,3725,0,498,0,1681,1.6,60.4,0,8.1,0,27.2,98.4,2986,485,2501,16.24,83.76,13,472,148,2353,161,2825,2.7,5.9,5.4,"75% or more P.O.C.","Less than $51000"
"06037236202","Census Tract 2362.02, Los Angeles County, California",5764,29766,293,2363,0,196,0,2734,5.1,41,0,3.4,0,47.4,94.9,2510,35,2475,1.39,98.61,0,35,185,2290,185,2325,0,7.5,7.4,"75% or more P.O.C.","Less than $51000"
"06037236203","Census Tract 2362.03, Los Angeles County, California",3118,30144,116,1710,34,224,0,889,3.7,54.8,1.1,7.2,0,28.5,96.3,1472,17,1455,1.15,98.85,0,17,55,1400,55,1417,0,3.8,3.7,"75% or more P.O.C.","Less than $51000"
"06037236204","Census Tract 2362.04, Los Angeles County, California",3109,23677,143,1567,10,22,11,1303,4.6,50.4,0.3,0.7,0.4,41.9,95.4,1373,0,1373,0,100,0,0,150,1223,150,1223,NA,10.9,10.9,"75% or more P.O.C.","Less than $51000"
"06037236400","Census Tract 2364, Los Angeles County, California",4282,66359,405,3518,13,75,0,120,9.5,82.2,0.3,1.8,0,2.8,90.5,2105,1090,1015,51.78,48.22,45,1045,11,1004,56,2049,4.1,1.1,2.7,"75% or more P.O.C.","$51000 - $70000"
"06037237101","Census Tract 2371.01, Los Angeles County, California",4409,33569,28,1169,0,92,0,3091,0.6,26.5,0,2.1,0,70.1,99.4,1169,302,867,25.83,74.17,76,226,231,636,307,862,25.2,26.6,26.3,"75% or more P.O.C.","Less than $51000"
"06037237102","Census Tract 2371.02, Los Angeles County, California",3407,37849,38,569,0,23,0,2753,1.1,16.7,0,0.7,0,80.8,98.9,931,270,661,29,71,62,208,148,513,210,721,23,22.4,22.6,"75% or more P.O.C.","Less than $51000"
"06037237201","Census Tract 2372.01, Los Angeles County, California",3814,44911,43,1018,0,74,0,2662,1.1,26.7,0,1.9,0,69.8,98.9,1011,433,578,42.83,57.17,126,307,165,413,291,720,29.1,28.5,28.8,"75% or more P.O.C.","Less than $51000"
"06037237202","Census Tract 2372.02, Los Angeles County, California",4556,38438,190,1339,0,71,21,2918,4.2,29.4,0,1.6,0.5,64,95.8,1394,676,718,48.49,51.51,227,449,112,606,339,1055,33.6,15.6,24.3,"75% or more P.O.C.","Less than $51000"
"06037237300","Census Tract 2373, Los Angeles County, California",5311,45107,145,2777,10,1,0,2308,2.7,52.3,0.2,0,0,43.5,97.3,1917,1011,906,52.74,47.26,203,808,55,851,258,1659,20.1,6.1,13.5,"75% or more P.O.C.","Less than $51000"
"06037237401","Census Tract 2374.01, Los Angeles County, California",4217,41703,68,983,0,0,0,3143,1.6,23.3,0,0,0,74.5,98.4,1095,548,547,50.05,49.95,192,356,104,443,296,799,35,19,27,"75% or more P.O.C.","Less than $51000"
"06037237402","Census Tract 2374.02, Los Angeles County, California",3335,45875,62,1157,0,0,0,1870,1.9,34.7,0,0,0,56.1,98.1,1031,633,398,61.4,38.6,128,505,44,354,172,859,20.2,11.1,16.7,"75% or more P.O.C.","Less than $51000"
"06037237500","Census Tract 2375, Los Angeles County, California",2922,32051,47,657,0,2,0,2212,1.6,22.5,0,0.1,0,75.7,98.4,882,144,738,16.33,83.67,52,92,128,610,180,702,36.1,17.3,20.4,"75% or more P.O.C.","Less than $51000"
"06037237600","Census Tract 2376, Los Angeles County, California",4101,32456,38,928,12,74,0,3039,0.9,22.6,0.3,1.8,0,74.1,99.1,1230,289,941,23.5,76.5,74,215,193,748,267,963,25.6,20.5,21.7,"75% or more P.O.C.","Less than $51000"
"06037237710","Census Tract 2377.10, Los Angeles County, California",4410,36029,23,755,30,0,0,3530,0.5,17.1,0.7,0,0,80,99.5,1144,197,947,17.22,82.78,110,87,234,713,344,800,55.8,24.7,30.1,"75% or more P.O.C.","Less than $51000"
"06037237720","Census Tract 2377.20, Los Angeles County, California",3707,33897,80,874,16,0,0,2701,2.2,23.6,0.4,0,0,72.9,97.8,906,170,736,18.76,81.24,72,98,176,560,248,658,42.4,23.9,27.4,"75% or more P.O.C.","Less than $51000"
"06037237800","Census Tract 2378, Los Angeles County, California",3796,48922,62,1996,61,8,0,1544,1.6,52.6,1.6,0.2,0,40.7,98.4,1398,845,553,60.44,39.56,73,772,12,541,85,1313,8.6,2.2,6.1,"75% or more P.O.C.","Less than $51000"
"06037237900","Census Tract 2379, Los Angeles County, California",4405,51612,136,2966,0,0,0,1151,3.1,67.3,0,0,0,26.1,96.9,1408,940,468,66.76,33.24,111,829,31,437,142,1266,11.8,6.6,10.1,"75% or more P.O.C.","$51000 - $70000"
"06037238000","Census Tract 2380, Los Angeles County, California",6174,61773,96,4197,0,24,43,1333,1.6,68,0,0.4,0.7,21.6,98.4,2342,1334,1008,56.96,43.04,103,1231,122,886,225,2117,7.7,12.1,9.6,"75% or more P.O.C.","$51000 - $70000"
"06037238100","Census Tract 2381, Los Angeles County, California",5163,48034,78,2869,0,31,0,2047,1.5,55.6,0,0.6,0,39.6,98.5,1823,883,940,48.44,51.56,110,773,60,880,170,1653,12.5,6.4,9.3,"75% or more P.O.C.","Less than $51000"
"06037238200","Census Tract 2382, Los Angeles County, California",5565,45075,22,3919,0,111,0,1475,0.4,70.4,0,2,0,26.5,99.6,2172,1006,1166,46.32,53.68,63,943,71,1095,134,2038,6.3,6.1,6.2,"75% or more P.O.C.","Less than $51000"
"06037238310","Census Tract 2383.10, Los Angeles County, California",5002,26356,52,1206,0,0,9,3723,1,24.1,0,0,0.2,74.4,99,1492,133,1359,8.91,91.09,18,115,314,1045,332,1160,13.5,23.1,22.3,"75% or more P.O.C.","Less than $51000"
"06037238320","Census Tract 2383.20, Los Angeles County, California",3804,34131,38,1235,0,52,0,2479,1,32.5,0,1.4,0,65.2,99,1143,178,965,15.57,84.43,35,143,167,798,202,941,19.7,17.3,17.7,"75% or more P.O.C.","Less than $51000"
"06037238400","Census Tract 2384, Los Angeles County, California",4694,54746,92,3614,47,0,16,837,2,77,1,0,0.3,17.8,98,1906,1189,717,62.38,37.62,36,1153,119,598,155,1751,3,16.6,8.1,"75% or more P.O.C.","$51000 - $70000"
"06037239201","Census Tract 2392.01, Los Angeles County, California",3753,36034,27,562,6,0,0,3145,0.7,15,0.2,0,0,83.8,99.3,958,165,793,17.22,82.78,41,124,208,585,249,709,24.8,26.2,26,"75% or more P.O.C.","Less than $51000"
"06037239202","Census Tract 2392.02, Los Angeles County, California",5999,42609,7,423,41,0,0,5495,0.1,7.1,0.7,0,0,91.6,99.9,1176,317,859,26.96,73.04,123,194,403,456,526,650,38.8,46.9,44.7,"75% or more P.O.C.","Less than $51000"
"06037239310","Census Tract 2393.10, Los Angeles County, California",4501,37259,46,483,0,6,0,3960,1,10.7,0,0.1,0,88,99,1009,245,764,24.28,75.72,103,142,271,493,374,635,42,35.5,37.1,"75% or more P.O.C.","Less than $51000"
"06037239320","Census Tract 2393.20, Los Angeles County, California",4086,44896,12,440,0,6,0,3451,0.3,10.8,0,0.1,0,84.5,99.7,848,319,529,37.62,62.38,107,212,213,316,320,528,33.5,40.3,37.7,"75% or more P.O.C.","Less than $51000"
"06037239330","Census Tract 2393.30, Los Angeles County, California",2458,32708,19,284,0,0,0,2130,0.8,11.6,0,0,0,86.7,99.2,683,235,448,34.41,65.59,64,171,128,320,192,491,27.2,28.6,28.1,"75% or more P.O.C.","Less than $51000"
"06037239501","Census Tract 2395.01, Los Angeles County, California",3729,44177,59,815,0,16,0,2831,1.6,21.9,0,0.4,0,75.9,98.4,927,330,597,35.6,64.4,69,261,186,411,255,672,20.9,31.2,27.5,"75% or more P.O.C.","Less than $51000"
"06037239502","Census Tract 2395.02, Los Angeles County, California",4016,41250,8,849,0,0,0,3139,0.2,21.1,0,0,0,78.2,99.8,920,330,590,35.87,64.13,147,183,203,387,350,570,44.5,34.4,38,"75% or more P.O.C.","Less than $51000"
"06037239601","Census Tract 2396.01, Los Angeles County, California",3682,43102,18,674,6,9,0,2904,0.5,18.3,0.2,0.2,0,78.9,99.5,891,255,636,28.62,71.38,65,190,243,393,308,583,25.5,38.2,34.6,"75% or more P.O.C.","Less than $51000"
"06037239602","Census Tract 2396.02, Los Angeles County, California",4016,38295,20,787,0,17,0,3192,0.5,19.6,0,0.4,0,79.5,99.5,893,248,645,27.77,72.23,118,130,227,418,345,548,47.6,35.2,38.6,"75% or more P.O.C.","Less than $51000"
"06037239701","Census Tract 2397.01, Los Angeles County, California",5134,36232,0,832,0,0,0,4302,0,16.2,0,0,0,83.8,100,1114,297,817,26.66,73.34,157,140,296,521,453,661,52.9,36.2,40.7,"75% or more P.O.C.","Less than $51000"
"06037239702","Census Tract 2397.02, Los Angeles County, California",4334,31189,14,1284,0,0,0,3036,0.3,29.6,0,0,0,70.1,99.7,1096,283,813,25.82,74.18,135,148,231,582,366,730,47.7,28.4,33.4,"75% or more P.O.C.","Less than $51000"
"06037239801","Census Tract 2398.01, Los Angeles County, California",3705,46938,4,746,0,5,0,2915,0.1,20.1,0,0.1,0,78.7,99.9,893,279,614,31.24,68.76,68,211,183,431,251,642,24.4,29.8,28.1,"75% or more P.O.C.","Less than $51000"
"06037239802","Census Tract 2398.02, Los Angeles County, California",5461,42171,59,1484,0,26,0,3828,1.1,27.2,0,0.5,0,70.1,98.9,1393,433,960,31.08,68.92,98,335,291,669,389,1004,22.6,30.3,27.9,"75% or more P.O.C.","Less than $51000"
"06037240010","Census Tract 2400.10, Los Angeles County, California",3737,30612,5,943,0,0,0,2770,0.1,25.2,0,0,0,74.1,99.9,984,210,774,21.34,78.66,21,189,231,543,252,732,10,29.8,25.6,"75% or more P.O.C.","Less than $51000"
"06037240020","Census Tract 2400.20, Los Angeles County, California",5223,38266,20,1489,0,0,0,3711,0.4,28.5,0,0,0,71.1,99.6,1283,620,663,48.32,51.68,240,380,257,406,497,786,38.7,38.8,38.7,"75% or more P.O.C.","Less than $51000"
"06037240200","Census Tract 2402, Los Angeles County, California",5159,40286,18,1156,36,86,0,3863,0.3,22.4,0.7,1.7,0,74.9,99.7,1406,316,1090,22.48,77.52,133,183,256,834,389,1017,42.1,23.5,27.7,"75% or more P.O.C.","Less than $51000"
"06037240300","Census Tract 2403, Los Angeles County, California",5637,22875,51,2031,0,20,0,3528,0.9,36,0,0.4,0,62.6,99.1,1636,339,1297,20.72,79.28,72,267,352,945,424,1212,21.2,27.1,25.9,"75% or more P.O.C.","Less than $51000"
"06037240401","Census Tract 2404.01, Los Angeles County, California",6379,42662,10,1168,0,46,0,5147,0.2,18.3,0,0.7,0,80.7,99.8,1486,436,1050,29.34,70.66,187,249,360,690,547,939,42.9,34.3,36.8,"75% or more P.O.C.","Less than $51000"
"06037240402","Census Tract 2404.02, Los Angeles County, California",3763,42422,54,1241,0,41,0,2412,1.4,33,0,1.1,0,64.1,98.6,1224,590,634,48.2,51.8,135,455,81,553,216,1008,22.9,12.8,17.6,"75% or more P.O.C.","Less than $51000"
"06037240500","Census Tract 2405, Los Angeles County, California",7326,40764,0,1959,0,0,0,5284,0,26.7,0,0,0,72.1,100,1737,484,1253,27.86,72.14,227,257,228,1025,455,1282,46.9,18.2,26.2,"75% or more P.O.C.","Less than $51000"
"06037240600","Census Tract 2406, Los Angeles County, California",6167,43250,78,1796,0,20,0,4273,1.3,29.1,0,0.3,0,69.3,98.7,1316,421,895,31.99,68.01,167,254,287,608,454,862,39.7,32.1,34.5,"75% or more P.O.C.","Less than $51000"
"06037240700","Census Tract 2407, Los Angeles County, California",6596,43584,20,1770,36,77,0,4693,0.3,26.8,0.5,1.2,0,71.1,99.7,1695,726,969,42.83,57.17,215,511,260,709,475,1220,29.6,26.8,28,"75% or more P.O.C.","Less than $51000"
"06037240800","Census Tract 2408, Los Angeles County, California",4341,41277,34,1125,28,89,0,3019,0.8,25.9,0.6,2.1,0,69.5,99.2,1154,562,592,48.7,51.3,126,436,194,398,320,834,22.4,32.8,27.7,"75% or more P.O.C.","Less than $51000"
"06037240900","Census Tract 2409, Los Angeles County, California",6736,45619,0,1413,0,19,0,5304,0,21,0,0.3,0,78.7,100,1483,640,843,43.16,56.84,220,420,300,543,520,963,34.4,35.6,35.1,"75% or more P.O.C.","Less than $51000"
"06037241001","Census Tract 2410.01, Los Angeles County, California",4197,41563,5,1043,0,8,8,3022,0.1,24.9,0,0.2,0.2,72,99.9,1163,500,663,42.99,57.01,156,344,190,473,346,817,31.2,28.7,29.8,"75% or more P.O.C.","Less than $51000"
"06037241002","Census Tract 2410.02, Los Angeles County, California",4144,59116,16,1544,0,3,0,2457,0.4,37.3,0,0.1,0,59.3,99.6,1039,446,593,42.93,57.07,195,251,150,443,345,694,43.7,25.3,33.2,"75% or more P.O.C.","$51000 - $70000"
"06037241110","Census Tract 2411.10, Los Angeles County, California",3356,47090,31,848,0,4,0,2473,0.9,25.3,0,0.1,0,73.7,99.1,795,301,494,37.86,62.14,109,192,128,366,237,558,36.2,25.9,29.8,"75% or more P.O.C.","Less than $51000"
"06037241120","Census Tract 2411.20, Los Angeles County, California",5146,35114,38,1350,0,85,0,3628,0.7,26.2,0,1.7,0,70.5,99.3,1319,439,880,33.28,66.72,119,320,222,658,341,978,27.1,25.2,25.9,"75% or more P.O.C.","Less than $51000"
"06037241201","Census Tract 2412.01, Los Angeles County, California",3015,48864,34,1238,0,17,0,1720,1.1,41.1,0,0.6,0,57,98.9,868,491,377,56.57,43.43,114,377,88,289,202,666,23.2,23.3,23.3,"75% or more P.O.C.","Less than $51000"
"06037241202","Census Tract 2412.02, Los Angeles County, California",5776,34662,35,2067,44,23,0,3393,0.6,35.8,0.8,0.4,0,58.7,99.4,1596,638,958,39.97,60.03,214,424,220,738,434,1162,33.5,23,27.2,"75% or more P.O.C.","Less than $51000"
"06037241300","Census Tract 2413, Los Angeles County, California",2480,46111,78,1142,0,7,8,1209,3.1,46,0,0.3,0.3,48.8,96.9,744,327,417,43.95,56.05,16,311,91,326,107,637,4.9,21.8,14.4,"75% or more P.O.C.","Less than $51000"
"06037241400","Census Tract 2414, Los Angeles County, California",3785,36667,52,682,15,57,0,2865,1.4,18,0.4,1.5,0,75.7,98.6,962,326,636,33.89,66.11,118,208,162,474,280,682,36.2,25.5,29.1,"75% or more P.O.C.","Less than $51000"
"06037242000","Census Tract 2420, Los Angeles County, California",4189,30698,133,823,0,16,0,3183,3.2,19.6,0,0.4,0,76,96.8,1074,332,742,30.91,69.09,146,186,180,562,326,748,44,24.3,30.4,"75% or more P.O.C.","Less than $51000"
"06037242100","Census Tract 2421, Los Angeles County, California",2852,18177,4,648,0,0,39,2161,0.1,22.7,0,0,1.4,75.8,99.9,751,2,749,0.27,99.73,0,2,172,577,172,579,0,23,22.9,"75% or more P.O.C.","Less than $51000"
"06037242200","Census Tract 2422, Los Angeles County, California",6402,28313,12,1536,0,10,0,4844,0.2,24,0,0.2,0,75.7,99.8,1661,546,1115,32.87,67.13,228,318,265,850,493,1168,41.8,23.8,29.7,"75% or more P.O.C.","Less than $51000"
"06037242300","Census Tract 2423, Los Angeles County, California",4952,26515,20,772,129,203,10,3663,0.4,15.6,2.6,4.1,0.2,74,99.6,1276,296,980,23.2,76.8,56,240,264,716,320,956,18.9,26.9,25.1,"75% or more P.O.C.","Less than $51000"
"06037242600","Census Tract 2426, Los Angeles County, California",4756,16586,3,1624,0,0,0,3044,0.1,34.1,0,0,0,64,99.9,1381,151,1230,10.93,89.07,97,54,232,998,329,1052,64.2,18.9,23.8,"75% or more P.O.C.","Less than $51000"
"06037242700","Census Tract 2427, Los Angeles County, California",6035,46492,68,1373,2,11,0,4570,1.1,22.8,0,0.2,0,75.7,98.9,1281,634,647,49.49,50.51,333,301,171,476,504,777,52.5,26.4,39.3,"75% or more P.O.C.","Less than $51000"
"06037243000","Census Tract 2430, Los Angeles County, California",6829,51479,34,775,280,41,0,5672,0.5,11.3,4.1,0.6,0,83.1,99.5,1350,803,547,59.48,40.52,330,473,191,356,521,829,41.1,34.9,38.6,"75% or more P.O.C.","$51000 - $70000"
"06037243100","Census Tract 2431, Los Angeles County, California",6772,27879,126,2057,0,15,0,4552,1.9,30.4,0,0.2,0,67.2,98.1,1530,450,1080,29.41,70.59,212,238,320,760,532,998,47.1,29.6,34.8,"75% or more P.O.C.","Less than $51000"
"06037261101","Census Tract 2611.01, Los Angeles County, California",3389,199094,2903,42,0,167,0,225,85.7,1.2,0,4.9,0,6.6,14.3,1381,1217,164,88.12,11.88,63,1154,0,164,63,1318,5.2,0,4.6,"Less than 25% P.O.C.","$95000 or more"
"06037261102","Census Tract 2611.02, Los Angeles County, California",3520,159563,3124,92,0,171,0,57,88.8,2.6,0,4.9,0,1.6,11.2,1467,1377,90,93.87,6.13,75,1302,0,90,75,1392,5.4,0,5.1,"Less than 25% P.O.C.","$95000 or more"
"06037261200","Census Tract 2612, Los Angeles County, California",4182,188424,3576,20,0,381,0,108,85.5,0.5,0,9.1,0,2.6,14.5,1603,1314,289,81.97,18.03,37,1277,15,274,52,1551,2.8,5.2,3.2,"Less than 25% P.O.C.","$95000 or more"
"06037262100","Census Tract 2621, Los Angeles County, California",2678,217462,2021,18,0,368,0,139,75.5,0.7,0,13.7,0,5.2,24.5,1131,988,143,87.36,12.64,49,939,10,133,59,1072,5,7,5.2,"Less than 25% P.O.C.","$95000 or more"
"06037262200","Census Tract 2622, Los Angeles County, California",4405,184000,3427,191,0,304,0,135,77.8,4.3,0,6.9,0,3.1,22.2,1766,1405,361,79.56,20.44,78,1327,12,349,90,1676,5.6,3.3,5.1,"Less than 25% P.O.C.","$95000 or more"
"06037262301","Census Tract 2623.01, Los Angeles County, California",2748,215750,1980,68,0,362,0,293,72.1,2.5,0,13.2,0,10.7,27.9,859,807,52,93.95,6.05,60,747,0,52,60,799,7.4,0,7,"25% - 50% P.O.C.","$95000 or more"
"06037262302","Census Tract 2623.02, Los Angeles County, California",2845,158571,2345,13,0,186,0,230,82.4,0.5,0,6.5,0,8.1,17.6,1194,852,342,71.36,28.64,74,778,20,322,94,1100,8.7,5.8,7.9,"Less than 25% P.O.C.","$95000 or more"
"06037262303","Census Tract 2623.03, Los Angeles County, California",3038,250001,2595,0,40,184,0,81,85.4,0,1.3,6.1,0,2.7,14.6,1086,1040,46,95.76,4.24,118,922,14,32,132,954,11.3,30.4,12.2,"Less than 25% P.O.C.","$95000 or more"
"06037262400","Census Tract 2624, Los Angeles County, California",3059,250001,2685,84,11,143,0,73,87.8,2.7,0.4,4.7,0,2.4,12.2,1101,989,112,89.83,10.17,85,904,33,79,118,983,8.6,29.5,10.7,"Less than 25% P.O.C.","$95000 or more"
"06037262501","Census Tract 2625.01, Los Angeles County, California",3785,224962,3283,0,9,168,0,168,86.7,0,0.2,4.4,0,4.4,13.3,1397,1169,228,83.68,16.32,101,1068,7,221,108,1289,8.6,3.1,7.7,"Less than 25% P.O.C.","$95000 or more"
"06037262601","Census Tract 2626.01, Los Angeles County, California",3539,212386,2522,46,0,320,0,200,71.3,1.3,0,9,0,5.7,28.7,1349,1200,149,88.95,11.05,88,1112,0,149,88,1261,7.3,0,6.5,"25% - 50% P.O.C.","$95000 or more"
"06037262604","Census Tract 2626.04, Los Angeles County, California",5523,200625,4763,0,0,311,0,183,86.2,0,0,5.6,0,3.3,13.8,2417,1978,439,81.84,18.16,34,1944,0,439,34,2383,1.7,0,1.4,"Less than 25% P.O.C.","$95000 or more"
"06037262704","Census Tract 2627.04, Los Angeles County, California",3561,122083,2920,24,0,244,2,231,82,0.7,0,6.9,0.1,6.5,18,1609,995,614,61.84,38.16,72,923,48,566,120,1489,7.2,7.8,7.5,"Less than 25% P.O.C.","$95000 or more"
"06037262706","Census Tract 2627.06, Los Angeles County, California",3571,188409,3104,9,0,94,0,203,86.9,0.3,0,2.6,0,5.7,13.1,1314,985,329,74.96,25.04,91,894,7,322,98,1216,9.2,2.1,7.5,"Less than 25% P.O.C.","$95000 or more"
"06037262802","Census Tract 2628.02, Los Angeles County, California",3424,217292,2772,11,0,102,0,367,81,0.3,0,3,0,10.7,19,1327,1030,297,77.62,22.38,35,995,44,253,79,1248,3.4,14.8,6,"Less than 25% P.O.C.","$95000 or more"
"06037264000","Census Tract 2640, Los Angeles County, California",3069,220417,2774,0,0,77,0,110,90.4,0,0,2.5,0,3.6,9.6,1211,914,297,75.47,24.53,65,849,47,250,112,1099,7.1,15.8,9.2,"Less than 25% P.O.C.","$95000 or more"
"06037264102","Census Tract 2641.02, Los Angeles County, California",2998,108004,2289,44,0,279,0,254,76.4,1.5,0,9.3,0,8.5,23.6,1649,593,1056,35.96,64.04,28,565,0,1056,28,1621,4.7,0,1.7,"Less than 25% P.O.C.","$95000 or more"
"06037264103","Census Tract 2641.03, Los Angeles County, California",2658,105481,2129,12,12,197,0,154,80.1,0.5,0.5,7.4,0,5.8,19.9,1464,341,1123,23.29,76.71,0,341,0,1123,0,1464,0,0,0,"Less than 25% P.O.C.","$95000 or more"
"06037264301","Census Tract 2643.01, Los Angeles County, California",5552,101439,4084,139,0,718,0,397,73.6,2.5,0,12.9,0,7.2,26.4,3169,614,2555,19.38,80.62,0,614,60,2495,60,3109,0,2.3,1.9,"25% - 50% P.O.C.","$95000 or more"
"06037264302","Census Tract 2643.02, Los Angeles County, California",5882,92381,4831,132,0,363,0,303,82.1,2.2,0,6.2,0,5.2,17.9,2962,1037,1925,35.01,64.99,13,1024,5,1920,18,2944,1.3,0.3,0.6,"Less than 25% P.O.C.","$70000 - $95000"
"06037265100","Census Tract 2651, Los Angeles County, California",2454,112500,2161,28,0,74,0,131,88.1,1.1,0,3,0,5.3,11.9,1264,800,464,63.29,36.71,17,783,0,464,17,1247,2.1,0,1.3,"Less than 25% P.O.C.","$95000 or more"
"06037265201","Census Tract 2652.01, Los Angeles County, California",2567,72361,1683,59,0,494,0,249,65.6,2.3,0,19.2,0,9.7,34.4,860,516,344,60,40,31,485,27,317,58,802,6,7.8,6.7,"25% - 50% P.O.C.","$70000 - $95000"
"06037265202","Census Tract 2652.02, Los Angeles County, California",3981,74417,2415,17,0,891,0,505,60.7,0.4,0,22.4,0,12.7,39.3,1873,574,1299,30.65,69.35,0,574,124,1175,124,1749,0,9.5,6.6,"25% - 50% P.O.C.","$70000 - $95000"
"06037265301","Census Tract 2653.01, Los Angeles County, California",11977,NA,3160,486,17,4808,19,2687,26.4,4.1,0.1,40.1,0.2,22.4,73.6,0,0,0,NA,NA,0,0,0,0,0,0,NA,NA,NA,"50% - 75% P.O.C.","N/A"
"06037265303","Census Tract 2653.03, Los Angeles County, California",5156,21506,1630,173,0,2260,43,826,31.6,3.4,0,43.8,0.8,16,68.4,1477,68,1409,4.6,95.4,8,60,273,1136,281,1196,11.8,19.4,19,"50% - 75% P.O.C.","Less than $51000"
"06037265304","Census Tract 2653.04, Los Angeles County, California",2878,21228,1077,50,0,1015,21,500,37.4,1.7,0,35.3,0.7,17.4,62.6,839,0,839,0,100,0,0,91,748,91,748,NA,10.8,10.8,"50% - 75% P.O.C.","Less than $51000"
"06037265305","Census Tract 2653.05, Los Angeles County, California",3990,20655,1393,10,1,1509,0,755,34.9,0.3,0,37.8,0,18.9,65.1,1575,0,1575,0,100,0,0,44,1531,44,1531,NA,2.8,2.8,"50% - 75% P.O.C.","Less than $51000"
"06037265410","Census Tract 2654.10, Los Angeles County, California",1495,117885,1190,0,0,145,0,97,79.6,0,0,9.7,0,6.5,20.4,610,360,250,59.02,40.98,38,322,10,240,48,562,10.6,4,7.9,"Less than 25% P.O.C.","$95000 or more"
"06037265420","Census Tract 2654.20, Los Angeles County, California",1838,198542,1428,105,0,191,12,27,77.7,5.7,0,10.4,0.7,1.5,22.3,751,474,277,63.12,36.88,43,431,10,267,53,698,9.1,3.6,7.1,"Less than 25% P.O.C.","$95000 or more"
"06037265510","Census Tract 2655.10, Los Angeles County, California",4663,54847,2284,131,42,1721,0,360,49,2.8,0.9,36.9,0,7.7,51,2200,284,1916,12.91,87.09,0,284,46,1870,46,2154,0,2.4,2.1,"50% - 75% P.O.C.","$51000 - $70000"
"06037265520","Census Tract 2655.20, Los Angeles County, California",5059,104559,2944,519,0,761,0,219,58.2,10.3,0,15,0,4.3,41.8,2290,837,1453,36.55,63.45,22,815,57,1396,79,2211,2.6,3.9,3.4,"25% - 50% P.O.C.","$95000 or more"
"06037265601","Census Tract 2656.01, Los Angeles County, California",3615,119886,2701,0,0,614,0,149,74.7,0,0,17,0,4.1,25.3,1372,515,857,37.54,62.46,29,486,41,816,70,1302,5.6,4.8,5.1,"25% - 50% P.O.C.","$95000 or more"
"06037265602","Census Tract 2656.02, Los Angeles County, California",3044,117629,2249,100,0,370,0,148,73.9,3.3,0,12.2,0,4.9,26.1,1455,858,597,58.97,41.03,51,807,5,592,56,1399,5.9,0.8,3.8,"25% - 50% P.O.C.","$95000 or more"
"06037265700","Census Tract 2657, Los Angeles County, California",4636,85083,3439,71,0,358,0,376,74.2,1.5,0,7.7,0,8.1,25.8,2393,973,1420,40.66,59.34,32,941,54,1366,86,2307,3.3,3.8,3.6,"25% - 50% P.O.C.","$70000 - $95000"
"06037267100","Census Tract 2671, Los Angeles County, California",6649,105284,4281,229,0,1253,0,432,64.4,3.4,0,18.8,0,6.5,35.6,2867,1419,1448,49.49,50.51,197,1222,45,1403,242,2625,13.9,3.1,8.4,"25% - 50% P.O.C.","$95000 or more"
"06037267200","Census Tract 2672, Los Angeles County, California",7004,86601,4735,260,0,1125,13,464,67.6,3.7,0,16.1,0.2,6.6,32.4,2941,1021,1920,34.72,65.28,84,937,74,1846,158,2783,8.2,3.9,5.4,"25% - 50% P.O.C.","$70000 - $95000"
"06037267300","Census Tract 2673, Los Angeles County, California",4235,68913,2015,218,0,1104,0,738,47.6,5.1,0,26.1,0,17.4,52.4,2022,257,1765,12.71,87.29,0,257,66,1699,66,1956,0,3.7,3.3,"50% - 75% P.O.C.","$51000 - $70000"
"06037267402","Census Tract 2674.02, Los Angeles County, California",4872,87095,3055,134,0,852,0,704,62.7,2.8,0,17.5,0,14.4,37.3,2707,479,2228,17.69,82.31,0,479,54,2174,54,2653,0,2.4,2,"25% - 50% P.O.C.","$70000 - $95000"
"06037267403","Census Tract 2674.03, Los Angeles County, California",3000,88631,1736,141,0,665,0,366,57.9,4.7,0,22.2,0,12.2,42.1,1689,259,1430,15.33,84.67,0,259,3,1427,3,1686,0,0.2,0.2,"25% - 50% P.O.C.","$70000 - $95000"
"06037267404","Census Tract 2674.04, Los Angeles County, California",3475,82500,2129,204,0,623,0,268,61.3,5.9,0,17.9,0,7.7,38.7,1622,246,1376,15.17,84.83,0,246,1,1375,1,1621,0,0.1,0.1,"25% - 50% P.O.C.","$70000 - $95000"
"06037267501","Census Tract 2675.01, Los Angeles County, California",5993,86086,2858,155,0,934,0,1707,47.7,2.6,0,15.6,0,28.5,52.3,2751,434,2317,15.78,84.22,40,394,146,2171,186,2565,9.2,6.3,6.8,"50% - 75% P.O.C.","$70000 - $95000"
"06037267502","Census Tract 2675.02, Los Angeles County, California",3632,86343,1747,67,20,669,0,914,48.1,1.8,0.6,18.4,0,25.2,51.9,1651,412,1239,24.95,75.05,17,395,50,1189,67,1584,4.1,4,4.1,"50% - 75% P.O.C.","$70000 - $95000"
"06037267600","Census Tract 2676, Los Angeles County, California",2916,70692,1104,162,0,906,0,591,37.9,5.6,0,31.1,0,20.3,62.1,1318,480,838,36.42,63.58,0,480,10,828,10,1308,0,1.2,0.8,"50% - 75% P.O.C.","$70000 - $95000"
"06037267700","Census Tract 2677, Los Angeles County, California",3276,94185,1477,34,0,964,0,624,45.1,1,0,29.4,0,19,54.9,1665,534,1131,32.07,67.93,0,534,26,1105,26,1639,0,2.3,1.6,"50% - 75% P.O.C.","$70000 - $95000"
"06037267800","Census Tract 2678, Los Angeles County, California",2666,86121,1739,16,0,520,19,246,65.2,0.6,0,19.5,0.7,9.2,34.8,1164,639,525,54.9,45.1,26,613,17,508,43,1121,4.1,3.2,3.7,"25% - 50% P.O.C.","$70000 - $95000"
"06037267901","Census Tract 2679.01, Los Angeles County, California",2428,118393,1806,35,0,440,0,76,74.4,1.4,0,18.1,0,3.1,25.6,1421,1131,290,79.59,20.41,0,1131,0,290,0,1421,0,0,0,"25% - 50% P.O.C.","$95000 or more"
"06037267902","Census Tract 2679.02, Los Angeles County, California",3365,138750,2414,204,0,499,9,139,71.7,6.1,0,14.8,0.3,4.1,28.3,1543,899,644,58.26,41.74,68,831,19,625,87,1456,7.6,3,5.6,"25% - 50% P.O.C.","$95000 or more"
"06037269000","Census Tract 2690, Los Angeles County, California",4813,127054,3331,48,0,594,7,743,69.2,1,0,12.3,0.1,15.4,30.8,2029,1291,738,63.63,36.37,116,1175,14,724,130,1899,9,1.9,6.4,"25% - 50% P.O.C.","$95000 or more"
"06037269100","Census Tract 2691, Los Angeles County, California",4274,88656,3515,67,0,252,0,333,82.2,1.6,0,5.9,0,7.8,17.8,1881,645,1236,34.29,65.71,110,535,69,1167,179,1702,17.1,5.6,9.5,"Less than 25% P.O.C.","$70000 - $95000"
"06037269300","Census Tract 2693, Los Angeles County, California",3840,165208,2984,65,0,341,0,146,77.7,1.7,0,8.9,0,3.8,22.3,1489,1199,290,80.52,19.48,85,1114,21,269,106,1383,7.1,7.2,7.1,"Less than 25% P.O.C.","$95000 or more"
"06037269500","Census Tract 2695, Los Angeles County, California",3797,191538,3380,29,0,254,0,73,89,0.8,0,6.7,0,1.9,11,1304,1135,169,87.04,12.96,91,1044,55,114,146,1158,8,32.5,11.2,"Less than 25% P.O.C.","$95000 or more"
"06037269601","Census Tract 2696.01, Los Angeles County, California",3393,53664,470,729,0,171,0,2000,13.9,21.5,0,5,0,58.9,86.1,1035,118,917,11.4,88.6,37,81,174,743,211,824,31.4,19,20.4,"75% or more P.O.C.","$51000 - $70000"
"06037269602","Census Tract 2696.02, Los Angeles County, California",2865,58668,954,402,0,124,0,994,33.3,14,0,4.3,0,34.7,66.7,1161,184,977,15.85,84.15,13,171,100,877,113,1048,7.1,10.2,9.7,"50% - 75% P.O.C.","$51000 - $70000"
"06037269700","Census Tract 2697, Los Angeles County, California",3546,89450,1452,316,0,507,0,1136,40.9,8.9,0,14.3,0,32,59.1,1627,709,918,43.58,56.42,54,655,0,918,54,1573,7.6,0,3.3,"50% - 75% P.O.C.","$70000 - $95000"
"06037269800","Census Tract 2698, Los Angeles County, California",3046,83214,1434,224,0,845,0,438,47.1,7.4,0,27.7,0,14.4,52.9,1548,272,1276,17.57,82.43,0,272,36,1240,36,1512,0,2.8,2.3,"50% - 75% P.O.C.","$70000 - $95000"
"06037269903","Census Tract 2699.03, Los Angeles County, California",3421,65750,1240,299,0,781,0,702,36.2,8.7,0,22.8,0,20.5,63.8,1705,99,1606,5.81,94.19,11,88,22,1584,33,1672,11.1,1.4,1.9,"50% - 75% P.O.C.","$51000 - $70000"
"06037269904","Census Tract 2699.04, Los Angeles County, California",3927,70682,1987,489,0,710,38,570,50.6,12.5,0,18.1,1,14.5,49.4,2148,37,2111,1.72,98.28,0,37,0,2111,0,2148,0,0,0,"25% - 50% P.O.C.","$70000 - $95000"
"06037269905","Census Tract 2699.05, Los Angeles County, California",2459,80119,882,315,0,511,0,630,35.9,12.8,0,20.8,0,25.6,64.1,1424,0,1424,0,100,0,0,33,1391,33,1391,NA,2.3,2.3,"50% - 75% P.O.C.","$70000 - $95000"
"06037269906","Census Tract 2699.06, Los Angeles County, California",3158,95542,1327,186,14,636,77,800,42,5.9,0.4,20.1,2.4,25.3,58,1564,72,1492,4.6,95.4,0,72,26,1466,26,1538,0,1.7,1.7,"50% - 75% P.O.C.","$95000 or more"
"06037269907","Census Tract 2699.07, Los Angeles County, California",2692,78895,1020,499,0,525,0,448,37.9,18.5,0,19.5,0,16.6,62.1,1384,126,1258,9.1,90.9,0,126,7,1251,7,1377,0,0.6,0.5,"50% - 75% P.O.C.","$70000 - $95000"
"06037270100","Census Tract 2701, Los Angeles County, California",4202,71389,1536,452,78,1105,0,668,36.6,10.8,1.9,26.3,0,15.9,63.4,2332,175,2157,7.5,92.5,6,169,59,2098,65,2267,3.4,2.7,2.8,"50% - 75% P.O.C.","$70000 - $95000"
"06037270200","Census Tract 2702, Los Angeles County, California",3226,67516,853,210,0,336,0,1691,26.4,6.5,0,10.4,0,52.4,73.6,1271,441,830,34.7,65.3,22,419,45,785,67,1204,5,5.4,5.3,"50% - 75% P.O.C.","$51000 - $70000"
"06037270300","Census Tract 2703, Los Angeles County, California",2542,74323,396,893,2,264,0,893,15.6,35.1,0.1,10.4,0,35.1,84.4,973,544,429,55.91,44.09,57,487,34,395,91,882,10.5,7.9,9.4,"75% or more P.O.C.","$70000 - $95000"
"06037271100","Census Tract 2711, Los Angeles County, California",2445,89219,1282,52,0,552,0,459,52.4,2.1,0,22.6,0,18.8,47.6,934,599,335,64.13,35.87,56,543,12,323,68,866,9.3,3.6,7.3,"25% - 50% P.O.C.","$70000 - $95000"
"06037271200","Census Tract 2712, Los Angeles County, California",2770,71393,1085,135,0,486,0,987,39.2,4.9,0,17.5,0,35.6,60.8,1177,197,980,16.74,83.26,0,197,141,839,141,1036,0,14.4,12,"50% - 75% P.O.C.","$70000 - $95000"
"06037271300","Census Tract 2713, Los Angeles County, California",4395,101006,2753,25,0,821,0,676,62.6,0.6,0,18.7,0,15.4,37.4,2021,1321,700,65.36,34.64,42,1279,12,688,54,1967,3.2,1.7,2.7,"25% - 50% P.O.C.","$95000 or more"
"06037271400","Census Tract 2714, Los Angeles County, California",3743,133547,2643,46,0,391,46,411,70.6,1.2,0,10.4,1.2,11,29.4,1310,1163,147,88.78,11.22,143,1020,0,147,143,1167,12.3,0,10.9,"25% - 50% P.O.C.","$95000 or more"
"06037271500","Census Tract 2715, Los Angeles County, California",3187,100679,2133,105,16,423,36,352,66.9,3.3,0.5,13.3,1.1,11,33.1,1349,714,635,52.93,47.07,34,680,37,598,71,1278,4.8,5.8,5.3,"25% - 50% P.O.C.","$95000 or more"
"06037271600","Census Tract 2716, Los Angeles County, California",4811,89792,2211,198,14,1402,0,674,46,4.1,0.3,29.1,0,14,54,1936,579,1357,29.91,70.09,12,567,96,1261,108,1828,2.1,7.1,5.6,"50% - 75% P.O.C.","$70000 - $95000"
"06037271701","Census Tract 2717.01, Los Angeles County, California",5694,93972,2580,743,21,1446,31,691,45.3,13,0.4,25.4,0.5,12.1,54.7,2677,753,1924,28.13,71.87,137,616,14,1910,151,2526,18.2,0.7,5.6,"50% - 75% P.O.C.","$70000 - $95000"
"06037271702","Census Tract 2717.02, Los Angeles County, California",3918,67446,1365,201,72,1440,0,678,34.8,5.1,1.8,36.8,0,17.3,65.2,1893,470,1423,24.83,75.17,37,433,28,1395,65,1828,7.9,2,3.4,"50% - 75% P.O.C.","$51000 - $70000"
"06037271801","Census Tract 2718.01, Los Angeles County, California",3071,55417,1063,196,0,850,9,864,34.6,6.4,0,27.7,0.3,28.1,65.4,1604,259,1345,16.15,83.85,12,247,35,1310,47,1557,4.6,2.6,2.9,"50% - 75% P.O.C.","$51000 - $70000"
"06037271802","Census Tract 2718.02, Los Angeles County, California",5644,85318,2291,260,0,1355,0,1591,40.6,4.6,0,24,0,28.2,59.4,2602,366,2236,14.07,85.93,0,366,84,2152,84,2518,0,3.8,3.2,"50% - 75% P.O.C.","$70000 - $95000"
"06037271901","Census Tract 2719.01, Los Angeles County, California",3245,92991,1288,276,0,607,0,926,39.7,8.5,0,18.7,0,28.5,60.3,1409,515,894,36.55,63.45,26,489,53,841,79,1330,5,5.9,5.6,"50% - 75% P.O.C.","$70000 - $95000"
"06037271902","Census Tract 2719.02, Los Angeles County, California",4207,73918,1850,283,21,434,0,1403,44,6.7,0.5,10.3,0,33.3,56,1851,586,1265,31.66,68.34,30,556,81,1184,111,1740,5.1,6.4,6,"50% - 75% P.O.C.","$70000 - $95000"
"06037272100","Census Tract 2721, Los Angeles County, California",4578,94911,2671,42,22,258,19,1300,58.3,0.9,0.5,5.6,0.4,28.4,41.7,1834,1030,804,56.16,43.84,28,1002,39,765,67,1767,2.7,4.9,3.7,"25% - 50% P.O.C.","$70000 - $95000"
"06037272201","Census Tract 2722.01, Los Angeles County, California",2390,62716,1083,51,0,249,0,959,45.3,2.1,0,10.4,0,40.1,54.7,1097,158,939,14.4,85.6,0,158,58,881,58,1039,0,6.2,5.3,"50% - 75% P.O.C.","$51000 - $70000"
"06037272202","Census Tract 2722.02, Los Angeles County, California",3359,63355,1205,163,13,309,29,1386,35.9,4.9,0.4,9.2,0.9,41.3,64.1,1588,280,1308,17.63,82.37,0,280,112,1196,112,1476,0,8.6,7.1,"50% - 75% P.O.C.","$51000 - $70000"
"06037272301","Census Tract 2723.01, Los Angeles County, California",3045,84583,1448,76,10,440,0,855,47.6,2.5,0.3,14.4,0,28.1,52.4,1293,498,795,38.52,61.48,26,472,18,777,44,1249,5.2,2.3,3.4,"50% - 75% P.O.C.","$70000 - $95000"
"06037272302","Census Tract 2723.02, Los Angeles County, California",4457,59286,1570,169,0,443,0,2179,35.2,3.8,0,9.9,0,48.9,64.8,1862,226,1636,12.14,87.86,0,226,157,1479,157,1705,0,9.6,8.4,"50% - 75% P.O.C.","$51000 - $70000"
"06037273100","Census Tract 2731, Los Angeles County, California",2742,121500,1844,62,5,214,0,557,67.3,2.3,0.2,7.8,0,20.3,32.7,1218,554,664,45.48,54.52,20,534,44,620,64,1154,3.6,6.6,5.3,"25% - 50% P.O.C.","$95000 or more"
"06037273200","Census Tract 2732, Los Angeles County, California",3229,88720,1714,211,16,72,0,1119,53.1,6.5,0.5,2.2,0,34.7,46.9,1532,529,1003,34.53,65.47,0,529,45,958,45,1487,0,4.5,2.9,"25% - 50% P.O.C.","$70000 - $95000"
"06037273300","Census Tract 2733, Los Angeles County, California",2915,71823,1605,418,0,70,0,725,55.1,14.3,0,2.4,0,24.9,44.9,1474,347,1127,23.54,76.46,8,339,86,1041,94,1380,2.3,7.6,6.4,"25% - 50% P.O.C.","$70000 - $95000"
"06037273402","Census Tract 2734.02, Los Angeles County, California",2641,72258,2087,157,0,5,0,364,79,5.9,0,0.2,0,13.8,21,1816,486,1330,26.76,73.24,12,474,11,1319,23,1793,2.5,0.8,1.3,"Less than 25% P.O.C.","$70000 - $95000"
"06037273502","Census Tract 2735.02, Los Angeles County, California",2861,90161,2194,174,18,58,0,328,76.7,6.1,0.6,2,0,11.5,23.3,1662,352,1310,21.18,78.82,14,338,11,1299,25,1637,4,0.8,1.5,"Less than 25% P.O.C.","$70000 - $95000"
"06037273600","Census Tract 2736, Los Angeles County, California",2375,123819,1888,42,0,34,0,361,79.5,1.8,0,1.4,0,15.2,20.5,1081,641,440,59.3,40.7,22,619,27,413,49,1032,3.4,6.1,4.5,"Less than 25% P.O.C.","$95000 or more"
"06037273700","Census Tract 2737, Los Angeles County, California",2895,96719,1820,155,0,92,0,678,62.9,5.4,0,3.2,0,23.4,37.1,1243,494,749,39.74,60.26,0,494,52,697,52,1191,0,6.9,4.2,"25% - 50% P.O.C.","$95000 or more"
"06037273800","Census Tract 2738, Los Angeles County, California",2872,96750,1792,99,11,234,0,639,62.4,3.4,0.4,8.1,0,22.2,37.6,1499,505,994,33.69,66.31,31,474,0,994,31,1468,6.1,0,2.1,"25% - 50% P.O.C.","$95000 or more"
"06037273902","Census Tract 2739.02, Los Angeles County, California",4221,144924,3314,76,0,162,0,459,78.5,1.8,0,3.8,0,10.9,21.5,2126,810,1316,38.1,61.9,0,810,20,1296,20,2106,0,1.5,0.9,"Less than 25% P.O.C.","$95000 or more"
"06037274100","Census Tract 2741, Los Angeles County, California",4838,116141,3052,696,0,474,0,260,63.1,14.4,0,9.8,0,5.4,36.9,2326,829,1497,35.64,64.36,0,829,13,1484,13,2313,0,0.9,0.6,"25% - 50% P.O.C.","$95000 or more"
"06037274202","Census Tract 2742.02, Los Angeles County, California",4284,128766,3240,67,0,352,0,428,75.6,1.6,0,8.2,0,10,24.4,2285,1293,992,56.59,43.41,16,1277,5,987,21,2264,1.2,0.5,0.9,"Less than 25% P.O.C.","$95000 or more"
"06037275101","Census Tract 2751.01, Los Angeles County, California",1161,97500,468,24,0,311,0,298,40.3,2.1,0,26.8,0,25.7,59.7,470,175,295,37.23,62.77,11,164,8,287,19,451,6.3,2.7,4,"50% - 75% P.O.C.","$95000 or more"
"06037275102","Census Tract 2751.02, Los Angeles County, California",4338,58221,793,240,0,174,0,3029,18.3,5.5,0,4,0,69.8,81.7,1421,420,1001,29.56,70.44,67,353,221,780,288,1133,16,22.1,20.3,"75% or more P.O.C.","$51000 - $70000"
"06037275200","Census Tract 2752, Los Angeles County, California",3751,62241,1336,269,21,499,0,1425,35.6,7.2,0.6,13.3,0,38,64.4,1721,424,1297,24.64,75.36,15,409,68,1229,83,1638,3.5,5.2,4.8,"50% - 75% P.O.C.","$51000 - $70000"
"06037275302","Census Tract 2753.02, Los Angeles County, California",5059,96917,3390,217,0,781,0,399,67,4.3,0,15.4,0,7.9,33,2656,1553,1103,58.47,41.53,27,1526,0,1103,27,2629,1.7,0,1,"25% - 50% P.O.C.","$95000 or more"
"06037275311","Census Tract 2753.11, Los Angeles County, California",5462,90261,2335,230,0,1051,0,1609,42.7,4.2,0,19.2,0,29.5,57.3,2337,1016,1321,43.47,56.53,122,894,37,1284,159,2178,12,2.8,6.8,"50% - 75% P.O.C.","$70000 - $95000"
"06037275400","Census Tract 2754, Los Angeles County, California",4069,137027,2639,100,0,614,0,528,64.9,2.5,0,15.1,0,13,35.1,2116,913,1203,43.15,56.85,14,899,0,1203,14,2102,1.5,0,0.7,"25% - 50% P.O.C.","$95000 or more"
"06037275500","Census Tract 2755, Los Angeles County, California",5449,42544,985,376,0,454,0,3492,18.1,6.9,0,8.3,0,64.1,81.9,1907,494,1413,25.9,74.1,96,398,184,1229,280,1627,19.4,13,14.7,"75% or more P.O.C.","Less than $51000"
"06037275602","Census Tract 2756.02, Los Angeles County, California",12100,148965,6371,795,0,2802,0,1651,52.7,6.6,0,23.2,0,13.6,47.3,5663,1903,3760,33.6,66.4,114,1789,18,3742,132,5531,6,0.5,2.3,"25% - 50% P.O.C.","$95000 or more"
"06037275603","Census Tract 2756.03, Los Angeles County, California",2537,84130,1087,68,0,648,0,611,42.8,2.7,0,25.5,0,24.1,57.2,1188,725,463,61.03,38.97,42,683,12,451,54,1134,5.8,2.6,4.5,"50% - 75% P.O.C.","$70000 - $95000"
"06037276000","Census Tract 2760, Los Angeles County, California",5657,144688,2920,360,56,708,0,1424,51.6,6.4,1,12.5,0,25.2,48.4,2519,1753,766,69.59,30.41,61,1692,0,766,61,2458,3.5,0,2.4,"25% - 50% P.O.C.","$95000 or more"
"06037276100","Census Tract 2761, Los Angeles County, California",5739,66520,1272,2017,0,1013,0,1026,22.2,35.1,0,17.7,0,17.9,77.8,2837,500,2337,17.62,82.38,0,500,9,2328,9,2828,0,0.4,0.3,"75% or more P.O.C.","$51000 - $70000"
"06037276400","Census Tract 2764, Los Angeles County, California",4071,158056,2886,99,0,316,0,628,70.9,2.4,0,7.8,0,15.4,29.1,1488,1265,223,85.01,14.99,93,1172,18,205,111,1377,7.4,8.1,7.5,"25% - 50% P.O.C.","$95000 or more"
"06037276500","Census Tract 2765, Los Angeles County, California",5674,91667,3087,381,12,874,10,956,54.4,6.7,0.2,15.4,0.2,16.8,45.6,710,436,274,61.41,38.59,33,403,24,250,57,653,7.6,8.8,8,"25% - 50% P.O.C.","$70000 - $95000"
"06037276601","Census Tract 2766.01, Los Angeles County, California",4115,138929,2652,224,0,546,0,384,64.4,5.4,0,13.3,0,9.3,35.6,1624,998,626,61.45,38.55,86,912,17,609,103,1521,8.6,2.7,6.3,"25% - 50% P.O.C.","$95000 or more"
"06037276603","Census Tract 2766.03, Los Angeles County, California",5489,90375,3345,582,27,707,0,629,60.9,10.6,0.5,12.9,0,11.5,39.1,3179,1546,1633,48.63,51.37,0,1546,0,1633,0,3179,0,0,0,"25% - 50% P.O.C.","$70000 - $95000"
"06037276604","Census Tract 2766.04, Los Angeles County, California",4624,93525,2317,353,0,902,0,761,50.1,7.6,0,19.5,0,16.5,49.9,2426,754,1672,31.08,68.92,29,725,0,1672,29,2397,3.8,0,1.2,"25% - 50% P.O.C.","$70000 - $95000"
"06037277000","Census Tract 2770, Los Angeles County, California",5566,137961,3717,211,68,742,0,593,66.8,3.8,1.2,13.3,0,10.7,33.2,2205,1601,604,72.61,27.39,91,1510,21,583,112,2093,5.7,3.5,5.1,"25% - 50% P.O.C.","$95000 or more"
"06037277100","Census Tract 2771, Los Angeles County, California",3100,124219,1613,56,0,419,11,597,52,1.8,0,13.5,0.4,19.3,48,1125,953,172,84.71,15.29,107,846,9,163,116,1009,11.2,5.2,10.3,"25% - 50% P.O.C.","$95000 or more"
"06037277200","Census Tract 2772, Los Angeles County, California",2196,60179,503,604,0,215,0,764,22.9,27.5,0,9.8,0,34.8,77.1,1009,203,806,20.12,79.88,18,185,60,746,78,931,8.9,7.4,7.7,"75% or more P.O.C.","$51000 - $70000"
"06037277400","Census Tract 2774, Los Angeles County, California",909,43264,48,436,0,60,0,293,5.3,48,0,6.6,0,32.2,94.7,341,9,332,2.64,97.36,0,9,50,282,50,291,0,15.1,14.7,"75% or more P.O.C.","Less than $51000"
"06037278001","Census Tract 2780.01, Los Angeles County, California",2508,109468,1163,106,0,304,57,746,46.4,4.2,0,12.1,2.3,29.7,53.6,993,580,413,58.41,41.59,36,544,8,405,44,949,6.2,1.9,4.4,"50% - 75% P.O.C.","$95000 or more"
"06037278102","Census Tract 2781.02, Los Angeles County, California",3088,148182,2326,31,0,214,0,402,75.3,1,0,6.9,0,13,24.7,1514,761,753,50.26,49.74,31,730,0,753,31,1483,4.1,0,2,"Less than 25% P.O.C.","$95000 or more"
"06037291110","Census Tract 2911.10, Los Angeles County, California",4391,43544,48,2072,13,0,0,2241,1.1,47.2,0.3,0,0,51,98.9,1340,300,1040,22.39,77.61,73,227,202,838,275,1065,24.3,19.4,20.5,"75% or more P.O.C.","Less than $51000"
"06037291120","Census Tract 2911.20, Los Angeles County, California",2407,53393,31,793,0,28,0,1555,1.3,32.9,0,1.2,0,64.6,98.7,648,174,474,26.85,73.15,76,98,100,374,176,472,43.7,21.1,27.2,"75% or more P.O.C.","$51000 - $70000"
"06037291130","Census Tract 2911.30, Los Angeles County, California",3626,67587,123,640,0,359,0,2423,3.4,17.7,0,9.9,0,66.8,96.6,985,679,306,68.93,31.07,162,517,26,280,188,797,23.9,8.5,19.1,"75% or more P.O.C.","$51000 - $70000"
"06037291210","Census Tract 2912.10, Los Angeles County, California",5768,61277,407,560,15,959,15,3773,7.1,9.7,0.3,16.6,0.3,65.4,92.9,1603,787,816,49.1,50.9,183,604,174,642,357,1246,23.3,21.3,22.3,"75% or more P.O.C.","$51000 - $70000"
"06037291220","Census Tract 2912.20, Los Angeles County, California",3640,50260,145,307,0,594,0,2524,4,8.4,0,16.3,0,69.3,96,1037,402,635,38.77,61.23,89,313,147,488,236,801,22.1,23.1,22.8,"75% or more P.O.C.","Less than $51000"
"06037291300","Census Tract 2913, Los Angeles County, California",3037,81281,447,289,7,1316,15,748,14.7,9.5,0.2,43.3,0.5,24.6,85.3,1107,792,315,71.54,28.46,87,705,19,296,106,1001,11,6,9.6,"75% or more P.O.C.","$70000 - $95000"
"06037292000","Census Tract 2920, Los Angeles County, California",6567,42135,495,701,0,1163,12,3639,7.5,10.7,0,17.7,0.2,55.4,92.5,1959,554,1405,28.28,71.72,94,460,242,1163,336,1623,17,17.2,17.2,"75% or more P.O.C.","Less than $51000"
"06037293201","Census Tract 2932.01, Los Angeles County, California",6289,64273,946,375,0,1479,0,3355,15,6,0,23.5,0,53.3,85,2029,808,1221,39.82,60.18,202,606,86,1135,288,1741,25,7,14.2,"75% or more P.O.C.","$51000 - $70000"
"06037293202","Census Tract 2932.02, Los Angeles County, California",6740,42877,326,523,0,1009,0,4764,4.8,7.8,0,15,0,70.7,95.2,1782,334,1448,18.74,81.26,66,268,374,1074,440,1342,19.8,25.8,24.7,"75% or more P.O.C.","Less than $51000"
"06037293301","Census Tract 2933.01, Los Angeles County, California",3108,83768,877,42,0,1530,0,434,28.2,1.4,0,49.2,0,14,71.8,1065,715,350,67.14,32.86,42,673,36,314,78,987,5.9,10.3,7.3,"50% - 75% P.O.C.","$70000 - $95000"
"06037293302","Census Tract 2933.02, Los Angeles County, California",5082,83955,1297,699,0,1302,148,1545,25.5,13.8,0,25.6,2.9,30.4,74.5,1656,1001,655,60.45,39.55,122,879,50,605,172,1484,12.2,7.6,10.4,"50% - 75% P.O.C.","$70000 - $95000"
"06037293304","Census Tract 2933.04, Los Angeles County, California",4832,63150,534,328,0,533,0,3289,11.1,6.8,0,11,0,68.1,88.9,1460,485,975,33.22,66.78,66,419,182,793,248,1212,13.6,18.7,17,"75% or more P.O.C.","$51000 - $70000"
"06037293306","Census Tract 2933.06, Los Angeles County, California",2436,100200,835,123,0,318,0,1087,34.3,5,0,13.1,0,44.6,65.7,794,561,233,70.65,29.35,75,486,45,188,120,674,13.4,19.3,15.1,"50% - 75% P.O.C.","$95000 or more"
"06037293307","Census Tract 2933.07, Los Angeles County, California",2284,51379,259,183,0,396,0,1384,11.3,8,0,17.3,0,60.6,88.7,914,217,697,23.74,76.26,15,202,98,599,113,801,6.9,14.1,12.4,"75% or more P.O.C.","$51000 - $70000"
"06037294110","Census Tract 2941.10, Los Angeles County, California",4129,51011,393,0,0,122,23,3498,9.5,0,0,3,0.6,84.7,90.5,1114,585,529,52.51,47.49,215,370,104,425,319,795,36.8,19.7,28.6,"75% or more P.O.C.","$51000 - $70000"
"06037294120","Census Tract 2941.20, Los Angeles County, California",2687,57159,55,87,0,50,0,2486,2,3.2,0,1.9,0,92.5,98,581,273,308,46.99,53.01,97,176,130,178,227,354,35.5,42.2,39.1,"75% or more P.O.C.","$51000 - $70000"
"06037294200","Census Tract 2942, Los Angeles County, California",4874,70272,261,120,19,170,19,4271,5.4,2.5,0.4,3.5,0.4,87.6,94.6,1367,853,514,62.4,37.6,194,659,166,348,360,1007,22.7,32.3,26.3,"75% or more P.O.C.","$70000 - $95000"
"06037294301","Census Tract 2943.01, Los Angeles County, California",2471,65870,139,34,0,255,0,2027,5.6,1.4,0,10.3,0,82,94.4,688,504,184,73.26,26.74,132,372,15,169,147,541,26.2,8.2,21.4,"75% or more P.O.C.","$51000 - $70000"
"06037294302","Census Tract 2943.02, Los Angeles County, California",4382,55313,284,191,13,73,10,3771,6.5,4.4,0.3,1.7,0.2,86.1,93.5,1195,544,651,45.52,54.48,128,416,142,509,270,925,23.5,21.8,22.6,"75% or more P.O.C.","$51000 - $70000"
"06037294410","Census Tract 2944.10, Los Angeles County, California",5079,50926,433,1258,0,1014,360,1948,8.5,24.8,0,20,7.1,38.4,91.5,1634,656,978,40.15,59.85,35,621,177,801,212,1422,5.3,18.1,13,"75% or more P.O.C.","Less than $51000"
"06037294421","Census Tract 2944.21, Los Angeles County, California",2891,47917,239,133,0,332,0,2141,8.3,4.6,0,11.5,0,74.1,91.7,995,400,595,40.2,59.8,39,361,95,500,134,861,9.8,16,13.5,"75% or more P.O.C.","Less than $51000"
"06037294510","Census Tract 2945.10, Los Angeles County, California",5082,49979,98,10,0,8,0,4958,1.9,0.2,0,0.2,0,97.6,98.1,1079,380,699,35.22,64.78,171,209,260,439,431,648,45,37.2,39.9,"75% or more P.O.C.","Less than $51000"
"06037294520","Census Tract 2945.20, Los Angeles County, California",3710,50732,131,80,9,24,0,3466,3.5,2.2,0.2,0.6,0,93.4,96.5,906,301,605,33.22,66.78,123,178,209,396,332,574,40.9,34.5,36.6,"75% or more P.O.C.","Less than $51000"
"06037294610","Census Tract 2946.10, Los Angeles County, California",4334,49773,145,45,0,232,0,3912,3.3,1,0,5.4,0,90.3,96.7,1160,452,708,38.97,61.03,109,343,206,502,315,845,24.1,29.1,27.2,"75% or more P.O.C.","Less than $51000"
"06037294620","Census Tract 2946.20, Los Angeles County, California",4683,44148,156,72,0,0,67,4366,3.3,1.5,0,0,1.4,93.2,96.7,1099,444,655,40.4,59.6,164,280,185,470,349,750,36.9,28.2,31.8,"75% or more P.O.C.","Less than $51000"
"06037294701","Census Tract 2947.01, Los Angeles County, California",3099,36719,86,152,0,18,0,2798,2.8,4.9,0,0.6,0,90.3,97.2,895,120,775,13.41,86.59,30,90,155,620,185,710,25,20,20.7,"75% or more P.O.C.","Less than $51000"
"06037294810","Census Tract 2948.10, Los Angeles County, California",4278,49952,105,108,0,88,57,3884,2.5,2.5,0,2.1,1.3,90.8,97.5,1025,123,902,12,88,66,57,343,559,409,616,53.7,38,39.9,"75% or more P.O.C.","Less than $51000"
"06037294820","Census Tract 2948.20, Los Angeles County, California",3473,39400,26,31,0,58,0,3358,0.7,0.9,0,1.7,0,96.7,99.3,874,89,785,10.18,89.82,35,54,263,522,298,576,39.3,33.5,34.1,"75% or more P.O.C.","Less than $51000"
"06037294830","Census Tract 2948.30, Los Angeles County, California",4134,44527,32,141,0,33,0,3867,0.8,3.4,0,0.8,0,93.5,99.2,1038,167,871,16.09,83.91,57,110,255,616,312,726,34.1,29.3,30.1,"75% or more P.O.C.","Less than $51000"
"06037294900","Census Tract 2949, Los Angeles County, California",3853,42150,139,125,0,114,18,3377,3.6,3.2,0,3,0.5,87.6,96.4,933,284,649,30.44,69.56,137,147,200,449,337,596,48.2,30.8,36.1,"75% or more P.O.C.","Less than $51000"
"06037295103","Census Tract 2951.03, Los Angeles County, California",5188,124663,2438,214,15,809,62,1534,47,4.1,0.3,15.6,1.2,29.6,53,1997,1654,343,82.82,17.18,104,1550,30,313,134,1863,6.3,8.7,6.7,"50% - 75% P.O.C.","$95000 or more"
"06037296210","Census Tract 2962.10, Los Angeles County, California",3132,40145,185,188,0,10,0,2726,5.9,6,0,0.3,0,87,94.1,1007,215,792,21.35,78.65,38,177,127,665,165,842,17.7,16,16.4,"75% or more P.O.C.","Less than $51000"
"06037296220","Census Tract 2962.20, Los Angeles County, California",4447,30020,412,568,0,422,21,2902,9.3,12.8,0,9.5,0.5,65.3,90.7,1775,127,1648,7.15,92.85,0,127,179,1469,179,1596,0,10.9,10.1,"75% or more P.O.C.","Less than $51000"
"06037296300","Census Tract 2963, Los Angeles County, California",5027,80718,2082,458,0,1245,0,1171,41.4,9.1,0,24.8,0,23.3,58.6,2054,1253,801,61,39,70,1183,103,698,173,1881,5.6,12.9,8.4,"50% - 75% P.O.C.","$70000 - $95000"
"06037296401","Census Tract 2964.01, Los Angeles County, California",3229,92571,1761,168,0,368,0,783,54.5,5.2,0,11.4,0,24.2,45.5,1268,968,300,76.34,23.66,77,891,6,294,83,1185,8,2,6.5,"25% - 50% P.O.C.","$70000 - $95000"
"06037296402","Census Tract 2964.02, Los Angeles County, California",3312,108929,1171,99,0,256,0,1785,35.4,3,0,7.7,0,53.9,64.6,1116,865,251,77.51,22.49,90,775,34,217,124,992,10.4,13.5,11.1,"50% - 75% P.O.C.","$95000 or more"
"06037296500","Census Tract 2965, Los Angeles County, California",3447,35870,321,398,10,150,0,2453,9.3,11.5,0.3,4.4,0,71.2,90.7,1306,478,828,36.6,63.4,76,402,41,787,117,1189,15.9,5,9,"75% or more P.O.C.","Less than $51000"
"06037296600","Census Tract 2966, Los Angeles County, California",5358,40607,795,313,5,115,0,4045,14.8,5.8,0.1,2.1,0,75.5,85.2,1948,444,1504,22.79,77.21,52,392,130,1374,182,1766,11.7,8.6,9.3,"75% or more P.O.C.","Less than $51000"
"06037296901","Census Tract 2969.01, Los Angeles County, California",4466,40913,827,412,8,171,0,2858,18.5,9.2,0.2,3.8,0,64,81.5,1635,221,1414,13.52,86.48,0,221,219,1195,219,1416,0,15.5,13.4,"75% or more P.O.C.","Less than $51000"
"06037296902","Census Tract 2969.02, Los Angeles County, California",4219,52585,1233,166,15,101,0,2515,29.2,3.9,0.4,2.4,0,59.6,70.8,1678,336,1342,20.02,79.98,47,289,92,1250,139,1539,14,6.9,8.3,"50% - 75% P.O.C.","$51000 - $70000"
"06037297000","Census Tract 2970, Los Angeles County, California",5597,110699,2626,269,0,278,0,2075,46.9,4.8,0,5,0,37.1,53.1,2337,1406,931,60.16,39.84,25,1381,141,790,166,2171,1.8,15.1,7.1,"50% - 75% P.O.C.","$95000 or more"
"06037297110","Census Tract 2971.10, Los Angeles County, California",4649,40000,758,515,0,251,18,2988,16.3,11.1,0,5.4,0.4,64.3,83.7,1558,235,1323,15.08,84.92,65,170,149,1174,214,1344,27.7,11.3,13.7,"75% or more P.O.C.","Less than $51000"
"06037297120","Census Tract 2971.20, Los Angeles County, California",3053,49229,523,171,0,287,0,2072,17.1,5.6,0,9.4,0,67.9,82.9,1059,217,842,20.49,79.51,25,192,184,658,209,850,11.5,21.9,19.7,"75% or more P.O.C.","Less than $51000"
"06037297201","Census Tract 2972.01, Los Angeles County, California",4505,60574,848,327,22,244,0,2892,18.8,7.3,0.5,5.4,0,64.2,81.2,1467,306,1161,20.86,79.14,43,263,179,982,222,1245,14.1,15.4,15.1,"75% or more P.O.C.","$51000 - $70000"
"06037297202","Census Tract 2972.02, Los Angeles County, California",3786,70767,1805,77,0,71,0,1791,47.7,2,0,1.9,0,47.3,52.3,1399,611,788,43.67,56.33,87,524,33,755,120,1279,14.2,4.2,8.6,"50% - 75% P.O.C.","$70000 - $95000"
"06037297300","Census Tract 2973, Los Angeles County, California",2193,102143,1159,134,0,96,25,671,52.8,6.1,0,4.4,1.1,30.6,47.2,772,335,437,43.39,56.61,17,318,89,348,106,666,5.1,20.4,13.7,"25% - 50% P.O.C.","$95000 or more"
"06037297400","Census Tract 2974, Los Angeles County, California",3356,82955,2258,81,0,170,0,768,67.3,2.4,0,5.1,0,22.9,32.7,1506,1276,230,84.73,15.27,72,1204,11,219,83,1423,5.6,4.8,5.5,"25% - 50% P.O.C.","$70000 - $95000"
"06037297500","Census Tract 2975, Los Angeles County, California",4707,88229,2638,145,0,227,0,1512,56,3.1,0,4.8,0,32.1,44,2092,1413,679,67.54,32.46,108,1305,12,667,120,1972,7.6,1.8,5.7,"25% - 50% P.O.C.","$70000 - $95000"
"06037297601","Census Tract 2976.01, Los Angeles County, California",2816,55246,1186,216,8,93,0,947,42.1,7.7,0.3,3.3,0,33.6,57.9,1213,209,1004,17.23,82.77,0,209,80,924,80,1133,0,8,6.6,"50% - 75% P.O.C.","$51000 - $70000"
"06037297602","Census Tract 2976.02, Los Angeles County, California",3687,64873,1633,125,9,330,20,1427,44.3,3.4,0.2,9,0.5,38.7,55.7,1712,700,1012,40.89,59.11,63,637,75,937,138,1574,9,7.4,8.1,"50% - 75% P.O.C.","$51000 - $70000"
"06037300100","Census Tract 3001, Los Angeles County, California",6014,139458,3483,19,0,1624,0,702,57.9,0.3,0,27,0,11.7,42.1,1946,1823,123,93.68,6.32,217,1606,0,123,217,1729,11.9,0,11.2,"25% - 50% P.O.C.","$95000 or more"
"06037300200","Census Tract 3002, Los Angeles County, California",5352,103209,2743,38,14,1903,0,532,51.3,0.7,0.3,35.6,0,9.9,48.7,1863,1256,607,67.42,32.58,115,1141,21,586,136,1727,9.2,3.5,7.3,"25% - 50% P.O.C.","$95000 or more"
"06037300301","Census Tract 3003.01, Los Angeles County, California",6024,114890,3870,21,0,1299,0,497,64.2,0.3,0,21.6,0,8.3,35.8,2061,1790,271,86.85,13.15,247,1543,8,263,255,1806,13.8,3,12.4,"25% - 50% P.O.C.","$95000 or more"
"06037300400","Census Tract 3004, Los Angeles County, California",5986,97083,3238,1,0,1374,0,1049,54.1,0,0,23,0,17.5,45.9,2074,1487,587,71.7,28.3,119,1368,51,536,170,1904,8,8.7,8.2,"25% - 50% P.O.C.","$95000 or more"
"06037300501","Census Tract 3005.01, Los Angeles County, California",3264,110792,1501,0,0,817,0,495,46,0,0,25,0,15.2,54,1055,838,217,79.43,20.57,93,745,41,176,134,921,11.1,18.9,12.7,"50% - 75% P.O.C.","$95000 or more"
"06037300502","Census Tract 3005.02, Los Angeles County, California",5874,67407,2556,1,0,1419,85,1650,43.5,0,0,24.2,1.4,28.1,56.5,2409,893,1516,37.07,62.93,90,803,57,1459,147,2262,10.1,3.8,6.1,"50% - 75% P.O.C.","$51000 - $70000"
"06037300600","Census Tract 3006, Los Angeles County, California",9609,69107,4691,120,0,2974,46,1631,48.8,1.2,0,31,0.5,17,51.2,3578,1316,2262,36.78,63.22,197,1119,120,2142,317,3261,15,5.3,8.9,"50% - 75% P.O.C.","$51000 - $70000"
"06037300701","Census Tract 3007.01, Los Angeles County, California",5835,129025,4350,58,0,663,0,502,74.6,1,0,11.4,0,8.6,25.4,2076,1717,359,82.71,17.29,236,1481,0,359,236,1840,13.7,0,11.4,"25% - 50% P.O.C.","$95000 or more"
"06037300702","Census Tract 3007.02, Los Angeles County, California",5430,112802,4563,0,0,428,0,263,84,0,0,7.9,0,4.8,16,1891,1635,256,86.46,13.54,102,1533,0,256,102,1789,6.2,0,5.4,"Less than 25% P.O.C.","$95000 or more"
"06037300800","Census Tract 3008, Los Angeles County, California",7280,96157,4086,42,12,1630,0,942,56.1,0.6,0.2,22.4,0,12.9,43.9,2776,1462,1314,52.67,47.33,156,1306,64,1250,220,2556,10.7,4.9,7.9,"25% - 50% P.O.C.","$95000 or more"
"06037300901","Census Tract 3009.01, Los Angeles County, California",6540,149707,4275,48,0,1565,0,288,65.4,0.7,0,23.9,0,4.4,34.6,2203,1923,280,87.29,12.71,219,1704,28,252,247,1956,11.4,10,11.2,"25% - 50% P.O.C.","$95000 or more"
"06037300902","Census Tract 3009.02, Los Angeles County, California",1981,136708,1293,0,0,293,0,309,65.3,0,0,14.8,0,15.6,34.7,741,673,68,90.82,9.18,35,638,4,64,39,702,5.2,5.9,5.3,"25% - 50% P.O.C.","$95000 or more"
"06037301000","Census Tract 3010, Los Angeles County, California",5230,68967,2995,94,0,798,7,957,57.3,1.8,0,15.3,0.1,18.3,42.7,2085,722,1363,34.63,65.37,68,654,58,1305,126,1959,9.4,4.3,6,"25% - 50% P.O.C.","$51000 - $70000"
"06037301100","Census Tract 3011, Los Angeles County, California",7114,74303,5233,87,0,723,0,778,73.6,1.2,0,10.2,0,10.9,26.4,2818,1072,1746,38.04,61.96,51,1021,0,1746,51,2767,4.8,0,1.8,"25% - 50% P.O.C.","$70000 - $95000"
"06037301203","Census Tract 3012.03, Los Angeles County, California",4711,66563,3081,148,0,618,0,706,65.4,3.1,0,13.1,0,15,34.6,1884,750,1134,39.81,60.19,47,703,26,1108,73,1811,6.3,2.3,3.9,"25% - 50% P.O.C.","$51000 - $70000"
"06037301204","Census Tract 3012.04, Los Angeles County, California",5284,58497,3165,406,0,847,0,846,59.9,7.7,0,16,0,16,40.1,2123,148,1975,6.97,93.03,0,148,51,1924,51,2072,0,2.6,2.4,"25% - 50% P.O.C.","$51000 - $70000"
"06037301205","Census Tract 3012.05, Los Angeles County, California",2106,107159,1531,29,0,245,0,242,72.7,1.4,0,11.6,0,11.5,27.3,747,595,152,79.65,20.35,39,556,9,143,48,699,6.6,5.9,6.4,"25% - 50% P.O.C.","$95000 or more"
"06037301206","Census Tract 3012.06, Los Angeles County, California",5281,63715,3911,160,0,719,0,431,74.1,3,0,13.6,0,8.2,25.9,1861,470,1391,25.26,74.74,25,445,111,1280,136,1725,5.3,8,7.3,"25% - 50% P.O.C.","$51000 - $70000"
"06037301300","Census Tract 3013, Los Angeles County, California",1894,119107,1596,0,0,144,0,148,84.3,0,0,7.6,0,7.8,15.7,700,637,63,91,9,58,579,10,53,68,632,9.1,15.9,9.7,"Less than 25% P.O.C.","$95000 or more"
"06037301400","Census Tract 3014, Los Angeles County, California",4190,150489,3398,7,106,230,0,271,81.1,0.2,2.5,5.5,0,6.5,18.9,1313,1042,271,79.36,20.64,135,907,71,200,206,1107,13,26.2,15.7,"Less than 25% P.O.C.","$95000 or more"
"06037301501","Census Tract 3015.01, Los Angeles County, California",1790,94375,1365,5,0,170,17,217,76.3,0.3,0,9.5,0.9,12.1,23.7,554,412,142,74.37,25.63,53,359,19,123,72,482,12.9,13.4,13,"Less than 25% P.O.C.","$70000 - $95000"
"06037301502","Census Tract 3015.02, Los Angeles County, California",6750,50205,5326,0,0,561,0,781,78.9,0,0,8.3,0,11.6,21.1,2459,197,2262,8.01,91.99,0,197,117,2145,117,2342,0,5.2,4.8,"Less than 25% P.O.C.","Less than $51000"
"06037301601","Census Tract 3016.01, Los Angeles County, California",6112,39053,4220,190,0,258,0,1341,69,3.1,0,4.2,0,21.9,31,2373,259,2114,10.91,89.09,10,249,86,2028,96,2277,3.9,4.1,4,"25% - 50% P.O.C.","Less than $51000"
"06037301602","Census Tract 3016.02, Los Angeles County, California",4446,65947,1860,137,0,510,36,1795,41.8,3.1,0,11.5,0.8,40.4,58.2,1608,345,1263,21.46,78.54,42,303,106,1157,148,1460,12.2,8.4,9.2,"50% - 75% P.O.C.","$51000 - $70000"
"06037301701","Census Tract 3017.01, Los Angeles County, California",2962,84688,1457,121,0,382,0,901,49.2,4.1,0,12.9,0,30.4,50.8,1140,494,646,43.33,56.67,51,443,22,624,73,1067,10.3,3.4,6.4,"50% - 75% P.O.C.","$70000 - $95000"
"06037301702","Census Tract 3017.02, Los Angeles County, California",5835,56571,3787,128,77,899,0,823,64.9,2.2,1.3,15.4,0,14.1,35.1,2064,309,1755,14.97,85.03,15,294,206,1549,221,1843,4.9,11.7,10.7,"25% - 50% P.O.C.","$51000 - $70000"
"06037301801","Census Tract 3018.01, Los Angeles County, California",5258,58779,2466,65,0,1252,64,1109,46.9,1.2,0,23.8,1.2,21.1,53.1,2264,296,1968,13.07,86.93,0,296,49,1919,49,2215,0,2.5,2.2,"50% - 75% P.O.C.","$51000 - $70000"
"06037301802","Census Tract 3018.02, Los Angeles County, California",4516,63328,2881,81,0,858,0,544,63.8,1.8,0,19,0,12,36.2,1923,310,1613,16.12,83.88,9,301,69,1544,78,1845,2.9,4.3,4.1,"25% - 50% P.O.C.","$51000 - $70000"
"06037301900","Census Tract 3019, Los Angeles County, California",8192,66061,4990,121,0,1758,0,1208,60.9,1.5,0,21.5,0,14.7,39.1,3243,1016,2227,31.33,68.67,48,968,62,2165,110,3133,4.7,2.8,3.4,"25% - 50% P.O.C.","$51000 - $70000"
"06037302002","Census Tract 3020.02, Los Angeles County, California",3949,49417,2531,122,0,713,0,491,64.1,3.1,0,18.1,0,12.4,35.9,1722,314,1408,18.23,81.77,29,285,82,1326,111,1611,9.2,5.8,6.4,"25% - 50% P.O.C.","Less than $51000"
"06037302003","Census Tract 3020.03, Los Angeles County, California",3665,55305,2488,30,0,653,9,387,67.9,0.8,0,17.8,0.2,10.6,32.1,1404,104,1300,7.41,92.59,0,104,40,1260,40,1364,0,3.1,2.8,"25% - 50% P.O.C.","$51000 - $70000"
"06037302004","Census Tract 3020.04, Los Angeles County, California",4151,50875,2399,108,0,789,0,769,57.8,2.6,0,19,0,18.5,42.2,1603,248,1355,15.47,84.53,40,208,92,1263,132,1471,16.1,6.8,8.2,"25% - 50% P.O.C.","Less than $51000"
"06037302102","Census Tract 3021.02, Los Angeles County, California",5946,76602,3520,175,0,1281,16,905,59.2,2.9,0,21.5,0.3,15.2,40.8,2498,853,1645,34.15,65.85,16,837,18,1627,34,2464,1.9,1.1,1.4,"25% - 50% P.O.C.","$70000 - $95000"
"06037302103","Census Tract 3021.03, Los Angeles County, California",5430,42461,3739,48,0,783,0,795,68.9,0.9,0,14.4,0,14.6,31.1,1932,215,1717,11.13,88.87,29,186,220,1497,249,1683,13.5,12.8,12.9,"25% - 50% P.O.C.","Less than $51000"
"06037302104","Census Tract 3021.04, Los Angeles County, California",4288,61005,1902,126,0,1246,0,921,44.4,2.9,0,29.1,0,21.5,55.6,1509,159,1350,10.54,89.46,14,145,75,1275,89,1420,8.8,5.6,5.9,"50% - 75% P.O.C.","$51000 - $70000"
"06037302201","Census Tract 3022.01, Los Angeles County, California",4019,24851,3087,98,0,351,0,389,76.8,2.4,0,8.7,0,9.7,23.2,1875,99,1776,5.28,94.72,9,90,45,1731,54,1821,9.1,2.5,2.9,"Less than 25% P.O.C.","Less than $51000"
"06037302202","Census Tract 3022.02, Los Angeles County, California",5510,45156,3150,74,0,776,0,1414,57.2,1.3,0,14.1,0,25.7,42.8,1988,221,1767,11.12,88.88,23,198,154,1613,177,1811,10.4,8.7,8.9,"25% - 50% P.O.C.","Less than $51000"
"06037302301","Census Tract 3023.01, Los Angeles County, California",3985,55795,2391,30,6,626,0,863,60,0.8,0.2,15.7,0,21.7,40,1403,328,1075,23.38,76.62,30,298,79,996,109,1294,9.1,7.3,7.8,"25% - 50% P.O.C.","$51000 - $70000"
"06037302302","Census Tract 3023.02, Los Angeles County, California",5337,52763,1958,94,0,805,0,2430,36.7,1.8,0,15.1,0,45.5,63.3,1962,94,1868,4.79,95.21,35,59,149,1719,184,1778,37.2,8,9.4,"50% - 75% P.O.C.","$51000 - $70000"
"06037302401","Census Tract 3024.01, Los Angeles County, California",7395,41300,3768,197,0,931,0,2457,51,2.7,0,12.6,0,33.2,49,2470,218,2252,8.83,91.17,69,149,180,2072,249,2221,31.7,8,10.1,"25% - 50% P.O.C.","Less than $51000"
"06037302503","Census Tract 3025.03, Los Angeles County, California",4290,41016,2659,0,0,643,0,941,62,0,0,15,0,21.9,38,1392,117,1275,8.41,91.59,48,69,122,1153,170,1222,41,9.6,12.2,"25% - 50% P.O.C.","Less than $51000"
"06037302504","Census Tract 3025.04, Los Angeles County, California",4273,38468,2311,36,0,511,0,1312,54.1,0.8,0,12,0,30.7,45.9,1500,196,1304,13.07,86.93,18,178,93,1211,111,1389,9.2,7.1,7.4,"25% - 50% P.O.C.","Less than $51000"
"06037302505","Census Tract 3025.05, Los Angeles County, California",4376,35269,2267,239,0,373,0,1451,51.8,5.5,0,8.5,0,33.2,48.2,1520,48,1472,3.16,96.84,5,43,127,1345,132,1388,10.4,8.6,8.7,"25% - 50% P.O.C.","Less than $51000"
"06037302506","Census Tract 3025.06, Los Angeles County, California",3262,61283,1755,59,0,361,26,907,53.8,1.8,0,11.1,0.8,27.8,46.2,1361,331,1030,24.32,75.68,10,321,20,1010,30,1331,3,1.9,2.2,"25% - 50% P.O.C.","$51000 - $70000"
"06037310100","Census Tract 3101, Los Angeles County, California",5644,136000,3732,280,0,574,0,958,66.1,5,0,10.2,0,17,33.9,1958,1735,223,88.61,11.39,158,1577,0,223,158,1800,9.1,0,8.1,"25% - 50% P.O.C.","$95000 or more"
"06037310201","Census Tract 3102.01, Los Angeles County, California",5732,75324,4238,40,0,449,0,723,73.9,0.7,0,7.8,0,12.6,26.1,2079,1033,1046,49.69,50.31,53,980,184,862,237,1842,5.1,17.6,11.4,"25% - 50% P.O.C.","$70000 - $95000"
"06037310202","Census Tract 3102.02, Los Angeles County, California",5104,74375,3716,129,37,264,0,674,72.8,2.5,0.7,5.2,0,13.2,27.2,1837,646,1191,35.17,64.83,25,621,37,1154,62,1775,3.9,3.1,3.4,"25% - 50% P.O.C.","$70000 - $95000"
"06037310300","Census Tract 3103, Los Angeles County, California",2881,151364,1942,0,0,454,0,370,67.4,0,0,15.8,0,12.8,32.6,1052,929,123,88.31,11.69,56,873,24,99,80,972,6,19.5,7.6,"25% - 50% P.O.C.","$95000 or more"
"06037310400","Census Tract 3104, Los Angeles County, California",3247,92955,2034,41,27,404,0,546,62.6,1.3,0.8,12.4,0,16.8,37.4,1242,745,497,59.98,40.02,73,672,42,455,115,1127,9.8,8.5,9.3,"25% - 50% P.O.C.","$70000 - $95000"
"06037310501","Census Tract 3105.01, Los Angeles County, California",4066,61906,1129,282,39,621,0,1943,27.8,6.9,1,15.3,0,47.8,72.2,1343,269,1074,20.03,79.97,77,192,50,1024,127,1216,28.6,4.7,9.5,"50% - 75% P.O.C.","$51000 - $70000"
"06037310601","Census Tract 3106.01, Los Angeles County, California",6383,69277,2963,301,0,974,0,1521,46.4,4.7,0,15.3,0,23.8,53.6,2362,725,1637,30.69,69.31,39,686,119,1518,158,2204,5.4,7.3,6.7,"50% - 75% P.O.C.","$51000 - $70000"
"06037310602","Census Tract 3106.02, Los Angeles County, California",2853,86806,1600,55,7,524,0,548,56.1,1.9,0.2,18.4,0,19.2,43.9,1053,447,606,42.45,57.55,43,404,25,581,68,985,9.6,4.1,6.5,"25% - 50% P.O.C.","$70000 - $95000"
"06037310701","Census Tract 3107.01, Los Angeles County, California",2181,30371,1650,1,0,175,0,247,75.7,0,0,8,0,11.3,24.3,1101,78,1023,7.08,92.92,12,66,55,968,67,1034,15.4,5.4,6.1,"Less than 25% P.O.C.","Less than $51000"
"06037310702","Census Tract 3107.02, Los Angeles County, California",6567,45632,4163,163,0,1048,0,867,63.4,2.5,0,16,0,13.2,36.6,3486,338,3148,9.7,90.3,0,338,48,3100,48,3438,0,1.5,1.4,"25% - 50% P.O.C.","Less than $51000"
"06037310703","Census Tract 3107.03, Los Angeles County, California",4793,42344,3070,126,0,328,0,995,64.1,2.6,0,6.8,0,20.8,35.9,2041,247,1794,12.1,87.9,8,239,88,1706,96,1945,3.2,4.9,4.7,"25% - 50% P.O.C.","Less than $51000"
"06037310800","Census Tract 3108, Los Angeles County, California",5314,66429,2863,58,31,536,11,1615,53.9,1.1,0.6,10.1,0.2,30.4,46.1,1978,982,996,49.65,50.35,96,886,70,926,166,1812,9.8,7,8.4,"25% - 50% P.O.C.","$51000 - $70000"
"06037310900","Census Tract 3109, Los Angeles County, California",6071,81536,3273,76,14,1005,0,1504,53.9,1.3,0.2,16.6,0,24.8,46.1,2411,1578,833,65.45,34.55,60,1518,13,820,73,2338,3.8,1.6,3,"25% - 50% P.O.C.","$70000 - $95000"
"06037311000","Census Tract 3110, Los Angeles County, California",3641,104875,1854,99,0,390,0,1178,50.9,2.7,0,10.7,0,32.4,49.1,1386,847,539,61.11,38.89,54,793,30,509,84,1302,6.4,5.6,6.1,"25% - 50% P.O.C.","$95000 or more"
"06037311100","Census Tract 3111, Los Angeles County, California",4183,106321,2016,27,120,650,0,1213,48.2,0.6,2.9,15.5,0,29,51.8,1379,1109,270,80.42,19.58,96,1013,0,270,96,1283,8.7,0,7,"50% - 75% P.O.C.","$95000 or more"
"06037311200","Census Tract 3112, Los Angeles County, California",3171,77147,1776,123,0,247,0,820,56,3.9,0,7.8,0,25.9,44,1299,569,730,43.8,56.2,55,514,10,720,65,1234,9.7,1.4,5,"25% - 50% P.O.C.","$70000 - $95000"
"06037311300","Census Tract 3113, Los Angeles County, California",3896,97931,2077,111,8,459,0,1102,53.3,2.8,0.2,11.8,0,28.3,46.7,1506,1028,478,68.26,31.74,63,965,9,469,72,1434,6.1,1.9,4.8,"25% - 50% P.O.C.","$95000 or more"
"06037311400","Census Tract 3114, Los Angeles County, California",2300,105000,1574,29,0,233,0,387,68.4,1.3,0,10.1,0,16.8,31.6,974,641,333,65.81,34.19,41,600,7,326,48,926,6.4,2.1,4.9,"25% - 50% P.O.C.","$95000 or more"
"06037311500","Census Tract 3115, Los Angeles County, California",5828,93125,3340,204,47,655,0,1435,57.3,3.5,0.8,11.2,0,24.6,42.7,2374,1056,1318,44.48,55.52,122,934,19,1299,141,2233,11.6,1.4,5.9,"25% - 50% P.O.C.","$70000 - $95000"
"06037311600","Census Tract 3116, Los Angeles County, California",6707,71528,3909,434,0,901,0,827,58.3,6.5,0,13.4,0,12.3,41.7,3609,693,2916,19.2,80.8,31,662,57,2859,88,3521,4.5,2,2.4,"25% - 50% P.O.C.","$70000 - $95000"
"06037311700","Census Tract 3117, Los Angeles County, California",6200,93750,4028,93,62,516,0,1333,65,1.5,1,8.3,0,21.5,35,2551,1297,1254,50.84,49.16,107,1190,50,1204,157,2394,8.2,4,6.2,"25% - 50% P.O.C.","$70000 - $95000"
"06037311801","Census Tract 3118.01, Los Angeles County, California",2873,63041,1081,92,20,328,0,1302,37.6,3.2,0.7,11.4,0,45.3,62.4,1304,305,999,23.39,76.61,18,287,23,976,41,1263,5.9,2.3,3.1,"50% - 75% P.O.C.","$51000 - $70000"
"06037311802","Census Tract 3118.02, Los Angeles County, California",4068,72992,999,61,38,588,0,2250,24.6,1.5,0.9,14.5,0,55.3,75.4,1472,199,1273,13.52,86.48,1,198,96,1177,97,1375,0.5,7.5,6.6,"75% or more P.O.C.","$70000 - $95000"
"06037320000","Census Tract 3200, Los Angeles County, California",0,NA,0,0,0,0,0,0,NA,NA,NA,NA,NA,NA,NA,0,0,0,NA,NA,0,0,0,0,0,0,NA,NA,NA,"N/A","N/A"
"06037320100","Census Tract 3201, Los Angeles County, California",7601,72438,335,138,0,190,0,6930,4.4,1.8,0,2.5,0,91.2,95.6,1886,1372,514,72.75,27.25,432,940,135,379,567,1319,31.5,26.3,30.1,"75% or more P.O.C.","$70000 - $95000"
"06037320201","Census Tract 3202.01, Los Angeles County, California",4049,35205,147,0,0,0,0,3876,3.6,0,0,0,0,95.7,96.4,1308,253,1055,19.34,80.66,32,221,204,851,236,1072,12.6,19.3,18,"75% or more P.O.C.","Less than $51000"
"06037320202","Census Tract 3202.02, Los Angeles County, California",6151,77386,404,11,0,90,6,5634,6.6,0.2,0,1.5,0.1,91.6,93.4,1442,968,474,67.13,32.87,288,680,212,262,500,942,29.8,44.7,34.7,"75% or more P.O.C.","$70000 - $95000"
"06037320300","Census Tract 3203, Los Angeles County, California",6734,52532,124,28,123,40,0,6419,1.8,0.4,1.8,0.6,0,95.3,98.2,1933,954,979,49.35,50.65,264,690,200,779,464,1469,27.7,20.4,24,"75% or more P.O.C.","$51000 - $70000"
"06037400204","Census Tract 4002.04, Los Angeles County, California",5637,117073,3361,56,25,828,0,1238,59.6,1,0.4,14.7,0,22,40.4,2098,2032,66,96.85,3.15,120,1912,0,66,120,1978,5.9,0,5.7,"25% - 50% P.O.C.","$95000 or more"
"06037400205","Census Tract 4002.05, Los Angeles County, California",2846,201250,1392,170,0,843,0,299,48.9,6,0,29.6,0,10.5,51.1,927,901,26,97.2,2.8,89,812,8,18,97,830,9.9,30.8,10.5,"50% - 75% P.O.C.","$95000 or more"
"06037400206","Census Tract 4002.06, Los Angeles County, California",5365,133715,2791,123,0,1058,0,1180,52,2.3,0,19.7,0,22,48,1753,1596,157,91.04,8.96,193,1403,22,135,215,1538,12.1,14,12.3,"25% - 50% P.O.C.","$95000 or more"
"06037400207","Census Tract 4002.07, Los Angeles County, California",4608,136500,2590,187,0,579,0,1195,56.2,4.1,0,12.6,0,25.9,43.8,1468,1366,102,93.05,6.95,182,1184,11,91,193,1275,13.3,10.8,13.1,"25% - 50% P.O.C.","$95000 or more"
"06037400302","Census Tract 4003.02, Los Angeles County, California",3154,81853,1382,132,0,236,153,1188,43.8,4.2,0,7.5,4.9,37.7,56.2,1133,681,452,60.11,39.89,143,538,0,452,143,990,21,0,12.6,"50% - 75% P.O.C.","$70000 - $95000"
"06037400304","Census Tract 4003.04, Los Angeles County, California",7788,74453,2951,102,103,1434,0,3017,37.9,1.3,1.3,18.4,0,38.7,62.1,2565,1244,1321,48.5,51.5,164,1080,214,1107,378,2187,13.2,16.2,14.7,"50% - 75% P.O.C.","$70000 - $95000"
"06037400402","Census Tract 4004.02, Los Angeles County, California",4305,99107,2315,48,0,493,0,1249,53.8,1.1,0,11.5,0,29,46.2,1356,1032,324,76.11,23.89,173,859,50,274,223,1133,16.8,15.4,16.4,"25% - 50% P.O.C.","$95000 or more"
"06037400403","Census Tract 4004.03, Los Angeles County, California",3906,106875,1960,71,19,358,0,1375,50.2,1.8,0.5,9.2,0,35.2,49.8,1292,893,399,69.12,30.88,123,770,69,330,192,1100,13.8,17.3,14.9,"25% - 50% P.O.C.","$95000 or more"
"06037400404","Census Tract 4004.04, Los Angeles County, California",4268,135038,2642,0,0,576,2,821,61.9,0,0,13.5,0,19.2,38.1,1403,1317,86,93.87,6.13,88,1229,44,42,132,1271,6.7,51.2,9.4,"25% - 50% P.O.C.","$95000 or more"
"06037400501","Census Tract 4005.01, Los Angeles County, California",2049,145417,1427,5,0,249,47,211,69.6,0.2,0,12.2,2.3,10.3,30.4,661,619,42,93.65,6.35,46,573,30,12,76,585,7.4,71.4,11.5,"25% - 50% P.O.C.","$95000 or more"
"06037400602","Census Tract 4006.02, Los Angeles County, California",4250,75722,881,89,15,331,0,2896,20.7,2.1,0.4,7.8,0,68.1,79.3,1289,666,623,51.67,48.33,106,560,142,481,248,1041,15.9,22.8,19.2,"75% or more P.O.C.","$70000 - $95000"
"06037400603","Census Tract 4006.03, Los Angeles County, California",5201,80729,1428,215,0,627,0,2762,27.5,4.1,0,12.1,0,53.1,72.5,1727,1108,619,64.16,35.84,94,1014,105,514,199,1528,8.5,17,11.5,"50% - 75% P.O.C.","$70000 - $95000"
"06037400604","Census Tract 4006.04, Los Angeles County, California",3501,100556,947,140,10,815,0,1522,27,4,0.3,23.3,0,43.5,73,1224,818,406,66.83,33.17,54,764,102,304,156,1068,6.6,25.1,12.7,"50% - 75% P.O.C.","$95000 or more"
"06037400800","Census Tract 4008, Los Angeles County, California",6967,86897,3317,337,9,1562,21,1461,47.6,4.8,0.1,22.4,0.3,21,52.4,1120,933,187,83.3,16.7,54,879,34,153,88,1032,5.8,18.2,7.9,"50% - 75% P.O.C.","$70000 - $95000"
"06037400900","Census Tract 4009, Los Angeles County, California",4424,102758,2032,43,0,591,0,1640,45.9,1,0,13.4,0,37.1,54.1,1525,1063,462,69.7,30.3,103,960,65,397,168,1357,9.7,14.1,11,"50% - 75% P.O.C.","$95000 or more"
"06037401001","Census Tract 4010.01, Los Angeles County, California",3062,117260,2003,6,0,292,0,655,65.4,0.2,0,9.5,0,21.4,34.6,1013,850,163,83.91,16.09,42,808,87,76,129,884,4.9,53.4,12.7,"25% - 50% P.O.C.","$95000 or more"
"06037401002","Census Tract 4010.02, Los Angeles County, California",3678,68676,2165,108,0,388,39,736,58.9,2.9,0,10.5,1.1,20,41.1,1484,625,859,42.12,57.88,61,564,35,824,96,1388,9.8,4.1,6.5,"25% - 50% P.O.C.","$51000 - $70000"
"06037401101","Census Tract 4011.01, Los Angeles County, California",5582,69719,2198,191,39,544,0,2403,39.4,3.4,0.7,9.7,0,43,60.6,1997,811,1186,40.61,59.39,140,671,92,1094,232,1765,17.3,7.8,11.6,"50% - 75% P.O.C.","$51000 - $70000"
"06037401102","Census Tract 4011.02, Los Angeles County, California",3896,79539,1524,27,0,670,0,1438,39.1,0.7,0,17.2,0,36.9,60.9,1234,537,697,43.52,56.48,61,476,103,594,164,1070,11.4,14.8,13.3,"50% - 75% P.O.C.","$70000 - $95000"
"06037401201","Census Tract 4012.01, Los Angeles County, California",3377,113194,1783,23,0,280,37,1117,52.8,0.7,0,8.3,1.1,33.1,47.2,1007,854,153,84.81,15.19,139,715,15,138,154,853,16.3,9.8,15.3,"25% - 50% P.O.C.","$95000 or more"
"06037401202","Census Tract 4012.02, Los Angeles County, California",4706,95046,1930,18,59,595,0,1931,41,0.4,1.3,12.6,0,41,59,1373,1169,204,85.14,14.86,193,976,9,195,202,1171,16.5,4.4,14.7,"50% - 75% P.O.C.","$95000 or more"
"06037401203","Census Tract 4012.03, Los Angeles County, California",5224,84063,1997,102,11,575,0,2371,38.2,2,0.2,11,0,45.4,61.8,1681,1293,388,76.92,23.08,89,1204,71,317,160,1521,6.9,18.3,9.5,"50% - 75% P.O.C.","$70000 - $95000"
"06037401303","Census Tract 4013.03, Los Angeles County, California",2074,107938,924,22,6,480,0,621,44.6,1.1,0.3,23.1,0,29.9,55.4,701,613,88,87.45,12.55,71,542,7,81,78,623,11.6,8,11.1,"50% - 75% P.O.C.","$95000 or more"
"06037401304","Census Tract 4013.04, Los Angeles County, California",5449,132026,2674,150,0,835,12,1426,49.1,2.8,0,15.3,0.2,26.2,50.9,1848,1669,179,90.31,9.69,268,1401,14,165,282,1566,16.1,7.8,15.3,"50% - 75% P.O.C.","$95000 or more"
"06037401311","Census Tract 4013.11, Los Angeles County, California",6120,80811,3281,47,0,544,0,2081,53.6,0.8,0,8.9,0,34,46.4,2124,1433,691,67.47,32.53,212,1221,103,588,315,1809,14.8,14.9,14.8,"25% - 50% P.O.C.","$70000 - $95000"
"06037401312","Census Tract 4013.12, Los Angeles County, California",5401,74219,2443,124,0,652,5,1994,45.2,2.3,0,12.1,0.1,36.9,54.8,1909,1495,414,78.31,21.69,179,1316,39,375,218,1691,12,9.4,11.4,"50% - 75% P.O.C.","$70000 - $95000"
"06037401500","Census Tract 4015, Los Angeles County, California",6213,78000,2664,138,8,407,10,2871,42.9,2.2,0.1,6.6,0.2,46.2,57.1,1898,1274,624,67.12,32.88,121,1153,78,546,199,1699,9.5,12.5,10.5,"50% - 75% P.O.C.","$70000 - $95000"
"06037401601","Census Tract 4016.01, Los Angeles County, California",5368,75964,2752,91,22,532,0,1875,51.3,1.7,0.4,9.9,0,34.9,48.7,2247,1713,534,76.23,23.77,118,1595,0,534,118,2129,6.9,0,5.3,"25% - 50% P.O.C.","$70000 - $95000"
"06037401602","Census Tract 4016.02, Los Angeles County, California",6294,67034,2699,284,0,309,0,2846,42.9,4.5,0,4.9,0,45.2,57.1,2035,1106,929,54.35,45.65,161,945,65,864,226,1809,14.6,7,11.1,"50% - 75% P.O.C.","$51000 - $70000"
"06037401603","Census Tract 4016.03, Los Angeles County, California",2951,63611,1579,122,0,159,0,1053,53.5,4.1,0,5.4,0,35.7,46.5,1300,926,374,71.23,28.77,36,890,23,351,59,1241,3.9,6.1,4.5,"25% - 50% P.O.C.","$51000 - $70000"
"06037401701","Census Tract 4017.01, Los Angeles County, California",4488,86856,2060,301,100,466,0,1259,45.9,6.7,2.2,10.4,0,28.1,54.1,1671,1246,425,74.57,25.43,112,1134,0,425,112,1559,9,0,6.7,"50% - 75% P.O.C.","$70000 - $95000"
"06037401703","Census Tract 4017.03, Los Angeles County, California",4107,70642,1213,326,0,438,0,1976,29.5,7.9,0,10.7,0,48.1,70.5,1433,626,807,43.68,56.32,102,524,75,732,177,1256,16.3,9.3,12.4,"50% - 75% P.O.C.","$70000 - $95000"
"06037401704","Census Tract 4017.04, Los Angeles County, California",7108,59513,1334,366,90,881,0,4267,18.8,5.1,1.3,12.4,0,60,81.2,2117,1161,956,54.84,45.16,252,909,185,771,437,1680,21.7,19.4,20.6,"75% or more P.O.C.","$51000 - $70000"
"06037401800","Census Tract 4018, Los Angeles County, California",7927,104643,3961,337,17,770,4,2031,50,4.3,0.2,9.7,0.1,25.6,50,2760,2117,643,76.7,23.3,261,1856,17,626,278,2482,12.3,2.6,10.1,"50% - 75% P.O.C.","$95000 or more"
"06037401901","Census Tract 4019.01, Los Angeles County, California",3945,79327,1704,196,16,988,8,807,43.2,5,0.4,25,0.2,20.5,56.8,127,8,119,6.3,93.7,0,8,5,114,5,122,0,4.2,3.9,"50% - 75% P.O.C.","$70000 - $95000"
"06037401902","Census Tract 4019.02, Los Angeles County, California",6223,96466,3614,288,56,397,0,1681,58.1,4.6,0.9,6.4,0,27,41.9,2676,1111,1565,41.52,58.48,60,1051,52,1513,112,2564,5.4,3.3,4.2,"25% - 50% P.O.C.","$95000 or more"
"06037402001","Census Tract 4020.01, Los Angeles County, California",3294,83409,930,370,0,589,0,1186,28.2,11.2,0,17.9,0,36,71.8,1124,495,629,44.04,55.96,14,481,74,555,88,1036,2.8,11.8,7.8,"50% - 75% P.O.C.","$70000 - $95000"
"06037402002","Census Tract 4020.02, Los Angeles County, California",4125,55946,2049,237,15,193,0,1548,49.7,5.7,0.4,4.7,0,37.5,50.3,1575,669,906,42.48,57.52,67,602,83,823,150,1425,10,9.2,9.5,"50% - 75% P.O.C.","$51000 - $70000"
"06037402101","Census Tract 4021.01, Los Angeles County, California",5558,77026,233,426,31,427,0,4387,4.2,7.7,0.6,7.7,0,78.9,95.8,1053,702,351,66.67,33.33,249,453,177,174,426,627,35.5,50.4,40.5,"75% or more P.O.C.","$70000 - $95000"
"06037402102","Census Tract 4021.02, Los Angeles County, California",4858,76500,543,556,64,346,44,3214,11.2,11.4,1.3,7.1,0.9,66.2,88.8,1216,794,422,65.3,34.7,192,602,123,299,315,901,24.2,29.1,25.9,"75% or more P.O.C.","$70000 - $95000"
"06037402200","Census Tract 4022, Los Angeles County, California",6782,85963,1394,607,6,685,0,4057,20.6,9,0.1,10.1,0,59.8,79.4,2011,1440,571,71.61,28.39,197,1243,119,452,316,1695,13.7,20.8,15.7,"75% or more P.O.C.","$70000 - $95000"
"06037402301","Census Tract 4023.01, Los Angeles County, California",5464,55565,413,129,18,509,2,4305,7.6,2.4,0.3,9.3,0,78.8,92.4,1318,616,702,46.74,53.26,117,499,301,401,418,900,19,42.9,31.7,"75% or more P.O.C.","$51000 - $70000"
"06037402303","Census Tract 4023.03, Los Angeles County, California",4080,50625,564,62,44,155,0,3199,13.8,1.5,1.1,3.8,0,78.4,86.2,1096,396,700,36.13,63.87,91,305,151,549,242,854,23,21.6,22.1,"75% or more P.O.C.","Less than $51000"
"06037402304","Census Tract 4023.04, Los Angeles County, California",4057,39427,203,66,4,182,6,3596,5,1.6,0.1,4.5,0.1,88.6,95,938,298,640,31.77,68.23,125,173,232,408,357,581,41.9,36.2,38.1,"75% or more P.O.C.","Less than $51000"
"06037402402","Census Tract 4024.02, Los Angeles County, California",6635,57650,939,174,32,893,0,4499,14.2,2.6,0.5,13.5,0,67.8,85.8,1886,862,1024,45.71,54.29,153,709,93,931,246,1640,17.7,9.1,13,"75% or more P.O.C.","$51000 - $70000"
"06037402403","Census Tract 4024.03, Los Angeles County, California",5231,74592,863,218,0,840,10,3056,16.5,4.2,0,16.1,0.2,58.4,83.5,947,800,147,84.48,15.52,304,496,32,115,336,611,38,21.8,35.5,"75% or more P.O.C.","$70000 - $95000"
"06037402404","Census Tract 4024.04, Los Angeles County, California",1862,NA,608,138,0,448,0,522,32.7,7.4,0,24.1,0,28,67.3,5,0,5,0,100,0,0,0,5,0,5,NA,0,0,"50% - 75% P.O.C.","N/A"
"06037402405","Census Tract 4024.05, Los Angeles County, California",2875,55000,30,268,0,22,32,2498,1,9.3,0,0.8,1.1,86.9,99,646,491,155,76.01,23.99,136,355,87,68,223,423,27.7,56.1,34.5,"75% or more P.O.C.","$51000 - $70000"
"06037402406","Census Tract 4024.06, Los Angeles County, California",5329,49679,317,173,0,273,0,4537,5.9,3.2,0,5.1,0,85.1,94.1,1182,604,578,51.1,48.9,281,323,182,396,463,719,46.5,31.5,39.2,"75% or more P.O.C.","Less than $51000"
"06037402501","Census Tract 4025.01, Los Angeles County, California",5591,40542,187,142,0,176,0,5066,3.3,2.5,0,3.1,0,90.6,96.7,1310,355,955,27.1,72.9,178,177,239,716,417,893,50.1,25,31.8,"75% or more P.O.C.","Less than $51000"
"06037402502","Census Tract 4025.02, Los Angeles County, California",6839,45432,264,239,0,798,0,5497,3.9,3.5,0,11.7,0,80.4,96.1,1783,522,1261,29.28,70.72,104,418,340,921,444,1339,19.9,27,24.9,"75% or more P.O.C.","Less than $51000"
"06037402600","Census Tract 4026, Los Angeles County, California",7493,54727,1402,263,0,434,0,5278,18.7,3.5,0,5.8,0,70.4,81.3,2342,1169,1173,49.91,50.09,167,1002,238,935,405,1937,14.3,20.3,17.3,"75% or more P.O.C.","$51000 - $70000"
"06037402702","Census Tract 4027.02, Los Angeles County, California",6365,34095,210,663,0,62,0,5423,3.3,10.4,0,1,0,85.2,96.7,1565,336,1229,21.47,78.53,124,212,324,905,448,1117,36.9,26.4,28.6,"75% or more P.O.C.","Less than $51000"
"06037402703","Census Tract 4027.03, Los Angeles County, California",4661,70091,563,502,9,395,9,3120,12.1,10.8,0.2,8.5,0.2,66.9,87.9,1281,813,468,63.47,36.53,196,617,94,374,290,991,24.1,20.1,22.6,"75% or more P.O.C.","$70000 - $95000"
"06037402705","Census Tract 4027.05, Los Angeles County, California",3254,80000,383,202,0,191,0,2385,11.8,6.2,0,5.9,0,73.3,88.2,840,693,147,82.5,17.5,206,487,37,110,243,597,29.7,25.2,28.9,"75% or more P.O.C.","$70000 - $95000"
"06037402706","Census Tract 4027.06, Los Angeles County, California",3834,69875,390,247,1,276,0,2764,10.2,6.4,0,7.2,0,72.1,89.8,970,611,359,62.99,37.01,145,466,167,192,312,658,23.7,46.5,32.2,"75% or more P.O.C.","$51000 - $70000"
"06037402801","Census Tract 4028.01, Los Angeles County, California",4976,45313,74,0,76,138,0,4688,1.5,0,1.5,2.8,0,94.2,98.5,1126,401,725,35.61,64.39,190,211,270,455,460,666,47.4,37.2,40.9,"75% or more P.O.C.","Less than $51000"
"06037402803","Census Tract 4028.03, Los Angeles County, California",3270,48090,22,60,0,217,0,2965,0.7,1.8,0,6.6,0,90.7,99.3,725,296,429,40.83,59.17,126,170,188,241,314,411,42.6,43.8,43.3,"75% or more P.O.C.","Less than $51000"
"06037402804","Census Tract 4028.04, Los Angeles County, California",4238,54063,90,155,0,464,7,3489,2.1,3.7,0,10.9,0.2,82.3,97.9,936,220,716,23.5,76.5,82,138,243,473,325,611,37.3,33.9,34.7,"75% or more P.O.C.","$51000 - $70000"
"06037402902","Census Tract 4029.02, Los Angeles County, California",6903,64583,438,314,0,880,0,5224,6.3,4.5,0,12.7,0,75.7,93.7,1531,731,800,47.75,52.25,171,560,307,493,478,1053,23.4,38.4,31.2,"75% or more P.O.C.","$51000 - $70000"
"06037402903","Census Tract 4029.03, Los Angeles County, California",4363,56667,189,158,0,483,0,3465,4.3,3.6,0,11.1,0,79.4,95.7,982,545,437,55.5,44.5,237,308,173,264,410,572,43.5,39.6,41.8,"75% or more P.O.C.","$51000 - $70000"
"06037402904","Census Tract 4029.04, Los Angeles County, California",3705,71637,196,41,18,108,0,3303,5.3,1.1,0.5,2.9,0,89.1,94.7,793,618,175,77.93,22.07,250,368,76,99,326,467,40.5,43.4,41.1,"75% or more P.O.C.","$70000 - $95000"
"06037403000","Census Tract 4030, Los Angeles County, California",6950,62300,195,262,0,453,0,5948,2.8,3.8,0,6.5,0,85.6,97.2,1516,1153,363,76.06,23.94,306,847,249,114,555,961,26.5,68.6,36.6,"75% or more P.O.C.","$51000 - $70000"
"06037403200","Census Tract 4032, Los Angeles County, California",399,NA,243,42,0,45,0,69,60.9,10.5,0,11.3,0,17.3,39.1,0,0,0,NA,NA,0,0,0,0,0,0,NA,NA,NA,"25% - 50% P.O.C.","N/A"
"06037403303","Census Tract 4033.03, Los Angeles County, California",2741,77083,257,83,14,1519,0,863,9.4,3,0.5,55.4,0,31.5,90.6,721,557,164,77.25,22.75,141,416,66,98,207,514,25.3,40.2,28.7,"75% or more P.O.C.","$70000 - $95000"
"06037403304","Census Tract 4033.04, Los Angeles County, California",4863,106188,666,46,40,3163,0,744,13.7,0.9,0.8,65,0,15.3,86.3,1648,1402,246,85.07,14.93,152,1250,0,246,152,1496,10.8,0,9.2,"75% or more P.O.C.","$95000 or more"
"06037403305","Census Tract 4033.05, Los Angeles County, California",2294,106758,224,35,0,1684,0,252,9.8,1.5,0,73.4,0,11,90.2,697,508,189,72.88,27.12,63,445,35,154,98,599,12.4,18.5,14.1,"75% or more P.O.C.","$95000 or more"
"06037403312","Census Tract 4033.12, Los Angeles County, California",5096,77813,1134,58,0,2111,0,1749,22.3,1.1,0,41.4,0,34.3,77.7,1602,1236,366,77.15,22.85,123,1113,53,313,176,1426,10,14.5,11,"75% or more P.O.C.","$70000 - $95000"
"06037403316","Census Tract 4033.16, Los Angeles County, California",6757,84976,2281,360,0,2686,0,1319,33.8,5.3,0,39.8,0,19.5,66.2,2385,1758,627,73.71,26.29,150,1608,69,558,219,2166,8.5,11,9.2,"50% - 75% P.O.C.","$70000 - $95000"
"06037403317","Census Tract 4033.17, Los Angeles County, California",4710,107208,703,388,29,1871,0,1521,14.9,8.2,0.6,39.7,0,32.3,85.1,1427,1232,195,86.33,13.67,270,962,0,195,270,1157,21.9,0,18.9,"75% or more P.O.C.","$95000 or more"
"06037403318","Census Tract 4033.18, Los Angeles County, California",6367,92935,1484,533,0,1996,0,1951,23.3,8.4,0,31.3,0,30.6,76.7,1928,1472,456,76.35,23.65,213,1259,41,415,254,1674,14.5,9,13.2,"75% or more P.O.C.","$70000 - $95000"
"06037403319","Census Tract 4033.19, Los Angeles County, California",4046,79750,545,226,8,2137,0,958,13.5,5.6,0.2,52.8,0,23.7,86.5,1594,1045,549,65.56,34.44,137,908,19,530,156,1438,13.1,3.5,9.8,"75% or more P.O.C.","$70000 - $95000"
"06037403320","Census Tract 4033.20, Los Angeles County, California",4992,114063,527,151,0,3530,0,743,10.6,3,0,70.7,0,14.9,89.4,1572,1326,246,84.35,15.65,118,1208,37,209,155,1417,8.9,15,9.9,"75% or more P.O.C.","$95000 or more"
"06037403321","Census Tract 4033.21, Los Angeles County, California",6303,102188,1303,346,0,2808,0,1595,20.7,5.5,0,44.6,0,25.3,79.3,1937,1435,502,74.08,25.92,181,1254,97,405,278,1659,12.6,19.3,14.4,"75% or more P.O.C.","$95000 or more"
"06037403322","Census Tract 4033.22, Los Angeles County, California",3703,108822,878,67,0,2026,0,622,23.7,1.8,0,54.7,0,16.8,76.3,1221,920,301,75.35,24.65,63,857,36,265,99,1122,6.8,12,8.1,"75% or more P.O.C.","$95000 or more"
"06037403323","Census Tract 4033.23, Los Angeles County, California",5494,90902,769,177,73,3855,38,451,14,3.2,1.3,70.2,0.7,8.2,86,1758,1245,513,70.82,29.18,84,1161,137,376,221,1537,6.7,26.7,12.6,"75% or more P.O.C.","$70000 - $95000"
"06037403324","Census Tract 4033.24, Los Angeles County, California",7193,106642,672,291,25,5100,0,1047,9.3,4,0.3,70.9,0,14.6,90.7,2115,1656,459,78.3,21.7,180,1476,101,358,281,1834,10.9,22,13.3,"75% or more P.O.C.","$95000 or more"
"06037403325","Census Tract 4033.25, Los Angeles County, California",5348,118481,781,297,0,3286,24,830,14.6,5.6,0,61.4,0.4,15.5,85.4,1689,1303,386,77.15,22.85,106,1197,15,371,121,1568,8.1,3.9,7.2,"75% or more P.O.C.","$95000 or more"
"06037403401","Census Tract 4034.01, Los Angeles County, California",5136,106477,375,384,0,3006,0,1330,7.3,7.5,0,58.5,0,25.9,92.7,1585,1271,314,80.19,19.81,206,1065,24,290,230,1355,16.2,7.6,14.5,"75% or more P.O.C.","$95000 or more"
"06037403402","Census Tract 4034.02, Los Angeles County, California",3745,84906,521,89,14,2016,98,944,13.9,2.4,0.4,53.8,2.6,25.2,86.1,1077,867,210,80.5,19.5,181,686,74,136,255,822,20.9,35.2,23.7,"75% or more P.O.C.","$70000 - $95000"
"06037403403","Census Tract 4034.03, Los Angeles County, California",4898,136094,260,248,0,3355,8,894,5.3,5.1,0,68.5,0.2,18.3,94.7,1547,1374,173,88.82,11.18,192,1182,35,138,227,1320,14,20.2,14.7,"75% or more P.O.C.","$95000 or more"
"06037403404","Census Tract 4034.04, Los Angeles County, California",2645,95625,358,126,0,1750,0,361,13.5,4.8,0,66.2,0,13.6,86.5,764,691,73,90.45,9.55,113,578,20,53,133,631,16.4,27.4,17.4,"75% or more P.O.C.","$95000 or more"
"06037403405","Census Tract 4034.05, Los Angeles County, California",1698,134688,251,3,0,1073,0,351,14.8,0.2,0,63.2,0,20.7,85.2,533,454,79,85.18,14.82,20,434,20,59,40,493,4.4,25.3,7.5,"75% or more P.O.C.","$95000 or more"
"06037403406","Census Tract 4034.06, Los Angeles County, California",2955,85417,708,21,0,1289,0,787,24,0.7,0,43.6,0,26.6,76,886,583,303,65.8,34.2,83,500,72,231,155,731,14.2,23.8,17.5,"75% or more P.O.C.","$70000 - $95000"
"06037403407","Census Tract 4034.07, Los Angeles County, California",2314,143889,90,61,0,1861,0,302,3.9,2.6,0,80.4,0,13.1,96.1,702,671,31,95.58,4.42,113,558,0,31,113,589,16.8,0,16.1,"75% or more P.O.C.","$95000 or more"
"06037403408","Census Tract 4034.08, Los Angeles County, California",6512,102292,544,331,0,4353,0,1079,8.4,5.1,0,66.8,0,16.6,91.6,1975,1785,190,90.38,9.62,246,1539,44,146,290,1685,13.8,23.2,14.7,"75% or more P.O.C.","$95000 or more"
"06037403500","Census Tract 4035, Los Angeles County, California",1835,106250,363,52,0,699,0,661,19.8,2.8,0,38.1,0,36,80.2,554,402,152,72.56,27.44,65,337,25,127,90,464,16.2,16.4,16.2,"75% or more P.O.C.","$95000 or more"
"06037403600","Census Tract 4036, Los Angeles County, California",6690,76635,1457,290,12,1156,0,3707,21.8,4.3,0.2,17.3,0,55.4,78.2,2093,1542,551,73.67,26.33,96,1446,203,348,299,1794,6.2,36.8,14.3,"75% or more P.O.C.","$70000 - $95000"
"06037403702","Census Tract 4037.02, Los Angeles County, California",3786,103438,1124,142,0,640,4,1742,29.7,3.8,0,16.9,0.1,46,70.3,1109,967,142,87.2,12.8,146,821,44,98,190,919,15.1,31,17.1,"50% - 75% P.O.C.","$95000 or more"
"06037403703","Census Tract 4037.03, Los Angeles County, California",4542,85977,1923,158,0,480,0,1919,42.3,3.5,0,10.6,0,42.3,57.7,1531,1185,346,77.4,22.6,134,1051,66,280,200,1331,11.3,19.1,13.1,"50% - 75% P.O.C.","$70000 - $95000"
"06037403721","Census Tract 4037.21, Los Angeles County, California",4897,64628,1449,120,15,584,0,2617,29.6,2.5,0.3,11.9,0,53.4,70.4,1606,905,701,56.35,43.65,143,762,51,650,194,1412,15.8,7.3,12.1,"50% - 75% P.O.C.","$51000 - $70000"
"06037403722","Census Tract 4037.22, Los Angeles County, California",5628,57377,1095,127,0,619,0,3695,19.5,2.3,0,11,0,65.7,80.5,1728,686,1042,39.7,60.3,109,577,190,852,299,1429,15.9,18.2,17.3,"75% or more P.O.C.","$51000 - $70000"
"06037403801","Census Tract 4038.01, Los Angeles County, California",6224,73250,1005,149,25,1058,0,3886,16.1,2.4,0.4,17,0,62.4,83.9,1925,1214,711,63.06,36.94,188,1026,101,610,289,1636,15.5,14.2,15,"75% or more P.O.C.","$70000 - $95000"
"06037403802","Census Tract 4038.02, Los Angeles County, California",6687,71591,1713,300,29,762,0,3570,25.6,4.5,0.4,11.4,0,53.4,74.4,1918,1025,893,53.44,46.56,175,850,193,700,368,1550,17.1,21.6,19.2,"50% - 75% P.O.C.","$70000 - $95000"
"06037403901","Census Tract 4039.01, Los Angeles County, California",3174,83750,1006,45,30,312,12,1691,31.7,1.4,0.9,9.8,0.4,53.3,68.3,911,704,207,77.28,22.72,130,574,31,176,161,750,18.5,15,17.7,"50% - 75% P.O.C.","$70000 - $95000"
"06037403902","Census Tract 4039.02, Los Angeles County, California",5140,88611,2240,319,60,386,0,2060,43.6,6.2,1.2,7.5,0,40.1,56.4,1494,1008,486,67.47,32.53,102,906,53,433,155,1339,10.1,10.9,10.4,"50% - 75% P.O.C.","$70000 - $95000"
"06037404000","Census Tract 4040, Los Angeles County, California",4614,84519,921,59,0,391,12,3231,20,1.3,0,8.5,0.3,70,80,1299,787,512,60.59,39.41,239,548,94,418,333,966,30.4,18.4,25.6,"75% or more P.O.C.","$70000 - $95000"
"06037404100","Census Tract 4041, Los Angeles County, California",6277,64643,408,218,0,432,27,5085,6.5,3.5,0,6.9,0.4,81,93.5,1458,947,511,64.95,35.05,242,705,183,328,425,1033,25.6,35.8,29.1,"75% or more P.O.C.","$51000 - $70000"
"06037404201","Census Tract 4042.01, Los Angeles County, California",3519,54896,536,25,37,388,0,2418,15.2,0.7,1.1,11,0,68.7,84.8,987,552,435,55.93,44.07,110,442,115,320,225,762,19.9,26.4,22.8,"75% or more P.O.C.","$51000 - $70000"
"06037404202","Census Tract 4042.02, Los Angeles County, California",4252,68537,1187,119,17,526,0,2330,27.9,2.8,0.4,12.4,0,54.8,72.1,731,391,340,53.49,46.51,118,273,59,281,177,554,30.2,17.4,24.2,"50% - 75% P.O.C.","$51000 - $70000"
"06037404301","Census Tract 4043.01, Los Angeles County, California",5503,49534,324,179,0,181,0,4800,5.9,3.3,0,3.3,0,87.2,94.1,1386,435,951,31.39,68.61,80,355,261,690,341,1045,18.4,27.4,24.6,"75% or more P.O.C.","Less than $51000"
"06037404302","Census Tract 4043.02, Los Angeles County, California",2176,78077,286,20,0,253,0,1608,13.1,0.9,0,11.6,0,73.9,86.9,572,351,221,61.36,38.64,94,257,59,162,153,419,26.8,26.7,26.7,"75% or more P.O.C.","$70000 - $95000"
"06037404401","Census Tract 4044.01, Los Angeles County, California",3715,67353,371,42,0,96,2,3155,10,1.1,0,2.6,0.1,84.9,90,966,607,359,62.84,37.16,203,404,103,256,306,660,33.4,28.7,31.7,"75% or more P.O.C.","$51000 - $70000"
"06037404402","Census Tract 4044.02, Los Angeles County, California",5156,69444,272,128,0,673,22,3931,5.3,2.5,0,13.1,0.4,76.2,94.7,1102,558,544,50.64,49.36,204,354,229,315,433,669,36.6,42.1,39.3,"75% or more P.O.C.","$51000 - $70000"
"06037404501","Census Tract 4045.01, Los Angeles County, California",2789,56115,135,28,0,178,0,2381,4.8,1,0,6.4,0,85.4,95.2,671,369,302,54.99,45.01,123,246,105,197,228,443,33.3,34.8,34,"75% or more P.O.C.","$51000 - $70000"
"06037404503","Census Tract 4045.03, Los Angeles County, California",2638,76394,221,77,0,311,11,1962,8.4,2.9,0,11.8,0.4,74.4,91.6,711,525,186,73.84,26.16,120,405,16,170,136,575,22.9,8.6,19.1,"75% or more P.O.C.","$70000 - $95000"
"06037404504","Census Tract 4045.04, Los Angeles County, California",5073,57206,373,171,0,483,0,4034,7.4,3.4,0,9.5,0,79.5,92.6,1296,540,756,41.67,58.33,211,329,190,566,401,895,39.1,25.1,30.9,"75% or more P.O.C.","$51000 - $70000"
"06037404600","Census Tract 4046, Los Angeles County, California",1394,72500,118,0,0,9,0,1259,8.5,0,0,0.6,0,90.3,91.5,392,282,110,71.94,28.06,84,198,35,75,119,273,29.8,31.8,30.4,"75% or more P.O.C.","$70000 - $95000"
"06037404701","Census Tract 4047.01, Los Angeles County, California",5665,75931,224,11,0,1033,0,4380,4,0.2,0,18.2,0,77.3,96,1238,782,456,63.17,36.83,262,520,154,302,416,822,33.5,33.8,33.6,"75% or more P.O.C.","$70000 - $95000"
"06037404702","Census Tract 4047.02, Los Angeles County, California",5629,58929,187,141,0,1567,0,3715,3.3,2.5,0,27.8,0,66,96.7,1400,701,699,50.07,49.93,105,596,233,466,338,1062,15,33.3,24.1,"75% or more P.O.C.","$51000 - $70000"
"06037404703","Census Tract 4047.03, Los Angeles County, California",3110,55455,69,48,0,349,0,2610,2.2,1.5,0,11.2,0,83.9,97.8,756,298,458,39.42,60.58,68,230,133,325,201,555,22.8,29,26.6,"75% or more P.O.C.","$51000 - $70000"
"06037404801","Census Tract 4048.01, Los Angeles County, California",7911,62153,295,77,0,1738,0,5789,3.7,1,0,22,0,73.2,96.3,1879,848,1031,45.13,54.87,304,544,324,707,628,1251,35.8,31.4,33.4,"75% or more P.O.C.","$51000 - $70000"
"06037404802","Census Tract 4048.02, Los Angeles County, California",4196,61921,187,57,27,744,103,3074,4.5,1.4,0.6,17.7,2.5,73.3,95.5,1059,443,616,41.83,58.17,123,320,250,366,373,686,27.8,40.6,35.2,"75% or more P.O.C.","$51000 - $70000"
"06037404803","Census Tract 4048.03, Los Angeles County, California",1719,66736,209,0,0,175,4,1331,12.2,0,0,10.2,0.2,77.4,87.8,445,277,168,62.25,37.75,39,238,54,114,93,352,14.1,32.1,20.9,"75% or more P.O.C.","$51000 - $70000"
"06037404901","Census Tract 4049.01, Los Angeles County, California",5700,67636,207,151,0,1219,0,4123,3.6,2.6,0,21.4,0,72.3,96.4,1289,844,445,65.48,34.52,266,578,98,347,364,925,31.5,22,28.2,"75% or more P.O.C.","$51000 - $70000"
"06037404902","Census Tract 4049.02, Los Angeles County, California",3968,74618,106,2,0,1300,0,2529,2.7,0.1,0,32.8,0,63.7,97.3,959,705,254,73.51,26.49,186,519,85,169,271,688,26.4,33.5,28.3,"75% or more P.O.C.","$70000 - $95000"
"06037404903","Census Tract 4049.03, Los Angeles County, California",2738,60993,73,0,0,890,0,1775,2.7,0,0,32.5,0,64.8,97.3,699,437,262,62.52,37.48,93,344,75,187,168,531,21.3,28.6,24,"75% or more P.O.C.","$51000 - $70000"
"06037405001","Census Tract 4050.01, Los Angeles County, California",6029,80042,169,35,0,639,0,5156,2.8,0.6,0,10.6,0,85.5,97.2,1357,1047,310,77.16,22.84,349,698,90,220,439,918,33.3,29,32.4,"75% or more P.O.C.","$70000 - $95000"
"06037405002","Census Tract 4050.02, Los Angeles County, California",3169,66316,66,13,39,453,0,2580,2.1,0.4,1.2,14.3,0,81.4,97.9,682,464,218,68.04,31.96,156,308,113,105,269,413,33.6,51.8,39.4,"75% or more P.O.C.","$51000 - $70000"
"06037405101","Census Tract 4051.01, Los Angeles County, California",5617,78667,182,47,0,1100,0,4272,3.2,0.8,0,19.6,0,76.1,96.8,1160,743,417,64.05,35.95,233,510,175,242,408,752,31.4,42,35.2,"75% or more P.O.C.","$70000 - $95000"
"06037405102","Census Tract 4051.02, Los Angeles County, California",5639,49130,270,126,26,1149,0,4068,4.8,2.2,0.5,20.4,0,72.1,95.2,1364,690,674,50.59,49.41,216,474,143,531,359,1005,31.3,21.2,26.3,"75% or more P.O.C.","Less than $51000"
"06037405201","Census Tract 4052.01, Los Angeles County, California",4933,56705,213,167,12,800,0,3661,4.3,3.4,0.2,16.2,0,74.2,95.7,1348,715,633,53.04,46.96,121,594,123,510,244,1104,16.9,19.4,18.1,"75% or more P.O.C.","$51000 - $70000"
"06037405202","Census Tract 4052.02, Los Angeles County, California",4850,64423,137,107,37,566,255,3727,2.8,2.2,0.8,11.7,5.3,76.8,97.2,1212,609,603,50.25,49.75,203,406,167,436,370,842,33.3,27.7,30.5,"75% or more P.O.C.","$51000 - $70000"
"06037405203","Census Tract 4052.03, Los Angeles County, California",3638,78615,355,25,0,725,0,2510,9.8,0.7,0,19.9,0,69,90.2,795,572,223,71.95,28.05,156,416,121,102,277,518,27.3,54.3,34.8,"75% or more P.O.C.","$70000 - $95000"
"06037405301","Census Tract 4053.01, Los Angeles County, California",3469,61654,348,102,0,590,7,2356,10,2.9,0,17,0.2,67.9,90,1019,507,512,49.75,50.25,117,390,57,455,174,845,23.1,11.1,17.1,"75% or more P.O.C.","$51000 - $70000"
"06037405302","Census Tract 4053.02, Los Angeles County, California",5433,57159,540,119,0,1021,0,3679,9.9,2.2,0,18.8,0,67.7,90.1,1488,853,635,57.33,42.67,185,668,132,503,317,1171,21.7,20.8,21.3,"75% or more P.O.C.","$51000 - $70000"
"06037405400","Census Tract 4054, Los Angeles County, California",4950,89332,614,87,0,406,35,3745,12.4,1.8,0,8.2,0.7,75.7,87.6,1263,1105,158,87.49,12.51,309,796,50,108,359,904,28,31.6,28.4,"75% or more P.O.C.","$70000 - $95000"
"06037405500","Census Tract 4055, Los Angeles County, California",6596,73566,905,51,60,1399,10,4078,13.7,0.8,0.9,21.2,0.2,61.8,86.3,1844,1312,532,71.15,28.85,239,1073,124,408,363,1481,18.2,23.3,19.7,"75% or more P.O.C.","$70000 - $95000"
"06037405600","Census Tract 4056, Los Angeles County, California",5553,87102,775,132,0,1143,0,3482,14,2.4,0,20.6,0,62.7,86,1603,1149,454,71.68,28.32,251,898,69,385,320,1283,21.8,15.2,20,"75% or more P.O.C.","$70000 - $95000"
"06037405701","Census Tract 4057.01, Los Angeles County, California",3862,95036,568,0,0,591,0,2667,14.7,0,0,15.3,0,69.1,85.3,1115,832,283,74.62,25.38,199,633,0,283,199,916,23.9,0,17.8,"75% or more P.O.C.","$95000 or more"
"06037405702","Census Tract 4057.02, Los Angeles County, California",4957,83558,688,388,0,893,0,2775,13.9,7.8,0,18,0,56,86.1,1481,1088,393,73.46,26.54,186,902,128,265,314,1167,17.1,32.6,21.2,"75% or more P.O.C.","$70000 - $95000"
"06037405800","Census Tract 4058, Los Angeles County, California",5825,79728,884,66,0,573,0,3963,15.2,1.1,0,9.8,0,68,84.8,1641,1017,624,61.97,38.03,204,813,127,497,331,1310,20.1,20.4,20.2,"75% or more P.O.C.","$70000 - $95000"
"06037405900","Census Tract 4059, Los Angeles County, California",3951,63672,746,98,26,455,0,2562,18.9,2.5,0.7,11.5,0,64.8,81.1,1190,799,391,67.14,32.86,131,668,95,296,226,964,16.4,24.3,19,"75% or more P.O.C.","$51000 - $70000"
"06037406000","Census Tract 4060, Los Angeles County, California",5206,79203,1236,84,13,606,21,3127,23.7,1.6,0.2,11.6,0.4,60.1,76.3,1507,1006,501,66.76,33.24,122,884,72,429,194,1313,12.1,14.4,12.9,"75% or more P.O.C.","$70000 - $95000"
"06037406101","Census Tract 4061.01, Los Angeles County, California",3105,68514,656,112,60,305,0,1876,21.1,3.6,1.9,9.8,0,60.4,78.9,1206,475,731,39.39,60.61,68,407,40,691,108,1098,14.3,5.5,9,"75% or more P.O.C.","$51000 - $70000"
"06037406102","Census Tract 4061.02, Los Angeles County, California",6167,57321,920,242,15,524,0,4370,14.9,3.9,0.2,8.5,0,70.9,85.1,2158,411,1747,19.05,80.95,48,363,228,1519,276,1882,11.7,13.1,12.8,"75% or more P.O.C.","$51000 - $70000"
"06037406200","Census Tract 4062, Los Angeles County, California",5811,49833,840,229,0,1129,0,3514,14.5,3.9,0,19.4,0,60.5,85.5,1888,720,1168,38.14,61.86,125,595,164,1004,289,1599,17.4,14,15.3,"75% or more P.O.C.","Less than $51000"
"06037406300","Census Tract 4063, Los Angeles County, California",5829,99770,1180,97,0,1954,9,2209,20.2,1.7,0,33.5,0.2,37.9,79.8,1673,1190,483,71.13,28.87,198,992,86,397,284,1389,16.6,17.8,17,"75% or more P.O.C.","$95000 or more"
"06037406402","Census Tract 4064.02, Los Angeles County, California",2043,95795,615,36,0,186,0,1094,30.1,1.8,0,9.1,0,53.5,69.9,563,531,32,94.32,5.68,115,416,19,13,134,429,21.7,59.4,23.8,"50% - 75% P.O.C.","$95000 or more"
"06037406411","Census Tract 4064.11, Los Angeles County, California",2002,75398,370,43,0,369,0,1150,18.5,2.1,0,18.4,0,57.4,81.5,513,363,150,70.76,29.24,93,270,40,110,133,380,25.6,26.7,25.9,"75% or more P.O.C.","$70000 - $95000"
"06037406412","Census Tract 4064.12, Los Angeles County, California",2123,85156,459,35,0,540,0,1071,21.6,1.6,0,25.4,0,50.4,78.4,748,649,99,86.76,13.24,54,595,0,99,54,694,8.3,0,7.2,"75% or more P.O.C.","$70000 - $95000"
"06037406500","Census Tract 4065, Los Angeles County, California",6655,89559,638,239,33,1568,0,3830,9.6,3.6,0.5,23.6,0,57.6,90.4,1870,1179,691,63.05,36.95,241,938,137,554,378,1492,20.4,19.8,20.2,"75% or more P.O.C.","$70000 - $95000"
"06037406601","Census Tract 4066.01, Los Angeles County, California",5550,103484,959,193,26,1036,0,3243,17.3,3.5,0.5,18.7,0,58.4,82.7,1391,1185,206,85.19,14.81,283,902,99,107,382,1009,23.9,48.1,27.5,"75% or more P.O.C.","$95000 or more"
"06037406602","Census Tract 4066.02, Los Angeles County, California",5198,91591,589,16,8,1151,0,3415,11.3,0.3,0.2,22.1,0,65.7,88.7,1276,905,371,70.92,29.08,221,684,105,266,326,950,24.4,28.3,25.5,"75% or more P.O.C.","$70000 - $95000"
"06037406701","Census Tract 4067.01, Los Angeles County, California",3082,83906,264,267,5,695,1,1806,8.6,8.7,0.2,22.6,0,58.6,91.4,869,537,332,61.8,38.2,129,408,57,275,186,683,24,17.2,21.4,"75% or more P.O.C.","$70000 - $95000"
"06037406702","Census Tract 4067.02, Los Angeles County, California",6375,79990,819,149,0,1453,148,3650,12.8,2.3,0,22.8,2.3,57.3,87.2,1775,853,922,48.06,51.94,191,662,156,766,347,1428,22.4,16.9,19.5,"75% or more P.O.C.","$70000 - $95000"
"06037406800","Census Tract 4068, Los Angeles County, California",4866,96042,532,116,0,1308,48,2808,10.9,2.4,0,26.9,1,57.7,89.1,1277,1075,202,84.18,15.82,246,829,53,149,299,978,22.9,26.2,23.4,"75% or more P.O.C.","$95000 or more"
"06037406901","Census Tract 4069.01, Los Angeles County, California",4773,74571,163,98,0,781,0,3683,3.4,2.1,0,16.4,0,77.2,96.6,1151,693,458,60.21,39.79,251,442,24,434,275,876,36.2,5.2,23.9,"75% or more P.O.C.","$70000 - $95000"
"06037406902","Census Tract 4069.02, Los Angeles County, California",3584,62692,187,41,0,543,120,2611,5.2,1.1,0,15.2,3.3,72.9,94.8,862,623,239,72.27,27.73,238,385,69,170,307,555,38.2,28.9,35.6,"75% or more P.O.C.","$51000 - $70000"
"06037407001","Census Tract 4070.01, Los Angeles County, California",6284,80592,97,24,0,345,0,5783,1.5,0.4,0,5.5,0,92,98.5,1259,978,281,77.68,22.32,313,665,126,155,439,820,32,44.8,34.9,"75% or more P.O.C.","$70000 - $95000"
"06037407002","Census Tract 4070.02, Los Angeles County, California",3436,62330,109,26,0,368,4,2902,3.2,0.8,0,10.7,0.1,84.5,96.8,747,641,106,85.81,14.19,252,389,50,56,302,445,39.3,47.2,40.4,"75% or more P.O.C.","$51000 - $70000"
"06037407101","Census Tract 4071.01, Los Angeles County, California",4883,64375,194,34,0,403,0,4252,4,0.7,0,8.3,0,87.1,96,1167,665,502,56.98,43.02,229,436,128,374,357,810,34.4,25.5,30.6,"75% or more P.O.C.","$51000 - $70000"
"06037407102","Census Tract 4071.02, Los Angeles County, California",5710,73529,115,58,29,938,0,4484,2,1,0.5,16.4,0,78.5,98,1230,876,354,71.22,28.78,360,516,123,231,483,747,41.1,34.7,39.3,"75% or more P.O.C.","$70000 - $95000"
"06037407200","Census Tract 4072, Los Angeles County, California",6910,61519,322,2,0,576,0,6010,4.7,0,0,8.3,0,87,95.3,1589,1107,482,69.67,30.33,309,798,186,296,495,1094,27.9,38.6,31.2,"75% or more P.O.C.","$51000 - $70000"
"06037407301","Census Tract 4073.01, Los Angeles County, California",4949,84458,233,50,0,793,5,3797,4.7,1,0,16,0.1,76.7,95.3,1073,804,269,74.93,25.07,330,474,92,177,422,651,41,34.2,39.3,"75% or more P.O.C.","$70000 - $95000"
"06037407302","Census Tract 4073.02, Los Angeles County, California",3503,68158,48,58,0,388,8,3001,1.4,1.7,0,11.1,0.2,85.7,98.6,768,665,103,86.59,13.41,251,414,58,45,309,459,37.7,56.3,40.2,"75% or more P.O.C.","$51000 - $70000"
"06037407400","Census Tract 4074, Los Angeles County, California",1977,96164,222,117,0,567,25,893,11.2,5.9,0,28.7,1.3,45.2,88.8,525,404,121,76.95,23.05,95,309,33,88,128,397,23.5,27.3,24.4,"75% or more P.O.C.","$95000 or more"
"06037407501","Census Tract 4075.01, Los Angeles County, California",4257,68860,196,55,0,663,0,3339,4.6,1.3,0,15.6,0,78.4,95.4,1025,577,448,56.29,43.71,176,401,115,333,291,734,30.5,25.7,28.4,"75% or more P.O.C.","$51000 - $70000"
"06037407502","Census Tract 4075.02, Los Angeles County, California",4170,78984,192,107,0,312,0,3530,4.6,2.6,0,7.5,0,84.7,95.4,859,580,279,67.52,32.48,247,333,112,167,359,500,42.6,40.1,41.8,"75% or more P.O.C.","$70000 - $95000"
"06037407601","Census Tract 4076.01, Los Angeles County, California",4608,61429,118,65,0,540,26,3859,2.6,1.4,0,11.7,0.6,83.7,97.4,1116,424,692,37.99,62.01,187,237,198,494,385,731,44.1,28.6,34.5,"75% or more P.O.C.","$51000 - $70000"
"06037407602","Census Tract 4076.02, Los Angeles County, California",3993,68346,95,96,27,483,53,3199,2.4,2.4,0.7,12.1,1.3,80.1,97.6,937,648,289,69.16,30.84,204,444,97,192,301,636,31.5,33.6,32.1,"75% or more P.O.C.","$51000 - $70000"
"06037407701","Census Tract 4077.01, Los Angeles County, California",4903,49531,135,15,0,645,34,4074,2.8,0.3,0,13.2,0.7,83.1,97.2,1159,444,715,38.31,61.69,130,314,298,417,428,731,29.3,41.7,36.9,"75% or more P.O.C.","Less than $51000"
"06037407702","Census Tract 4077.02, Los Angeles County, California",6744,75664,488,42,43,993,0,5146,7.2,0.6,0.6,14.7,0,76.3,92.8,1611,1146,465,71.14,28.86,368,778,172,293,540,1071,32.1,37,33.5,"75% or more P.O.C.","$70000 - $95000"
"06037407801","Census Tract 4078.01, Los Angeles County, California",5727,96620,178,60,8,1385,0,3947,3.1,1,0.1,24.2,0,68.9,96.9,1085,856,229,78.89,21.11,389,467,112,117,501,584,45.4,48.9,46.2,"75% or more P.O.C.","$95000 or more"
"06037407802","Census Tract 4078.02, Los Angeles County, California",3476,84643,138,45,42,514,49,2685,4,1.3,1.2,14.8,1.4,77.2,96,774,591,183,76.36,23.64,199,392,44,139,243,531,33.7,24,31.4,"75% or more P.O.C.","$70000 - $95000"
"06037407900","Census Tract 4079, Los Angeles County, California",6082,91458,307,304,0,1333,40,4069,5,5,0,21.9,0.7,66.9,95,1530,1133,397,74.05,25.95,233,900,99,298,332,1198,20.6,24.9,21.7,"75% or more P.O.C.","$70000 - $95000"
"06037408003","Census Tract 4080.03, Los Angeles County, California",4577,86463,228,285,0,1263,0,2793,5,6.2,0,27.6,0,61,95,1276,973,303,76.25,23.75,228,745,22,281,250,1026,23.4,7.3,19.6,"75% or more P.O.C.","$70000 - $95000"
"06037408004","Census Tract 4080.04, Los Angeles County, California",2493,78641,165,267,0,910,0,1110,6.6,10.7,0,36.5,0,44.5,93.4,839,430,409,51.25,48.75,65,365,41,368,106,733,15.1,10,12.6,"75% or more P.O.C.","$70000 - $95000"
"06037408005","Census Tract 4080.05, Los Angeles County, California",5161,113477,631,281,0,2077,0,1939,12.2,5.4,0,40.2,0,37.6,87.8,1587,1126,461,70.95,29.05,105,1021,84,377,189,1398,9.3,18.2,11.9,"75% or more P.O.C.","$95000 or more"
"06037408006","Census Tract 4080.06, Los Angeles County, California",3344,80500,118,133,0,1795,9,1223,3.5,4,0,53.7,0.3,36.6,96.5,966,463,503,47.93,52.07,122,341,66,437,188,778,26.3,13.1,19.5,"75% or more P.O.C.","$70000 - $95000"
"06037408133","Census Tract 4081.33, Los Angeles County, California",5203,70667,319,216,0,1821,0,2774,6.1,4.2,0,35,0,53.3,93.9,1520,633,887,41.64,58.36,93,540,149,738,242,1278,14.7,16.8,15.9,"75% or more P.O.C.","$70000 - $95000"
"06037408134","Census Tract 4081.34, Los Angeles County, California",2760,107404,290,138,0,1391,0,835,10.5,5,0,50.4,0,30.3,89.5,767,591,176,77.05,22.95,74,517,53,123,127,640,12.5,30.1,16.6,"75% or more P.O.C.","$95000 or more"
"06037408135","Census Tract 4081.35, Los Angeles County, California",3882,92250,330,177,0,1889,0,1443,8.5,4.6,0,48.7,0,37.2,91.5,1164,627,537,53.87,46.13,47,580,137,400,184,980,7.5,25.5,15.8,"75% or more P.O.C.","$70000 - $95000"
"06037408136","Census Tract 4081.36, Los Angeles County, California",4224,97500,339,262,19,1346,0,2224,8,6.2,0.4,31.9,0,52.7,92,1004,793,211,78.98,21.02,216,577,96,115,312,692,27.2,45.5,31.1,"75% or more P.O.C.","$95000 or more"
"06037408137","Census Tract 4081.37, Los Angeles County, California",4277,70976,355,323,0,1564,54,1931,8.3,7.6,0,36.6,1.3,45.1,91.7,1334,495,839,37.11,62.89,98,397,152,687,250,1084,19.8,18.1,18.7,"75% or more P.O.C.","$70000 - $95000"
"06037408138","Census Tract 4081.38, Los Angeles County, California",5432,58594,256,40,0,250,0,4841,4.7,0.7,0,4.6,0,89.1,95.3,1207,873,334,72.33,27.67,303,570,168,166,471,736,34.7,50.3,39,"75% or more P.O.C.","$51000 - $70000"
"06037408139","Census Tract 4081.39, Los Angeles County, California",4536,71028,139,15,0,111,0,4271,3.1,0.3,0,2.4,0,94.2,96.9,835,612,223,73.29,26.71,288,324,124,99,412,423,47.1,55.6,49.3,"75% or more P.O.C.","$70000 - $95000"
"06037408140","Census Tract 4081.40, Los Angeles County, California",3793,64692,82,31,0,224,0,3456,2.2,0.8,0,5.9,0,91.1,97.8,760,580,180,76.32,23.68,271,309,67,113,338,422,46.7,37.2,44.5,"75% or more P.O.C.","$51000 - $70000"
"06037408141","Census Tract 4081.41, Los Angeles County, California",5366,75722,48,6,0,983,0,4329,0.9,0.1,0,18.3,0,80.7,99.1,1112,837,275,75.27,24.73,325,512,107,168,432,680,38.8,38.9,38.8,"75% or more P.O.C.","$70000 - $95000"
"06037408202","Census Tract 4082.02, Los Angeles County, California",2015,62583,135,0,0,209,0,1628,6.7,0,0,10.4,0,80.8,93.3,469,258,211,55.01,44.99,81,177,74,137,155,314,31.4,35.1,33,"75% or more P.O.C.","$51000 - $70000"
"06037408211","Census Tract 4082.11, Los Angeles County, California",6381,60429,269,75,0,4083,0,1850,4.2,1.2,0,64,0,29,95.8,1800,920,880,51.11,48.89,152,768,245,635,397,1403,16.5,27.8,22.1,"75% or more P.O.C.","$51000 - $70000"
"06037408212","Census Tract 4082.12, Los Angeles County, California",5042,74167,368,175,1,2925,0,1497,7.3,3.5,0,58,0,29.7,92.7,1378,1088,290,78.96,21.04,269,819,38,252,307,1071,24.7,13.1,22.3,"75% or more P.O.C.","$70000 - $95000"
"06037408301","Census Tract 4083.01, Los Angeles County, California",5569,67464,91,30,0,520,0,4928,1.6,0.5,0,9.3,0,88.5,98.4,1239,799,440,64.49,35.51,358,441,83,357,441,798,44.8,18.9,35.6,"75% or more P.O.C.","$51000 - $70000"
"06037408302","Census Tract 4083.02, Los Angeles County, California",3836,85968,274,0,0,615,0,2898,7.1,0,0,16,0,75.5,92.9,1070,913,157,85.33,14.67,173,740,56,101,229,841,18.9,35.7,21.4,"75% or more P.O.C.","$70000 - $95000"
"06037408303","Census Tract 4083.03, Los Angeles County, California",4183,91750,565,51,0,745,0,2822,13.5,1.2,0,17.8,0,67.5,86.5,1185,1026,159,86.58,13.42,134,892,70,89,204,981,13.1,44,17.2,"75% or more P.O.C.","$70000 - $95000"
"06037408401","Census Tract 4084.01, Los Angeles County, California",4389,75023,417,113,0,1130,0,2721,9.5,2.6,0,25.7,0,62,90.5,1237,730,507,59.01,40.99,238,492,61,446,299,938,32.6,12,24.2,"75% or more P.O.C.","$70000 - $95000"
"06037408402","Census Tract 4084.02, Los Angeles County, California",6646,86667,1080,68,19,1399,0,4080,16.3,1,0.3,21.1,0,61.4,83.7,1886,1759,127,93.27,6.73,298,1461,44,83,342,1544,16.9,34.6,18.1,"75% or more P.O.C.","$70000 - $95000"
"06037408501","Census Tract 4085.01, Los Angeles County, California",3050,64306,150,14,0,716,0,2163,4.9,0.5,0,23.5,0,70.9,95.1,806,511,295,63.4,36.6,117,394,74,221,191,615,22.9,25.1,23.7,"75% or more P.O.C.","$51000 - $70000"
"06037408503","Census Tract 4085.03, Los Angeles County, California",6673,120721,1126,114,22,2975,16,2261,16.9,1.7,0.3,44.6,0.2,33.9,83.1,1973,1774,199,89.91,10.09,347,1427,72,127,419,1554,19.6,36.2,21.2,"75% or more P.O.C.","$95000 or more"
"06037408504","Census Tract 4085.04, Los Angeles County, California",5193,86296,570,10,0,1746,0,2804,11,0.2,0,33.6,0,54,89,1583,877,706,55.4,44.6,188,689,82,624,270,1313,21.4,11.6,17.1,"75% or more P.O.C.","$70000 - $95000"
"06037408505","Census Tract 4085.05, Los Angeles County, California",2653,113702,464,19,22,912,4,1232,17.5,0.7,0.8,34.4,0.2,46.4,82.5,769,629,140,81.79,18.21,82,547,37,103,119,650,13,26.4,15.5,"75% or more P.O.C.","$95000 or more"
"06037408623","Census Tract 4086.23, Los Angeles County, California",3268,73393,525,87,0,1558,0,1003,16.1,2.7,0,47.7,0,30.7,83.9,970,652,318,67.22,32.78,88,564,87,231,175,795,13.5,27.4,18,"75% or more P.O.C.","$70000 - $95000"
"06037408624","Census Tract 4086.24, Los Angeles County, California",2958,89107,244,1,0,1945,0,739,8.2,0,0,65.8,0,25,91.8,962,806,156,83.78,16.22,69,737,35,121,104,858,8.6,22.4,10.8,"75% or more P.O.C.","$70000 - $95000"
"06037408625","Census Tract 4086.25, Los Angeles County, California",4214,87632,621,0,14,2201,0,1343,14.7,0,0.3,52.2,0,31.9,85.3,1324,1002,322,75.68,24.32,105,897,52,270,157,1167,10.5,16.1,11.9,"75% or more P.O.C.","$70000 - $95000"
"06037408626","Census Tract 4086.26, Los Angeles County, California",4037,81379,245,84,0,2828,0,880,6.1,2.1,0,70.1,0,21.8,93.9,1328,790,538,59.49,40.51,109,681,25,513,134,1194,13.8,4.6,10.1,"75% or more P.O.C.","$70000 - $95000"
"06037408627","Census Tract 4086.27, Los Angeles County, California",3076,104141,345,41,0,2026,9,607,11.2,1.3,0,65.9,0.3,19.7,88.8,922,796,126,86.33,13.67,111,685,57,69,168,754,13.9,45.2,18.2,"75% or more P.O.C.","$95000 or more"
"06037408628","Census Tract 4086.28, Los Angeles County, California",5177,67029,443,66,0,3487,0,1072,8.6,1.3,0,67.4,0,20.7,91.4,1866,1283,583,68.76,31.24,65,1218,72,511,137,1729,5.1,12.3,7.3,"75% or more P.O.C.","$51000 - $70000"
"06037408629","Census Tract 4086.29, Los Angeles County, California",3012,96786,399,62,6,1734,0,714,13.2,2.1,0.2,57.6,0,23.7,86.8,926,783,143,84.56,15.44,61,722,44,99,105,821,7.8,30.8,11.3,"75% or more P.O.C.","$95000 or more"
"06037408630","Census Tract 4086.30, Los Angeles County, California",2510,83793,107,0,0,438,0,1899,4.3,0,0,17.5,0,75.7,95.7,534,384,150,71.91,28.09,126,258,78,72,204,330,32.8,52,38.2,"75% or more P.O.C.","$70000 - $95000"
"06037408631","Census Tract 4086.31, Los Angeles County, California",5214,80417,438,8,0,1651,0,3065,8.4,0.2,0,31.7,0,58.8,91.6,1366,969,397,70.94,29.06,171,798,189,208,360,1006,17.6,47.6,26.4,"75% or more P.O.C.","$70000 - $95000"
"06037408703","Census Tract 4087.03, Los Angeles County, California",6545,124643,418,56,0,5362,0,624,6.4,0.9,0,81.9,0,9.5,93.6,1928,1670,258,86.62,13.38,325,1345,0,258,325,1603,19.5,0,16.9,"75% or more P.O.C.","$95000 or more"
"06037408704","Census Tract 4087.04, Los Angeles County, California",3311,58281,250,63,0,2089,0,866,7.6,1.9,0,63.1,0,26.2,92.4,1042,516,526,49.52,50.48,112,404,87,439,199,843,21.7,16.5,19.1,"75% or more P.O.C.","$51000 - $70000"
"06037408705","Census Tract 4087.05, Los Angeles County, California",5625,72656,662,0,0,3611,0,1323,11.8,0,0,64.2,0,23.5,88.2,1597,1125,472,70.44,29.56,245,880,65,407,310,1287,21.8,13.8,19.4,"75% or more P.O.C.","$70000 - $95000"
"06037408706","Census Tract 4087.06, Los Angeles County, California",1835,120341,222,7,136,1111,4,308,12.1,0.4,7.4,60.5,0.2,16.8,87.9,477,432,45,90.57,9.43,125,307,0,45,125,352,28.9,0,26.2,"75% or more P.O.C.","$95000 or more"
"06037408722","Census Tract 4087.22, Los Angeles County, California",4313,90962,522,8,10,2484,132,1140,12.1,0.2,0.2,57.6,3.1,26.4,87.9,1174,867,307,73.85,26.15,167,700,57,250,224,950,19.3,18.6,19.1,"75% or more P.O.C.","$70000 - $95000"
"06037408723","Census Tract 4087.23, Los Angeles County, California",2975,70109,318,70,5,1706,0,770,10.7,2.4,0.2,57.3,0,25.9,89.3,818,563,255,68.83,31.17,111,452,62,193,173,645,19.7,24.3,21.1,"75% or more P.O.C.","$70000 - $95000"
"06037408724","Census Tract 4087.24, Los Angeles County, California",5542,41486,139,77,0,2132,0,3123,2.5,1.4,0,38.5,0,56.4,97.5,1552,30,1522,1.93,98.07,0,30,291,1231,291,1261,0,19.1,18.8,"75% or more P.O.C.","Less than $51000"
"06037408800","Census Tract 4088, Los Angeles County, California",4387,46635,630,285,0,302,0,2995,14.4,6.5,0,6.9,0,68.3,85.6,1461,290,1171,19.85,80.15,95,195,109,1062,204,1257,32.8,9.3,14,"75% or more P.O.C.","Less than $51000"
"06037430002","Census Tract 4300.02, Los Angeles County, California",6522,73218,1744,472,0,1400,0,2865,26.7,7.2,0,21.5,0,43.9,73.3,2409,1475,934,61.23,38.77,155,1320,93,841,248,2161,10.5,10,10.3,"50% - 75% P.O.C.","$70000 - $95000"
"06037430003","Census Tract 4300.03, Los Angeles County, California",4971,117543,1804,168,13,1028,0,1650,36.3,3.4,0.3,20.7,0,33.2,63.7,1607,1519,88,94.52,5.48,208,1311,26,62,234,1373,13.7,29.5,14.6,"50% - 75% P.O.C.","$95000 or more"
"06037430101","Census Tract 4301.01, Los Angeles County, California",5382,47031,1339,321,18,846,11,2718,24.9,6,0.3,15.7,0.2,50.5,75.1,1907,724,1183,37.97,62.03,128,596,154,1029,282,1625,17.7,13,14.8,"75% or more P.O.C.","Less than $51000"
"06037430102","Census Tract 4301.02, Los Angeles County, California",4684,67425,438,216,80,417,0,3522,9.4,4.6,1.7,8.9,0,75.2,90.6,1209,780,429,64.52,35.48,226,554,60,369,286,923,29,14,23.7,"75% or more P.O.C.","$51000 - $70000"
"06037430200","Census Tract 4302, Los Angeles County, California",1026,95417,569,8,0,312,0,124,55.5,0.8,0,30.4,0,12.1,44.5,393,228,165,58.02,41.98,28,200,3,162,31,362,12.3,1.8,7.9,"25% - 50% P.O.C.","$95000 or more"
"06037430301","Census Tract 4303.01, Los Angeles County, California",4319,128854,2719,178,0,518,0,769,63,4.1,0,12,0,17.8,37,1511,1276,235,84.45,15.55,102,1174,14,221,116,1395,8,6,7.7,"25% - 50% P.O.C.","$95000 or more"
"06037430302","Census Tract 4303.02, Los Angeles County, California",5339,80586,2851,84,0,440,49,1533,53.4,1.6,0,8.2,0.9,28.7,46.6,2183,1431,752,65.55,34.45,91,1340,0,752,91,2092,6.4,0,4.2,"25% - 50% P.O.C.","$70000 - $95000"
"06037430400","Census Tract 4304, Los Angeles County, California",4642,128298,1191,143,0,2897,0,315,25.7,3.1,0,62.4,0,6.8,74.3,1464,1147,317,78.35,21.65,142,1005,21,296,163,1301,12.4,6.6,11.1,"50% - 75% P.O.C.","$95000 or more"
"06037430501","Census Tract 4305.01, Los Angeles County, California",4030,120469,2751,47,8,742,0,241,68.3,1.2,0.2,18.4,0,6,31.7,1666,1348,318,80.91,19.09,37,1311,10,308,47,1619,2.7,3.1,2.8,"25% - 50% P.O.C.","$95000 or more"
"06037430502","Census Tract 4305.02, Los Angeles County, California",6902,81866,4499,36,0,851,0,1331,65.2,0.5,0,12.3,0,19.3,34.8,2998,1530,1468,51.03,48.97,129,1401,16,1452,145,2853,8.4,1.1,4.8,"25% - 50% P.O.C.","$70000 - $95000"
"06037430600","Census Tract 4306, Los Angeles County, California",4553,148750,1453,79,0,2517,0,222,31.9,1.7,0,55.3,0,4.9,68.1,1433,1229,204,85.76,14.24,166,1063,26,178,192,1241,13.5,12.7,13.4,"50% - 75% P.O.C.","$95000 or more"
"06037430701","Census Tract 4307.01, Los Angeles County, California",5846,92500,1639,84,0,3070,0,907,28,1.4,0,52.5,0,15.5,72,1912,1203,709,62.92,37.08,117,1086,119,590,236,1676,9.7,16.8,12.3,"50% - 75% P.O.C.","$70000 - $95000"
"06037430721","Census Tract 4307.21, Los Angeles County, California",3963,93114,1126,109,0,2014,0,598,28.4,2.8,0,50.8,0,15.1,71.6,1322,628,694,47.5,52.5,86,542,34,660,120,1202,13.7,4.9,9.1,"50% - 75% P.O.C.","$70000 - $95000"
"06037430723","Census Tract 4307.23, Los Angeles County, California",4365,75891,1152,147,0,2441,0,478,26.4,3.4,0,55.9,0,11,73.6,1629,579,1050,35.54,64.46,27,552,76,974,103,1526,4.7,7.2,6.3,"50% - 75% P.O.C.","$70000 - $95000"
"06037430724","Census Tract 4307.24, Los Angeles County, California",4723,69215,820,75,0,2986,0,761,17.4,1.6,0,63.2,0,16.1,82.6,1895,428,1467,22.59,77.41,31,397,100,1367,131,1764,7.2,6.8,6.9,"75% or more P.O.C.","$51000 - $70000"
"06037430801","Census Tract 4308.01, Los Angeles County, California",6978,90408,1170,106,0,4824,34,489,16.8,1.5,0,69.1,0.5,7,83.2,2350,1052,1298,44.77,55.23,108,944,106,1192,214,2136,10.3,8.2,9.1,"75% or more P.O.C.","$70000 - $95000"
"06037430802","Census Tract 4308.02, Los Angeles County, California",4586,102500,600,15,31,3413,0,465,13.1,0.3,0.7,74.4,0,10.1,86.9,1352,1019,333,75.37,24.63,181,838,150,183,331,1021,17.8,45,24.5,"75% or more P.O.C.","$95000 or more"
"06037430803","Census Tract 4308.03, Los Angeles County, California",5397,94315,1310,0,14,3234,0,727,24.3,0,0.3,59.9,0,13.5,75.7,1819,1382,437,75.98,24.02,129,1253,54,383,183,1636,9.3,12.4,10.1,"75% or more P.O.C.","$70000 - $95000"
"06037430901","Census Tract 4309.01, Los Angeles County, California",4517,64583,967,390,0,851,0,2201,21.4,8.6,0,18.8,0,48.7,78.6,1569,511,1058,32.57,67.43,95,416,93,965,188,1381,18.6,8.8,12,"75% or more P.O.C.","$51000 - $70000"
"06037430902","Census Tract 4309.02, Los Angeles County, California",4539,83853,1090,195,0,1327,73,1762,24,4.3,0,29.2,1.6,38.8,76,1536,513,1023,33.4,66.6,31,482,90,933,121,1415,6,8.8,7.9,"75% or more P.O.C.","$70000 - $95000"
"06037431001","Census Tract 4310.01, Los Angeles County, California",7669,71066,2283,346,0,722,0,4064,29.8,4.5,0,9.4,0,53,70.2,2649,869,1780,32.8,67.2,95,774,314,1466,409,2240,10.9,17.6,15.4,"50% - 75% P.O.C.","$70000 - $95000"
"06037431002","Census Tract 4310.02, Los Angeles County, California",3165,52813,1462,124,0,356,245,855,46.2,3.9,0,11.2,7.7,27,53.8,1240,640,600,51.61,48.39,31,609,70,530,101,1139,4.8,11.7,8.1,"50% - 75% P.O.C.","$51000 - $70000"
"06037431100","Census Tract 4311, Los Angeles County, California",6758,78427,1091,608,0,990,59,3935,16.1,9,0,14.6,0.9,58.2,83.9,2076,747,1329,35.98,64.02,105,642,225,1104,330,1746,14.1,16.9,15.9,"75% or more P.O.C.","$70000 - $95000"
"06037431200","Census Tract 4312, Los Angeles County, California",6399,63750,637,598,0,682,7,4369,10,9.3,0,10.7,0.1,68.3,90,1490,973,517,65.3,34.7,283,690,218,299,501,989,29.1,42.2,33.6,"75% or more P.O.C.","$51000 - $70000"
"06037431300","Census Tract 4313, Los Angeles County, California",2689,92125,898,22,5,523,126,1002,33.4,0.8,0.2,19.4,4.7,37.3,66.6,850,641,209,75.41,24.59,47,594,34,175,81,769,7.3,16.3,9.5,"50% - 75% P.O.C.","$70000 - $95000"
"06037431400","Census Tract 4314, Los Angeles County, California",4202,86538,806,31,16,1900,64,1266,19.2,0.7,0.4,45.2,1.5,30.1,80.8,1312,942,370,71.8,28.2,125,817,98,272,223,1089,13.3,26.5,17,"75% or more P.O.C.","$70000 - $95000"
"06037431501","Census Tract 4315.01, Los Angeles County, California",4480,64244,762,144,10,2003,3,1505,17,3.2,0.2,44.7,0.1,33.6,83,1666,981,685,58.88,41.12,39,942,82,603,121,1545,4,12,7.3,"75% or more P.O.C.","$51000 - $70000"
"06037431502","Census Tract 4315.02, Los Angeles County, California",4273,62531,1060,42,4,1945,0,1096,24.8,1,0.1,45.5,0,25.6,75.2,1407,837,570,59.49,40.51,115,722,119,451,234,1173,13.7,20.9,16.6,"75% or more P.O.C.","$51000 - $70000"
"06037431600","Census Tract 4316, Los Angeles County, California",4190,107386,850,49,22,2774,0,350,20.3,1.2,0.5,66.2,0,8.4,79.7,1299,1003,296,77.21,22.79,159,844,46,250,205,1094,15.9,15.5,15.8,"75% or more P.O.C.","$95000 or more"
"06037431700","Census Tract 4317, Los Angeles County, California",6000,108106,916,85,0,4416,0,487,15.3,1.4,0,73.6,0,8.1,84.7,2046,1540,506,75.27,24.73,223,1317,36,470,259,1787,14.5,7.1,12.7,"75% or more P.O.C.","$95000 or more"
"06037431800","Census Tract 4318, Los Angeles County, California",5655,73548,1225,111,0,3361,29,778,21.7,2,0,59.4,0.5,13.8,78.3,1853,1009,844,54.45,45.55,103,906,36,808,139,1714,10.2,4.3,7.5,"75% or more P.O.C.","$70000 - $95000"
"06037431900","Census Tract 4319, Los Angeles County, California",4400,61146,795,118,0,2524,40,852,18.1,2.7,0,57.4,0.9,19.4,81.9,1458,604,854,41.43,58.57,82,522,53,801,135,1323,13.6,6.2,9.3,"75% or more P.O.C.","$51000 - $70000"
"06037432000","Census Tract 4320, Los Angeles County, California",7601,78083,1221,30,27,4672,100,1471,16.1,0.4,0.4,61.5,1.3,19.4,83.9,2405,1366,1039,56.8,43.2,187,1179,137,902,324,2081,13.7,13.2,13.5,"75% or more P.O.C.","$70000 - $95000"
"06037432101","Census Tract 4321.01, Los Angeles County, California",4103,91607,760,1,41,2608,0,601,18.5,0,1,63.6,0,14.6,81.5,1359,1023,336,75.28,24.72,112,911,33,303,145,1214,10.9,9.8,10.7,"75% or more P.O.C.","$70000 - $95000"
"06037432102","Census Tract 4321.02, Los Angeles County, California",5951,92782,839,40,21,3711,39,1182,14.1,0.7,0.4,62.4,0.7,19.9,85.9,1713,1309,404,76.42,23.58,172,1137,135,269,307,1406,13.1,33.4,17.9,"75% or more P.O.C.","$70000 - $95000"
"06037432201","Census Tract 4322.01, Los Angeles County, California",4491,69662,475,10,0,3333,5,591,10.6,0.2,0,74.2,0.1,13.2,89.4,1228,708,520,57.65,42.35,199,509,50,470,249,979,28.1,9.6,20.3,"75% or more P.O.C.","$51000 - $70000"
"06037432202","Census Tract 4322.02, Los Angeles County, California",4471,66154,306,21,10,2601,0,1508,6.8,0.5,0.2,58.2,0,33.7,93.2,1164,680,484,58.42,41.58,207,473,205,279,412,752,30.4,42.4,35.4,"75% or more P.O.C.","$51000 - $70000"
"06037432300","Census Tract 4323, Los Angeles County, California",4350,54155,334,0,21,1672,290,2024,7.7,0,0.5,38.4,6.7,46.5,92.3,1160,639,521,55.09,44.91,156,483,129,392,285,875,24.4,24.8,24.6,"75% or more P.O.C.","$51000 - $70000"
"06037432401","Census Tract 4324.01, Los Angeles County, California",3705,52500,193,6,0,1479,4,2019,5.2,0.2,0,39.9,0.1,54.5,94.8,1008,413,595,40.97,59.03,78,335,151,444,229,779,18.9,25.4,22.7,"75% or more P.O.C.","$51000 - $70000"
"06037432402","Census Tract 4324.02, Los Angeles County, California",6938,57889,583,82,0,2576,7,3671,8.4,1.2,0,37.1,0.1,52.9,91.6,1647,715,932,43.41,56.59,279,436,158,774,437,1210,39,17,26.5,"75% or more P.O.C.","$51000 - $70000"
"06037432500","Census Tract 4325, Los Angeles County, California",8180,51353,565,14,0,2614,29,4887,6.9,0.2,0,32,0.4,59.7,93.1,2451,1363,1088,55.61,44.39,227,1136,161,927,388,2063,16.7,14.8,15.8,"75% or more P.O.C.","$51000 - $70000"
"06037432601","Census Tract 4326.01, Los Angeles County, California",7210,67760,273,100,0,2773,0,3979,3.8,1.4,0,38.5,0,55.2,96.2,1737,892,845,51.35,48.65,255,637,268,577,523,1214,28.6,31.7,30.1,"75% or more P.O.C.","$51000 - $70000"
"06037432602","Census Tract 4326.02, Los Angeles County, California",4852,65321,78,0,0,2050,10,2642,1.6,0,0,42.3,0.2,54.5,98.4,1138,692,446,60.81,39.19,180,512,160,286,340,798,26,35.9,29.9,"75% or more P.O.C.","$51000 - $70000"
"06037432700","Census Tract 4327, Los Angeles County, California",5779,52882,113,0,0,957,0,4709,2,0,0,16.6,0,81.5,98,1397,661,736,47.32,52.68,107,554,254,482,361,1036,16.2,34.5,25.8,"75% or more P.O.C.","$51000 - $70000"
"06037432801","Census Tract 4328.01, Los Angeles County, California",2797,23466,78,5,0,1330,0,1384,2.8,0.2,0,47.6,0,49.5,97.2,937,222,715,23.69,76.31,57,165,81,634,138,799,25.7,11.3,14.7,"75% or more P.O.C.","Less than $51000"
"06037432802","Census Tract 4328.02, Los Angeles County, California",5077,39474,88,0,0,1234,29,3682,1.7,0,0,24.3,0.6,72.5,98.3,1396,210,1186,15.04,84.96,22,188,302,884,324,1072,10.5,25.5,23.2,"75% or more P.O.C.","Less than $51000"
"06037432901","Census Tract 4329.01, Los Angeles County, California",3727,59417,134,45,15,2472,0,1003,3.6,1.2,0.4,66.3,0,26.9,96.4,1159,630,529,54.36,45.64,111,519,115,414,226,933,17.6,21.7,19.5,"75% or more P.O.C.","$51000 - $70000"
"06037432902","Census Tract 4329.02, Los Angeles County, California",3312,72455,272,7,19,1904,0,979,8.2,0.2,0.6,57.5,0,29.6,91.8,861,617,244,71.66,28.34,141,476,44,200,185,676,22.9,18,21.5,"75% or more P.O.C.","$70000 - $95000"
"06037433101","Census Tract 4331.01, Los Angeles County, California",2464,45000,60,4,4,1193,0,1190,2.4,0.2,0.2,48.4,0,48.3,97.6,668,412,256,61.68,38.32,127,285,13,243,140,528,30.8,5.1,21,"75% or more P.O.C.","Less than $51000"
"06037433102","Census Tract 4331.02, Los Angeles County, California",5348,46800,38,0,0,2218,60,3032,0.7,0,0,41.5,1.1,56.7,99.3,1292,474,818,36.69,63.31,182,292,221,597,403,889,38.4,27,31.2,"75% or more P.O.C.","Less than $51000"
"06037433200","Census Tract 4332, Los Angeles County, California",6246,50570,413,46,0,1742,107,3878,6.6,0.7,0,27.9,1.7,62.1,93.4,1699,712,987,41.91,58.09,166,546,223,764,389,1310,23.3,22.6,22.9,"75% or more P.O.C.","Less than $51000"
"06037433302","Census Tract 4333.02, Los Angeles County, California",1530,34500,31,59,0,229,0,1205,2,3.9,0,15,0,78.8,98,418,112,306,26.79,73.21,30,82,85,221,115,303,26.8,27.8,27.5,"75% or more P.O.C.","Less than $51000"
"06037433304","Census Tract 4333.04, Los Angeles County, California",5063,36250,187,53,0,1298,0,3498,3.7,1,0,25.6,0,69.1,96.3,1315,195,1120,14.83,85.17,51,144,316,804,367,948,26.2,28.2,27.9,"75% or more P.O.C.","Less than $51000"
"06037433305","Census Tract 4333.05, Los Angeles County, California",4582,44390,56,18,0,1521,29,2947,1.2,0.4,0,33.2,0.6,64.3,98.8,1280,271,1009,21.17,78.83,46,225,289,720,335,945,17,28.6,26.2,"75% or more P.O.C.","Less than $51000"
"06037433306","Census Tract 4333.06, Los Angeles County, California",3136,57803,98,4,0,833,61,2140,3.1,0.1,0,26.6,1.9,68.2,96.9,794,280,514,35.26,64.74,74,206,161,353,235,559,26.4,31.3,29.6,"75% or more P.O.C.","$51000 - $70000"
"06037433307","Census Tract 4333.07, Los Angeles County, California",3193,60673,36,6,129,1002,0,1996,1.1,0.2,4,31.4,0,62.5,98.9,880,375,505,42.61,57.39,43,332,111,394,154,726,11.5,22,17.5,"75% or more P.O.C.","$51000 - $70000"
"06037433401","Census Tract 4334.01, Los Angeles County, California",3405,49115,77,12,0,905,21,2377,2.3,0.4,0,26.6,0.6,69.8,97.7,775,325,450,41.94,58.06,110,215,172,278,282,493,33.8,38.2,36.4,"75% or more P.O.C.","Less than $51000"
"06037433402","Census Tract 4334.02, Los Angeles County, California",4713,48547,162,12,37,743,36,3595,3.4,0.3,0.8,15.8,0.8,76.3,96.6,1197,445,752,37.18,62.82,80,365,274,478,354,843,18,36.4,29.6,"75% or more P.O.C.","Less than $51000"
"06037433403","Census Tract 4334.03, Los Angeles County, California",4882,45967,28,0,0,914,26,3914,0.6,0,0,18.7,0.5,80.2,99.4,1367,288,1079,21.07,78.93,68,220,289,790,357,1010,23.6,26.8,26.1,"75% or more P.O.C.","Less than $51000"
"06037433501","Census Tract 4335.01, Los Angeles County, California",1949,36703,14,0,0,105,0,1830,0.7,0,0,5.4,0,93.9,99.3,572,190,382,33.22,66.78,31,159,82,300,113,459,16.3,21.5,19.8,"75% or more P.O.C.","Less than $51000"
"06037433503","Census Tract 4335.03, Los Angeles County, California",3269,60080,44,0,0,751,0,2474,1.3,0,0,23,0,75.7,98.7,723,263,460,36.38,63.62,92,171,175,285,267,456,35,38,36.9,"75% or more P.O.C.","$51000 - $70000"
"06037433504","Census Tract 4335.04, Los Angeles County, California",4802,36811,41,15,0,1095,162,3465,0.9,0.3,0,22.8,3.4,72.2,99.1,1025,234,791,22.83,77.17,59,175,336,455,395,630,25.2,42.5,38.5,"75% or more P.O.C.","Less than $51000"
"06037433601","Census Tract 4336.01, Los Angeles County, California",5066,66174,122,0,0,3312,0,1632,2.4,0,0,65.4,0,32.2,97.6,1287,661,626,51.36,48.64,118,543,183,443,301,986,17.9,29.2,23.4,"75% or more P.O.C.","$51000 - $70000"
"06037433602","Census Tract 4336.02, Los Angeles County, California",2896,52464,93,0,0,1852,0,945,3.2,0,0,64,0,32.6,96.8,801,374,427,46.69,53.31,117,257,142,285,259,542,31.3,33.3,32.3,"75% or more P.O.C.","$51000 - $70000"
"06037433700","Census Tract 4337, Los Angeles County, California",3684,60724,60,0,10,466,0,3131,1.6,0,0.3,12.6,0,85,98.4,889,563,326,63.33,36.67,149,414,100,226,249,640,26.5,30.7,28,"75% or more P.O.C.","$51000 - $70000"
"06037433801","Census Tract 4338.01, Los Angeles County, California",5944,49720,105,11,0,490,0,5338,1.8,0.2,0,8.2,0,89.8,98.2,1415,497,918,35.12,64.88,86,411,301,617,387,1028,17.3,32.8,27.3,"75% or more P.O.C.","Less than $51000"
"06037433802","Census Tract 4338.02, Los Angeles County, California",3362,71645,289,42,10,624,0,2397,8.6,1.2,0.3,18.6,0,71.3,91.4,941,758,183,80.55,19.45,168,590,42,141,210,731,22.2,23,22.3,"75% or more P.O.C.","$70000 - $95000"
"06037433901","Census Tract 4339.01, Los Angeles County, California",6032,41779,53,43,6,1209,8,4707,0.9,0.7,0.1,20,0.1,78,99.1,1372,351,1021,25.58,74.42,82,269,364,657,446,926,23.4,35.7,32.5,"75% or more P.O.C.","Less than $51000"
"06037433902","Census Tract 4339.02, Los Angeles County, California",3284,53205,95,0,20,433,0,2736,2.9,0,0.6,13.2,0,83.3,97.1,840,490,350,58.33,41.67,114,376,67,283,181,659,23.3,19.1,21.5,"75% or more P.O.C.","$51000 - $70000"
"06037434001","Census Tract 4340.01, Los Angeles County, California",4410,52436,137,6,17,717,0,3533,3.1,0.1,0.4,16.3,0,80.1,96.9,986,684,302,69.37,30.63,248,436,122,180,370,616,36.3,40.4,37.5,"75% or more P.O.C.","$51000 - $70000"
"06037434003","Census Tract 4340.03, Los Angeles County, California",4717,53125,143,5,0,666,0,3866,3,0.1,0,14.1,0,82,97,1032,400,632,38.76,61.24,147,253,208,424,355,677,36.8,32.9,34.4,"75% or more P.O.C.","$51000 - $70000"
"06037434004","Census Tract 4340.04, Los Angeles County, California",3039,64443,40,5,0,189,0,2805,1.3,0.2,0,6.2,0,92.3,98.7,713,355,358,49.79,50.21,119,236,115,243,234,479,33.5,32.1,32.8,"75% or more P.O.C.","$51000 - $70000"
"06037460000","Census Tract 4600, Los Angeles County, California",4421,129393,2486,46,0,1035,0,713,56.2,1,0,23.4,0,16.1,43.8,1657,1435,222,86.6,13.4,109,1326,8,214,117,1540,7.6,3.6,7.1,"25% - 50% P.O.C.","$95000 or more"
"06037460100","Census Tract 4601, Los Angeles County, California",6196,131477,3479,720,20,543,0,903,56.1,11.6,0.3,8.8,0,14.6,43.9,2368,2097,271,88.56,11.44,125,1972,0,271,125,2243,6,0,5.3,"25% - 50% P.O.C.","$95000 or more"
"06037460200","Census Tract 4602, Los Angeles County, California",5861,101875,2017,1923,0,475,54,1123,34.4,32.8,0,8.1,0.9,19.2,65.6,2016,1578,438,78.27,21.73,156,1422,141,297,297,1719,9.9,32.2,14.7,"50% - 75% P.O.C.","$95000 or more"
"06037460301","Census Tract 4603.01, Los Angeles County, California",4845,110714,1840,1739,22,295,0,787,38,35.9,0.5,6.1,0,16.2,62,1606,1370,236,85.31,14.69,176,1194,17,219,193,1413,12.8,7.2,12,"50% - 75% P.O.C.","$95000 or more"
"06037460302","Census Tract 4603.02, Los Angeles County, California",4221,68306,812,1166,0,140,0,2013,19.2,27.6,0,3.3,0,47.7,80.8,1381,1000,381,72.41,27.59,120,880,109,272,229,1152,12,28.6,16.6,"75% or more P.O.C.","$51000 - $70000"
"06037460401","Census Tract 4604.01, Los Angeles County, California",985,100417,180,283,0,45,10,399,18.3,28.7,0,4.6,1,40.5,81.7,317,218,99,68.77,31.23,8,210,40,59,48,269,3.7,40.4,15.1,"75% or more P.O.C.","$95000 or more"
"06037460501","Census Tract 4605.01, Los Angeles County, California",5614,189107,2907,0,0,2060,0,393,51.8,0,0,36.7,0,7,48.2,1754,1657,97,94.47,5.53,179,1478,22,75,201,1553,10.8,22.7,11.5,"25% - 50% P.O.C.","$95000 or more"
"06037460502","Census Tract 4605.02, Los Angeles County, California",4277,163438,2005,13,0,1572,0,533,46.9,0.3,0,36.8,0,12.5,53.1,1338,1245,93,93.05,6.95,123,1122,11,82,134,1204,9.9,11.8,10,"50% - 75% P.O.C.","$95000 or more"
"06037460600","Census Tract 4606, Los Angeles County, California",4416,170648,2914,0,0,988,0,310,66,0,0,22.4,0,7,34,1416,1317,99,93.01,6.99,164,1153,0,99,164,1252,12.5,0,11.6,"25% - 50% P.O.C.","$95000 or more"
"06037460700","Census Tract 4607, Los Angeles County, California",5139,210208,2839,141,0,1328,0,615,55.2,2.7,0,25.8,0,12,44.8,1559,1469,90,94.23,5.77,269,1200,33,57,302,1257,18.3,36.7,19.4,"25% - 50% P.O.C.","$95000 or more"
"06037460800","Census Tract 4608, Los Angeles County, California",3103,212639,2058,210,16,447,0,339,66.3,6.8,0.5,14.4,0,10.9,33.7,1195,1144,51,95.73,4.27,124,1020,0,51,124,1071,10.8,0,10.4,"25% - 50% P.O.C.","$95000 or more"
"06037460900","Census Tract 4609, Los Angeles County, California",6731,79101,907,1011,0,676,0,3974,13.5,15,0,10,0,59,86.5,2002,1155,847,57.69,42.31,232,923,217,630,449,1553,20.1,25.6,22.4,"75% or more P.O.C.","$70000 - $95000"
"06037461000","Census Tract 4610, Los Angeles County, California",6249,77569,561,2189,18,233,0,3106,9,35,0.3,3.7,0,49.7,91,1664,1145,519,68.81,31.19,276,869,123,396,399,1265,24.1,23.7,24,"75% or more P.O.C.","$70000 - $95000"
"06037461100","Census Tract 4611, Los Angeles County, California",5419,90444,1527,1170,0,161,0,2387,28.2,21.6,0,3,0,44,71.8,1837,973,864,52.97,47.03,106,867,127,737,233,1604,10.9,14.7,12.7,"50% - 75% P.O.C.","$70000 - $95000"
"06037461200","Census Tract 4612, Los Angeles County, California",4535,129974,2849,510,8,228,0,776,62.8,11.2,0.2,5,0,17.1,37.2,1663,1410,253,84.79,15.21,124,1286,57,196,181,1482,8.8,22.5,10.9,"25% - 50% P.O.C.","$95000 or more"
"06037461300","Census Tract 4613, Los Angeles County, California",6840,82847,4178,251,40,783,5,1205,61.1,3.7,0.6,11.4,0.1,17.6,38.9,2464,1396,1068,56.66,43.34,39,1357,96,972,135,2329,2.8,9,5.5,"25% - 50% P.O.C.","$70000 - $95000"
"06037461400","Census Tract 4614, Los Angeles County, California",3119,60435,1478,159,0,250,0,965,47.4,5.1,0,8,0,30.9,52.6,1280,503,777,39.3,60.7,59,444,41,736,100,1180,11.7,5.3,7.8,"50% - 75% P.O.C.","$51000 - $70000"
"06037461501","Census Tract 4615.01, Los Angeles County, California",3971,83387,937,626,0,404,0,1920,23.6,15.8,0,10.2,0,48.4,76.4,1288,638,650,49.53,50.47,117,521,46,604,163,1125,18.3,7.1,12.7,"75% or more P.O.C.","$70000 - $95000"
"06037461502","Census Tract 4615.02, Los Angeles County, California",6423,62769,1372,962,0,492,10,3440,21.4,15,0,7.7,0.2,53.6,78.6,1675,604,1071,36.06,63.94,149,455,162,909,311,1364,24.7,15.1,18.6,"75% or more P.O.C.","$51000 - $70000"
"06037461600","Census Tract 4616, Los Angeles County, California",6058,71250,786,839,38,702,0,3438,13,13.8,0.6,11.6,0,56.8,87,1786,704,1082,39.42,60.58,99,605,266,816,365,1421,14.1,24.6,20.4,"75% or more P.O.C.","$70000 - $95000"
"06037461700","Census Tract 4617, Los Angeles County, California",1526,123854,937,156,0,150,0,246,61.4,10.2,0,9.8,0,16.1,38.6,659,545,114,82.7,17.3,36,509,22,92,58,601,6.6,19.3,8.8,"25% - 50% P.O.C.","$95000 or more"
"06037461901","Census Tract 4619.01, Los Angeles County, California",5051,52000,902,677,5,419,0,2893,17.9,13.4,0.1,8.3,0,57.3,82.1,1670,234,1436,14.01,85.99,58,176,217,1219,275,1395,24.8,15.1,16.5,"75% or more P.O.C.","$51000 - $70000"
"06037461902","Census Tract 4619.02, Los Angeles County, California",1801,31164,685,232,0,541,0,223,38,12.9,0,30,0,12.4,62,1191,102,1089,8.56,91.44,0,102,18,1071,18,1173,0,1.7,1.5,"50% - 75% P.O.C.","Less than $51000"
"06037462001","Census Tract 4620.01, Los Angeles County, California",4460,61964,406,387,0,183,133,3306,9.1,8.7,0,4.1,3,74.1,90.9,1154,276,878,23.92,76.08,23,253,220,658,243,911,8.3,25.1,21.1,"75% or more P.O.C.","$51000 - $70000"
"06037462002","Census Tract 4620.02, Los Angeles County, California",4043,30982,410,574,28,67,0,2890,10.1,14.2,0.7,1.7,0,71.5,89.9,1162,243,919,20.91,79.09,77,166,152,767,229,933,31.7,16.5,19.7,"75% or more P.O.C.","Less than $51000"
"06037462100","Census Tract 4621, Los Angeles County, California",5748,61417,1173,462,0,452,0,3507,20.4,8,0,7.9,0,61,79.6,1862,661,1201,35.5,64.5,81,580,147,1054,228,1634,12.3,12.2,12.2,"75% or more P.O.C.","$51000 - $70000"
"06037462201","Census Tract 4622.01, Los Angeles County, California",3941,40038,1469,361,0,643,0,1331,37.3,9.2,0,16.3,0,33.8,62.7,1935,114,1821,5.89,94.11,15,99,87,1734,102,1833,13.2,4.8,5.3,"50% - 75% P.O.C.","Less than $51000"
"06037462202","Census Tract 4622.02, Los Angeles County, California",2775,64388,1166,222,0,849,0,429,42,8,0,30.6,0,15.5,58,1351,204,1147,15.1,84.9,0,204,30,1117,30,1321,0,2.6,2.2,"50% - 75% P.O.C.","$51000 - $70000"
"06037462301","Census Tract 4623.01, Los Angeles County, California",5265,57898,1063,456,9,382,0,3242,20.2,8.7,0.2,7.3,0,61.6,79.8,1909,325,1584,17.02,82.98,13,312,232,1352,245,1664,4,14.6,12.8,"75% or more P.O.C.","$51000 - $70000"
"06037462302","Census Tract 4623.02, Los Angeles County, California",3213,68102,1043,164,0,861,0,1026,32.5,5.1,0,26.8,0,31.9,67.5,1525,300,1225,19.67,80.33,6,294,27,1198,33,1492,2,2.2,2.2,"50% - 75% P.O.C.","$51000 - $70000"
"06037462400","Census Tract 4624, Los Angeles County, California",3944,91116,2082,92,33,332,38,1170,52.8,2.3,0.8,8.4,1,29.7,47.2,1605,888,717,55.33,44.67,29,859,49,668,78,1527,3.3,6.8,4.9,"25% - 50% P.O.C.","$70000 - $95000"
"06037462500","Census Tract 4625, Los Angeles County, California",6146,92743,3265,253,0,1118,0,1235,53.1,4.1,0,18.2,0,20.1,46.9,2333,1289,1044,55.25,44.75,74,1215,57,987,131,2202,5.7,5.5,5.6,"25% - 50% P.O.C.","$70000 - $95000"
"06037462600","Census Tract 4626, Los Angeles County, California",2152,148393,1110,158,0,297,0,534,51.6,7.3,0,13.8,0,24.8,48.4,845,697,148,82.49,17.51,42,655,0,148,42,803,6,0,5,"25% - 50% P.O.C.","$95000 or more"
"06037462700","Census Tract 4627, Los Angeles County, California",5413,80294,1575,263,0,1108,0,2240,29.1,4.9,0,20.5,0,41.4,70.9,2118,748,1370,35.32,64.68,39,709,143,1227,182,1936,5.2,10.4,8.6,"50% - 75% P.O.C.","$70000 - $95000"
"06037462800","Census Tract 4628, Los Angeles County, California",2827,81424,1084,246,0,422,15,930,38.3,8.7,0,14.9,0.5,32.9,61.7,1069,472,597,44.15,55.85,68,404,31,566,99,970,14.4,5.2,9.3,"50% - 75% P.O.C.","$70000 - $95000"
"06037462900","Census Tract 4629, Los Angeles County, California",3797,138611,1743,113,0,528,0,1281,45.9,3,0,13.9,0,33.7,54.1,1362,1056,306,77.53,22.47,79,977,0,306,79,1283,7.5,0,5.8,"50% - 75% P.O.C.","$95000 or more"
"06037463000","Census Tract 4630, Los Angeles County, California",2665,116181,1151,144,0,793,0,408,43.2,5.4,0,29.8,0,15.3,56.8,1049,690,359,65.78,34.22,55,635,0,359,55,994,8,0,5.2,"50% - 75% P.O.C.","$95000 or more"
"06037463101","Census Tract 4631.01, Los Angeles County, California",2373,96618,672,106,0,753,0,746,28.3,4.5,0,31.7,0,31.4,71.7,830,510,320,61.45,38.55,11,499,43,277,54,776,2.2,13.4,6.5,"50% - 75% P.O.C.","$95000 or more"
"06037463102","Census Tract 4631.02, Los Angeles County, California",3878,84182,937,92,0,1274,12,1494,24.2,2.4,0,32.9,0.3,38.5,75.8,1132,822,310,72.61,27.39,92,730,24,286,116,1016,11.2,7.7,10.2,"75% or more P.O.C.","$70000 - $95000"
"06037463200","Census Tract 4632, Los Angeles County, California",3563,109583,1428,204,0,976,18,819,40.1,5.7,0,27.4,0.5,23,59.9,1429,821,608,57.45,42.55,40,781,0,608,40,1389,4.9,0,2.8,"50% - 75% P.O.C.","$95000 or more"
"06037463300","Census Tract 4633, Los Angeles County, California",1970,101964,915,93,0,520,0,404,46.4,4.7,0,26.4,0,20.5,53.6,919,501,418,54.52,45.48,18,483,12,406,30,889,3.6,2.9,3.3,"50% - 75% P.O.C.","$95000 or more"
"06037463400","Census Tract 4634, Los Angeles County, California",5787,93433,2276,379,16,1596,0,1252,39.3,6.5,0.3,27.6,0,21.6,60.7,2521,1089,1432,43.2,56.8,48,1041,24,1408,72,2449,4.4,1.7,2.9,"50% - 75% P.O.C.","$70000 - $95000"
"06037463500","Census Tract 4635, Los Angeles County, California",5982,95339,2966,321,20,1602,4,868,49.6,5.4,0.3,26.8,0.1,14.5,50.4,2568,782,1786,30.45,69.55,4,778,88,1698,92,2476,0.5,4.9,3.6,"50% - 75% P.O.C.","$95000 or more"
"06037463601","Census Tract 4636.01, Los Angeles County, California",5988,81782,2567,145,0,1841,17,1235,42.9,2.4,0,30.7,0.3,20.6,57.1,3213,821,2392,25.55,74.45,0,821,40,2352,40,3173,0,1.7,1.2,"50% - 75% P.O.C.","$70000 - $95000"
"06037463602","Census Tract 4636.02, Los Angeles County, California",6057,83065,2297,565,0,1937,0,1050,37.9,9.3,0,32,0,17.3,62.1,2887,419,2468,14.51,85.49,0,419,83,2385,83,2804,0,3.4,2.9,"50% - 75% P.O.C.","$70000 - $95000"
"06037463700","Census Tract 4637, Los Angeles County, California",3138,136389,1929,190,0,433,0,393,61.5,6.1,0,13.8,0,12.5,38.5,1608,620,988,38.56,61.44,0,620,22,966,22,1586,0,2.2,1.4,"25% - 50% P.O.C.","$95000 or more"
"06037463800","Census Tract 4638, Los Angeles County, California",4066,158438,2527,95,0,681,0,476,62.1,2.3,0,16.7,0,11.7,37.9,1599,1381,218,86.37,13.63,118,1263,9,209,127,1472,8.5,4.1,7.9,"25% - 50% P.O.C.","$95000 or more"
"06037463900","Census Tract 4639, Los Angeles County, California",3290,104260,1988,298,27,381,0,483,60.4,9.1,0.8,11.6,0,14.7,39.6,1529,832,697,54.41,45.59,27,805,5,692,32,1497,3.2,0.7,2.1,"25% - 50% P.O.C.","$95000 or more"
"06037464000","Census Tract 4640, Los Angeles County, California",5623,107438,2564,506,0,1364,0,890,45.6,9,0,24.3,0,15.8,54.4,2521,1554,967,61.64,38.36,56,1498,35,932,91,2430,3.6,3.6,3.6,"50% - 75% P.O.C.","$95000 or more"
"06037464100","Census Tract 4641, Los Angeles County, California",7121,168438,2189,56,0,4162,27,475,30.7,0.8,0,58.4,0.4,6.7,69.3,2392,2087,305,87.25,12.75,136,1951,61,244,197,2195,6.5,20,8.2,"50% - 75% P.O.C.","$95000 or more"
"06037464200","Census Tract 4642, Los Angeles County, California",6073,161979,1547,190,0,3817,0,350,25.5,3.1,0,62.9,0,5.8,74.5,2095,1778,317,84.87,15.13,139,1639,22,295,161,1934,7.8,6.9,7.7,"50% - 75% P.O.C.","$95000 or more"
"06037480002","Census Tract 4800.02, Los Angeles County, California",3623,109625,929,69,0,1823,0,733,25.6,1.9,0,50.3,0,20.2,74.4,1128,894,234,79.26,20.74,125,769,59,175,184,944,14,25.2,16.3,"50% - 75% P.O.C.","$95000 or more"
"06037480011","Census Tract 4800.11, Los Angeles County, California",5466,63446,813,28,0,2505,7,1977,14.9,0.5,0,45.8,0.1,36.2,85.1,1805,744,1061,41.22,58.78,110,634,203,858,313,1492,14.8,19.1,17.3,"75% or more P.O.C.","$51000 - $70000"
"06037480012","Census Tract 4800.12, Los Angeles County, California",4975,84234,902,51,0,3017,0,965,18.1,1,0,60.6,0,19.4,81.9,1649,963,686,58.4,41.6,103,860,13,673,116,1533,10.7,1.9,7,"75% or more P.O.C.","$70000 - $95000"
"06037480101","Census Tract 4801.01, Los Angeles County, California",3731,74896,443,3,15,2746,0,391,11.9,0.1,0.4,73.6,0,10.5,88.1,1217,708,509,58.18,41.82,84,624,6,503,90,1127,11.9,1.2,7.4,"75% or more P.O.C.","$70000 - $95000"
"06037480102","Census Tract 4801.02, Los Angeles County, California",4487,75216,707,90,0,2599,0,958,15.8,2,0,57.9,0,21.4,84.2,1453,874,579,60.15,39.85,94,780,56,523,150,1303,10.8,9.7,10.3,"75% or more P.O.C.","$70000 - $95000"
"06037480201","Census Tract 4802.01, Los Angeles County, California",3787,113393,1254,49,0,1468,0,909,33.1,1.3,0,38.8,0,24,66.9,1245,1093,152,87.79,12.21,95,998,0,152,95,1150,8.7,0,7.6,"50% - 75% P.O.C.","$95000 or more"
"06037480202","Census Tract 4802.02, Los Angeles County, California",2553,100875,547,21,16,1111,0,732,21.4,0.8,0.6,43.5,0,28.7,78.6,844,640,204,75.83,24.17,75,565,73,131,148,696,11.7,35.8,17.5,"75% or more P.O.C.","$95000 or more"
"06037480302","Census Tract 4803.02, Los Angeles County, California",4672,75326,742,41,99,1952,0,1661,15.9,0.9,2.1,41.8,0,35.6,84.1,1820,698,1122,38.35,61.65,55,643,87,1035,142,1678,7.9,7.8,7.8,"75% or more P.O.C.","$70000 - $95000"
"06037480303","Census Tract 4803.03, Los Angeles County, California",4103,51667,231,195,0,1809,13,1818,5.6,4.8,0,44.1,0.3,44.3,94.4,1428,354,1074,24.79,75.21,13,341,98,976,111,1317,3.7,9.1,7.8,"75% or more P.O.C.","$51000 - $70000"
"06037480304","Census Tract 4803.04, Los Angeles County, California",4506,50280,364,76,23,2445,0,1548,8.1,1.7,0.5,54.3,0,34.4,91.9,1895,233,1662,12.3,87.7,28,205,67,1595,95,1800,12,4,5,"75% or more P.O.C.","Less than $51000"
"06037480400","Census Tract 4804, Los Angeles County, California",5538,66389,782,167,25,2687,0,1589,14.1,3,0.5,48.5,0,28.7,85.9,2218,918,1300,41.39,58.61,60,858,83,1217,143,2075,6.5,6.4,6.4,"75% or more P.O.C.","$51000 - $70000"
"06037480500","Census Tract 4805, Los Angeles County, California",5108,120521,2623,3,0,1437,0,800,51.4,0.1,0,28.1,0,15.7,48.6,2033,1292,741,63.55,36.45,59,1233,42,699,101,1932,4.6,5.7,5,"25% - 50% P.O.C.","$95000 or more"
"06037480600","Census Tract 4806, Los Angeles County, California",8038,92837,3837,472,2,1737,0,1559,47.7,5.9,0,21.6,0,19.4,52.3,3237,1046,2191,32.31,67.69,62,984,65,2126,127,3110,5.9,3,3.9,"50% - 75% P.O.C.","$70000 - $95000"
"06037480702","Census Tract 4807.02, Los Angeles County, California",4284,153487,1432,214,0,1823,0,715,33.4,5,0,42.6,0,16.7,66.6,1563,1073,490,68.65,31.35,92,981,25,465,117,1446,8.6,5.1,7.5,"50% - 75% P.O.C.","$95000 or more"
"06037480703","Census Tract 4807.03, Los Angeles County, California",3612,122188,1397,62,0,1286,0,727,38.7,1.7,0,35.6,0,20.1,61.3,1208,648,560,53.64,46.36,46,602,56,504,102,1106,7.1,10,8.4,"50% - 75% P.O.C.","$95000 or more"
"06037480704","Census Tract 4807.04, Los Angeles County, California",4619,82159,1667,45,44,1498,0,944,36.1,1,1,32.4,0,20.4,63.9,1786,600,1186,33.59,66.41,87,513,34,1152,121,1665,14.5,2.9,6.8,"50% - 75% P.O.C.","$70000 - $95000"
"06037480802","Census Tract 4808.02, Los Angeles County, California",3162,68145,190,5,0,1173,3,1683,6,0.2,0,37.1,0.1,53.2,94,1016,688,328,67.72,32.28,66,622,11,317,77,939,9.6,3.4,7.6,"75% or more P.O.C.","$51000 - $70000"
"06037480803","Census Tract 4808.03, Los Angeles County, California",3699,76156,407,29,11,853,0,2221,11,0.8,0.3,23.1,0,60,89,1285,717,568,55.8,44.2,90,627,83,485,173,1112,12.6,14.6,13.5,"75% or more P.O.C.","$70000 - $95000"
"06037480804","Census Tract 4808.04, Los Angeles County, California",4892,66625,456,157,0,2243,0,1894,9.3,3.2,0,45.9,0,38.7,90.7,1709,411,1298,24.05,75.95,29,382,161,1137,190,1519,7.1,12.4,11.1,"75% or more P.O.C.","$51000 - $70000"
"06037480901","Census Tract 4809.01, Los Angeles County, California",5407,57802,354,197,0,2687,0,2118,6.5,3.6,0,49.7,0,39.2,93.5,1675,432,1243,25.79,74.21,54,378,126,1117,180,1495,12.5,10.1,10.7,"75% or more P.O.C.","$51000 - $70000"
"06037480902","Census Tract 4809.02, Los Angeles County, California",4109,50127,189,71,19,1954,0,1807,4.6,1.7,0.5,47.6,0,44,95.4,1294,230,1064,17.77,82.23,16,214,184,880,200,1094,7,17.3,15.5,"75% or more P.O.C.","Less than $51000"
"06037480903","Census Tract 4809.03, Los Angeles County, California",3248,67039,195,28,6,2092,0,855,6,0.9,0.2,64.4,0,26.3,94,1003,367,636,36.59,63.41,43,324,134,502,177,826,11.7,21.1,17.6,"75% or more P.O.C.","$51000 - $70000"
"06037481001","Census Tract 4810.01, Los Angeles County, California",4369,51591,531,18,0,2599,0,1186,12.2,0.4,0,59.5,0,27.1,87.8,1578,568,1010,35.99,64.01,70,498,45,965,115,1463,12.3,4.5,7.3,"75% or more P.O.C.","$51000 - $70000"
"06037481002","Census Tract 4810.02, Los Angeles County, California",5646,60275,552,14,0,2964,28,2033,9.8,0.2,0,52.5,0.5,36,90.2,2079,721,1358,34.68,65.32,0,721,98,1260,98,1981,0,7.2,4.7,"75% or more P.O.C.","$51000 - $70000"
"06037481101","Census Tract 4811.01, Los Angeles County, California",4513,62824,502,72,11,2080,14,1806,11.1,1.6,0.2,46.1,0.3,40,88.9,1468,305,1163,20.78,79.22,14,291,146,1017,160,1308,4.6,12.6,10.9,"75% or more P.O.C.","$51000 - $70000"
"06037481102","Census Tract 4811.02, Los Angeles County, California",4000,53024,482,48,0,2611,0,779,12,1.2,0,65.3,0,19.5,88,1447,186,1261,12.85,87.15,38,148,96,1165,134,1313,20.4,7.6,9.3,"75% or more P.O.C.","$51000 - $70000"
"06037481103","Census Tract 4811.03, Los Angeles County, California",4926,70618,300,8,0,2528,0,2079,6.1,0.2,0,51.3,0,42.2,93.9,1465,729,736,49.76,50.24,124,605,137,599,261,1204,17,18.6,17.8,"75% or more P.O.C.","$70000 - $95000"
"06037481201","Census Tract 4812.01, Los Angeles County, California",3910,75078,274,13,0,2463,0,1127,7,0.3,0,63,0,28.8,93,1204,501,703,41.61,58.39,28,473,151,552,179,1025,5.6,21.5,14.9,"75% or more P.O.C.","$70000 - $95000"
"06037481202","Census Tract 4812.02, Los Angeles County, California",6188,73182,511,7,0,3548,0,2023,8.3,0.1,0,57.3,0,32.7,91.7,1936,880,1056,45.45,54.55,124,756,162,894,286,1650,14.1,15.3,14.8,"75% or more P.O.C.","$70000 - $95000"
"06037481300","Census Tract 4813, Los Angeles County, California",3299,66500,126,1,8,2219,6,939,3.8,0,0.2,67.3,0.2,28.5,96.2,842,569,273,67.58,32.42,143,426,58,215,201,641,25.1,21.2,23.9,"75% or more P.O.C.","$51000 - $70000"
"06037481401","Census Tract 4814.01, Los Angeles County, California",6267,47207,344,3,12,4753,0,1073,5.5,0,0.2,75.8,0,17.1,94.5,1833,728,1105,39.72,60.28,127,601,89,1016,216,1617,17.4,8.1,11.8,"75% or more P.O.C.","Less than $51000"
"06037481402","Census Tract 4814.02, Los Angeles County, California",6598,60847,511,5,0,4626,50,1321,7.7,0.1,0,70.1,0.8,20,92.3,1936,1014,922,52.38,47.62,149,865,142,780,291,1645,14.7,15.4,15,"75% or more P.O.C.","$51000 - $70000"
"06037481500","Census Tract 4815, Los Angeles County, California",4489,69452,234,58,0,3400,0,738,5.2,1.3,0,75.7,0,16.4,94.8,1531,1074,457,70.15,29.85,173,901,20,437,193,1338,16.1,4.4,12.6,"75% or more P.O.C.","$51000 - $70000"
"06037481603","Census Tract 4816.03, Los Angeles County, California",3486,56159,141,168,31,2314,160,645,4,4.8,0.9,66.4,4.6,18.5,96,1216,547,669,44.98,55.02,55,492,30,639,85,1131,10.1,4.5,7,"75% or more P.O.C.","$51000 - $70000"
"06037481604","Census Tract 4816.04, Los Angeles County, California",3701,58137,359,37,0,2113,0,1178,9.7,1,0,57.1,0,31.8,90.3,1348,454,894,33.68,66.32,52,402,77,817,129,1219,11.5,8.6,9.6,"75% or more P.O.C.","$51000 - $70000"
"06037481605","Census Tract 4816.05, Los Angeles County, California",2831,55948,133,0,9,1771,7,894,4.7,0,0.3,62.6,0.2,31.6,95.3,1076,386,690,35.87,64.13,8,378,60,630,68,1008,2.1,8.7,6.3,"75% or more P.O.C.","$51000 - $70000"
"06037481606","Census Tract 4816.06, Los Angeles County, California",5013,54762,136,279,0,3395,0,1203,2.7,5.6,0,67.7,0,24,97.3,1596,415,1181,26,74,106,309,172,1009,278,1318,25.5,14.6,17.4,"75% or more P.O.C.","$51000 - $70000"
"06037481711","Census Tract 4817.11, Los Angeles County, California",4246,45554,122,15,0,3610,75,409,2.9,0.4,0,85,1.8,9.6,97.1,1383,333,1050,24.08,75.92,47,286,81,969,128,1255,14.1,7.7,9.3,"75% or more P.O.C.","Less than $51000"
"06037481712","Census Tract 4817.12, Los Angeles County, California",5329,49837,27,0,0,4180,83,1013,0.5,0,0,78.4,1.6,19,99.5,1683,597,1086,35.47,64.53,53,544,85,1001,138,1545,8.9,7.8,8.2,"75% or more P.O.C.","Less than $51000"
"06037481713","Census Tract 4817.13, Los Angeles County, California",2736,63563,54,0,0,2109,0,564,2,0,0,77.1,0,20.6,98,879,286,593,32.54,67.46,55,231,88,505,143,736,19.2,14.8,16.3,"75% or more P.O.C.","$51000 - $70000"
"06037481714","Census Tract 4817.14, Los Angeles County, California",2739,42604,102,11,0,2385,13,180,3.7,0.4,0,87.1,0.5,6.6,96.3,908,250,658,27.53,72.47,72,178,52,606,124,784,28.8,7.9,13.7,"75% or more P.O.C.","Less than $51000"
"06037481800","Census Tract 4818, Los Angeles County, California",2558,94531,371,6,0,1571,0,549,14.5,0.2,0,61.4,0,21.5,85.5,898,737,161,82.07,17.93,93,644,13,148,106,792,12.6,8.1,11.8,"75% or more P.O.C.","$70000 - $95000"
"06037481901","Census Tract 4819.01, Los Angeles County, California",5775,94943,815,47,5,1964,0,2916,14.1,0.8,0.1,34,0,50.5,85.9,1967,1377,590,70.01,29.99,148,1229,42,548,190,1777,10.7,7.1,9.7,"75% or more P.O.C.","$70000 - $95000"
"06037481902","Census Tract 4819.02, Los Angeles County, California",3443,56836,319,124,17,1094,0,1875,9.3,3.6,0.5,31.8,0,54.5,90.7,1139,571,568,50.13,49.87,57,514,75,493,132,1007,10,13.2,11.6,"75% or more P.O.C.","$51000 - $70000"
"06037482001","Census Tract 4820.01, Los Angeles County, California",2650,90179,109,0,0,2130,0,376,4.1,0,0,80.4,0,14.2,95.9,1029,806,223,78.33,21.67,99,707,0,223,99,930,12.3,0,9.6,"75% or more P.O.C.","$70000 - $95000"
"06037482002","Census Tract 4820.02, Los Angeles County, California",6760,66103,274,97,61,4127,12,2141,4.1,1.4,0.9,61.1,0.2,31.7,95.9,2500,1318,1182,52.72,47.28,101,1217,106,1076,207,2293,7.7,9,8.3,"75% or more P.O.C.","$51000 - $70000"
"06037482101","Census Tract 4821.01, Los Angeles County, California",4750,61667,255,14,0,3196,77,1175,5.4,0.3,0,67.3,1.6,24.7,94.6,1484,809,675,54.51,45.49,112,697,93,582,205,1279,13.8,13.8,13.8,"75% or more P.O.C.","$51000 - $70000"
"06037482102","Census Tract 4821.02, Los Angeles County, California",2943,87000,190,15,0,1713,0,920,6.5,0.5,0,58.2,0,31.3,93.5,914,735,179,80.42,19.58,90,645,34,145,124,790,12.2,19,13.6,"75% or more P.O.C.","$70000 - $95000"
"06037482201","Census Tract 4822.01, Los Angeles County, California",4076,46768,115,1,0,2859,0,1060,2.8,0,0,70.1,0,26,97.2,1265,513,752,40.55,59.45,32,481,201,551,233,1032,6.2,26.7,18.4,"75% or more P.O.C.","Less than $51000"
"06037482202","Census Tract 4822.02, Los Angeles County, California",5087,57361,92,32,26,3657,11,1246,1.8,0.6,0.5,71.9,0.2,24.5,98.2,1557,627,930,40.27,59.73,68,559,171,759,239,1318,10.8,18.4,15.4,"75% or more P.O.C.","$51000 - $70000"
"06037482301","Census Tract 4823.01, Los Angeles County, California",4941,41266,92,25,0,3860,0,943,1.9,0.5,0,78.1,0,19.1,98.1,1327,433,894,32.63,67.37,102,331,206,688,308,1019,23.6,23,23.2,"75% or more P.O.C.","Less than $51000"
"06037482303","Census Tract 4823.03, Los Angeles County, California",6156,54177,159,0,0,4087,0,1897,2.6,0,0,66.4,0,30.8,97.4,1552,534,1018,34.41,65.59,154,380,219,799,373,1179,28.8,21.5,24,"75% or more P.O.C.","$51000 - $70000"
"06037482304","Census Tract 4823.04, Los Angeles County, California",3216,33940,80,52,0,1592,0,1434,2.5,1.6,0,49.5,0,44.6,97.5,847,223,624,26.33,73.67,59,164,168,456,227,620,26.5,26.9,26.8,"75% or more P.O.C.","Less than $51000"
"06037482401","Census Tract 4824.01, Los Angeles County, California",3670,49295,94,0,0,2006,0,1554,2.6,0,0,54.7,0,42.3,97.4,973,399,574,41.01,58.99,118,281,117,457,235,738,29.6,20.4,24.2,"75% or more P.O.C.","Less than $51000"
"06037482402","Census Tract 4824.02, Los Angeles County, California",7566,53901,313,9,0,3796,0,3440,4.1,0.1,0,50.2,0,45.5,95.9,2239,1115,1124,49.8,50.2,66,1049,299,825,365,1874,5.9,26.6,16.3,"75% or more P.O.C.","$51000 - $70000"
"06037482502","Census Tract 4825.02, Los Angeles County, California",3310,57045,32,16,0,2560,0,680,1,0.5,0,77.3,0,20.5,99,854,373,481,43.68,56.32,136,237,68,413,204,650,36.5,14.1,23.9,"75% or more P.O.C.","$51000 - $70000"
"06037482503","Census Tract 4825.03, Los Angeles County, California",4293,62675,85,42,93,2574,0,1347,2,1,2.2,60,0,31.4,98,1019,358,661,35.13,64.87,118,240,229,432,347,672,33,34.6,34.1,"75% or more P.O.C.","$51000 - $70000"
"06037482521","Census Tract 4825.21, Los Angeles County, California",5842,67295,316,30,10,3199,0,2226,5.4,0.5,0.2,54.8,0,38.1,94.6,1451,989,462,68.16,31.84,253,736,162,300,415,1036,25.6,35.1,28.6,"75% or more P.O.C.","$51000 - $70000"
"06037482522","Census Tract 4825.22, Los Angeles County, California",4478,65786,307,17,7,1989,0,2067,6.9,0.4,0.2,44.4,0,46.2,93.1,1516,876,640,57.78,42.22,118,758,66,574,184,1332,13.5,10.3,12.1,"75% or more P.O.C.","$51000 - $70000"
"06037482600","Census Tract 4826, Los Angeles County, California",6262,70417,458,0,149,3794,0,1810,7.3,0,2.4,60.6,0,28.9,92.7,2338,1509,829,64.54,35.46,53,1456,34,795,87,2251,3.5,4.1,3.7,"75% or more P.O.C.","$70000 - $95000"
"06037482701","Census Tract 4827.01, Los Angeles County, California",4323,74148,131,1,0,1545,0,2636,3,0,0,35.7,0,61,97,1325,823,502,62.11,37.89,172,651,62,440,234,1091,20.9,12.4,17.7,"75% or more P.O.C.","$70000 - $95000"
"06037482702","Census Tract 4827.02, Los Angeles County, California",2373,82917,178,27,4,1091,0,1009,7.5,1.1,0.2,46,0,42.5,92.5,802,579,223,72.19,27.81,85,494,0,223,85,717,14.7,0,10.6,"75% or more P.O.C.","$70000 - $95000"
"06037482800","Census Tract 4828, Los Angeles County, California",4524,71401,217,9,37,2333,10,1812,4.8,0.2,0.8,51.6,0.2,40.1,95.2,1341,902,439,67.26,32.74,77,825,80,359,157,1184,8.5,18.2,11.7,"75% or more P.O.C.","$70000 - $95000"
"06037500100","Census Tract 5001, Los Angeles County, California",4840,123021,2096,5,25,795,0,1873,43.3,0.1,0.5,16.4,0,38.7,56.7,1493,1252,241,83.86,16.14,173,1079,61,180,234,1259,13.8,25.3,15.7,"50% - 75% P.O.C.","$95000 or more"
"06037500201","Census Tract 5002.01, Los Angeles County, California",7267,114831,4170,28,0,549,0,2211,57.4,0.4,0,7.6,0,30.4,42.6,2209,1904,305,86.19,13.81,263,1641,53,252,316,1893,13.8,17.4,14.3,"25% - 50% P.O.C.","$95000 or more"
"06037500202","Census Tract 5002.02, Los Angeles County, California",4988,133125,1508,33,4,1039,0,2281,30.2,0.7,0.1,20.8,0,45.7,69.8,1460,1293,167,88.56,11.44,275,1018,20,147,295,1165,21.3,12,20.2,"50% - 75% P.O.C.","$95000 or more"
"06037500300","Census Tract 5003, Los Angeles County, California",2973,102875,838,0,0,469,0,1609,28.2,0,0,15.8,0,54.1,71.8,1087,991,96,91.17,8.83,80,911,0,96,80,1007,8.1,0,7.4,"50% - 75% P.O.C.","$95000 or more"
"06037500402","Census Tract 5004.02, Los Angeles County, California",4856,54375,90,0,0,0,0,4739,1.9,0,0,0,0,97.6,98.1,1190,524,666,44.03,55.97,132,392,177,489,309,881,25.2,26.6,26,"75% or more P.O.C.","$51000 - $70000"
"06037500403","Census Tract 5004.03, Los Angeles County, California",3829,82169,203,0,23,298,0,3295,5.3,0,0.6,7.8,0,86.1,94.7,1067,954,113,89.41,10.59,157,797,61,52,218,849,16.5,54,20.4,"75% or more P.O.C.","$70000 - $95000"
"06037500404","Census Tract 5004.04, Los Angeles County, California",4551,71654,422,24,0,286,0,3738,9.3,0.5,0,6.3,0,82.1,90.7,1343,1030,313,76.69,23.31,242,788,101,212,343,1000,23.5,32.3,25.5,"75% or more P.O.C.","$70000 - $95000"
"06037500500","Census Tract 5005, Los Angeles County, California",2703,53500,140,10,0,226,0,2327,5.2,0.4,0,8.4,0,86.1,94.8,894,610,284,68.23,31.77,85,525,71,213,156,738,13.9,25,17.4,"75% or more P.O.C.","$51000 - $70000"
"06037500600","Census Tract 5006, Los Angeles County, California",4912,56920,77,0,0,100,0,4735,1.6,0,0,2,0,96.4,98.4,1282,1026,256,80.03,19.97,320,706,66,190,386,896,31.2,25.8,30.1,"75% or more P.O.C.","$51000 - $70000"
"06037500700","Census Tract 5007, Los Angeles County, California",7150,79872,315,27,0,78,0,6667,4.4,0.4,0,1.1,0,93.2,95.6,1794,1311,483,73.08,26.92,338,973,115,368,453,1341,25.8,23.8,25.3,"75% or more P.O.C.","$70000 - $95000"
"06037500800","Census Tract 5008, Los Angeles County, California",5362,66116,314,58,30,62,0,4883,5.9,1.1,0.6,1.2,0,91.1,94.1,1344,1009,335,75.07,24.93,354,655,41,294,395,949,35.1,12.2,29.4,"75% or more P.O.C.","$51000 - $70000"
"06037500900","Census Tract 5009, Los Angeles County, California",6363,55446,210,104,13,263,3,5744,3.3,1.6,0.2,4.1,0,90.3,96.7,1665,902,763,54.17,45.83,255,647,188,575,443,1222,28.3,24.6,26.6,"75% or more P.O.C.","$51000 - $70000"
"06037501001","Census Tract 5010.01, Los Angeles County, California",3046,76067,188,0,21,16,0,2814,6.2,0,0.7,0.5,0,92.4,93.8,769,475,294,61.77,38.23,87,388,87,207,174,595,18.3,29.6,22.6,"75% or more P.O.C.","$70000 - $95000"
"06037501002","Census Tract 5010.02, Los Angeles County, California",5013,100217,620,26,15,66,0,4257,12.4,0.5,0.3,1.3,0,84.9,87.6,1450,1114,336,76.83,23.17,201,913,110,226,311,1139,18,32.7,21.4,"75% or more P.O.C.","$95000 or more"
"06037501200","Census Tract 5012, Los Angeles County, California",4864,96071,737,12,33,438,0,3551,15.2,0.2,0.7,9,0,73,84.8,1470,1009,461,68.64,31.36,230,779,66,395,296,1174,22.8,14.3,20.1,"75% or more P.O.C.","$95000 or more"
"06037501300","Census Tract 5013, Los Angeles County, California",7154,76027,1504,95,0,171,0,5273,21,1.3,0,2.4,0,73.7,79,2388,1354,1034,56.7,43.3,245,1109,152,882,397,1991,18.1,14.7,16.6,"75% or more P.O.C.","$70000 - $95000"
"06037501400","Census Tract 5014, Los Angeles County, California",3669,43929,414,59,67,84,0,3019,11.3,1.6,1.8,2.3,0,82.3,88.7,1236,407,829,32.93,67.07,86,321,96,733,182,1054,21.1,11.6,14.7,"75% or more P.O.C.","Less than $51000"
"06037501501","Census Tract 5015.01, Los Angeles County, California",2272,102292,745,0,0,222,0,1265,32.8,0,0,9.8,0,55.7,67.2,845,700,145,82.84,17.16,49,651,26,119,75,770,7,17.9,8.9,"50% - 75% P.O.C.","$95000 or more"
"06037501503","Census Tract 5015.03, Los Angeles County, California",5280,66053,1097,34,79,106,0,3854,20.8,0.6,1.5,2,0,73,79.2,1864,467,1397,25.05,74.95,55,412,194,1203,249,1615,11.8,13.9,13.4,"75% or more P.O.C.","$51000 - $70000"
"06037501504","Census Tract 5015.04, Los Angeles County, California",3369,35601,440,31,13,202,0,2612,13.1,0.9,0.4,6,0,77.5,86.9,1469,114,1355,7.76,92.24,0,114,105,1250,105,1364,0,7.7,7.1,"75% or more P.O.C.","Less than $51000"
"06037501600","Census Tract 5016, Los Angeles County, California",7769,95587,2310,127,12,584,22,4324,29.7,1.6,0.2,7.5,0.3,55.7,70.3,2275,1593,682,70.02,29.98,148,1445,102,580,250,2025,9.3,15,11,"50% - 75% P.O.C.","$95000 or more"
"06037501700","Census Tract 5017, Los Angeles County, California",3425,101579,1303,9,0,138,0,1975,38,0.3,0,4,0,57.7,62,1196,809,387,67.64,32.36,73,736,76,311,149,1047,9,19.6,12.5,"50% - 75% P.O.C.","$95000 or more"
"06037501802","Census Tract 5018.02, Los Angeles County, California",3311,68783,583,130,0,37,0,2526,17.6,3.9,0,1.1,0,76.3,82.4,1175,599,576,50.98,49.02,74,525,38,538,112,1063,12.4,6.6,9.5,"75% or more P.O.C.","$51000 - $70000"
"06037501803","Census Tract 5018.03, Los Angeles County, California",4427,39885,364,22,17,45,0,3865,8.2,0.5,0.4,1,0,87.3,91.8,1490,183,1307,12.28,87.72,51,132,106,1201,157,1333,27.9,8.1,10.5,"75% or more P.O.C.","Less than $51000"
"06037501804","Census Tract 5018.04, Los Angeles County, California",2175,50134,295,34,0,69,0,1746,13.6,1.6,0,3.2,0,80.3,86.4,705,175,530,24.82,75.18,34,141,90,440,124,581,19.4,17,17.6,"75% or more P.O.C.","Less than $51000"
"06037501900","Census Tract 5019, Los Angeles County, California",4153,96591,768,79,0,68,0,3141,18.5,1.9,0,1.6,0,75.6,81.5,1276,1095,181,85.82,14.18,163,932,41,140,204,1072,14.9,22.7,16,"75% or more P.O.C.","$95000 or more"
"06037502003","Census Tract 5020.03, Los Angeles County, California",2634,68698,307,16,0,35,0,2186,11.7,0.6,0,1.3,0,83,88.3,739,403,336,54.53,45.47,67,336,71,265,138,601,16.6,21.1,18.7,"75% or more P.O.C.","$51000 - $70000"
"06037502004","Census Tract 5020.04, Los Angeles County, California",4251,66563,227,56,0,195,0,3657,5.3,1.3,0,4.6,0,86,94.7,992,638,354,64.31,35.69,252,386,111,243,363,629,39.5,31.4,36.6,"75% or more P.O.C.","$51000 - $70000"
"06037502005","Census Tract 5020.05, Los Angeles County, California",4930,62279,1007,68,0,90,0,3487,20.4,1.4,0,1.8,0,70.7,79.6,1293,738,555,57.08,42.92,212,526,129,426,341,952,28.7,23.2,26.4,"75% or more P.O.C.","$51000 - $70000"
"06037502100","Census Tract 5021, Los Angeles County, California",5036,66808,795,50,12,68,24,4087,15.8,1,0.2,1.4,0.5,81.2,84.2,1593,1032,561,64.78,35.22,148,884,47,514,195,1398,14.3,8.4,12.2,"75% or more P.O.C.","$51000 - $70000"
"06037502200","Census Tract 5022, Los Angeles County, California",6937,68882,386,10,0,193,0,6325,5.6,0.1,0,2.8,0,91.2,94.4,1875,1318,557,70.29,29.71,392,926,193,364,585,1290,29.7,34.6,31.2,"75% or more P.O.C.","$51000 - $70000"
"06037502301","Census Tract 5023.01, Los Angeles County, California",5794,67238,244,55,134,28,0,5331,4.2,0.9,2.3,0.5,0,92,95.8,1409,1054,355,74.8,25.2,255,799,96,259,351,1058,24.2,27,24.9,"75% or more P.O.C.","$51000 - $70000"
"06037502302","Census Tract 5023.02, Los Angeles County, California",2970,56750,172,64,0,52,0,2656,5.8,2.2,0,1.8,0,89.4,94.2,745,287,458,38.52,61.48,106,181,166,292,272,473,36.9,36.2,36.5,"75% or more P.O.C.","$51000 - $70000"
"06037502401","Census Tract 5024.01, Los Angeles County, California",4957,71159,421,37,0,168,15,4286,8.5,0.7,0,3.4,0.3,86.5,91.5,1277,971,306,76.04,23.96,294,677,50,256,344,933,30.3,16.3,26.9,"75% or more P.O.C.","$70000 - $95000"
"06037502402","Census Tract 5024.02, Los Angeles County, California",3874,80208,305,2,7,11,5,3544,7.9,0.1,0.2,0.3,0.1,91.5,92.1,990,845,145,85.35,14.65,208,637,24,121,232,758,24.6,16.6,23.4,"75% or more P.O.C.","$70000 - $95000"
"06037502500","Census Tract 5025, Los Angeles County, California",4274,63098,191,12,0,17,29,4025,4.5,0.3,0,0.4,0.7,94.2,95.5,1117,517,600,46.28,53.72,146,371,165,435,311,806,28.2,27.5,27.8,"75% or more P.O.C.","$51000 - $70000"
"06037502601","Census Tract 5026.01, Los Angeles County, California",6939,77170,357,158,7,87,0,6330,5.1,2.3,0.1,1.3,0,91.2,94.9,1846,1518,328,82.23,17.77,442,1076,95,233,537,1309,29.1,29,29.1,"75% or more P.O.C.","$70000 - $95000"
"06037502602","Census Tract 5026.02, Los Angeles County, California",4477,56688,394,55,0,70,0,3918,8.8,1.2,0,1.6,0,87.5,91.2,1339,566,773,42.27,57.73,130,436,89,684,219,1120,23,11.5,16.4,"75% or more P.O.C.","$51000 - $70000"
"06037502700","Census Tract 5027, Los Angeles County, California",6919,77065,762,324,15,178,9,5435,11,4.7,0.2,2.6,0.1,78.6,89,1866,1450,416,77.71,22.29,424,1026,12,404,436,1430,29.2,2.9,23.4,"75% or more P.O.C.","$70000 - $95000"
"06037502801","Census Tract 5028.01, Los Angeles County, California",6468,85160,887,28,0,167,0,5341,13.7,0.4,0,2.6,0,82.6,86.3,1692,1403,289,82.92,17.08,341,1062,90,199,431,1261,24.3,31.1,25.5,"75% or more P.O.C.","$70000 - $95000"
"06037502802","Census Tract 5028.02, Los Angeles County, California",3221,47350,443,232,7,809,0,1673,13.8,7.2,0.2,25.1,0,51.9,86.2,1281,428,853,33.41,66.59,5,423,83,770,88,1193,1.2,9.7,6.9,"75% or more P.O.C.","Less than $51000"
"06037502901","Census Tract 5029.01, Los Angeles County, California",5816,94375,885,62,17,165,0,4408,15.2,1.1,0.3,2.8,0,75.8,84.8,1444,1255,189,86.91,13.09,334,921,114,75,448,996,26.6,60.3,31,"75% or more P.O.C.","$70000 - $95000"
"06037502902","Census Tract 5029.02, Los Angeles County, California",4168,48750,184,17,0,170,0,3687,4.4,0.4,0,4.1,0,88.5,95.6,975,441,534,45.23,54.77,130,311,227,307,357,618,29.5,42.5,36.6,"75% or more P.O.C.","Less than $51000"
"06037503000","Census Tract 5030, Los Angeles County, California",5606,59671,273,0,177,130,0,4997,4.9,0,3.2,2.3,0,89.1,95.1,1232,659,573,53.49,46.51,198,461,237,336,435,797,30,41.4,35.3,"75% or more P.O.C.","$51000 - $70000"
"06037503103","Census Tract 5031.03, Los Angeles County, California",5204,77795,438,6,0,324,0,4436,8.4,0.1,0,6.2,0,85.2,91.6,1129,826,303,73.16,26.84,333,493,172,131,505,624,40.3,56.8,44.7,"75% or more P.O.C.","$70000 - $95000"
"06037503104","Census Tract 5031.04, Los Angeles County, California",2542,62974,113,0,21,88,153,2167,4.4,0,0.8,3.5,6,85.2,95.6,625,381,244,60.96,39.04,85,296,96,148,181,444,22.3,39.3,29,"75% or more P.O.C.","$51000 - $70000"
"06037503105","Census Tract 5031.05, Los Angeles County, California",4228,73611,554,4,0,176,0,3457,13.1,0.1,0,4.2,0,81.8,86.9,1056,550,506,52.08,47.92,54,496,218,288,272,784,9.8,43.1,25.8,"75% or more P.O.C.","$70000 - $95000"
"06037503106","Census Tract 5031.06, Los Angeles County, California",4091,68255,624,0,0,278,0,2967,15.3,0,0,6.8,0,72.5,84.7,1180,684,496,57.97,42.03,213,471,74,422,287,893,31.1,14.9,24.3,"75% or more P.O.C.","$51000 - $70000"
"06037503201","Census Tract 5032.01, Los Angeles County, California",4144,97277,704,161,0,483,0,2742,17,3.9,0,11.7,0,66.2,83,1095,1069,26,97.63,2.37,263,806,15,11,278,817,24.6,57.7,25.4,"75% or more P.O.C.","$95000 or more"
"06037503202","Census Tract 5032.02, Los Angeles County, California",5028,68107,617,31,0,505,0,3862,12.3,0.6,0,10,0,76.8,87.7,1293,767,526,59.32,40.68,195,572,117,409,312,981,25.4,22.2,24.1,"75% or more P.O.C.","$51000 - $70000"
"06037503301","Census Tract 5033.01, Los Angeles County, California",3374,98929,1007,25,0,137,0,2152,29.8,0.7,0,4.1,0,63.8,70.2,1004,880,124,87.65,12.35,193,687,0,124,193,811,21.9,0,19.2,"50% - 75% P.O.C.","$95000 or more"
"06037503302","Census Tract 5033.02, Los Angeles County, California",6784,78617,1183,3,35,255,0,5112,17.4,0,0.5,3.8,0,75.4,82.6,1849,1025,824,55.44,44.56,218,807,205,619,423,1426,21.3,24.9,22.9,"75% or more P.O.C.","$70000 - $95000"
"06037503401","Census Tract 5034.01, Los Angeles County, California",6492,100498,2148,93,0,394,0,3791,33.1,1.4,0,6.1,0,58.4,66.9,2209,1536,673,69.53,30.47,184,1352,40,633,224,1985,12,5.9,10.1,"50% - 75% P.O.C.","$95000 or more"
"06037503402","Census Tract 5034.02, Los Angeles County, California",4129,104069,1197,11,5,156,0,2716,29,0.3,0.1,3.8,0,65.8,71,1342,1022,320,76.15,23.85,45,977,0,320,45,1297,4.4,0,3.4,"50% - 75% P.O.C.","$95000 or more"
"06037503501","Census Tract 5035.01, Los Angeles County, California",6444,61535,1195,61,65,435,24,4505,18.5,0.9,1,6.8,0.4,69.9,81.5,2006,1251,755,62.36,37.64,243,1008,92,663,335,1671,19.4,12.2,16.7,"75% or more P.O.C.","$51000 - $70000"
"06037503502","Census Tract 5035.02, Los Angeles County, California",4655,90125,1098,3,48,125,0,3311,23.6,0.1,1,2.7,0,71.1,76.4,1211,945,266,78.03,21.97,199,746,54,212,253,958,21.1,20.3,20.9,"75% or more P.O.C.","$70000 - $95000"
"06037503601","Census Tract 5036.01, Los Angeles County, California",4151,93750,1434,258,55,479,18,1741,34.5,6.2,1.3,11.5,0.4,41.9,65.5,1215,1058,157,87.08,12.92,176,882,35,122,211,1004,16.6,22.3,17.4,"50% - 75% P.O.C.","$70000 - $95000"
"06037503602","Census Tract 5036.02, Los Angeles County, California",4212,110278,1514,19,0,504,0,2024,35.9,0.5,0,12,0,48.1,64.1,1182,1046,136,88.49,11.51,207,839,9,127,216,966,19.8,6.6,18.3,"50% - 75% P.O.C.","$95000 or more"
"06037503701","Census Tract 5037.01, Los Angeles County, California",4840,69981,2051,0,0,176,11,2594,42.4,0,0,3.6,0.2,53.6,57.6,1707,1032,675,60.46,39.54,127,905,69,606,196,1511,12.3,10.2,11.5,"50% - 75% P.O.C.","$51000 - $70000"
"06037503702","Census Tract 5037.02, Los Angeles County, California",5516,79886,1904,37,0,361,13,3021,34.5,0.7,0,6.5,0.2,54.8,65.5,1753,1206,547,68.8,31.2,124,1082,113,434,237,1516,10.3,20.7,13.5,"50% - 75% P.O.C.","$70000 - $95000"
"06037503703","Census Tract 5037.03, Los Angeles County, California",7622,86250,2105,22,0,4004,0,1413,27.6,0.3,0,52.5,0,18.5,72.4,2920,1985,935,67.98,32.02,185,1800,29,906,214,2706,9.3,3.1,7.3,"50% - 75% P.O.C.","$70000 - $95000"
"06037503801","Census Tract 5038.01, Los Angeles County, California",3851,92772,1229,0,0,606,0,1773,31.9,0,0,15.7,0,46,68.1,1167,859,308,73.61,26.39,118,741,61,247,179,988,13.7,19.8,15.3,"50% - 75% P.O.C.","$70000 - $95000"
"06037503802","Census Tract 5038.02, Los Angeles County, California",4900,102711,1395,96,0,1343,0,1965,28.5,2,0,27.4,0,40.1,71.5,1622,1369,253,84.4,15.6,169,1200,19,234,188,1434,12.3,7.5,11.6,"50% - 75% P.O.C.","$95000 or more"
"06037503901","Census Tract 5039.01, Los Angeles County, California",2942,107361,962,21,0,556,0,1328,32.7,0.7,0,18.9,0,45.1,67.3,827,707,120,85.49,14.51,150,557,17,103,167,660,21.2,14.2,20.2,"50% - 75% P.O.C.","$95000 or more"
"06037503902","Census Tract 5039.02, Los Angeles County, California",4939,106125,1727,23,10,635,14,2360,35,0.5,0.2,12.9,0.3,47.8,65,1378,1134,244,82.29,17.71,191,943,72,172,263,1115,16.8,29.5,19.1,"50% - 75% P.O.C.","$95000 or more"
"06037504001","Census Tract 5040.01, Los Angeles County, California",5860,95347,2511,113,0,952,6,2036,42.8,1.9,0,16.2,0.1,34.7,57.2,1087,803,284,73.87,26.13,183,620,22,262,205,882,22.8,7.7,18.9,"50% - 75% P.O.C.","$95000 or more"
"06037504002","Census Tract 5040.02, Los Angeles County, California",5461,105833,1861,205,16,666,0,2647,34.1,3.8,0.3,12.2,0,48.5,65.9,1482,1191,291,80.36,19.64,252,939,55,236,307,1175,21.2,18.9,20.7,"50% - 75% P.O.C.","$95000 or more"
"06037504101","Census Tract 5041.01, Los Angeles County, California",4826,64623,734,112,20,721,0,3204,15.2,2.3,0.4,14.9,0,66.4,84.8,1337,837,500,62.6,37.4,218,619,54,446,272,1065,26,10.8,20.3,"75% or more P.O.C.","$51000 - $70000"
"06037504102","Census Tract 5041.02, Los Angeles County, California",9,NA,0,0,9,0,0,0,0,0,100,0,0,0,100,9,0,9,0,100,0,0,0,9,0,9,NA,0,0,"75% or more P.O.C.","N/A"
"06037530003","Census Tract 5300.03, Los Angeles County, California",3080,101563,686,60,0,575,0,1745,22.3,1.9,0,18.7,0,56.7,77.7,961,889,72,92.51,7.49,131,758,5,67,136,825,14.7,6.9,14.2,"75% or more P.O.C.","$95000 or more"
"06037530004","Census Tract 5300.04, Los Angeles County, California",3495,58203,505,78,0,505,0,2253,14.4,2.2,0,14.4,0,64.5,85.6,1113,563,550,50.58,49.42,101,462,77,473,178,935,17.9,14,16,"75% or more P.O.C.","$51000 - $70000"
"06037530005","Census Tract 5300.05, Los Angeles County, California",3971,88750,360,18,0,2041,0,1532,9.1,0.5,0,51.4,0,38.6,90.9,1342,1085,257,80.85,19.15,195,890,8,249,203,1139,18,3.1,15.1,"75% or more P.O.C.","$70000 - $95000"
"06037530006","Census Tract 5300.06, Los Angeles County, California",4430,65550,598,21,0,1007,0,2732,13.5,0.5,0,22.7,0,61.7,86.5,1442,241,1201,16.71,83.29,21,220,147,1054,168,1274,8.7,12.2,11.7,"75% or more P.O.C.","$51000 - $70000"
"06037530101","Census Tract 5301.01, Los Angeles County, California",5285,42056,440,216,46,285,0,4124,8.3,4.1,0.9,5.4,0,78,91.7,1684,360,1324,21.38,78.62,65,295,146,1178,211,1473,18.1,11,12.5,"75% or more P.O.C.","Less than $51000"
"06037530102","Census Tract 5301.02, Los Angeles County, California",4862,44400,584,26,0,409,0,3823,12,0.5,0,8.4,0,78.6,88,1632,661,971,40.5,59.5,170,491,48,923,218,1414,25.7,4.9,13.4,"75% or more P.O.C.","Less than $51000"
"06037530202","Census Tract 5302.02, Los Angeles County, California",4348,72045,146,0,0,338,0,3864,3.4,0,0,7.8,0,88.9,96.6,1206,817,389,67.74,32.26,142,675,74,315,216,990,17.4,19,17.9,"75% or more P.O.C.","$70000 - $95000"
"06037530203","Census Tract 5302.03, Los Angeles County, California",2728,46385,231,20,0,194,7,2254,8.5,0.7,0,7.1,0.3,82.6,91.5,985,291,694,29.54,70.46,36,255,51,643,87,898,12.4,7.3,8.8,"75% or more P.O.C.","Less than $51000"
"06037530204","Census Tract 5302.04, Los Angeles County, California",3904,59940,73,0,0,452,0,3379,1.9,0,0,11.6,0,86.6,98.1,1145,327,818,28.56,71.44,50,277,170,648,220,925,15.3,20.8,19.2,"75% or more P.O.C.","$51000 - $70000"
"06037530301","Census Tract 5303.01, Los Angeles County, California",2211,49018,87,0,0,108,0,2004,3.9,0,0,4.9,0,90.6,96.1,639,225,414,35.21,64.79,61,164,63,351,124,515,27.1,15.2,19.4,"75% or more P.O.C.","Less than $51000"
"06037530302","Census Tract 5303.02, Los Angeles County, California",6849,52906,246,46,0,190,0,6367,3.6,0.7,0,2.8,0,93,96.4,1897,873,1024,46.02,53.98,229,644,166,858,395,1502,26.2,16.2,20.8,"75% or more P.O.C.","$51000 - $70000"
"06037530400","Census Tract 5304, Los Angeles County, California",3744,41686,28,150,0,810,0,2744,0.7,4,0,21.6,0,73.3,99.3,1203,410,793,34.08,65.92,17,393,153,640,170,1033,4.1,19.3,14.1,"75% or more P.O.C.","Less than $51000"
"06037530500","Census Tract 5305, Los Angeles County, California",3719,44750,116,2,0,196,0,3405,3.1,0.1,0,5.3,0,91.6,96.9,1118,401,717,35.87,64.13,81,320,130,587,211,907,20.2,18.1,18.9,"75% or more P.O.C.","Less than $51000"
"06037530601","Census Tract 5306.01, Los Angeles County, California",2930,51719,179,0,0,52,5,2685,6.1,0,0,1.8,0.2,91.6,93.9,851,429,422,50.41,49.59,91,338,102,320,193,658,21.2,24.2,22.7,"75% or more P.O.C.","$51000 - $70000"
"06037530602","Census Tract 5306.02, Los Angeles County, California",1769,84750,185,5,0,51,0,1528,10.5,0.3,0,2.9,0,86.4,89.5,413,236,177,57.14,42.86,97,139,58,119,155,258,41.1,32.8,37.5,"75% or more P.O.C.","$70000 - $95000"
"06037530700","Census Tract 5307, Los Angeles County, California",2157,55855,67,0,0,39,0,2047,3.1,0,0,1.8,0,94.9,96.9,547,236,311,43.14,56.86,55,181,58,253,113,434,23.3,18.6,20.7,"75% or more P.O.C.","$51000 - $70000"
"06037530801","Census Tract 5308.01, Los Angeles County, California",5407,47885,298,0,0,90,0,5011,5.5,0,0,1.7,0,92.7,94.5,1466,561,905,38.27,61.73,91,470,229,676,320,1146,16.2,25.3,21.8,"75% or more P.O.C.","Less than $51000"
"06037530802","Census Tract 5308.02, Los Angeles County, California",3165,60433,102,34,0,43,4,2982,3.2,1.1,0,1.4,0.1,94.2,96.8,914,538,376,58.86,41.14,166,372,54,322,220,694,30.9,14.4,24.1,"75% or more P.O.C.","$51000 - $70000"
"06037530901","Census Tract 5309.01, Los Angeles County, California",3684,52356,27,13,0,4,0,3640,0.7,0.4,0,0.1,0,98.8,99.3,903,241,662,26.69,73.31,99,142,176,486,275,628,41.1,26.6,30.5,"75% or more P.O.C.","$51000 - $70000"
"06037530902","Census Tract 5309.02, Los Angeles County, California",3840,44722,46,0,0,170,0,3624,1.2,0,0,4.4,0,94.4,98.8,1060,404,656,38.11,61.89,103,301,196,460,299,761,25.5,29.9,28.2,"75% or more P.O.C.","Less than $51000"
"06037531000","Census Tract 5310, Los Angeles County, California",5133,41615,84,0,0,0,0,5034,1.6,0,0,0,0,98.1,98.4,1284,528,756,41.12,58.88,166,362,289,467,455,829,31.4,38.2,35.4,"75% or more P.O.C.","Less than $51000"
"06037531101","Census Tract 5311.01, Los Angeles County, California",4851,44699,41,4,9,0,0,4797,0.8,0.1,0.2,0,0,98.9,99.2,1241,390,851,31.43,68.57,43,347,269,582,312,929,11,31.6,25.1,"75% or more P.O.C.","Less than $51000"
"06037531102","Census Tract 5311.02, Los Angeles County, California",3210,33512,14,0,7,15,3,3171,0.4,0,0.2,0.5,0.1,98.8,99.6,897,205,692,22.85,77.15,52,153,158,534,210,687,25.4,22.8,23.4,"75% or more P.O.C.","Less than $51000"
"06037531201","Census Tract 5312.01, Los Angeles County, California",5530,50455,46,14,0,0,6,5464,0.8,0.3,0,0,0.1,98.8,99.2,1272,362,910,28.46,71.54,78,284,311,599,389,883,21.5,34.2,30.6,"75% or more P.O.C.","Less than $51000"
"06037531202","Census Tract 5312.02, Los Angeles County, California",4431,48344,40,32,0,46,0,4313,0.9,0.7,0,1,0,97.3,99.1,1145,346,799,30.22,69.78,111,235,228,571,339,806,32.1,28.5,29.6,"75% or more P.O.C.","Less than $51000"
"06037531301","Census Tract 5313.01, Los Angeles County, California",4824,40385,34,27,0,41,0,4719,0.7,0.6,0,0.8,0,97.8,99.3,1232,261,971,21.19,78.81,83,178,351,620,434,798,31.8,36.1,35.2,"75% or more P.O.C.","Less than $51000"
"06037531302","Census Tract 5313.02, Los Angeles County, California",6215,41065,31,0,0,0,0,6184,0.5,0,0,0,0,99.5,99.5,1490,484,1006,32.48,67.52,245,239,316,690,561,929,50.6,31.4,37.7,"75% or more P.O.C.","Less than $51000"
"06037531502","Census Tract 5315.02, Los Angeles County, California",3397,45404,28,0,0,16,0,3353,0.8,0,0,0.5,0,98.7,99.2,807,173,634,21.44,78.56,63,110,231,403,294,513,36.4,36.4,36.4,"75% or more P.O.C.","Less than $51000"
"06037531503","Census Tract 5315.03, Los Angeles County, California",2753,44736,13,0,9,0,0,2731,0.5,0,0.3,0,0,99.2,99.5,737,110,627,14.93,85.07,34,76,156,471,190,547,30.9,24.9,25.8,"75% or more P.O.C.","Less than $51000"
"06037531504","Census Tract 5315.04, Los Angeles County, California",4250,48167,8,0,0,0,0,4236,0.2,0,0,0,0,99.7,99.8,1052,380,672,36.12,63.88,153,227,145,527,298,754,40.3,21.6,28.3,"75% or more P.O.C.","Less than $51000"
"06037531602","Census Tract 5316.02, Los Angeles County, California",4432,31681,47,7,60,0,7,4311,1.1,0.2,1.4,0,0.2,97.3,98.9,1195,263,932,22.01,77.99,48,215,259,673,307,888,18.3,27.8,25.7,"75% or more P.O.C.","Less than $51000"
"06037531603","Census Tract 5316.03, Los Angeles County, California",3409,45972,16,0,0,32,0,3242,0.5,0,0,0.9,0,95.1,99.5,875,314,561,35.89,64.11,103,211,183,378,286,589,32.8,32.6,32.7,"75% or more P.O.C.","Less than $51000"
"06037531604","Census Tract 5316.04, Los Angeles County, California",3775,41652,62,0,0,0,0,3713,1.6,0,0,0,0,98.4,98.4,926,258,668,27.86,72.14,84,174,210,458,294,632,32.6,31.4,31.7,"75% or more P.O.C.","Less than $51000"
"06037531701","Census Tract 5317.01, Los Angeles County, California",5375,42899,216,0,14,0,0,5145,4,0,0.3,0,0,95.7,96,1357,362,995,26.68,73.32,154,208,276,719,430,927,42.5,27.7,31.7,"75% or more P.O.C.","Less than $51000"
"06037531702","Census Tract 5317.02, Los Angeles County, California",5163,54470,83,0,0,27,0,5003,1.6,0,0,0.5,0,96.9,98.4,1345,369,976,27.43,72.57,125,244,173,803,298,1047,33.9,17.7,22.2,"75% or more P.O.C.","$51000 - $70000"
"06037531800","Census Tract 5318, Los Angeles County, California",4960,48859,75,0,83,0,0,4802,1.5,0,1.7,0,0,96.8,98.5,1278,481,797,37.64,62.36,119,362,179,618,298,980,24.7,22.5,23.3,"75% or more P.O.C.","Less than $51000"
"06037531901","Census Tract 5319.01, Los Angeles County, California",6237,43944,72,22,0,78,0,6065,1.2,0.4,0,1.3,0,97.2,98.8,1662,530,1132,31.89,68.11,163,367,260,872,423,1239,30.8,23,25.5,"75% or more P.O.C.","Less than $51000"
"06037531902","Census Tract 5319.02, Los Angeles County, California",4763,63235,223,0,0,18,0,4522,4.7,0,0,0.4,0,94.9,95.3,1156,606,550,52.42,47.58,79,527,202,348,281,875,13,36.7,24.3,"75% or more P.O.C.","$51000 - $70000"
"06037532001","Census Tract 5320.01, Los Angeles County, California",3036,36458,117,26,0,7,0,2855,3.9,0.9,0,0.2,0,94,96.1,1009,249,760,24.68,75.32,6,243,128,632,134,875,2.4,16.8,13.3,"75% or more P.O.C.","Less than $51000"
"06037532002","Census Tract 5320.02, Los Angeles County, California",3360,47708,115,0,16,197,0,3032,3.4,0,0.5,5.9,0,90.2,96.6,936,386,550,41.24,58.76,39,347,155,395,194,742,10.1,28.2,20.7,"75% or more P.O.C.","Less than $51000"
"06037532101","Census Tract 5321.01, Los Angeles County, California",6747,50313,102,0,70,215,0,6360,1.5,0,1,3.2,0,94.3,98.5,1774,488,1286,27.51,72.49,109,379,318,968,427,1347,22.3,24.7,24.1,"75% or more P.O.C.","Less than $51000"
"06037532102","Census Tract 5321.02, Los Angeles County, California",3936,74425,106,4,0,435,0,3391,2.7,0.1,0,11.1,0,86.2,97.3,1013,662,351,65.35,34.65,179,483,80,271,259,754,27,22.8,25.6,"75% or more P.O.C.","$70000 - $95000"
"06037532200","Census Tract 5322, Los Angeles County, California",7363,52585,184,119,0,552,0,6473,2.5,1.6,0,7.5,0,87.9,97.5,1754,584,1170,33.3,66.7,157,427,481,689,638,1116,26.9,41.1,36.4,"75% or more P.O.C.","$51000 - $70000"
"06037532302","Census Tract 5323.02, Los Angeles County, California",4881,49219,72,35,0,7,0,4758,1.5,0.7,0,0.1,0,97.5,98.5,1130,567,563,50.18,49.82,190,377,156,407,346,784,33.5,27.7,30.6,"75% or more P.O.C.","Less than $51000"
"06037532303","Census Tract 5323.03, Los Angeles County, California",4599,55810,67,18,0,37,17,4426,1.5,0.4,0,0.8,0.4,96.2,98.5,1339,708,631,52.88,47.12,208,500,106,525,314,1025,29.4,16.8,23.5,"75% or more P.O.C.","$51000 - $70000"
"06037532304","Census Tract 5323.04, Los Angeles County, California",4013,44113,154,410,130,13,0,3269,3.8,10.2,3.2,0.3,0,81.5,96.2,1090,385,705,35.32,64.68,103,282,138,567,241,849,26.8,19.6,22.1,"75% or more P.O.C.","Less than $51000"
"06037532400","Census Tract 5324, Los Angeles County, California",45,42188,8,1,0,0,0,36,17.8,2.2,0,0,0,80,82.2,21,4,17,19.05,80.95,0,4,0,17,0,21,0,0,0,"75% or more P.O.C.","Less than $51000"
"06037532500","Census Tract 5325, Los Angeles County, California",4195,55219,68,91,0,97,0,3939,1.6,2.2,0,2.3,0,93.9,98.4,1120,392,728,35,65,94,298,148,580,242,878,24,20.3,21.6,"75% or more P.O.C.","$51000 - $70000"
"06037532603","Census Tract 5326.03, Los Angeles County, California",3289,44223,38,37,0,0,0,3214,1.2,1.1,0,0,0,97.7,98.8,759,211,548,27.8,72.2,65,146,211,337,276,483,30.8,38.5,36.4,"75% or more P.O.C.","Less than $51000"
"06037532604","Census Tract 5326.04, Los Angeles County, California",2739,49063,28,22,0,7,0,2678,1,0.8,0,0.3,0,97.8,99,687,131,556,19.07,80.93,77,54,130,426,207,480,58.8,23.4,30.1,"75% or more P.O.C.","Less than $51000"
"06037532605","Census Tract 5326.05, Los Angeles County, California",3301,27404,77,80,10,16,13,3105,2.3,2.4,0.3,0.5,0.4,94.1,97.7,1072,198,874,18.47,81.53,50,148,134,740,184,888,25.3,15.3,17.2,"75% or more P.O.C.","Less than $51000"
"06037532606","Census Tract 5326.06, Los Angeles County, California",4405,36167,112,25,0,9,0,4259,2.5,0.6,0,0.2,0,96.7,97.5,1278,152,1126,11.89,88.11,24,128,203,923,227,1051,15.8,18,17.8,"75% or more P.O.C.","Less than $51000"
"06037532700","Census Tract 5327, Los Angeles County, California",3417,46125,34,177,0,11,0,3195,1,5.2,0,0.3,0,93.5,99,691,147,544,21.27,78.73,73,74,196,348,269,422,49.7,36,38.9,"75% or more P.O.C.","Less than $51000"
"06037532800","Census Tract 5328, Los Angeles County, California",4590,40306,25,237,0,2,0,4326,0.5,5.2,0,0,0,94.2,99.5,1008,373,635,37,63,123,250,290,345,413,595,33,45.7,41,"75% or more P.O.C.","Less than $51000"
"06037532900","Census Tract 5329, Los Angeles County, California",7058,38682,45,381,0,26,0,6606,0.6,5.4,0,0.4,0,93.6,99.4,1653,428,1225,25.89,74.11,106,322,424,801,530,1123,24.8,34.6,32.1,"75% or more P.O.C.","Less than $51000"
"06037533001","Census Tract 5330.01, Los Angeles County, California",4709,38232,48,247,0,0,0,4414,1,5.2,0,0,0,93.7,99,1044,306,738,29.31,70.69,141,165,251,487,392,652,46.1,34,37.5,"75% or more P.O.C.","Less than $51000"
"06037533002","Census Tract 5330.02, Los Angeles County, California",2705,38065,19,10,0,0,0,2600,0.7,0.4,0,0,0,96.1,99.3,597,239,358,40.03,59.97,72,167,173,185,245,352,30.1,48.3,41,"75% or more P.O.C.","Less than $51000"
"06037533103","Census Tract 5331.03, Los Angeles County, California",3283,35792,86,14,0,0,0,3183,2.6,0.4,0,0,0,97,97.4,815,95,720,11.66,88.34,40,55,142,578,182,633,42.1,19.7,22.3,"75% or more P.O.C.","Less than $51000"
"06037533104","Census Tract 5331.04, Los Angeles County, California",4415,38676,74,53,1,3,0,4279,1.7,1.2,0,0.1,0,96.9,98.3,1266,129,1137,10.19,89.81,26,103,307,830,333,933,20.2,27,26.3,"75% or more P.O.C.","Less than $51000"
"06037533105","Census Tract 5331.05, Los Angeles County, California",2510,35625,14,0,0,0,0,2496,0.6,0,0,0,0,99.4,99.4,647,91,556,14.06,85.94,8,83,143,413,151,496,8.8,25.7,23.3,"75% or more P.O.C.","Less than $51000"
"06037533106","Census Tract 5331.06, Los Angeles County, California",1655,41504,7,0,46,0,0,1602,0.4,0,2.8,0,0,96.8,99.6,399,115,284,28.82,71.18,16,99,79,205,95,304,13.9,27.8,23.8,"75% or more P.O.C.","Less than $51000"
"06037533107","Census Tract 5331.07, Los Angeles County, California",3503,39228,35,0,0,6,0,3462,1,0,0,0.2,0,98.8,99,935,128,807,13.69,86.31,31,97,190,617,221,714,24.2,23.5,23.6,"75% or more P.O.C.","Less than $51000"
"06037533201","Census Tract 5332.01, Los Angeles County, California",2788,39878,55,0,0,0,0,2733,2,0,0,0,0,98,98,676,187,489,27.66,72.34,47,140,194,295,241,435,25.1,39.7,35.7,"75% or more P.O.C.","Less than $51000"
"06037533202","Census Tract 5332.02, Los Angeles County, California",3124,54205,13,0,8,0,0,3103,0.4,0,0.3,0,0,99.3,99.6,648,237,411,36.57,63.43,86,151,122,289,208,440,36.3,29.7,32.1,"75% or more P.O.C.","$51000 - $70000"
"06037533203","Census Tract 5332.03, Los Angeles County, California",1931,46645,5,1,0,9,0,1895,0.3,0.1,0,0.5,0,98.1,99.7,415,121,294,29.16,70.84,36,85,117,177,153,262,29.8,39.8,36.9,"75% or more P.O.C.","Less than $51000"
"06037533300","Census Tract 5333, Los Angeles County, California",3346,37841,42,12,0,0,0,3279,1.3,0.4,0,0,0,98,98.7,868,150,718,17.28,82.72,32,118,168,550,200,668,21.3,23.4,23,"75% or more P.O.C.","Less than $51000"
"06037533401","Census Tract 5334.01, Los Angeles County, California",5098,58214,20,0,0,0,0,5078,0.4,0,0,0,0,99.6,99.6,1218,475,743,39,61,167,308,201,542,368,850,35.2,27.1,30.2,"75% or more P.O.C.","$51000 - $70000"
"06037533402","Census Tract 5334.02, Los Angeles County, California",4240,32845,58,0,0,0,0,4182,1.4,0,0,0,0,98.6,98.6,1062,248,814,23.35,76.65,106,142,180,634,286,776,42.7,22.1,26.9,"75% or more P.O.C.","Less than $51000"
"06037533403","Census Tract 5334.03, Los Angeles County, California",2848,45217,63,46,0,42,0,2697,2.2,1.6,0,1.5,0,94.7,97.8,742,210,532,28.3,71.7,62,148,112,420,174,568,29.5,21.1,23.5,"75% or more P.O.C.","Less than $51000"
"06037533501","Census Tract 5335.01, Los Angeles County, California",3051,41549,8,0,0,0,0,3043,0.3,0,0,0,0,99.7,99.7,723,228,495,31.54,68.46,80,148,137,358,217,506,35.1,27.7,30,"75% or more P.O.C.","Less than $51000"
"06037533502","Census Tract 5335.02, Los Angeles County, California",2143,53631,64,0,0,0,0,2079,3,0,0,0,0,97,97,483,230,253,47.62,52.38,55,175,74,179,129,354,23.9,29.2,26.7,"75% or more P.O.C.","$51000 - $70000"
"06037533503","Census Tract 5335.03, Los Angeles County, California",2141,53542,7,110,0,0,0,2018,0.3,5.1,0,0,0,94.3,99.7,468,165,303,35.26,64.74,103,62,109,194,212,256,62.4,36,45.3,"75% or more P.O.C.","$51000 - $70000"
"06037533601","Census Tract 5336.01, Los Angeles County, California",4762,46831,177,0,0,19,52,4514,3.7,0,0,0.4,1.1,94.8,96.3,1119,187,932,16.71,83.29,124,63,260,672,384,735,66.3,27.9,34.3,"75% or more P.O.C.","Less than $51000"
"06037533602","Census Tract 5336.02, Los Angeles County, California",5546,46429,292,0,13,80,0,5014,5.3,0,0.2,1.4,0,90.4,94.7,1406,365,1041,25.96,74.04,162,203,185,856,347,1059,44.4,17.8,24.7,"75% or more P.O.C.","Less than $51000"
"06037533603","Census Tract 5336.03, Los Angeles County, California",6986,42750,485,47,18,0,0,6386,6.9,0.7,0.3,0,0,91.4,93.1,1783,495,1288,27.76,72.24,129,366,322,966,451,1332,26.1,25,25.3,"75% or more P.O.C.","Less than $51000"
"06037533701","Census Tract 5337.01, Los Angeles County, California",2998,36845,94,14,8,8,0,2869,3.1,0.5,0.3,0.3,0,95.7,96.9,900,200,700,22.22,77.78,53,147,98,602,151,749,26.5,14,16.8,"75% or more P.O.C.","Less than $51000"
"06037533702","Census Tract 5337.02, Los Angeles County, California",3543,43214,7,0,0,17,0,3519,0.2,0,0,0.5,0,99.3,99.8,868,188,680,21.66,78.34,61,127,210,470,271,597,32.4,30.9,31.2,"75% or more P.O.C.","Less than $51000"
"06037533703","Census Tract 5337.03, Los Angeles County, California",5259,58344,0,0,0,0,0,5259,0,0,0,0,0,100,100,1037,276,761,26.62,73.38,154,122,332,429,486,551,55.8,43.6,46.9,"75% or more P.O.C.","$51000 - $70000"
"06037533803","Census Tract 5338.03, Los Angeles County, California",6324,44075,673,64,4,20,11,5552,10.6,1,0.1,0.3,0.2,87.8,89.4,1600,492,1108,30.75,69.25,202,290,222,886,424,1176,41.1,20,26.5,"75% or more P.O.C.","Less than $51000"
"06037533804","Census Tract 5338.04, Los Angeles County, California",4207,39688,50,0,0,22,0,4135,1.2,0,0,0.5,0,98.3,98.8,1193,482,711,40.4,59.6,138,344,111,600,249,944,28.6,15.6,20.9,"75% or more P.O.C.","Less than $51000"
"06037533805","Census Tract 5338.05, Los Angeles County, California",3485,52143,9,57,0,24,0,3395,0.3,1.6,0,0.7,0,97.4,99.7,924,353,571,38.2,61.8,121,232,134,437,255,669,34.3,23.5,27.6,"75% or more P.O.C.","$51000 - $70000"
"06037533806","Census Tract 5338.06, Los Angeles County, California",3794,41510,36,134,0,24,0,3600,0.9,3.5,0,0.6,0,94.9,99.1,947,294,653,31.05,68.95,77,217,146,507,223,724,26.2,22.4,23.5,"75% or more P.O.C.","Less than $51000"
"06037533901","Census Tract 5339.01, Los Angeles County, California",6320,47823,144,129,0,0,0,6004,2.3,2,0,0,0,95,97.7,1453,311,1142,21.4,78.6,128,183,436,706,564,889,41.2,38.2,38.8,"75% or more P.O.C.","Less than $51000"
"06037533902","Census Tract 5339.02, Los Angeles County, California",4049,43426,62,0,0,0,9,3978,1.5,0,0,0,0.2,98.2,98.5,958,212,746,22.13,77.87,69,143,249,497,318,640,32.5,33.4,33.2,"75% or more P.O.C.","Less than $51000"
"06037534001","Census Tract 5340.01, Los Angeles County, California",5125,45933,74,0,16,42,0,4993,1.4,0,0.3,0.8,0,97.4,98.6,1267,225,1042,17.76,82.24,70,155,276,766,346,921,31.1,26.5,27.3,"75% or more P.O.C.","Less than $51000"
"06037534002","Census Tract 5340.02, Los Angeles County, California",4628,50000,223,39,0,43,0,4320,4.8,0.8,0,0.9,0,93.3,95.2,1008,347,661,34.42,65.58,134,213,262,399,396,612,38.6,39.6,39.3,"75% or more P.O.C.","Less than $51000"
"06037534101","Census Tract 5341.01, Los Angeles County, California",2358,34792,31,45,0,134,0,2148,1.3,1.9,0,5.7,0,91.1,98.7,505,137,368,27.13,72.87,60,77,168,200,228,277,43.8,45.7,45.1,"75% or more P.O.C.","Less than $51000"
"06037534102","Census Tract 5341.02, Los Angeles County, California",6219,39384,16,78,0,0,0,6125,0.3,1.3,0,0,0,98.5,99.7,1463,154,1309,10.53,89.47,72,82,456,853,528,935,46.8,34.8,36.1,"75% or more P.O.C.","Less than $51000"
"06037534201","Census Tract 5342.01, Los Angeles County, California",4768,43586,98,47,14,20,0,4584,2.1,1,0.3,0.4,0,96.1,97.9,1027,283,744,27.56,72.44,127,156,301,443,428,599,44.9,40.5,41.7,"75% or more P.O.C.","Less than $51000"
"06037534202","Census Tract 5342.02, Los Angeles County, California",5748,32083,361,14,0,14,0,5359,6.3,0.2,0,0.2,0,93.2,93.7,1279,243,1036,19,81,81,162,327,709,408,871,33.3,31.6,31.9,"75% or more P.O.C.","Less than $51000"
"06037534203","Census Tract 5342.03, Los Angeles County, California",3206,34556,55,7,0,0,5,3139,1.7,0.2,0,0,0.2,97.9,98.3,863,185,678,21.44,78.56,106,79,155,523,261,602,57.3,22.9,30.2,"75% or more P.O.C.","Less than $51000"
"06037534301","Census Tract 5343.01, Los Angeles County, California",4320,50943,156,75,0,69,0,3981,3.6,1.7,0,1.6,0,92.2,96.4,1136,154,982,13.56,86.44,30,124,243,739,273,863,19.5,24.7,24,"75% or more P.O.C.","Less than $51000"
"06037534302","Census Tract 5343.02, Los Angeles County, California",3720,49833,57,52,6,14,0,3591,1.5,1.4,0.2,0.4,0,96.5,98.5,834,157,677,18.82,81.18,96,61,228,449,324,510,61.1,33.7,38.8,"75% or more P.O.C.","Less than $51000"
"06037534403","Census Tract 5344.03, Los Angeles County, California",2795,44318,163,0,0,0,0,2632,5.8,0,0,0,0,94.2,94.2,714,92,622,12.89,87.11,15,77,199,423,214,500,16.3,32,30,"75% or more P.O.C.","Less than $51000"
"06037534404","Census Tract 5344.04, Los Angeles County, California",3677,42841,288,12,12,8,35,3322,7.8,0.3,0.3,0.2,1,90.3,92.2,976,198,778,20.29,79.71,69,129,223,555,292,684,34.8,28.7,29.9,"75% or more P.O.C.","Less than $51000"
"06037534405","Census Tract 5344.05, Los Angeles County, California",4351,45875,31,11,9,32,0,4244,0.7,0.3,0.2,0.7,0,97.5,99.3,962,102,860,10.6,89.4,41,61,357,503,398,564,40.2,41.5,41.4,"75% or more P.O.C.","Less than $51000"
"06037534406","Census Tract 5344.06, Los Angeles County, California",5027,45500,49,9,0,0,0,4969,1,0.2,0,0,0,98.8,99,1068,68,1000,6.37,93.63,49,19,471,529,520,548,72.1,47.1,48.7,"75% or more P.O.C.","Less than $51000"
"06037534501","Census Tract 5345.01, Los Angeles County, California",5226,55811,91,4,5,0,0,5080,1.7,0.1,0.1,0,0,97.2,98.3,1239,510,729,41.16,58.84,163,347,254,475,417,822,32,34.8,33.7,"75% or more P.O.C.","$51000 - $70000"
"06037534502","Census Tract 5345.02, Los Angeles County, California",4654,48900,105,18,0,16,0,4508,2.3,0.4,0,0.3,0,96.9,97.7,988,661,327,66.9,33.1,287,374,75,252,362,626,43.4,22.9,36.6,"75% or more P.O.C.","Less than $51000"
"06037534700","Census Tract 5347, Los Angeles County, California",4435,71042,89,0,16,18,0,4306,2,0,0.4,0.4,0,97.1,98,1008,742,266,73.61,26.39,270,472,72,194,342,666,36.4,27.1,33.9,"75% or more P.O.C.","$70000 - $95000"
"06037534802","Census Tract 5348.02, Los Angeles County, California",3136,61629,41,6,0,0,0,3060,1.3,0.2,0,0,0,97.6,98.7,705,403,302,57.16,42.84,159,244,86,216,245,460,39.5,28.5,34.8,"75% or more P.O.C.","$51000 - $70000"
"06037534803","Census Tract 5348.03, Los Angeles County, California",4589,39432,36,0,0,84,0,4455,0.8,0,0,1.8,0,97.1,99.2,1177,510,667,43.33,56.67,203,307,88,579,291,886,39.8,13.2,24.7,"75% or more P.O.C.","Less than $51000"
"06037534804","Census Tract 5348.04, Los Angeles County, California",3736,51475,19,0,0,33,0,3680,0.5,0,0,0.9,0,98.5,99.5,885,431,454,48.7,51.3,169,262,68,386,237,648,39.2,15,26.8,"75% or more P.O.C.","$51000 - $70000"
"06037534900","Census Tract 5349, Los Angeles County, California",6319,59333,26,0,0,19,0,6274,0.4,0,0,0.3,0,99.3,99.6,1476,655,821,44.38,55.62,277,378,358,463,635,841,42.3,43.6,43,"75% or more P.O.C.","$51000 - $70000"
"06037535001","Census Tract 5350.01, Los Angeles County, California",4512,41969,0,329,26,0,0,4149,0,7.3,0.6,0,0,92,100,1019,378,641,37.1,62.9,126,252,242,399,368,651,33.3,37.8,36.1,"75% or more P.O.C.","Less than $51000"
"06037535002","Census Tract 5350.02, Los Angeles County, California",3648,39960,0,85,13,0,0,3550,0,2.3,0.4,0,0,97.3,100,842,317,525,37.65,62.35,137,180,151,374,288,554,43.2,28.8,34.2,"75% or more P.O.C.","Less than $51000"
"06037535101","Census Tract 5351.01, Los Angeles County, California",7949,39669,54,667,0,0,0,7113,0.7,8.4,0,0,0,89.5,99.3,1795,593,1202,33.04,66.96,147,446,511,691,658,1137,24.8,42.5,36.7,"75% or more P.O.C.","Less than $51000"
"06037535102","Census Tract 5351.02, Los Angeles County, California",4621,56250,38,457,0,6,0,4085,0.8,9.9,0,0.1,0,88.4,99.2,1043,510,533,48.9,51.1,173,337,152,381,325,718,33.9,28.5,31.2,"75% or more P.O.C.","$51000 - $70000"
"06037535200","Census Tract 5352, Los Angeles County, California",6111,52011,9,670,0,0,0,5386,0.1,11,0,0,0,88.1,99.9,1263,562,701,44.5,55.5,347,215,213,488,560,703,61.7,30.4,44.3,"75% or more P.O.C.","$51000 - $70000"
"06037535300","Census Tract 5353, Los Angeles County, California",6524,43000,0,274,0,0,0,6250,0,4.2,0,0,0,95.8,100,1428,705,723,49.37,50.63,318,387,280,443,598,830,45.1,38.7,41.9,"75% or more P.O.C.","Less than $51000"
"06037535400","Census Tract 5354, Los Angeles County, California",3553,44205,23,336,0,6,0,3175,0.6,9.5,0,0.2,0,89.4,99.4,771,205,566,26.59,73.41,97,108,203,363,300,471,47.3,35.9,38.9,"75% or more P.O.C.","Less than $51000"
"06037535501","Census Tract 5355.01, Los Angeles County, California",3898,41599,71,28,0,6,4,3767,1.8,0.7,0,0.2,0.1,96.6,98.2,1017,191,826,18.78,81.22,66,125,140,686,206,811,34.6,16.9,20.3,"75% or more P.O.C.","Less than $51000"
"06037535502","Census Tract 5355.02, Los Angeles County, California",5411,52059,126,20,0,162,0,5092,2.3,0.4,0,3,0,94.1,97.7,1246,398,848,31.94,68.06,154,244,120,728,274,972,38.7,14.2,22,"75% or more P.O.C.","$51000 - $70000"
"06037535503","Census Tract 5355.03, Los Angeles County, California",2240,40739,8,0,25,0,0,2207,0.4,0,1.1,0,0,98.5,99.6,643,231,412,35.93,64.07,73,158,65,347,138,505,31.6,15.8,21.5,"75% or more P.O.C.","Less than $51000"
"06037535603","Census Tract 5356.03, Los Angeles County, California",3998,43073,13,126,0,6,0,3853,0.3,3.2,0,0.2,0,96.4,99.7,1019,373,646,36.6,63.4,89,284,185,461,274,745,23.9,28.6,26.9,"75% or more P.O.C.","Less than $51000"
"06037535604","Census Tract 5356.04, Los Angeles County, California",4476,51172,26,0,0,0,0,4450,0.6,0,0,0,0,99.4,99.4,1020,367,653,35.98,64.02,146,221,196,457,342,678,39.8,30,33.5,"75% or more P.O.C.","$51000 - $70000"
"06037535605","Census Tract 5356.05, Los Angeles County, California",4440,46081,28,0,0,0,0,4412,0.6,0,0,0,0,99.4,99.4,1122,259,863,23.08,76.92,114,145,273,590,387,735,44,31.6,34.5,"75% or more P.O.C.","Less than $51000"
"06037535606","Census Tract 5356.06, Los Angeles County, California",2007,45208,39,15,0,0,0,1953,1.9,0.7,0,0,0,97.3,98.1,451,145,306,32.15,67.85,69,76,101,205,170,281,47.6,33,37.7,"75% or more P.O.C.","Less than $51000"
"06037535607","Census Tract 5356.07, Los Angeles County, California",4946,46081,25,0,26,0,0,4895,0.5,0,0.5,0,0,99,99.5,1090,648,442,59.45,40.55,261,387,197,245,458,632,40.3,44.6,42,"75% or more P.O.C.","Less than $51000"
"06037535701","Census Tract 5357.01, Los Angeles County, California",5237,52500,36,0,0,92,0,5091,0.7,0,0,1.8,0,97.2,99.3,1420,540,880,38.03,61.97,180,360,132,748,312,1108,33.3,15,22,"75% or more P.O.C.","$51000 - $70000"
"06037535702","Census Tract 5357.02, Los Angeles County, California",5638,54157,237,0,0,9,0,5362,4.2,0,0,0.2,0,95.1,95.8,1439,477,962,33.15,66.85,156,321,263,699,419,1020,32.7,27.3,29.1,"75% or more P.O.C.","$51000 - $70000"
"06037535802","Census Tract 5358.02, Los Angeles County, California",6600,53545,237,0,0,0,36,6307,3.6,0,0,0,0.5,95.6,96.4,1609,862,747,53.57,46.43,271,591,176,571,447,1162,31.4,23.6,27.8,"75% or more P.O.C.","$51000 - $70000"
"06037535803","Census Tract 5358.03, Los Angeles County, California",4246,49813,39,0,0,6,0,4201,0.9,0,0,0.1,0,98.9,99.1,1121,303,818,27.03,72.97,87,216,165,653,252,869,28.7,20.2,22.5,"75% or more P.O.C.","Less than $51000"
"06037535804","Census Tract 5358.04, Los Angeles County, California",5328,45739,58,52,11,0,0,5207,1.1,1,0.2,0,0,97.7,98.9,1346,470,876,34.92,65.08,176,294,212,664,388,958,37.4,24.2,28.8,"75% or more P.O.C.","Less than $51000"
"06037535901","Census Tract 5359.01, Los Angeles County, California",5578,51968,38,0,0,0,0,5540,0.7,0,0,0,0,99.3,99.3,1448,717,731,49.52,50.48,187,530,236,495,423,1025,26.1,32.3,29.2,"75% or more P.O.C.","$51000 - $70000"
"06037535902","Census Tract 5359.02, Los Angeles County, California",7209,72689,189,0,0,39,69,6898,2.6,0,0,0.5,1,95.7,97.4,1578,1091,487,69.14,30.86,494,597,154,333,648,930,45.3,31.6,41.1,"75% or more P.O.C.","$70000 - $95000"
"06037536000","Census Tract 5360, Los Angeles County, California",3701,49773,39,0,28,14,0,3620,1.1,0,0.8,0.4,0,97.8,98.9,1008,229,779,22.72,77.28,81,148,190,589,271,737,35.4,24.4,26.9,"75% or more P.O.C.","Less than $51000"
"06037536102","Census Tract 5361.02, Los Angeles County, California",3155,58594,713,12,0,0,10,2412,22.6,0.4,0,0,0.3,76.5,77.4,1036,731,305,70.56,29.44,71,660,88,217,159,877,9.7,28.9,15.3,"75% or more P.O.C.","$51000 - $70000"
"06037536103","Census Tract 5361.03, Los Angeles County, California",5353,59933,119,9,0,8,0,5167,2.2,0.2,0,0.1,0,96.5,97.8,1481,775,706,52.33,47.67,226,549,140,566,366,1115,29.2,19.8,24.7,"75% or more P.O.C.","$51000 - $70000"
"06037536104","Census Tract 5361.04, Los Angeles County, California",3900,49444,127,59,0,31,0,3656,3.3,1.5,0,0.8,0,93.7,96.7,1032,425,607,41.18,58.82,69,356,174,433,243,789,16.2,28.7,23.5,"75% or more P.O.C.","Less than $51000"
"06037536200","Census Tract 5362, Los Angeles County, California",7281,59449,567,150,0,137,58,6369,7.8,2.1,0,1.9,0.8,87.5,92.2,1945,1083,862,55.68,44.32,313,770,187,675,500,1445,28.9,21.7,25.7,"75% or more P.O.C.","$51000 - $70000"
"06037540000","Census Tract 5400, Los Angeles County, California",7139,59330,99,188,0,49,0,6788,1.4,2.6,0,0.7,0,95.1,98.6,1587,553,1034,34.85,65.15,173,380,460,574,633,954,31.3,44.5,39.9,"75% or more P.O.C.","$51000 - $70000"
"06037540101","Census Tract 5401.01, Los Angeles County, California",6743,81494,169,512,0,0,67,5995,2.5,7.6,0,0,1,88.9,97.5,1475,1077,398,73.02,26.98,509,568,118,280,627,848,47.3,29.6,42.5,"75% or more P.O.C.","$70000 - $95000"
"06037540102","Census Tract 5401.02, Los Angeles County, California",6905,60934,85,736,87,0,22,5975,1.2,10.7,1.3,0,0.3,86.5,98.8,1562,988,574,63.25,36.75,401,587,196,378,597,965,40.6,34.1,38.2,"75% or more P.O.C.","$51000 - $70000"
"06037540201","Census Tract 5402.01, Los Angeles County, California",2587,34855,8,20,8,15,0,2536,0.3,0.8,0.3,0.6,0,98,99.7,591,103,488,17.43,82.57,62,41,155,333,217,374,60.2,31.8,36.7,"75% or more P.O.C.","Less than $51000"
"06037540202","Census Tract 5402.02, Los Angeles County, California",7116,39707,321,214,23,125,0,6423,4.5,3,0.3,1.8,0,90.3,95.5,1601,333,1268,20.8,79.2,121,212,438,830,559,1042,36.3,34.5,34.9,"75% or more P.O.C.","Less than $51000"
"06037540203","Census Tract 5402.03, Los Angeles County, California",5807,48663,56,516,40,29,0,5136,1,8.9,0.7,0.5,0,88.4,99,1282,414,868,32.29,67.71,226,188,297,571,523,759,54.6,34.2,40.8,"75% or more P.O.C.","Less than $51000"
"06037540300","Census Tract 5403, Los Angeles County, California",4728,59200,47,11,0,79,0,4591,1,0.2,0,1.7,0,97.1,99,1172,649,523,55.38,44.62,178,471,140,383,318,854,27.4,26.8,27.1,"75% or more P.O.C.","$51000 - $70000"
"06037540400","Census Tract 5404, Los Angeles County, California",2109,52045,4,329,0,0,0,1776,0.2,15.6,0,0,0,84.2,99.8,442,227,215,51.36,48.64,102,125,86,129,188,254,44.9,40,42.5,"75% or more P.O.C.","$51000 - $70000"
"06037540501","Census Tract 5405.01, Los Angeles County, California",6713,57386,523,702,18,65,0,5357,7.8,10.5,0.3,1,0,79.8,92.2,1053,606,447,57.55,42.45,244,362,142,305,386,667,40.3,31.8,36.7,"75% or more P.O.C.","$51000 - $70000"
"06037540502","Census Tract 5405.02, Los Angeles County, California",6163,35213,197,797,0,19,6,5144,3.2,12.9,0,0.3,0.1,83.5,96.8,1454,204,1250,14.03,85.97,113,91,372,878,485,969,55.4,29.8,33.4,"75% or more P.O.C.","Less than $51000"
"06037540600","Census Tract 5406, Los Angeles County, California",4981,31875,26,1153,0,0,0,3802,0.5,23.1,0,0,0,76.3,99.5,1130,356,774,31.5,68.5,191,165,221,553,412,718,53.7,28.6,36.5,"75% or more P.O.C.","Less than $51000"
"06037540700","Census Tract 5407, Los Angeles County, California",3230,44623,111,809,0,22,0,2284,3.4,25,0,0.7,0,70.7,96.6,810,409,401,50.49,49.51,115,294,130,271,245,565,28.1,32.4,30.2,"75% or more P.O.C.","Less than $51000"
"06037540800","Census Tract 5408, Los Angeles County, California",5287,66964,1,2714,0,0,0,2338,0,51.3,0,0,0,44.2,100,1514,1031,483,68.1,31.9,212,819,61,422,273,1241,20.6,12.6,18,"75% or more P.O.C.","$51000 - $70000"
"06037540901","Census Tract 5409.01, Los Angeles County, California",4904,40033,148,1044,13,36,5,3630,3,21.3,0.3,0.7,0.1,74,97,1201,717,484,59.7,40.3,283,434,100,384,383,818,39.5,20.7,31.9,"75% or more P.O.C.","Less than $51000"
"06037540902","Census Tract 5409.02, Los Angeles County, California",4707,59907,54,2744,0,0,0,1813,1.1,58.3,0,0,0,38.5,98.9,1487,922,565,62,38,165,757,59,506,224,1263,17.9,10.4,15.1,"75% or more P.O.C.","$51000 - $70000"
"06037541001","Census Tract 5410.01, Los Angeles County, California",1144,50060,42,557,0,90,0,455,3.7,48.7,0,7.9,0,39.8,96.3,365,305,60,83.56,16.44,55,250,4,56,59,306,18,6.7,16.2,"75% or more P.O.C.","Less than $51000"
"06037541002","Census Tract 5410.02, Los Angeles County, California",3318,64490,485,1828,0,34,0,958,14.6,55.1,0,1,0,28.9,85.4,982,830,152,84.52,15.48,133,697,64,88,197,785,16,42.1,20.1,"75% or more P.O.C.","$51000 - $70000"
"06037541100","Census Tract 5411, Los Angeles County, California",3251,59375,63,1251,0,60,0,1795,1.9,38.5,0,1.8,0,55.2,98.1,918,630,288,68.63,31.37,147,483,71,217,218,700,23.3,24.7,23.7,"75% or more P.O.C.","$51000 - $70000"
"06037541200","Census Tract 5412, Los Angeles County, California",6546,82125,66,3085,0,49,0,3144,1,47.1,0,0.7,0,48,99,1853,1340,513,72.32,27.68,326,1014,95,418,421,1432,24.3,18.5,22.7,"75% or more P.O.C.","$70000 - $95000"
"06037541300","Census Tract 5413, Los Angeles County, California",5512,48701,42,1539,0,33,7,3807,0.8,27.9,0,0.6,0.1,69.1,99.2,1473,1034,439,70.2,29.8,239,795,146,293,385,1088,23.1,33.3,26.1,"75% or more P.O.C.","Less than $51000"
"06037541400","Census Tract 5414, Los Angeles County, California",7989,46563,61,670,222,257,0,6768,0.8,8.4,2.8,3.2,0,84.7,99.2,1696,775,921,45.7,54.3,321,454,330,591,651,1045,41.4,35.8,38.4,"75% or more P.O.C.","Less than $51000"
"06037541500","Census Tract 5415, Los Angeles County, California",6273,51024,26,1049,0,0,0,5191,0.4,16.7,0,0,0,82.8,99.6,1349,436,913,32.32,67.68,205,231,291,622,496,853,47,31.9,36.8,"75% or more P.O.C.","$51000 - $70000"
"06037541603","Census Tract 5416.03, Los Angeles County, California",3059,37027,57,387,0,24,0,2563,1.9,12.7,0,0.8,0,83.8,98.1,676,262,414,38.76,61.24,94,168,122,292,216,460,35.9,29.5,32,"75% or more P.O.C.","Less than $51000"
"06037541604","Census Tract 5416.04, Los Angeles County, California",5917,42188,131,700,0,11,0,5043,2.2,11.8,0,0.2,0,85.2,97.8,1453,441,1012,30.35,69.65,172,269,214,798,386,1067,39,21.1,26.6,"75% or more P.O.C.","Less than $51000"
"06037541605","Census Tract 5416.05, Los Angeles County, California",4805,50802,27,1139,0,126,0,3513,0.6,23.7,0,2.6,0,73.1,99.4,1289,503,786,39.02,60.98,151,352,193,593,344,945,30,24.6,26.7,"75% or more P.O.C.","Less than $51000"
"06037541606","Census Tract 5416.06, Los Angeles County, California",2348,40509,19,411,0,0,0,1918,0.8,17.5,0,0,0,81.7,99.2,611,181,430,29.62,70.38,74,107,109,321,183,428,40.9,25.3,30,"75% or more P.O.C.","Less than $51000"
"06037541700","Census Tract 5417, Los Angeles County, California",6638,71532,57,482,33,33,0,5996,0.9,7.3,0.5,0.5,0,90.3,99.1,1396,1000,396,71.63,28.37,428,572,188,208,616,780,42.8,47.5,44.1,"75% or more P.O.C.","$70000 - $95000"
"06037541801","Census Tract 5418.01, Los Angeles County, California",6180,50714,67,1194,18,1,0,4800,1.1,19.3,0.3,0,0,77.7,98.9,1322,572,750,43.27,56.73,224,348,279,471,503,819,39.2,37.2,38,"75% or more P.O.C.","Less than $51000"
"06037541802","Census Tract 5418.02, Los Angeles County, California",5306,56557,52,583,0,107,0,4553,1,11,0,2,0,85.8,99,1150,767,383,66.7,33.3,295,472,203,180,498,652,38.5,53,43.3,"75% or more P.O.C.","$51000 - $70000"
"06037542000","Census Tract 5420, Los Angeles County, California",4708,55481,81,1527,0,57,0,3043,1.7,32.4,0,1.2,0,64.6,98.3,1141,722,419,63.28,36.72,275,447,179,240,454,687,38.1,42.7,39.8,"75% or more P.O.C.","$51000 - $70000"
"06037542103","Census Tract 5421.03, Los Angeles County, California",3685,56089,16,456,0,7,0,3206,0.4,12.4,0,0.2,0,87,99.6,847,448,399,52.89,47.11,178,270,114,285,292,555,39.7,28.6,34.5,"75% or more P.O.C.","$51000 - $70000"
"06037542104","Census Tract 5421.04, Los Angeles County, California",3473,66389,115,317,12,14,0,2983,3.3,9.1,0.3,0.4,0,85.9,96.7,706,429,277,60.76,39.24,211,218,55,222,266,440,49.2,19.9,37.7,"75% or more P.O.C.","$51000 - $70000"
"06037542105","Census Tract 5421.05, Los Angeles County, California",4781,48125,51,633,42,0,0,4006,1.1,13.2,0.9,0,0,83.8,98.9,1095,395,700,36.07,63.93,189,206,207,493,396,699,47.8,29.6,36.2,"75% or more P.O.C.","Less than $51000"
"06037542106","Census Tract 5421.06, Los Angeles County, California",3523,51496,42,302,0,120,0,3000,1.2,8.6,0,3.4,0,85.2,98.8,777,305,472,39.25,60.75,117,188,182,290,299,478,38.4,38.6,38.5,"75% or more P.O.C.","$51000 - $70000"
"06037542200","Census Tract 5422, Los Angeles County, California",7155,51181,75,1878,0,0,0,5112,1,26.2,0,0,0,71.4,99,1576,998,578,63.32,36.68,374,624,283,295,657,919,37.5,49,41.7,"75% or more P.O.C.","$51000 - $70000"
"06037542401","Census Tract 5424.01, Los Angeles County, California",4735,48938,33,1639,0,56,102,2837,0.7,34.6,0,1.2,2.2,59.9,99.3,1223,789,434,64.51,35.49,166,623,128,306,294,929,21,29.5,24,"75% or more P.O.C.","Less than $51000"
"06037542402","Census Tract 5424.02, Los Angeles County, California",3306,68203,18,1109,0,19,0,2160,0.5,33.5,0,0.6,0,65.3,99.5,758,538,220,70.98,29.02,153,385,37,183,190,568,28.4,16.8,25.1,"75% or more P.O.C.","$51000 - $70000"
"06037542501","Census Tract 5425.01, Los Angeles County, California",4891,58934,0,2272,0,12,0,2100,0,46.5,0,0.2,0,42.9,100,1167,623,544,53.38,46.62,81,542,238,306,319,848,13,43.8,27.3,"75% or more P.O.C.","$51000 - $70000"
"06037542502","Census Tract 5425.02, Los Angeles County, California",5006,38051,33,1730,17,4,0,3137,0.7,34.6,0.3,0.1,0,62.7,99.3,1303,380,923,29.16,70.84,80,300,255,668,335,968,21.1,27.6,25.7,"75% or more P.O.C.","Less than $51000"
"06037542601","Census Tract 5426.01, Los Angeles County, California",3295,37589,46,541,0,48,13,2647,1.4,16.4,0,1.5,0.4,80.3,98.6,677,177,500,26.14,73.86,106,71,192,308,298,379,59.9,38.4,44,"75% or more P.O.C.","Less than $51000"
"06037542602","Census Tract 5426.02, Los Angeles County, California",5934,60051,45,1294,0,0,0,4567,0.8,21.8,0,0,0,77,99.2,1421,580,841,40.82,59.18,229,351,205,636,434,987,39.5,24.4,30.5,"75% or more P.O.C.","$51000 - $70000"
"06037542700","Census Tract 5427, Los Angeles County, California",6129,61573,127,1171,8,0,0,4799,2.1,19.1,0.1,0,0,78.3,97.9,1345,837,508,62.23,37.77,256,581,225,283,481,864,30.6,44.3,35.8,"75% or more P.O.C.","$51000 - $70000"
"06037542800","Census Tract 5428, Los Angeles County, California",2980,57270,77,1272,0,0,0,1578,2.6,42.7,0,0,0,53,97.4,899,739,160,82.2,17.8,157,582,20,140,177,722,21.2,12.5,19.7,"75% or more P.O.C.","$51000 - $70000"
"06037542900","Census Tract 5429, Los Angeles County, California",3254,53550,30,426,0,13,11,2759,0.9,13.1,0,0.4,0.3,84.8,99.1,737,437,300,59.29,40.71,114,323,117,183,231,506,26.1,39,31.3,"75% or more P.O.C.","$51000 - $70000"
"06037543000","Census Tract 5430, Los Angeles County, California",4531,52333,71,2244,0,12,11,2153,1.6,49.5,0,0.3,0.2,47.5,98.4,1168,774,394,66.27,33.73,267,507,116,278,383,785,34.5,29.4,32.8,"75% or more P.O.C.","$51000 - $70000"
"06037543100","Census Tract 5431, Los Angeles County, California",7254,57445,75,3443,0,118,0,3312,1,47.5,0,1.6,0,45.7,99,1765,1257,508,71.22,28.78,342,915,235,273,577,1188,27.2,46.3,32.7,"75% or more P.O.C.","$51000 - $70000"
"06037543201","Census Tract 5432.01, Los Angeles County, California",3605,57805,115,1242,7,37,0,2185,3.2,34.5,0.2,1,0,60.6,96.8,908,549,359,60.46,39.54,138,411,96,263,234,674,25.1,26.7,25.8,"75% or more P.O.C.","$51000 - $70000"
"06037543202","Census Tract 5432.02, Los Angeles County, California",5124,46250,56,803,0,85,163,4004,1.1,15.7,0,1.7,3.2,78.1,98.9,1160,548,612,47.24,52.76,222,326,200,412,422,738,40.5,32.7,36.4,"75% or more P.O.C.","Less than $51000"
"06037543304","Census Tract 5433.04, Los Angeles County, California",5872,86435,461,4735,0,189,0,364,7.9,80.6,0,3.2,0,6.2,92.1,1946,1746,200,89.72,10.28,168,1578,48,152,216,1730,9.6,24,11.1,"75% or more P.O.C.","$70000 - $95000"
"06037543305","Census Tract 5433.05, Los Angeles County, California",3776,71750,713,951,0,103,21,1892,18.9,25.2,0,2.7,0.6,50.1,81.1,1077,957,120,88.86,11.14,193,764,29,91,222,855,20.2,24.2,20.6,"75% or more P.O.C.","$70000 - $95000"
"06037543306","Census Tract 5433.06, Los Angeles County, California",7863,77426,596,1126,0,2987,512,2268,7.6,14.3,0,38,6.5,28.8,92.4,2123,1391,732,65.52,34.48,296,1095,118,614,414,1709,21.3,16.1,19.5,"75% or more P.O.C.","$70000 - $95000"
"06037543321","Census Tract 5433.21, Los Angeles County, California",5446,90022,380,3185,0,880,14,643,7,58.5,0,16.2,0.3,11.8,93,1831,1494,337,81.59,18.41,192,1302,32,305,224,1607,12.9,9.5,12.2,"75% or more P.O.C.","$70000 - $95000"
"06037543322","Census Tract 5433.22, Los Angeles County, California",7959,114388,178,5737,96,549,283,832,2.2,72.1,1.2,6.9,3.6,10.5,97.8,2154,2020,134,93.78,6.22,340,1680,32,102,372,1782,16.8,23.9,17.3,"75% or more P.O.C.","$95000 or more"
"06037543400","Census Tract 5434, Los Angeles County, California",3731,79875,154,781,0,514,32,2160,4.1,20.9,0,13.8,0.9,57.9,95.9,954,732,222,76.73,23.27,190,542,118,104,308,646,26,53.2,32.3,"75% or more P.O.C.","$70000 - $95000"
"06037543501","Census Tract 5435.01, Los Angeles County, California",7457,72548,457,457,0,3910,400,2043,6.1,6.1,0,52.4,5.4,27.4,93.9,2051,1021,1030,49.78,50.22,234,787,274,756,508,1543,22.9,26.6,24.8,"75% or more P.O.C.","$70000 - $95000"
"06037543502","Census Tract 5435.02, Los Angeles County, California",4218,82132,422,137,11,1198,0,2365,10,3.2,0.3,28.4,0,56.1,90,1351,825,526,61.07,38.93,132,693,100,426,232,1119,16,19,17.2,"75% or more P.O.C.","$70000 - $95000"
"06037543503","Census Tract 5435.03, Los Angeles County, California",5696,74375,893,481,0,2271,9,1884,15.7,8.4,0,39.9,0.2,33.1,84.3,1772,1065,707,60.1,39.9,32,1033,110,597,142,1630,3,15.6,8,"75% or more P.O.C.","$70000 - $95000"
"06037543601","Census Tract 5436.01, Los Angeles County, California",3781,79500,228,351,19,1318,164,1610,6,9.3,0.5,34.9,4.3,42.6,94,966,648,318,67.08,32.92,175,473,108,210,283,683,27,34,29.3,"75% or more P.O.C.","$70000 - $95000"
"06037543602","Census Tract 5436.02, Los Angeles County, California",7864,71582,1485,418,0,3173,0,2385,18.9,5.3,0,40.3,0,30.3,81.1,2852,2195,657,76.96,23.04,224,1971,2,655,226,2626,10.2,0.3,7.9,"75% or more P.O.C.","$70000 - $95000"
"06037543603","Census Tract 5436.03, Los Angeles County, California",4301,70658,793,1183,0,1173,59,940,18.4,27.5,0,27.3,1.4,21.9,81.6,1508,1301,207,86.27,13.73,181,1120,10,197,191,1317,13.9,4.8,12.7,"75% or more P.O.C.","$70000 - $95000"
"06037543604","Census Tract 5436.04, Los Angeles County, California",5226,98704,429,404,0,2514,0,1640,8.2,7.7,0,48.1,0,31.4,91.8,1370,1160,210,84.67,15.33,258,902,75,135,333,1037,22.2,35.7,24.3,"75% or more P.O.C.","$95000 or more"
"06037543701","Census Tract 5437.01, Los Angeles County, California",3057,90781,117,0,0,964,263,1699,3.8,0,0,31.5,8.6,55.6,96.2,622,460,162,73.95,26.05,202,258,67,95,269,353,43.9,41.4,43.2,"75% or more P.O.C.","$70000 - $95000"
"06037543702","Census Tract 5437.02, Los Angeles County, California",6637,78911,452,506,0,1801,54,3677,6.8,7.6,0,27.1,0.8,55.4,93.2,1797,1282,515,71.34,28.66,227,1055,141,374,368,1429,17.7,27.4,20.5,"75% or more P.O.C.","$70000 - $95000"
"06037543703","Census Tract 5437.03, Los Angeles County, California",3370,105208,300,85,0,792,45,1907,8.9,2.5,0,23.5,1.3,56.6,91.1,907,690,217,76.07,23.93,153,537,21,196,174,733,22.2,9.7,19.2,"75% or more P.O.C.","$95000 or more"
"06037543801","Census Tract 5438.01, Los Angeles County, California",5159,81190,633,522,57,1842,0,1959,12.3,10.1,1.1,35.7,0,38,87.7,1360,1111,249,81.69,18.31,248,863,114,135,362,998,22.3,45.8,26.6,"75% or more P.O.C.","$70000 - $95000"
"06037543802","Census Tract 5438.02, Los Angeles County, California",6478,77339,282,492,30,2984,156,2401,4.4,7.6,0.5,46.1,2.4,37.1,95.6,1941,1032,909,53.17,46.83,245,787,88,821,333,1608,23.7,9.7,17.2,"75% or more P.O.C.","$70000 - $95000"
"06037543903","Census Tract 5439.03, Los Angeles County, California",3740,71667,486,151,6,1269,57,1616,13,4,0.2,33.9,1.5,43.2,87,1144,814,330,71.15,28.85,179,635,19,311,198,946,22,5.8,17.3,"75% or more P.O.C.","$70000 - $95000"
"06037543905","Census Tract 5439.05, Los Angeles County, California",4636,66250,132,179,7,655,160,3492,2.8,3.9,0.2,14.1,3.5,75.3,97.2,949,550,399,57.96,42.04,181,369,226,173,407,542,32.9,56.6,42.9,"75% or more P.O.C.","$51000 - $70000"
"06037544001","Census Tract 5440.01, Los Angeles County, California",4574,78611,321,288,0,518,228,3176,7,6.3,0,11.3,5,69.4,93,1144,754,390,65.91,34.09,196,558,61,329,257,887,26,15.6,22.5,"75% or more P.O.C.","$70000 - $95000"
"06037544002","Census Tract 5440.02, Los Angeles County, California",3187,80625,371,225,11,456,20,1931,11.6,7.1,0.3,14.3,0.6,60.6,88.4,808,569,239,70.42,29.58,146,423,108,131,254,554,25.7,45.2,31.4,"75% or more P.O.C.","$70000 - $95000"
"06037550000","Census Tract 5500, Los Angeles County, California",1982,86806,602,307,13,142,2,892,30.4,15.5,0.7,7.2,0.1,45,69.6,149,126,23,84.56,15.44,31,95,10,13,41,108,24.6,43.5,27.5,"50% - 75% P.O.C.","$70000 - $95000"
"06037550100","Census Tract 5501, Los Angeles County, California",7329,71875,695,401,0,720,0,5500,9.5,5.5,0,9.8,0,75,90.5,1850,1468,382,79.35,20.65,409,1059,163,219,572,1278,27.9,42.7,30.9,"75% or more P.O.C.","$70000 - $95000"
"06037550201","Census Tract 5502.01, Los Angeles County, California",2911,67750,243,105,0,174,7,2341,8.3,3.6,0,6,0.2,80.4,91.7,769,459,310,59.69,40.31,115,344,68,242,183,586,25.1,21.9,23.8,"75% or more P.O.C.","$51000 - $70000"
"06037550202","Census Tract 5502.02, Los Angeles County, California",5710,82009,607,375,45,457,11,4100,10.6,6.6,0.8,8,0.2,71.8,89.4,1453,1149,304,79.08,20.92,174,975,142,162,316,1137,15.1,46.7,21.7,"75% or more P.O.C.","$70000 - $95000"
"06037550300","Census Tract 5503, Los Angeles County, California",8421,79676,1273,174,0,1053,34,5742,15.1,2.1,0,12.5,0.4,68.2,84.9,2047,1302,745,63.61,36.39,433,869,204,541,637,1410,33.3,27.4,31.1,"75% or more P.O.C.","$70000 - $95000"
"06037550400","Census Tract 5504, Los Angeles County, California",1226,78393,142,1,2,89,7,985,11.6,0.1,0.2,7.3,0.6,80.3,88.4,371,351,20,94.61,5.39,71,280,14,6,85,286,20.2,70,22.9,"75% or more P.O.C.","$70000 - $95000"
"06037550500","Census Tract 5505, Los Angeles County, California",8316,86674,1221,85,0,815,0,6073,14.7,1,0,9.8,0,73,85.3,2337,1505,832,64.4,35.6,361,1144,122,710,483,1854,24,14.7,20.7,"75% or more P.O.C.","$70000 - $95000"
"06037550601","Census Tract 5506.01, Los Angeles County, California",5960,77292,961,151,0,398,0,4371,16.1,2.5,0,6.7,0,73.3,83.9,1721,793,928,46.08,53.92,236,557,83,845,319,1402,29.8,8.9,18.5,"75% or more P.O.C.","$70000 - $95000"
"06037550602","Census Tract 5506.02, Los Angeles County, California",4328,87500,855,26,0,320,0,3036,19.8,0.6,0,7.4,0,70.1,80.2,1216,1048,168,86.18,13.82,251,797,13,155,264,952,24,7.7,21.7,"75% or more P.O.C.","$70000 - $95000"
"06037550700","Census Tract 5507, Los Angeles County, California",6104,100844,1249,59,14,148,0,4589,20.5,1,0.2,2.4,0,75.2,79.5,1797,1382,415,76.91,23.09,287,1095,109,306,396,1401,20.8,26.3,22,"75% or more P.O.C.","$95000 or more"
"06037550800","Census Tract 5508, Los Angeles County, California",7403,82479,979,55,0,438,0,5850,13.2,0.7,0,5.9,0,79,86.8,2077,1174,903,56.52,43.48,224,950,189,714,413,1664,19.1,20.9,19.9,"75% or more P.O.C.","$70000 - $95000"
"06037550901","Census Tract 5509.01, Los Angeles County, California",4141,68388,609,125,0,351,0,3017,14.7,3,0,8.5,0,72.9,85.3,1357,267,1090,19.68,80.32,69,198,153,937,222,1135,25.8,14,16.4,"75% or more P.O.C.","$51000 - $70000"
"06037550902","Census Tract 5509.02, Los Angeles County, California",5803,63205,753,47,0,409,11,4512,13,0.8,0,7,0.2,77.8,87,1884,463,1421,24.58,75.42,78,385,184,1237,262,1622,16.8,12.9,13.9,"75% or more P.O.C.","$51000 - $70000"
"06037551000","Census Tract 5510, Los Angeles County, California",7281,96514,1311,172,0,837,0,4839,18,2.4,0,11.5,0,66.5,82,2182,1430,752,65.54,34.46,254,1176,69,683,323,1859,17.8,9.2,14.8,"75% or more P.O.C.","$95000 or more"
"06037551101","Census Tract 5511.01, Los Angeles County, California",3964,54549,207,220,0,413,0,3079,5.2,5.5,0,10.4,0,77.7,94.8,1181,388,793,32.85,67.15,61,327,135,658,196,985,15.7,17,16.6,"75% or more P.O.C.","$51000 - $70000"
"06037551102","Census Tract 5511.02, Los Angeles County, California",5427,59407,351,255,0,340,0,4440,6.5,4.7,0,6.3,0,81.8,93.5,1666,184,1482,11.04,88.96,54,130,242,1240,296,1370,29.3,16.3,17.8,"75% or more P.O.C.","$51000 - $70000"
"06037551201","Census Tract 5512.01, Los Angeles County, California",3272,61003,429,148,0,243,0,2452,13.1,4.5,0,7.4,0,74.9,86.9,1129,412,717,36.49,63.51,88,324,69,648,157,972,21.4,9.6,13.9,"75% or more P.O.C.","$51000 - $70000"
"06037551202","Census Tract 5512.02, Los Angeles County, California",7840,73154,1031,418,17,296,0,6058,13.2,5.3,0.2,3.8,0,77.3,86.8,2144,899,1245,41.93,58.07,261,638,166,1079,427,1717,29,13.3,19.9,"75% or more P.O.C.","$70000 - $95000"
"06037551300","Census Tract 5513, Los Angeles County, California",5449,58125,638,162,0,265,19,4319,11.7,3,0,4.9,0.3,79.3,88.3,1704,434,1270,25.47,74.53,30,404,150,1120,180,1524,6.9,11.8,10.6,"75% or more P.O.C.","$51000 - $70000"
"06037551401","Census Tract 5514.01, Los Angeles County, California",4582,65880,456,192,25,282,0,3627,10,4.2,0.5,6.2,0,79.2,90,1356,539,817,39.75,60.25,81,458,116,701,197,1159,15,14.2,14.5,"75% or more P.O.C.","$51000 - $70000"
"06037551402","Census Tract 5514.02, Los Angeles County, California",4677,79353,810,201,0,261,1,3394,17.3,4.3,0,5.6,0,72.6,82.7,1280,833,447,65.08,34.92,140,693,142,305,282,998,16.8,31.8,22,"75% or more P.O.C.","$70000 - $95000"
"06037551501","Census Tract 5515.01, Los Angeles County, California",4596,71656,841,298,25,344,0,3044,18.3,6.5,0.5,7.5,0,66.2,81.7,1425,873,552,61.26,38.74,123,750,48,504,171,1254,14.1,8.7,12,"75% or more P.O.C.","$70000 - $95000"
"06037551502","Census Tract 5515.02, Los Angeles County, California",4898,85766,708,290,0,438,0,3388,14.5,5.9,0,8.9,0,69.2,85.5,1225,680,545,55.51,44.49,170,510,239,306,409,816,25,43.9,33.4,"75% or more P.O.C.","$70000 - $95000"
"06037551600","Census Tract 5516, Los Angeles County, California",31,NA,19,0,0,0,0,12,61.3,0,0,0,0,38.7,38.7,0,0,0,NA,NA,0,0,0,0,0,0,NA,NA,NA,"25% - 50% P.O.C.","N/A"
"06037551700","Census Tract 5517, Los Angeles County, California",6262,74231,663,199,0,214,61,4983,10.6,3.2,0,3.4,1,79.6,89.4,1680,979,701,58.27,41.73,266,713,174,527,440,1240,27.2,24.8,26.2,"75% or more P.O.C.","$70000 - $95000"
"06037551800","Census Tract 5518, Los Angeles County, California",7267,79132,1115,433,0,482,0,5124,15.3,6,0,6.6,0,70.5,84.7,2375,1262,1113,53.14,46.86,304,958,120,993,424,1951,24.1,10.8,17.9,"75% or more P.O.C.","$70000 - $95000"
"06037551900","Census Tract 5519, Los Angeles County, California",5203,71512,671,369,10,714,0,3418,12.9,7.1,0.2,13.7,0,65.7,87.1,1416,1032,384,72.88,27.12,267,765,42,342,309,1107,25.9,10.9,21.8,"75% or more P.O.C.","$70000 - $95000"
"06037552001","Census Tract 5520.01, Los Angeles County, California",4188,86818,320,269,13,497,0,3023,7.6,6.4,0.3,11.9,0,72.2,92.4,982,680,302,69.25,30.75,221,459,103,199,324,658,32.5,34.1,33,"75% or more P.O.C.","$70000 - $95000"
"06037552002","Census Tract 5520.02, Los Angeles County, California",3409,68600,265,305,0,686,14,2108,7.8,8.9,0,20.1,0.4,61.8,92.2,918,439,479,47.82,52.18,91,348,57,422,148,770,20.7,11.9,16.1,"75% or more P.O.C.","$51000 - $70000"
"06037552100","Census Tract 5521, Los Angeles County, California",6624,61314,614,263,0,995,0,4669,9.3,4,0,15,0,70.5,90.7,1856,1150,706,61.96,38.04,351,799,131,575,482,1374,30.5,18.6,26,"75% or more P.O.C.","$51000 - $70000"
"06037552200","Census Tract 5522, Los Angeles County, California",5686,48077,387,216,27,399,0,4607,6.8,3.8,0.5,7,0,81,93.2,1646,367,1279,22.3,77.7,71,296,334,945,405,1241,19.3,26.1,24.6,"75% or more P.O.C.","Less than $51000"
"06037552301","Census Tract 5523.01, Los Angeles County, California",4482,88205,290,480,0,706,204,2785,6.5,10.7,0,15.8,4.6,62.1,93.5,1224,756,468,61.76,38.24,137,619,85,383,222,1002,18.1,18.2,18.1,"75% or more P.O.C.","$70000 - $95000"
"06037552302","Census Tract 5523.02, Los Angeles County, California",4107,66278,573,313,0,849,12,2325,14,7.6,0,20.7,0.3,56.6,86,1243,632,611,50.84,49.16,130,502,59,552,189,1054,20.6,9.7,15.2,"75% or more P.O.C.","$51000 - $70000"
"06037552400","Census Tract 5524, Los Angeles County, California",2423,65391,135,91,6,222,0,1900,5.6,3.8,0.2,9.2,0,78.4,94.4,569,436,133,76.63,23.37,150,286,45,88,195,374,34.4,33.8,34.3,"75% or more P.O.C.","$51000 - $70000"
"06037552601","Census Tract 5526.01, Los Angeles County, California",5260,72982,204,175,8,251,0,4578,3.9,3.3,0.2,4.8,0,87,96.1,1178,844,334,71.65,28.35,320,524,48,286,368,810,37.9,14.4,31.2,"75% or more P.O.C.","$70000 - $95000"
"06037552602","Census Tract 5526.02, Los Angeles County, California",4416,57454,370,230,19,1352,0,2399,8.4,5.2,0.4,30.6,0,54.3,91.6,1101,712,389,64.67,35.33,222,490,121,268,343,758,31.2,31.1,31.2,"75% or more P.O.C.","$51000 - $70000"
"06037552700","Census Tract 5527, Los Angeles County, California",6819,71717,802,46,0,880,9,5047,11.8,0.7,0,12.9,0.1,74,88.2,1702,1289,413,75.73,24.27,365,924,86,327,451,1251,28.3,20.8,26.5,"75% or more P.O.C.","$70000 - $95000"
"06037552800","Census Tract 5528, Los Angeles County, California",6198,77917,802,0,0,730,68,4575,12.9,0,0,11.8,1.1,73.8,87.1,1627,1013,614,62.26,37.74,294,719,209,405,503,1124,29,34,30.9,"75% or more P.O.C.","$70000 - $95000"
"06037552900","Census Tract 5529, Los Angeles County, California",7156,62757,760,393,32,1172,290,4363,10.6,5.5,0.4,16.4,4.1,61,89.4,1925,1062,863,55.17,44.83,175,887,222,641,397,1528,16.5,25.7,20.6,"75% or more P.O.C.","$51000 - $70000"
"06037553000","Census Tract 5530, Los Angeles County, California",5033,87205,604,83,0,318,33,3922,12,1.6,0,6.3,0.7,77.9,88,1249,994,255,79.58,20.42,263,731,121,134,384,865,26.5,47.5,30.7,"75% or more P.O.C.","$70000 - $95000"
"06037553100","Census Tract 5531, Los Angeles County, California",6770,69091,1179,880,19,1073,183,3168,17.4,13,0.3,15.8,2.7,46.8,82.6,1896,879,1017,46.36,53.64,143,736,275,742,418,1478,16.3,27,22,"75% or more P.O.C.","$51000 - $70000"
"06037553200","Census Tract 5532, Los Angeles County, California",7637,86314,1198,594,10,894,0,4846,15.7,7.8,0.1,11.7,0,63.5,84.3,1954,1394,560,71.34,28.66,374,1020,167,393,541,1413,26.8,29.8,27.7,"75% or more P.O.C.","$70000 - $95000"
"06037553300","Census Tract 5533, Los Angeles County, California",3214,49950,467,189,2,343,6,2126,14.5,5.9,0.1,10.7,0.2,66.1,85.5,989,748,241,75.63,24.37,74,674,54,187,128,861,9.9,22.4,12.9,"75% or more P.O.C.","Less than $51000"
"06037553400","Census Tract 5534, Los Angeles County, California",3495,70662,323,121,0,230,31,2790,9.2,3.5,0,6.6,0.9,79.8,90.8,938,585,353,62.37,37.63,140,445,90,263,230,708,23.9,25.5,24.5,"75% or more P.O.C.","$70000 - $95000"
"06037553502","Census Tract 5535.02, Los Angeles County, California",4066,66159,373,544,0,276,0,2817,9.2,13.4,0,6.8,0,69.3,90.8,1195,502,693,42.01,57.99,69,433,138,555,207,988,13.7,19.9,17.3,"75% or more P.O.C.","$51000 - $70000"
"06037553503","Census Tract 5535.03, Los Angeles County, California",2906,53615,68,405,0,20,0,2380,2.3,13.9,0,0.7,0,81.9,97.7,751,251,500,33.42,66.58,83,168,66,434,149,602,33.1,13.2,19.8,"75% or more P.O.C.","$51000 - $70000"
"06037553504","Census Tract 5535.04, Los Angeles County, California",5363,61250,423,417,0,213,0,4268,7.9,7.8,0,4,0,79.6,92.1,1362,716,646,52.57,47.43,204,512,206,440,410,952,28.5,31.9,30.1,"75% or more P.O.C.","$51000 - $70000"
"06037553601","Census Tract 5536.01, Los Angeles County, California",4699,48333,179,232,0,226,0,4029,3.8,4.9,0,4.8,0,85.7,96.2,1274,403,871,31.63,68.37,89,314,197,674,286,988,22.1,22.6,22.4,"75% or more P.O.C.","Less than $51000"
"06037553602","Census Tract 5536.02, Los Angeles County, California",4752,66069,236,886,17,73,82,3458,5,18.6,0.4,1.5,1.7,72.8,95,1375,456,919,33.16,66.84,115,341,117,802,232,1143,25.2,12.7,16.9,"75% or more P.O.C.","$51000 - $70000"
"06037553701","Census Tract 5537.01, Los Angeles County, California",3981,51629,134,73,0,52,0,3706,3.4,1.8,0,1.3,0,93.1,96.6,899,368,531,40.93,59.07,97,271,176,355,273,626,26.4,33.1,30.4,"75% or more P.O.C.","$51000 - $70000"
"06037553702","Census Tract 5537.02, Los Angeles County, California",4723,54179,37,306,0,69,0,4288,0.8,6.5,0,1.5,0,90.8,99.2,1090,609,481,55.87,44.13,258,351,145,336,403,687,42.4,30.1,37,"75% or more P.O.C.","$51000 - $70000"
"06037553801","Census Tract 5538.01, Los Angeles County, California",4954,56842,49,468,0,39,138,4229,1,9.4,0,0.8,2.8,85.4,99,1080,244,836,22.59,77.41,40,204,317,519,357,723,16.4,37.9,33.1,"75% or more P.O.C.","$51000 - $70000"
"06037553802","Census Tract 5538.02, Los Angeles County, California",6881,41962,514,779,10,170,0,5272,7.5,11.3,0.1,2.5,0,76.6,92.5,2023,826,1197,40.83,59.17,202,624,369,828,571,1452,24.5,30.8,28.2,"75% or more P.O.C.","Less than $51000"
"06037553901","Census Tract 5539.01, Los Angeles County, California",6773,76116,361,307,0,214,0,5740,5.3,4.5,0,3.2,0,84.7,94.7,1619,860,759,53.12,46.88,345,515,274,485,619,1000,40.1,36.1,38.2,"75% or more P.O.C.","$70000 - $95000"
"06037553902","Census Tract 5539.02, Los Angeles County, California",5415,53859,630,387,0,203,150,3957,11.6,7.1,0,3.7,2.8,73.1,88.4,1539,588,951,38.21,61.79,109,479,215,736,324,1215,18.5,22.6,21.1,"75% or more P.O.C.","$51000 - $70000"
"06037554001","Census Tract 5540.01, Los Angeles County, California",3756,59125,812,250,0,483,0,2171,21.6,6.7,0,12.9,0,57.8,78.4,1060,706,354,66.6,33.4,133,573,62,292,195,865,18.8,17.5,18.4,"75% or more P.O.C.","$51000 - $70000"
"06037554002","Census Tract 5540.02, Los Angeles County, California",5856,55063,896,602,0,755,0,3508,15.3,10.3,0,12.9,0,59.9,84.7,1681,553,1128,32.9,67.1,133,420,186,942,319,1362,24.1,16.5,19,"75% or more P.O.C.","$51000 - $70000"
"06037554101","Census Tract 5541.01, Los Angeles County, California",3548,47618,293,232,0,160,0,2806,8.3,6.5,0,4.5,0,79.1,91.7,997,349,648,35.01,64.99,106,243,163,485,269,728,30.4,25.2,27,"75% or more P.O.C.","Less than $51000"
"06037554103","Census Tract 5541.03, Los Angeles County, California",1396,82216,167,165,0,102,0,945,12,11.8,0,7.3,0,67.7,88,431,279,152,64.73,35.27,30,249,39,113,69,362,10.8,25.7,16,"75% or more P.O.C.","$70000 - $95000"
"06037554104","Census Tract 5541.04, Los Angeles County, California",2414,67159,272,404,10,316,0,1389,11.3,16.7,0.4,13.1,0,57.5,88.7,737,183,554,24.83,75.17,38,145,105,449,143,594,20.8,19,19.4,"75% or more P.O.C.","$51000 - $70000"
"06037554105","Census Tract 5541.05, Los Angeles County, California",4478,46121,780,1078,56,408,31,2059,17.4,24.1,1.3,9.1,0.7,46,82.6,1444,85,1359,5.89,94.11,30,55,211,1148,241,1203,35.3,15.5,16.7,"75% or more P.O.C.","Less than $51000"
"06037554201","Census Tract 5542.01, Los Angeles County, California",4356,83229,672,125,10,470,0,2973,15.4,2.9,0.2,10.8,0,68.3,84.6,1172,670,502,57.17,42.83,169,501,117,385,286,886,25.2,23.3,24.4,"75% or more P.O.C.","$70000 - $95000"
"06037554203","Census Tract 5542.03, Los Angeles County, California",3730,46053,960,102,0,322,110,2183,25.7,2.7,0,8.6,2.9,58.5,74.3,1222,427,795,34.94,65.06,108,319,110,685,218,1004,25.3,13.8,17.8,"50% - 75% P.O.C.","Less than $51000"
"06037554204","Census Tract 5542.04, Los Angeles County, California",4313,39878,562,617,0,398,0,2556,13,14.3,0,9.2,0,59.3,87,1671,267,1404,15.98,84.02,49,218,107,1297,156,1515,18.4,7.6,9.3,"75% or more P.O.C.","Less than $51000"
"06037554301","Census Tract 5543.01, Los Angeles County, California",3499,63375,377,536,0,271,0,2315,10.8,15.3,0,7.7,0,66.2,89.2,1020,433,587,42.45,57.55,63,370,90,497,153,867,14.5,15.3,15,"75% or more P.O.C.","$51000 - $70000"
"06037554302","Census Tract 5543.02, Los Angeles County, California",4393,55075,217,666,6,789,71,2537,4.9,15.2,0.1,18,1.6,57.8,95.1,1223,396,827,32.38,67.62,46,350,192,635,238,985,11.6,23.2,19.5,"75% or more P.O.C.","$51000 - $70000"
"06037554403","Census Tract 5544.03, Los Angeles County, California",5848,49413,794,1415,7,560,0,2870,13.6,24.2,0.1,9.6,0,49.1,86.4,1713,421,1292,24.58,75.42,26,395,276,1016,302,1411,6.2,21.4,17.6,"75% or more P.O.C.","Less than $51000"
"06037554404","Census Tract 5544.04, Los Angeles County, California",4206,56335,591,791,13,713,0,2012,14.1,18.8,0.3,17,0,47.8,85.9,1297,263,1034,20.28,79.72,69,194,112,922,181,1116,26.2,10.8,14,"75% or more P.O.C.","$51000 - $70000"
"06037554405","Census Tract 5544.05, Los Angeles County, California",3015,56641,642,572,24,264,13,1404,21.3,19,0.8,8.8,0.4,46.6,78.7,1113,233,880,20.93,79.07,54,179,79,801,133,980,23.2,9,11.9,"75% or more P.O.C.","$51000 - $70000"
"06037554406","Census Tract 5544.06, Los Angeles County, California",4766,68839,1381,791,5,990,0,1280,29,16.6,0.1,20.8,0,26.9,71,1620,840,780,51.85,48.15,163,677,92,688,255,1365,19.4,11.8,15.7,"50% - 75% P.O.C.","$51000 - $70000"
"06037554511","Census Tract 5545.11, Los Angeles County, California",4140,99097,537,214,0,2624,73,524,13,5.2,0,63.4,1.8,12.7,87,1191,942,249,79.09,20.91,109,833,66,183,175,1016,11.6,26.5,14.7,"75% or more P.O.C.","$95000 or more"
"06037554512","Census Tract 5545.12, Los Angeles County, California",6455,120176,741,408,12,4619,0,528,11.5,6.3,0.2,71.6,0,8.2,88.5,1983,1589,394,80.13,19.87,170,1419,49,345,219,1764,10.7,12.4,11,"75% or more P.O.C.","$95000 or more"
"06037554513","Census Tract 5545.13, Los Angeles County, California",2758,97604,270,155,0,1756,124,287,9.8,5.6,0,63.7,4.5,10.4,90.2,821,586,235,71.38,28.62,100,486,16,219,116,705,17.1,6.8,14.1,"75% or more P.O.C.","$95000 or more"
"06037554514","Census Tract 5545.14, Los Angeles County, California",4700,91250,606,439,0,2678,6,831,12.9,9.3,0,57,0.1,17.7,87.1,1444,962,482,66.62,33.38,79,883,101,381,180,1264,8.2,21,12.5,"75% or more P.O.C.","$70000 - $95000"
"06037554515","Census Tract 5545.15, Los Angeles County, California",3793,106520,629,559,0,1696,16,516,16.6,14.7,0,44.7,0.4,13.6,83.4,1104,852,252,77.17,22.83,111,741,84,168,195,909,13,33.3,17.7,"75% or more P.O.C.","$95000 or more"
"06037554516","Census Tract 5545.16, Los Angeles County, California",3885,120993,417,562,11,2272,0,623,10.7,14.5,0.3,58.5,0,16,89.3,1161,1062,99,91.47,8.53,111,951,32,67,143,1018,10.5,32.3,12.3,"75% or more P.O.C.","$95000 or more"
"06037554517","Census Tract 5545.17, Los Angeles County, California",4510,106354,483,111,0,3238,0,460,10.7,2.5,0,71.8,0,10.2,89.3,1447,936,511,64.69,35.31,58,878,54,457,112,1335,6.2,10.6,7.7,"75% or more P.O.C.","$95000 or more"
"06037554518","Census Tract 5545.18, Los Angeles County, California",5511,102961,770,482,0,3377,0,761,14,8.7,0,61.3,0,13.8,86,1623,1394,229,85.89,14.11,218,1176,38,191,256,1367,15.6,16.6,15.8,"75% or more P.O.C.","$95000 or more"
"06037554519","Census Tract 5545.19, Los Angeles County, California",3498,109663,557,97,93,2276,7,355,15.9,2.8,2.7,65.1,0.2,10.1,84.1,1205,1063,142,88.22,11.78,124,939,15,127,139,1066,11.7,10.6,11.5,"75% or more P.O.C.","$95000 or more"
"06037554521","Census Tract 5545.21, Los Angeles County, California",5949,81793,1159,749,0,2469,22,1142,19.5,12.6,0,41.5,0.4,19.2,80.5,1903,1225,678,64.37,35.63,152,1073,100,578,252,1651,12.4,14.7,13.2,"75% or more P.O.C.","$70000 - $95000"
"06037554522","Census Tract 5545.22, Los Angeles County, California",4944,114375,859,464,12,2508,0,889,17.4,9.4,0.2,50.7,0,18,82.6,1496,1285,211,85.9,14.1,210,1075,39,172,249,1247,16.3,18.5,16.6,"75% or more P.O.C.","$95000 or more"
"06037554600","Census Tract 5546, Los Angeles County, California",4173,76350,508,94,5,1558,0,1926,12.2,2.3,0.1,37.3,0,46.2,87.8,1251,644,607,51.48,48.52,60,584,84,523,144,1107,9.3,13.8,11.5,"75% or more P.O.C.","$70000 - $95000"
"06037554700","Census Tract 5547, Los Angeles County, California",4328,78152,200,31,0,734,17,3330,4.6,0.7,0,17,0.4,76.9,95.4,976,681,295,69.77,30.23,190,491,106,189,296,680,27.9,35.9,30.3,"75% or more P.O.C.","$70000 - $95000"
"06037554801","Census Tract 5548.01, Los Angeles County, California",2744,51896,193,74,0,280,0,2100,7,2.7,0,10.2,0,76.5,93,727,404,323,55.57,44.43,58,346,146,177,204,523,14.4,45.2,28.1,"75% or more P.O.C.","$51000 - $70000"
"06037554802","Census Tract 5548.02, Los Angeles County, California",6378,73594,1015,274,0,3158,32,1685,15.9,4.3,0,49.5,0.5,26.4,84.1,1628,786,842,48.28,51.72,159,627,226,616,385,1243,20.2,26.8,23.6,"75% or more P.O.C.","$70000 - $95000"
"06037554900","Census Tract 5549, Los Angeles County, California",7636,68079,1336,502,54,2602,18,2909,17.5,6.6,0.7,34.1,0.2,38.1,82.5,2105,965,1140,45.84,54.16,186,779,194,946,380,1725,19.3,17,18.1,"75% or more P.O.C.","$51000 - $70000"
"06037555001","Census Tract 5550.01, Los Angeles County, California",5321,76149,812,307,8,1593,0,2520,15.3,5.8,0.2,29.9,0,47.4,84.7,1472,929,543,63.11,36.89,199,730,101,442,300,1172,21.4,18.6,20.4,"75% or more P.O.C.","$70000 - $95000"
"06037555002","Census Tract 5550.02, Los Angeles County, California",3625,82011,1042,534,0,488,148,1368,28.7,14.7,0,13.5,4.1,37.7,71.3,1117,585,532,52.37,47.63,87,498,26,506,113,1004,14.9,4.9,10.1,"50% - 75% P.O.C.","$70000 - $95000"
"06037555102","Census Tract 5551.02, Los Angeles County, California",5987,58262,618,567,29,1529,71,3050,10.3,9.5,0.5,25.5,1.2,50.9,89.7,1879,812,1067,43.21,56.79,120,692,187,880,307,1572,14.8,17.5,16.3,"75% or more P.O.C.","$51000 - $70000"
"06037555103","Census Tract 5551.03, Los Angeles County, California",4873,86964,971,490,0,1726,0,1523,19.9,10.1,0,35.4,0,31.3,80.1,1458,802,656,55.01,44.99,123,679,91,565,214,1244,15.3,13.9,14.7,"75% or more P.O.C.","$70000 - $95000"
"06037555104","Census Tract 5551.04, Los Angeles County, California",4210,62117,741,299,12,754,0,2311,17.6,7.1,0.3,17.9,0,54.9,82.4,1291,720,571,55.77,44.23,130,590,104,467,234,1057,18.1,18.2,18.1,"75% or more P.O.C.","$51000 - $70000"
"06037555202","Census Tract 5552.02, Los Angeles County, California",3661,123807,2273,93,0,347,0,614,62.1,2.5,0,9.5,0,16.8,37.9,1083,962,121,88.83,11.17,159,803,61,60,220,863,16.5,50.4,20.3,"25% - 50% P.O.C.","$95000 or more"
"06037555211","Census Tract 5552.11, Los Angeles County, California",5652,47375,96,4,0,446,0,5095,1.7,0.1,0,7.9,0,90.1,98.3,1373,615,758,44.79,55.21,166,449,272,486,438,935,27,35.9,31.9,"75% or more P.O.C.","Less than $51000"
"06037555212","Census Tract 5552.12, Los Angeles County, California",5110,53017,286,153,0,343,0,4179,5.6,3,0,6.7,0,81.8,94.4,1204,608,596,50.5,49.5,134,474,328,268,462,742,22,55,38.4,"75% or more P.O.C.","$51000 - $70000"
"06037570001","Census Tract 5700.01, Los Angeles County, California",4764,87162,1529,351,12,979,235,1409,32.1,7.4,0.3,20.5,4.9,29.6,67.9,1464,1068,396,72.95,27.05,166,902,48,348,214,1250,15.5,12.1,14.6,"50% - 75% P.O.C.","$70000 - $95000"
"06037570002","Census Tract 5700.02, Los Angeles County, California",2679,93819,1064,308,8,343,84,810,39.7,11.5,0.3,12.8,3.1,30.2,60.3,837,660,177,78.85,21.15,130,530,0,177,130,707,19.7,0,15.5,"50% - 75% P.O.C.","$70000 - $95000"
"06037570003","Census Tract 5700.03, Los Angeles County, California",4119,101500,1433,286,0,661,0,1677,34.8,6.9,0,16,0,40.7,65.2,1334,1016,318,76.16,23.84,105,911,45,273,150,1184,10.3,14.2,11.2,"50% - 75% P.O.C.","$95000 or more"
"06037570100","Census Tract 5701, Los Angeles County, California",3192,79750,491,656,0,538,22,1452,15.4,20.6,0,16.9,0.7,45.5,84.6,754,539,215,71.49,28.51,157,382,30,185,187,567,29.1,14,24.8,"75% or more P.O.C.","$70000 - $95000"
"06037570202","Census Tract 5702.02, Los Angeles County, California",6124,58681,423,898,33,605,111,4007,6.9,14.7,0.5,9.9,1.8,65.4,93.1,1609,1096,513,68.12,31.88,244,852,173,340,417,1192,22.3,33.7,25.9,"75% or more P.O.C.","$51000 - $70000"
"06037570203","Census Tract 5702.03, Los Angeles County, California",4165,43937,133,996,0,147,43,2810,3.2,23.9,0,3.5,1,67.5,96.8,1205,182,1023,15.1,84.9,58,124,243,780,301,904,31.9,23.8,25,"75% or more P.O.C.","Less than $51000"
"06037570204","Census Tract 5702.04, Los Angeles County, California",4201,48947,583,736,18,523,0,2254,13.9,17.5,0.4,12.4,0,53.7,86.1,1198,350,848,29.22,70.78,144,206,163,685,307,891,41.1,19.2,25.6,"75% or more P.O.C.","Less than $51000"
"06037570301","Census Tract 5703.01, Los Angeles County, California",7273,39361,580,856,0,583,60,4981,8,11.8,0,8,0.8,68.5,92,2255,561,1694,24.88,75.12,140,421,261,1433,401,1854,25,15.4,17.8,"75% or more P.O.C.","Less than $51000"
"06037570303","Census Tract 5703.03, Los Angeles County, California",4471,62500,243,808,0,370,170,2664,5.4,18.1,0,8.3,3.8,59.6,94.6,1248,617,631,49.44,50.56,182,435,119,512,301,947,29.5,18.9,24.1,"75% or more P.O.C.","$51000 - $70000"
"06037570304","Census Tract 5703.04, Los Angeles County, California",5094,51404,310,879,32,463,11,3375,6.1,17.3,0.6,9.1,0.2,66.3,93.9,1439,537,902,37.32,62.68,163,374,226,676,389,1050,30.4,25.1,27,"75% or more P.O.C.","$51000 - $70000"
"06037570402","Census Tract 5704.02, Los Angeles County, California",3400,70417,120,1239,0,150,58,1792,3.5,36.4,0,4.4,1.7,52.7,96.5,953,690,263,72.4,27.6,92,598,99,164,191,762,13.3,37.6,20,"75% or more P.O.C.","$70000 - $95000"
"06037570403","Census Tract 5704.03, Los Angeles County, California",4832,48676,168,229,0,324,0,4071,3.5,4.7,0,6.7,0,84.3,96.5,1124,408,716,36.3,63.7,140,268,281,435,421,703,34.3,39.2,37.5,"75% or more P.O.C.","Less than $51000"
"06037570404","Census Tract 5704.04, Los Angeles County, California",3676,54777,48,669,0,33,157,2642,1.3,18.2,0,0.9,4.3,71.9,98.7,857,516,341,60.21,39.79,209,307,112,229,321,536,40.5,32.8,37.5,"75% or more P.O.C.","$51000 - $70000"
"06037570501","Census Tract 5705.01, Los Angeles County, California",8042,61224,659,1540,0,601,625,4530,8.2,19.1,0,7.5,7.8,56.3,91.8,2086,1176,910,56.38,43.62,263,913,279,631,542,1544,22.4,30.7,26,"75% or more P.O.C.","$51000 - $70000"
"06037570502","Census Tract 5705.02, Los Angeles County, California",6588,66364,674,354,12,1328,74,3845,10.2,5.4,0.2,20.2,1.1,58.4,89.8,1824,945,879,51.81,48.19,230,715,190,689,420,1404,24.3,21.6,23,"75% or more P.O.C.","$51000 - $70000"
"06037570601","Census Tract 5706.01, Los Angeles County, California",5610,49506,479,918,227,687,28,3209,8.5,16.4,4,12.2,0.5,57.2,91.5,1541,678,863,44,56,175,503,201,662,376,1165,25.8,23.3,24.4,"75% or more P.O.C.","Less than $51000"
"06037570602","Census Tract 5706.02, Los Angeles County, California",6177,61978,445,654,0,1853,52,3020,7.2,10.6,0,30,0.8,48.9,92.8,1834,743,1091,40.51,59.49,155,588,198,893,353,1481,20.9,18.1,19.2,"75% or more P.O.C.","$51000 - $70000"
"06037570603","Census Tract 5706.03, Los Angeles County, California",5172,49623,499,2314,0,308,183,1771,9.6,44.7,0,6,3.5,34.2,90.4,1804,282,1522,15.63,84.37,30,252,148,1374,178,1626,10.6,9.7,9.9,"75% or more P.O.C.","Less than $51000"
"06037570701","Census Tract 5707.01, Los Angeles County, California",7372,81917,1285,1476,0,2010,0,2404,17.4,20,0,27.3,0,32.6,82.6,2596,1315,1281,50.65,49.35,220,1095,99,1182,319,2277,16.7,7.7,12.3,"75% or more P.O.C.","$70000 - $95000"
"06037570702","Census Tract 5707.02, Los Angeles County, California",2296,105000,625,365,80,282,6,813,27.2,15.9,3.5,12.3,0.3,35.4,72.8,790,698,92,88.35,11.65,48,650,8,84,56,734,6.9,8.7,7.1,"50% - 75% P.O.C.","$95000 or more"
"06037570800","Census Tract 5708, Los Angeles County, California",5300,106031,2494,332,20,759,9,1576,47.1,6.3,0.4,14.3,0.2,29.7,52.9,1727,1415,312,81.93,18.07,122,1293,84,228,206,1521,8.6,26.9,11.9,"50% - 75% P.O.C.","$95000 or more"
"06037570901","Census Tract 5709.01, Los Angeles County, California",5752,115536,2683,326,0,834,17,1587,46.6,5.7,0,14.5,0.3,27.6,53.4,1789,1534,255,85.75,14.25,197,1337,24,231,221,1568,12.8,9.4,12.4,"50% - 75% P.O.C.","$95000 or more"
"06037570902","Census Tract 5709.02, Los Angeles County, California",3583,93409,1538,246,0,463,0,990,42.9,6.9,0,12.9,0,27.6,57.1,1202,820,382,68.22,31.78,190,630,14,368,204,998,23.2,3.7,17,"50% - 75% P.O.C.","$70000 - $95000"
"06037571000","Census Tract 5710, Los Angeles County, California",5628,105758,3276,99,0,496,0,1449,58.2,1.8,0,8.8,0,25.7,41.8,1882,1680,202,89.27,10.73,154,1526,7,195,161,1721,9.2,3.5,8.6,"25% - 50% P.O.C.","$95000 or more"
"06037571101","Census Tract 5711.01, Los Angeles County, California",4402,104000,2339,85,0,398,17,1436,53.1,1.9,0,9,0.4,32.6,46.9,1470,1273,197,86.6,13.4,115,1158,42,155,157,1313,9,21.3,10.7,"25% - 50% P.O.C.","$95000 or more"
"06037571102","Census Tract 5711.02, Los Angeles County, California",4073,108000,1829,229,16,460,248,1170,44.9,5.6,0.4,11.3,6.1,28.7,55.1,1304,1042,262,79.91,20.09,80,962,101,161,181,1123,7.7,38.5,13.9,"50% - 75% P.O.C.","$95000 or more"
"06037571200","Census Tract 5712, Los Angeles County, California",8175,93781,3910,603,108,1021,0,2209,47.8,7.4,1.3,12.5,0,27,52.2,3089,1581,1508,51.18,48.82,184,1397,35,1473,219,2870,11.6,2.3,7.1,"50% - 75% P.O.C.","$70000 - $95000"
"06037571300","Census Tract 5713, Los Angeles County, California",4484,99709,1734,471,0,737,16,1411,38.7,10.5,0,16.4,0.4,31.5,61.3,1456,1317,139,90.45,9.55,235,1082,23,116,258,1198,17.8,16.5,17.7,"50% - 75% P.O.C.","$95000 or more"
"06037571400","Census Tract 5714, Los Angeles County, California",4844,88264,1766,465,0,925,0,1529,36.5,9.6,0,19.1,0,31.6,63.5,1667,1153,514,69.17,30.83,164,989,24,490,188,1479,14.2,4.7,11.3,"50% - 75% P.O.C.","$70000 - $95000"
"06037571502","Census Tract 5715.02, Los Angeles County, California",4739,57132,1118,907,0,903,11,1677,23.6,19.1,0,19.1,0.2,35.4,76.4,1775,988,787,55.66,44.34,119,869,47,740,166,1609,12,6,9.4,"75% or more P.O.C.","$51000 - $70000"
"06037571503","Census Tract 5715.03, Los Angeles County, California",3878,89457,710,700,0,1011,0,1377,18.3,18.1,0,26.1,0,35.5,81.7,1268,779,489,61.44,38.56,132,647,30,459,162,1106,16.9,6.1,12.8,"75% or more P.O.C.","$70000 - $95000"
"06037571504","Census Tract 5715.04, Los Angeles County, California",4512,68138,1342,783,0,370,60,1769,29.7,17.4,0,8.2,1.3,39.2,70.3,1879,764,1115,40.66,59.34,31,733,53,1062,84,1795,4.1,4.8,4.5,"50% - 75% P.O.C.","$51000 - $70000"
"06037571600","Census Tract 5716, Los Angeles County, California",2309,19425,133,1201,0,60,0,772,5.8,52,0,2.6,0,33.4,94.2,823,33,790,4.01,95.99,5,28,105,685,110,713,15.2,13.3,13.4,"75% or more P.O.C.","Less than $51000"
"06037571701","Census Tract 5717.01, Los Angeles County, California",6247,51827,537,807,0,618,77,4110,8.6,12.9,0,9.9,1.2,65.8,91.4,1813,653,1160,36.02,63.98,132,521,298,862,430,1383,20.2,25.7,23.7,"75% or more P.O.C.","$51000 - $70000"
"06037571703","Census Tract 5717.03, Los Angeles County, California",3557,45066,223,512,0,354,0,2374,6.3,14.4,0,10,0,66.7,93.7,1065,408,657,38.31,61.69,142,266,117,540,259,806,34.8,17.8,24.3,"75% or more P.O.C.","Less than $51000"
"06037571704","Census Tract 5717.04, Los Angeles County, California",4076,50438,372,684,33,331,0,2619,9.1,16.8,0.8,8.1,0,64.3,90.9,1235,531,704,43,57,87,444,72,632,159,1076,16.4,10.2,12.9,"75% or more P.O.C.","Less than $51000"
"06037571800","Census Tract 5718, Los Angeles County, California",3222,106538,1725,318,0,423,0,695,53.5,9.9,0,13.1,0,21.6,46.5,1330,964,366,72.48,27.52,58,906,25,341,83,1247,6,6.8,6.2,"25% - 50% P.O.C.","$95000 or more"
"06037571900","Census Tract 5719, Los Angeles County, California",5413,66993,2134,660,36,550,0,1680,39.4,12.2,0.7,10.2,0,31,60.6,2306,1049,1257,45.49,54.51,76,973,51,1206,127,2179,7.2,4.1,5.5,"50% - 75% P.O.C.","$51000 - $70000"
"06037572001","Census Tract 5720.01, Los Angeles County, California",5957,100625,2884,345,0,721,0,1604,48.4,5.8,0,12.1,0,26.9,51.6,2156,1371,785,63.59,36.41,132,1239,76,709,208,1948,9.6,9.7,9.6,"50% - 75% P.O.C.","$95000 or more"
"06037572002","Census Tract 5720.02, Los Angeles County, California",4723,73319,1684,1145,0,680,82,932,35.7,24.2,0,14.4,1.7,19.7,64.3,1984,700,1284,35.28,64.72,82,618,39,1245,121,1863,11.7,3,6.1,"50% - 75% P.O.C.","$70000 - $95000"
"06037572100","Census Tract 5721, Los Angeles County, California",1113,103603,265,146,6,287,8,357,23.8,13.1,0.5,25.8,0.7,32.1,76.2,319,311,8,97.49,2.51,93,218,0,8,93,226,29.9,0,29.2,"75% or more P.O.C.","$95000 or more"
"06037572201","Census Tract 5722.01, Los Angeles County, California",5592,59091,1269,982,0,1504,0,1731,22.7,17.6,0,26.9,0,31,77.3,2078,1207,871,58.08,41.92,213,994,95,776,308,1770,17.6,10.9,14.8,"75% or more P.O.C.","$51000 - $70000"
"06037572202","Census Tract 5722.02, Los Angeles County, California",3614,93580,625,438,0,1016,184,1330,17.3,12.1,0,28.1,5.1,36.8,82.7,1094,761,333,69.56,30.44,122,639,0,333,122,972,16,0,11.2,"75% or more P.O.C.","$70000 - $95000"
"06037572301","Census Tract 5723.01, Los Angeles County, California",3841,55724,292,297,0,643,25,2471,7.6,7.7,0,16.7,0.7,64.3,92.4,963,374,589,38.84,61.16,98,276,200,389,298,665,26.2,34,30.9,"75% or more P.O.C.","$51000 - $70000"
"06037572302","Census Tract 5723.02, Los Angeles County, California",3610,75750,78,452,0,856,80,1999,2.2,12.5,0,23.7,2.2,55.4,97.8,835,493,342,59.04,40.96,209,284,99,243,308,527,42.4,28.9,36.9,"75% or more P.O.C.","$70000 - $95000"
"06037572400","Census Tract 5724, Los Angeles County, California",1425,95152,45,396,0,234,17,578,3.2,27.8,0,16.4,1.2,40.6,96.8,323,297,26,91.95,8.05,108,189,9,17,117,206,36.4,34.6,36.2,"75% or more P.O.C.","$95000 or more"
"06037572500","Census Tract 5725, Los Angeles County, California",3643,29577,342,749,0,775,0,1492,9.4,20.6,0,21.3,0,41,90.6,1232,423,809,34.33,65.67,93,330,104,705,197,1035,22,12.9,16,"75% or more P.O.C.","Less than $51000"
"06037572600","Census Tract 5726, Los Angeles County, California",5357,65625,104,478,9,1789,80,2754,1.9,8.9,0.2,33.4,1.5,51.4,98.1,1217,905,312,74.36,25.64,393,512,75,237,468,749,43.4,24,38.5,"75% or more P.O.C.","$51000 - $70000"
"06037572700","Census Tract 5727, Los Angeles County, California",5268,68500,130,354,18,2444,165,2013,2.5,6.7,0.3,46.4,3.1,38.2,97.5,1334,851,483,63.79,36.21,221,630,126,357,347,987,26,26.1,26,"75% or more P.O.C.","$51000 - $70000"
"06037572800","Census Tract 5728, Los Angeles County, California",986,13500,187,324,0,71,4,304,19,32.9,0,7.2,0.4,30.8,81,226,0,226,0,100,0,0,20,206,20,206,NA,8.8,8.8,"75% or more P.O.C.","Less than $51000"
"06037572900","Census Tract 5729, Los Angeles County, California",5360,47262,188,312,2,854,113,3683,3.5,5.8,0,15.9,2.1,68.7,96.5,1318,465,853,35.28,64.72,147,318,289,564,436,882,31.6,33.9,33.1,"75% or more P.O.C.","Less than $51000"
"06037573002","Census Tract 5730.02, Los Angeles County, California",4086,43825,233,590,0,214,0,3013,5.7,14.4,0,5.2,0,73.7,94.3,1131,98,1033,8.66,91.34,16,82,264,769,280,851,16.3,25.6,24.8,"75% or more P.O.C.","Less than $51000"
"06037573003","Census Tract 5730.03, Los Angeles County, California",1843,69038,460,100,11,383,0,838,25,5.4,0.6,20.8,0,45.5,75,622,364,258,58.52,41.48,41,323,50,208,91,531,11.3,19.4,14.6,"75% or more P.O.C.","$51000 - $70000"
"06037573004","Census Tract 5730.04, Los Angeles County, California",4577,41911,436,1285,0,337,240,2209,9.5,28.1,0,7.4,5.2,48.3,90.5,1655,203,1452,12.27,87.73,38,165,189,1263,227,1428,18.7,13,13.7,"75% or more P.O.C.","Less than $51000"
"06037573100","Census Tract 5731, Los Angeles County, California",7547,60616,683,1431,0,827,0,4226,9,19,0,11,0,56,91,2406,760,1646,31.59,68.41,106,654,359,1287,465,1941,13.9,21.8,19.3,"75% or more P.O.C.","$51000 - $70000"
"06037573201","Census Tract 5732.01, Los Angeles County, California",4597,37723,242,380,0,1044,0,2890,5.3,8.3,0,22.7,0,62.9,94.7,1318,376,942,28.53,71.47,117,259,187,755,304,1014,31.1,19.9,23.1,"75% or more P.O.C.","Less than $51000"
"06037573202","Census Tract 5732.02, Los Angeles County, California",6379,54617,288,987,132,1127,0,3817,4.5,15.5,2.1,17.7,0,59.8,95.5,1697,573,1124,33.77,66.23,154,419,267,857,421,1276,26.9,23.8,24.8,"75% or more P.O.C.","$51000 - $70000"
"06037573300","Census Tract 5733, Los Angeles County, California",4158,40677,134,741,0,1601,0,1682,3.2,17.8,0,38.5,0,40.5,96.8,1094,271,823,24.77,75.23,49,222,227,596,276,818,18.1,27.6,25.2,"75% or more P.O.C.","Less than $51000"
"06037573401","Census Tract 5734.01, Los Angeles County, California",1642,75040,421,279,0,298,0,611,25.6,17,0,18.1,0,37.2,74.4,645,232,413,35.97,64.03,0,232,7,406,7,638,0,1.7,1.1,"50% - 75% P.O.C.","$70000 - $95000"
"06037573402","Census Tract 5734.02, Los Angeles County, California",6384,66508,1689,466,0,1649,15,2324,26.5,7.3,0,25.8,0.2,36.4,73.5,2614,1112,1502,42.54,57.46,18,1094,231,1271,249,2365,1.6,15.4,9.5,"50% - 75% P.O.C.","$51000 - $70000"
"06037573403","Census Tract 5734.03, Los Angeles County, California",3519,101351,1237,541,0,918,6,736,35.2,15.4,0,26.1,0.2,20.9,64.8,1484,1135,349,76.48,23.52,96,1039,42,307,138,1346,8.5,12,9.3,"50% - 75% P.O.C.","$95000 or more"
"06037573601","Census Tract 5736.01, Los Angeles County, California",6402,119020,3418,442,0,618,21,1619,53.4,6.9,0,9.7,0.3,25.3,46.6,2201,1855,346,84.28,15.72,150,1705,43,303,193,2008,8.1,12.4,8.8,"25% - 50% P.O.C.","$95000 or more"
"06037573700","Census Tract 5737, Los Angeles County, California",5009,107431,2709,102,27,390,20,1435,54.1,2,0.5,7.8,0.4,28.6,45.9,1712,1495,217,87.32,12.68,116,1379,26,191,142,1570,7.8,12,8.3,"25% - 50% P.O.C.","$95000 or more"
"06037573800","Census Tract 5738, Los Angeles County, California",4309,116146,2643,57,232,276,56,829,61.3,1.3,5.4,6.4,1.3,19.2,38.7,1489,1296,193,87.04,12.96,141,1155,38,155,179,1310,10.9,19.7,12,"25% - 50% P.O.C.","$95000 or more"
"06037573902","Census Tract 5739.02, Los Angeles County, California",2031,125000,1137,84,10,213,0,479,56,4.1,0.5,10.5,0,23.6,44,856,735,121,85.86,14.14,43,692,16,105,59,797,5.9,13.2,6.9,"25% - 50% P.O.C.","$95000 or more"
"06037574000","Census Tract 5740, Los Angeles County, California",5165,137909,3125,252,0,529,0,964,60.5,4.9,0,10.2,0,18.7,39.5,1853,1660,193,89.58,10.42,123,1537,8,185,131,1722,7.4,4.1,7.1,"25% - 50% P.O.C.","$95000 or more"
"06037574100","Census Tract 5741, Los Angeles County, California",5014,107917,3086,130,17,520,0,1069,61.5,2.6,0.3,10.4,0,21.3,38.5,1906,1531,375,80.33,19.67,76,1455,33,342,109,1797,5,8.8,5.7,"25% - 50% P.O.C.","$95000 or more"
"06037574201","Census Tract 5742.01, Los Angeles County, California",3100,108150,1639,126,0,344,0,858,52.9,4.1,0,11.1,0,27.7,47.1,1098,934,164,85.06,14.94,111,823,88,76,199,899,11.9,53.7,18.1,"25% - 50% P.O.C.","$95000 or more"
"06037574202","Census Tract 5742.02, Los Angeles County, California",2251,77386,1034,128,0,122,3,886,45.9,5.7,0,5.4,0.1,39.4,54.1,737,325,412,44.1,55.9,17,308,32,380,49,688,5.2,7.8,6.6,"50% - 75% P.O.C.","$70000 - $95000"
"06037574300","Census Tract 5743, Los Angeles County, California",6052,104440,4428,43,61,500,0,870,73.2,0.7,1,8.3,0,14.4,26.8,2249,1658,591,73.72,26.28,93,1565,17,574,110,2139,5.6,2.9,4.9,"25% - 50% P.O.C.","$95000 or more"
"06037574400","Census Tract 5744, Los Angeles County, California",5474,122262,3299,245,0,421,12,1272,60.3,4.5,0,7.7,0.2,23.2,39.7,1920,1577,343,82.14,17.86,86,1491,15,328,101,1819,5.5,4.4,5.3,"25% - 50% P.O.C.","$95000 or more"
"06037574500","Census Tract 5745, Los Angeles County, California",6631,100096,4286,345,0,599,0,1114,64.6,5.2,0,9,0,16.8,35.4,2267,2019,248,89.06,10.94,133,1886,99,149,232,2035,6.6,39.9,10.2,"25% - 50% P.O.C.","$95000 or more"
"06037574601","Census Tract 5746.01, Los Angeles County, California",2276,NA,1214,79,0,348,7,508,53.3,3.5,0,15.3,0.3,22.3,46.7,0,0,0,NA,NA,0,0,0,0,0,0,NA,NA,NA,"25% - 50% P.O.C.","N/A"
"06037574602","Census Tract 5746.02, Los Angeles County, California",1291,94688,778,19,0,183,0,249,60.3,1.5,0,14.2,0,19.3,39.7,535,472,63,88.22,11.78,38,434,7,56,45,490,8.1,11.1,8.4,"25% - 50% P.O.C.","$70000 - $95000"
"06037574700","Census Tract 5747, Los Angeles County, California",133,NA,99,15,0,4,0,15,74.4,11.3,0,3,0,11.3,25.6,0,0,0,NA,NA,0,0,0,0,0,0,NA,NA,NA,"25% - 50% P.O.C.","N/A"
"06037574800","Census Tract 5748, Los Angeles County, California",2961,70625,1845,357,15,251,0,398,62.3,12.1,0.5,8.5,0,13.4,37.7,1496,724,772,48.4,51.6,47,677,11,761,58,1438,6.5,1.4,3.9,"25% - 50% P.O.C.","$70000 - $95000"
"06037574901","Census Tract 5749.01, Los Angeles County, California",3697,121429,2313,35,12,388,0,766,62.6,0.9,0.3,10.5,0,20.7,37.4,1358,1057,301,77.84,22.16,76,981,11,290,87,1271,7.2,3.7,6.4,"25% - 50% P.O.C.","$95000 or more"
"06037574902","Census Tract 5749.02, Los Angeles County, California",5549,51108,2231,705,35,1369,0,952,40.2,12.7,0.6,24.7,0,17.2,59.8,1787,361,1426,20.2,79.8,35,326,100,1326,135,1652,9.7,7,7.6,"50% - 75% P.O.C.","$51000 - $70000"
"06037575001","Census Tract 5750.01, Los Angeles County, California",3688,83482,1397,552,0,847,0,763,37.9,15,0,23,0,20.7,62.1,1696,592,1104,34.91,65.09,49,543,12,1092,61,1635,8.3,1.1,3.6,"50% - 75% P.O.C.","$70000 - $95000"
"06037575002","Census Tract 5750.02, Los Angeles County, California",4843,75648,1884,428,0,773,0,1575,38.9,8.8,0,16,0,32.5,61.1,1870,748,1122,40,60,99,649,42,1080,141,1729,13.2,3.7,7.5,"50% - 75% P.O.C.","$70000 - $95000"
"06037575101","Census Tract 5751.01, Los Angeles County, California",4339,46250,588,646,46,608,0,2433,13.6,14.9,1.1,14,0,56.1,86.4,1458,300,1158,20.58,79.42,11,289,199,959,210,1248,3.7,17.2,14.4,"75% or more P.O.C.","Less than $51000"
"06037575102","Census Tract 5751.02, Los Angeles County, California",4151,36551,363,376,0,743,0,2537,8.7,9.1,0,17.9,0,61.1,91.3,1263,173,1090,13.7,86.3,41,132,171,919,212,1051,23.7,15.7,16.8,"75% or more P.O.C.","Less than $51000"
"06037575103","Census Tract 5751.03, Los Angeles County, California",5171,53933,927,753,102,747,64,2396,17.9,14.6,2,14.4,1.2,46.3,82.1,2039,323,1716,15.84,84.16,22,301,58,1658,80,1959,6.8,3.4,3.9,"75% or more P.O.C.","$51000 - $70000"
"06037575201","Census Tract 5752.01, Los Angeles County, California",4772,46050,147,577,0,1338,0,2629,3.1,12.1,0,28,0,55.1,96.9,1243,296,947,23.81,76.19,128,168,230,717,358,885,43.2,24.3,28.8,"75% or more P.O.C.","Less than $51000"
"06037575202","Census Tract 5752.02, Los Angeles County, California",4175,37750,74,332,0,962,0,2773,1.8,8,0,23,0,66.4,98.2,1236,210,1026,16.99,83.01,50,160,236,790,286,950,23.8,23,23.1,"75% or more P.O.C.","Less than $51000"
"06037575300","Census Tract 5753, Los Angeles County, California",4360,37969,333,449,21,857,31,2631,7.6,10.3,0.5,19.7,0.7,60.3,92.4,1306,165,1141,12.63,87.37,34,131,227,914,261,1045,20.6,19.9,20,"75% or more P.O.C.","Less than $51000"
"06037575401","Census Tract 5754.01, Los Angeles County, California",4788,32452,318,451,15,117,0,3855,6.6,9.4,0.3,2.4,0,80.5,93.4,1217,47,1170,3.86,96.14,23,24,336,834,359,858,48.9,28.7,29.5,"75% or more P.O.C.","Less than $51000"
"06037575402","Census Tract 5754.02, Los Angeles County, California",4129,46199,200,261,0,191,0,3415,4.8,6.3,0,4.6,0,82.7,95.2,989,108,881,10.92,89.08,50,58,287,594,337,652,46.3,32.6,34.1,"75% or more P.O.C.","Less than $51000"
"06037575500","Census Tract 5755, Los Angeles County, California",93,14271,12,0,0,0,0,81,12.9,0,0,0,0,87.1,87.1,41,0,41,0,100,0,0,0,41,0,41,NA,0,0,"75% or more P.O.C.","Less than $51000"
"06037575801","Census Tract 5758.01, Los Angeles County, California",2254,36573,270,243,0,60,0,1679,12,10.8,0,2.7,0,74.5,88,696,41,655,5.89,94.11,12,29,115,540,127,569,29.3,17.6,18.2,"75% or more P.O.C.","Less than $51000"
"06037575802","Census Tract 5758.02, Los Angeles County, California",5664,39432,601,461,15,291,139,4103,10.6,8.1,0.3,5.1,2.5,72.4,89.4,1633,180,1453,11.02,88.98,59,121,341,1112,400,1233,32.8,23.5,24.5,"75% or more P.O.C.","Less than $51000"
"06037575803","Census Tract 5758.03, Los Angeles County, California",3229,27235,542,260,11,339,0,1975,16.8,8.1,0.3,10.5,0,61.2,83.2,1289,161,1128,12.49,87.51,35,126,171,957,206,1083,21.7,15.2,16,"75% or more P.O.C.","Less than $51000"
"06037575901","Census Tract 5759.01, Los Angeles County, California",3553,54799,654,706,14,267,0,1797,18.4,19.9,0.4,7.5,0,50.6,81.6,1382,524,858,37.92,62.08,8,516,182,676,190,1192,1.5,21.2,13.7,"75% or more P.O.C.","$51000 - $70000"
"06037575902","Census Tract 5759.02, Los Angeles County, California",5208,44855,1978,802,0,357,0,1823,38,15.4,0,6.9,0,35,62,2970,371,2599,12.49,87.51,0,371,87,2512,87,2883,0,3.3,2.9,"50% - 75% P.O.C.","Less than $51000"
"06037576001","Census Tract 5760.01, Los Angeles County, California",5174,80462,2635,710,0,971,74,659,50.9,13.7,0,18.8,1.4,12.7,49.1,3238,1120,2118,34.59,65.41,0,1120,0,2118,0,3238,0,0,0,"25% - 50% P.O.C.","$70000 - $95000"
"06037576200","Census Tract 5762, Los Angeles County, California",5324,35870,1586,1074,0,303,38,1867,29.8,20.2,0,5.7,0.7,35.1,70.2,2976,445,2531,14.95,85.05,0,445,90,2441,90,2886,0,3.6,3,"50% - 75% P.O.C.","Less than $51000"
"06037576301","Census Tract 5763.01, Los Angeles County, California",4165,39023,553,902,44,581,55,1837,13.3,21.7,1.1,13.9,1.3,44.1,86.7,1819,170,1649,9.35,90.65,0,170,112,1537,112,1707,0,6.8,6.2,"75% or more P.O.C.","Less than $51000"
"06037576302","Census Tract 5763.02, Los Angeles County, California",4077,42721,457,467,0,840,0,2235,11.2,11.5,0,20.6,0,54.8,88.8,1224,108,1116,8.82,91.18,19,89,274,842,293,931,17.6,24.6,23.9,"75% or more P.O.C.","Less than $51000"
"06037576401","Census Tract 5764.01, Los Angeles County, California",5021,47083,302,570,0,475,0,3344,6,11.4,0,9.5,0,66.6,94,1233,80,1153,6.49,93.51,54,26,393,760,447,786,67.5,34.1,36.3,"75% or more P.O.C.","Less than $51000"
"06037576402","Census Tract 5764.02, Los Angeles County, California",5015,45400,474,633,2,453,12,3375,9.5,12.6,0,9,0.2,67.3,90.5,1348,298,1050,22.11,77.89,39,259,319,731,358,990,13.1,30.4,26.6,"75% or more P.O.C.","Less than $51000"
"06037576403","Census Tract 5764.03, Los Angeles County, California",5140,38921,586,883,0,566,11,3067,11.4,17.2,0,11,0.2,59.7,88.6,1440,215,1225,14.93,85.07,31,184,245,980,276,1164,14.4,20,19.2,"75% or more P.O.C.","Less than $51000"
"06037576501","Census Tract 5765.01, Los Angeles County, California",2986,36742,827,360,0,239,0,1286,27.7,12.1,0,8,0,43.1,72.3,1429,120,1309,8.4,91.6,18,102,73,1236,91,1338,15,5.6,6.4,"50% - 75% P.O.C.","Less than $51000"
"06037576502","Census Tract 5765.02, Los Angeles County, California",4658,54162,1496,527,39,239,0,2259,32.1,11.3,0.8,5.1,0,48.5,67.9,1955,383,1572,19.59,80.41,9,374,169,1403,178,1777,2.3,10.8,9.1,"50% - 75% P.O.C.","$51000 - $70000"
"06037576503","Census Tract 5765.03, Los Angeles County, California",4469,57679,1464,733,50,238,0,1779,32.8,16.4,1.1,5.3,0,39.8,67.2,1908,245,1663,12.84,87.16,25,220,57,1606,82,1826,10.2,3.4,4.3,"50% - 75% P.O.C.","$51000 - $70000"
"06037576601","Census Tract 5766.01, Los Angeles County, California",4293,55768,2311,445,0,104,41,1316,53.8,10.4,0,2.4,1,30.7,46.2,2789,509,2280,18.25,81.75,0,509,17,2263,17,2772,0,0.7,0.6,"25% - 50% P.O.C.","$51000 - $70000"
"06037576602","Census Tract 5766.02, Los Angeles County, California",4423,62409,2486,307,0,283,0,1118,56.2,6.9,0,6.4,0,25.3,43.8,2584,526,2058,20.36,79.64,0,526,36,2022,36,2548,0,1.7,1.4,"25% - 50% P.O.C.","$51000 - $70000"
"06037576700","Census Tract 5767, Los Angeles County, California",3935,73041,2456,349,0,384,5,606,62.4,8.9,0,9.8,0.1,15.4,37.6,2016,815,1201,40.43,59.57,0,815,0,1201,0,2016,0,0,0,"25% - 50% P.O.C.","$70000 - $95000"
"06037576801","Census Tract 5768.01, Los Angeles County, California",4070,49982,1511,508,0,453,0,1597,37.1,12.5,0,11.1,0,39.2,62.9,1926,416,1510,21.6,78.4,18,398,137,1373,155,1771,4.3,9.1,8,"50% - 75% P.O.C.","Less than $51000"
"06037576802","Census Tract 5768.02, Los Angeles County, California",4061,62240,1646,1091,0,421,11,775,40.5,26.9,0,10.4,0.3,19.1,59.5,1906,436,1470,22.88,77.12,0,436,108,1362,108,1798,0,7.3,5.7,"50% - 75% P.O.C.","$51000 - $70000"
"06037576901","Census Tract 5769.01, Los Angeles County, California",5357,31406,617,664,0,1004,0,3022,11.5,12.4,0,18.7,0,56.4,88.5,1775,162,1613,9.13,90.87,21,141,254,1359,275,1500,13,15.7,15.5,"75% or more P.O.C.","Less than $51000"
"06037576903","Census Tract 5769.03, Los Angeles County, California",3644,41378,612,450,0,557,0,1983,16.8,12.3,0,15.3,0,54.4,83.2,1336,221,1115,16.54,83.46,20,201,165,950,185,1151,9,14.8,13.8,"75% or more P.O.C.","Less than $51000"
"06037576904","Census Tract 5769.04, Los Angeles County, California",3157,52373,938,435,0,333,0,1307,29.7,13.8,0,10.5,0,41.4,70.3,1273,324,949,25.45,74.55,45,279,55,894,100,1173,13.9,5.8,7.9,"50% - 75% P.O.C.","$51000 - $70000"
"06037577000","Census Tract 5770, Los Angeles County, California",7288,70887,3034,865,32,1299,0,1765,41.6,11.9,0.4,17.8,0,24.2,58.4,3259,805,2454,24.7,75.3,3,802,118,2336,121,3138,0.4,4.8,3.7,"50% - 75% P.O.C.","$70000 - $95000"
"06037577100","Census Tract 5771, Los Angeles County, California",7185,79235,3883,477,0,595,0,1904,54,6.6,0,8.3,0,26.5,46,3330,1045,2285,31.38,68.62,0,1045,40,2245,40,3290,0,1.8,1.2,"25% - 50% P.O.C.","$70000 - $95000"
"06037577200","Census Tract 5772, Los Angeles County, California",5848,87708,3685,406,0,326,0,1325,63,6.9,0,5.6,0,22.7,37,3175,821,2354,25.86,74.14,29,792,16,2338,45,3130,3.5,0.7,1.4,"25% - 50% P.O.C.","$70000 - $95000"
"06037577300","Census Tract 5773, Los Angeles County, California",5431,86035,3728,103,0,321,0,1067,68.6,1.9,0,5.9,0,19.6,31.4,3167,726,2441,22.92,77.08,25,701,19,2422,44,3123,3.4,0.8,1.4,"25% - 50% P.O.C.","$70000 - $95000"
"06037577400","Census Tract 5774, Los Angeles County, California",2947,81250,2191,43,0,98,0,579,74.3,1.5,0,3.3,0,19.6,25.7,1560,507,1053,32.5,67.5,25,482,0,1053,25,1535,4.9,0,1.6,"25% - 50% P.O.C.","$70000 - $95000"
"06037577501","Census Tract 5775.01, Los Angeles County, California",3370,125125,2654,48,0,193,0,385,78.8,1.4,0,5.7,0,11.4,21.2,1710,1156,554,67.6,32.4,57,1099,0,554,57,1653,4.9,0,3.3,"Less than 25% P.O.C.","$95000 or more"
"06037577504","Census Tract 5775.04, Los Angeles County, California",1378,95929,1115,14,0,72,23,90,80.9,1,0,5.2,1.7,6.5,19.1,770,312,458,40.52,59.48,12,300,0,458,12,758,3.8,0,1.6,"Less than 25% P.O.C.","$95000 or more"
"06037577602","Census Tract 5776.02, Los Angeles County, California",3259,90583,2181,157,12,481,0,328,66.9,4.8,0.4,14.8,0,10.1,33.1,1616,1053,563,65.16,34.84,35,1018,0,563,35,1581,3.3,0,2.2,"25% - 50% P.O.C.","$70000 - $95000"
"06037577603","Census Tract 5776.03, Los Angeles County, California",8457,106337,5581,418,41,802,135,1308,66,4.9,0.5,9.5,1.6,15.5,34,3706,2599,1107,70.13,29.87,113,2486,15,1092,128,3578,4.3,1.4,3.5,"25% - 50% P.O.C.","$95000 or more"
"06037577604","Census Tract 5776.04, Los Angeles County, California",1367,99000,954,26,0,109,0,246,69.8,1.9,0,8,0,18,30.2,774,630,144,81.4,18.6,6,624,0,144,6,768,1,0,0.8,"25% - 50% P.O.C.","$95000 or more"
"06037599000","Census Tract 5990, Los Angeles County, California",3684,74028,1568,4,0,2,1,2060,42.6,0.1,0,0.1,0,55.9,57.4,1471,405,1066,27.53,72.47,6,399,144,922,150,1321,1.5,13.5,10.2,"50% - 75% P.O.C.","$70000 - $95000"
"06037599100","Census Tract 5991, Los Angeles County, California",483,NA,348,14,0,15,51,47,72,2.9,0,3.1,10.6,9.7,28,82,18,64,21.95,78.05,0,18,4,60,4,78,0,6.2,4.9,"25% - 50% P.O.C.","N/A"
"06037600100","Census Tract 6001, Los Angeles County, California",7410,35000,45,1756,0,21,0,5549,0.6,23.7,0,0.3,0,74.9,99.4,2180,361,1819,16.56,83.44,114,247,431,1388,545,1635,31.6,23.7,25,"75% or more P.O.C.","Less than $51000"
"06037600201","Census Tract 6002.01, Los Angeles County, California",5063,35081,65,2090,8,2,0,2853,1.3,41.3,0.2,0,0,56.3,98.7,1452,194,1258,13.36,86.64,72,122,227,1031,299,1153,37.1,18,20.6,"75% or more P.O.C.","Less than $51000"
"06037600202","Census Tract 6002.02, Los Angeles County, California",7767,34819,129,2626,0,1,0,4980,1.7,33.8,0,0,0,64.1,98.3,2201,580,1621,26.35,73.65,137,443,359,1262,496,1705,23.6,22.1,22.5,"75% or more P.O.C.","Less than $51000"
"06037600302","Census Tract 6003.02, Los Angeles County, California",3086,57188,16,1852,0,12,0,1146,0.5,60,0,0.4,0,37.1,99.5,1061,738,323,69.56,30.44,68,670,7,316,75,986,9.2,2.2,7.1,"75% or more P.O.C.","$51000 - $70000"
"06037600303","Census Tract 6003.03, Los Angeles County, California",3883,21429,73,1297,0,2,0,2485,1.9,33.4,0,0.1,0,64,98.1,1212,164,1048,13.53,86.47,42,122,163,885,205,1007,25.6,15.6,16.9,"75% or more P.O.C.","Less than $51000"
"06037600304","Census Tract 6003.04, Los Angeles County, California",3910,33262,5,1306,22,44,0,2488,0.1,33.4,0.6,1.1,0,63.6,99.9,1115,189,926,16.95,83.05,88,101,191,735,279,836,46.6,20.6,25,"75% or more P.O.C.","Less than $51000"
"06037600400","Census Tract 6004, Los Angeles County, California",4147,64625,101,3239,0,0,0,650,2.4,78.1,0,0,0,15.7,97.6,1542,847,695,54.93,45.07,105,742,71,624,176,1366,12.4,10.2,11.4,"75% or more P.O.C.","$51000 - $70000"
"06037600501","Census Tract 6005.01, Los Angeles County, California",2712,66908,38,1901,0,49,0,638,1.4,70.1,0,1.8,0,23.5,98.6,871,623,248,71.53,28.47,76,547,20,228,96,775,12.2,8.1,11,"75% or more P.O.C.","$51000 - $70000"
"06037600502","Census Tract 6005.02, Los Angeles County, California",2097,66542,135,858,0,85,0,997,6.4,40.9,0,4.1,0,47.5,93.6,635,447,188,70.39,29.61,78,369,44,144,122,513,17.4,23.4,19.2,"75% or more P.O.C.","$51000 - $70000"
"06037600601","Census Tract 6006.01, Los Angeles County, California",2653,80708,62,2111,8,3,0,348,2.3,79.6,0.3,0.1,0,13.1,97.7,920,553,367,60.11,39.89,35,518,53,314,88,832,6.3,14.4,9.6,"75% or more P.O.C.","$70000 - $95000"
"06037600602","Census Tract 6006.02, Los Angeles County, California",2542,42143,62,839,0,44,0,1586,2.4,33,0,1.7,0,62.4,97.6,696,38,658,5.46,94.54,21,17,137,521,158,538,55.3,20.8,22.7,"75% or more P.O.C.","Less than $51000"
"06037600702","Census Tract 6007.02, Los Angeles County, California",4306,98571,139,3304,0,0,0,822,3.2,76.7,0,0,0,19.1,96.8,1402,1053,349,75.11,24.89,164,889,23,326,187,1215,15.6,6.6,13.3,"75% or more P.O.C.","$95000 or more"
"06037600703","Census Tract 6007.03, Los Angeles County, California",1783,72500,12,1458,0,32,0,143,0.7,81.8,0,1.8,0,8,99.3,874,712,162,81.46,18.54,6,706,19,143,25,849,0.8,11.7,2.9,"75% or more P.O.C.","$70000 - $95000"
"06037600704","Census Tract 6007.04, Los Angeles County, California",3373,70054,175,2676,0,62,0,389,5.2,79.3,0,1.8,0,11.5,94.8,1215,535,680,44.03,55.97,78,457,0,680,78,1137,14.6,0,6.4,"75% or more P.O.C.","$70000 - $95000"
"06037600801","Census Tract 6008.01, Los Angeles County, California",3199,93125,38,2595,0,52,0,375,1.2,81.1,0,1.6,0,11.7,98.8,1232,1019,213,82.71,17.29,77,942,8,205,85,1147,7.6,3.8,6.9,"75% or more P.O.C.","$70000 - $95000"
"06037600802","Census Tract 6008.02, Los Angeles County, California",2485,69519,28,2105,0,42,28,211,1.1,84.7,0,1.7,1.1,8.5,98.9,1127,416,711,36.91,63.09,36,380,22,689,58,1069,8.7,3.1,5.1,"75% or more P.O.C.","$51000 - $70000"
"06037600902","Census Tract 6009.02, Los Angeles County, California",6491,41477,204,2444,0,84,0,3413,3.1,37.7,0,1.3,0,52.6,96.9,2375,499,1876,21.01,78.99,26,473,217,1659,243,2132,5.2,11.6,10.2,"75% or more P.O.C.","Less than $51000"
"06037600911","Census Tract 6009.11, Los Angeles County, California",3146,59688,318,1049,0,0,0,1665,10.1,33.3,0,0,0,52.9,89.9,1124,557,567,49.56,50.44,134,423,8,559,142,982,24.1,1.4,12.6,"75% or more P.O.C.","$51000 - $70000"
"06037600912","Census Tract 6009.12, Los Angeles County, California",5659,55568,280,787,0,31,0,4453,4.9,13.9,0,0.5,0,78.7,95.1,1447,681,766,47.06,52.94,167,514,223,543,390,1057,24.5,29.1,27,"75% or more P.O.C.","$51000 - $70000"
"06037601001","Census Tract 6010.01, Los Angeles County, California",2381,32143,58,1446,0,17,0,800,2.4,60.7,0,0.7,0,33.6,97.6,1072,147,925,13.71,86.29,35,112,111,814,146,926,23.8,12,13.6,"75% or more P.O.C.","Less than $51000"
"06037601002","Census Tract 6010.02, Los Angeles County, California",5167,53008,97,2367,203,101,0,2051,1.9,45.8,3.9,2,0,39.7,98.1,1894,402,1492,21.22,78.78,17,385,72,1420,89,1805,4.2,4.8,4.7,"75% or more P.O.C.","$51000 - $70000"
"06037601100","Census Tract 6011, Los Angeles County, California",6869,34849,135,1991,54,331,0,4248,2,29,0.8,4.8,0,61.8,98,2104,244,1860,11.6,88.4,50,194,484,1376,534,1570,20.5,26,25.4,"75% or more P.O.C.","Less than $51000"
"06037601202","Census Tract 6012.02, Los Angeles County, California",4000,67083,266,156,0,91,0,3448,6.7,3.9,0,2.3,0,86.2,93.3,978,540,438,55.21,44.79,244,296,82,356,326,652,45.2,18.7,33.3,"75% or more P.O.C.","$51000 - $70000"
"06037601211","Census Tract 6012.11, Los Angeles County, California",2880,44934,100,1077,0,9,26,1545,3.5,37.4,0,0.3,0.9,53.6,96.5,1050,147,903,14,86,16,131,62,841,78,972,10.9,6.9,7.4,"75% or more P.O.C.","Less than $51000"
"06037601212","Census Tract 6012.12, Los Angeles County, California",6774,44932,282,2143,13,70,378,3819,4.2,31.6,0.2,1,5.6,56.4,95.8,2068,340,1728,16.44,83.56,24,316,326,1402,350,1718,7.1,18.9,16.9,"75% or more P.O.C.","Less than $51000"
"06037601301","Census Tract 6013.01, Los Angeles County, California",1921,72679,254,1107,6,66,0,411,13.2,57.6,0.3,3.4,0,21.4,86.8,733,481,252,65.62,34.38,37,444,40,212,77,656,7.7,15.9,10.5,"75% or more P.O.C.","$70000 - $95000"
"06037601302","Census Tract 6013.02, Los Angeles County, California",7333,51857,781,3949,2,239,0,2228,10.7,53.9,0,3.3,0,30.4,89.3,2795,458,2337,16.39,83.61,82,376,134,2203,216,2579,17.9,5.7,7.7,"75% or more P.O.C.","$51000 - $70000"
"06037601303","Census Tract 6013.03, Los Angeles County, California",5084,50077,338,2566,24,192,10,1724,6.6,50.5,0.5,3.8,0.2,33.9,93.4,2075,306,1769,14.75,85.25,8,298,139,1630,147,1928,2.6,7.9,7.1,"75% or more P.O.C.","Less than $51000"
"06037601401","Census Tract 6014.01, Los Angeles County, California",5949,50094,442,1973,16,245,0,3025,7.4,33.2,0.3,4.1,0,50.8,92.6,1728,463,1265,26.79,73.21,69,394,153,1112,222,1506,14.9,12.1,12.8,"75% or more P.O.C.","Less than $51000"
"06037601402","Census Tract 6014.02, Los Angeles County, California",4793,62316,231,59,0,74,8,4368,4.8,1.2,0,1.5,0.2,91.1,95.2,1287,777,510,60.37,39.63,126,651,102,408,228,1059,16.2,20,17.7,"75% or more P.O.C.","$51000 - $70000"
"06037601501","Census Tract 6015.01, Los Angeles County, California",3918,42794,52,201,0,0,193,3464,1.3,5.1,0,0,4.9,88.4,98.7,1084,194,890,17.9,82.1,52,142,280,610,332,752,26.8,31.5,30.6,"75% or more P.O.C.","Less than $51000"
"06037601502","Census Tract 6015.02, Los Angeles County, California",4059,59239,105,31,0,117,0,3806,2.6,0.8,0,2.9,0,93.8,97.4,872,224,648,25.69,74.31,135,89,276,372,411,461,60.3,42.6,47.1,"75% or more P.O.C.","$51000 - $70000"
"06037601600","Census Tract 6016, Los Angeles County, California",4439,54607,55,41,0,318,153,3821,1.2,0.9,0,7.2,3.4,86.1,98.8,1057,405,652,38.32,61.68,217,188,131,521,348,709,53.6,20.1,32.9,"75% or more P.O.C.","$51000 - $70000"
"06037601700","Census Tract 6017, Los Angeles County, California",5126,39013,11,407,0,85,0,4459,0.2,7.9,0,1.7,0,87,99.8,1303,316,987,24.25,75.75,100,216,199,788,299,1004,31.6,20.2,22.9,"75% or more P.O.C.","Less than $51000"
"06037601801","Census Tract 6018.01, Los Angeles County, California",2834,40870,5,63,13,36,0,2710,0.2,2.2,0.5,1.3,0,95.6,99.8,802,297,505,37.03,62.97,51,246,117,388,168,634,17.2,23.2,20.9,"75% or more P.O.C.","Less than $51000"
"06037601802","Census Tract 6018.02, Los Angeles County, California",3945,63692,109,141,8,120,0,3567,2.8,3.6,0.2,3,0,90.4,97.2,998,331,667,33.17,66.83,107,224,173,494,280,718,32.3,25.9,28.1,"75% or more P.O.C.","$51000 - $70000"
"06037601900","Census Tract 6019, Los Angeles County, California",4847,50933,33,617,41,9,0,4110,0.7,12.7,0.8,0.2,0,84.8,99.3,1238,288,950,23.26,76.74,136,152,208,742,344,894,47.2,21.9,27.8,"75% or more P.O.C.","Less than $51000"
"06037602002","Census Tract 6020.02, Los Angeles County, California",3057,45846,115,421,0,134,0,2333,3.8,13.8,0,4.4,0,76.3,96.2,809,295,514,36.46,63.54,103,192,115,399,218,591,34.9,22.4,26.9,"75% or more P.O.C.","Less than $51000"
"06037602003","Census Tract 6020.03, Los Angeles County, California",4760,45948,75,455,0,61,0,4140,1.6,9.6,0,1.3,0,87,98.4,1258,439,819,34.9,65.1,132,307,206,613,338,920,30.1,25.2,26.9,"75% or more P.O.C.","Less than $51000"
"06037602004","Census Tract 6020.04, Los Angeles County, California",3709,51875,247,883,0,77,0,2483,6.7,23.8,0,2.1,0,66.9,93.3,1052,463,589,44.01,55.99,71,392,126,463,197,855,15.3,21.4,18.7,"75% or more P.O.C.","$51000 - $70000"
"06037602103","Census Tract 6021.03, Los Angeles County, California",6650,34645,157,1288,0,296,0,4705,2.4,19.4,0,4.5,0,70.8,97.6,2090,402,1688,19.23,80.77,65,337,298,1390,363,1727,16.2,17.7,17.4,"75% or more P.O.C.","Less than $51000"
"06037602104","Census Tract 6021.04, Los Angeles County, California",6091,51750,266,1150,0,174,0,4441,4.4,18.9,0,2.9,0,72.9,95.6,1739,366,1373,21.05,78.95,130,236,275,1098,405,1334,35.5,20,23.3,"75% or more P.O.C.","$51000 - $70000"
"06037602105","Census Tract 6021.05, Los Angeles County, California",4116,57391,454,660,0,196,0,2774,11,16,0,4.8,0,67.4,89,1248,274,974,21.96,78.04,77,197,153,821,230,1018,28.1,15.7,18.4,"75% or more P.O.C.","$51000 - $70000"
"06037602106","Census Tract 6021.06, Los Angeles County, California",5403,46581,696,843,0,726,0,3063,12.9,15.6,0,13.4,0,56.7,87.1,2001,373,1628,18.64,81.36,76,297,122,1506,198,1803,20.4,7.5,9.9,"75% or more P.O.C.","Less than $51000"
"06037602200","Census Tract 6022, Los Angeles County, California",7200,80077,1583,1091,3,647,117,3323,22,15.2,0,9,1.6,46.2,78,2577,1126,1451,43.69,56.31,142,984,128,1323,270,2307,12.6,8.8,10.5,"75% or more P.O.C.","$70000 - $95000"
"06037602301","Census Tract 6023.01, Los Angeles County, California",6311,100333,1706,291,0,299,33,3821,27,4.6,0,4.7,0.5,60.5,73,1886,1316,570,69.78,30.22,179,1137,154,416,333,1553,13.6,27,17.7,"50% - 75% P.O.C.","$95000 or more"
"06037602302","Census Tract 6023.02, Los Angeles County, California",4819,131824,2579,94,0,970,0,826,53.5,2,0,20.1,0,17.1,46.5,1844,1569,275,85.09,14.91,73,1496,32,243,105,1739,4.7,11.6,5.7,"25% - 50% P.O.C.","$95000 or more"
"06037602402","Census Tract 6024.02, Los Angeles County, California",6869,72939,912,825,0,808,26,4124,13.3,12,0,11.8,0.4,60,86.7,2085,1071,1014,51.37,48.63,108,963,187,827,295,1790,10.1,18.4,14.1,"75% or more P.O.C.","$70000 - $95000"
"06037602403","Census Tract 6024.03, Los Angeles County, California",5199,55833,315,890,0,449,101,3388,6.1,17.1,0,8.6,1.9,65.2,93.9,1666,239,1427,14.35,85.65,43,196,196,1231,239,1427,18,13.7,14.3,"75% or more P.O.C.","$51000 - $70000"
"06037602404","Census Tract 6024.04, Los Angeles County, California",5457,47541,425,712,0,471,0,3550,7.8,13,0,8.6,0,65.1,92.2,1818,257,1561,14.14,85.86,44,213,172,1389,216,1602,17.1,11,11.9,"75% or more P.O.C.","Less than $51000"
"06037602504","Census Tract 6025.04, Los Angeles County, California",4961,45421,467,1770,0,408,0,2245,9.4,35.7,0,8.2,0,45.3,90.6,1748,129,1619,7.38,92.62,48,81,170,1449,218,1530,37.2,10.5,12.5,"75% or more P.O.C.","Less than $51000"
"06037602505","Census Tract 6025.05, Los Angeles County, California",4590,37237,323,1469,0,39,21,2611,7,32,0,0.8,0.5,56.9,93,1660,74,1586,4.46,95.54,0,74,202,1384,202,1458,0,12.7,12.2,"75% or more P.O.C.","Less than $51000"
"06037602506","Census Tract 6025.06, Los Angeles County, California",4297,39016,179,1593,0,178,9,2044,4.2,37.1,0,4.1,0.2,47.6,95.8,1721,165,1556,9.59,90.41,19,146,162,1394,181,1540,11.5,10.4,10.5,"75% or more P.O.C.","Less than $51000"
"06037602507","Census Tract 6025.07, Los Angeles County, California",5122,52969,225,2901,0,273,0,1694,4.4,56.6,0,5.3,0,33.1,95.6,1835,191,1644,10.41,89.59,0,191,132,1512,132,1703,0,8,7.2,"75% or more P.O.C.","$51000 - $70000"
"06037602508","Census Tract 6025.08, Los Angeles County, California",6922,50112,568,2149,0,491,0,3572,8.2,31,0,7.1,0,51.6,91.8,2383,285,2098,11.96,88.04,61,224,247,1851,308,2075,21.4,11.8,12.9,"75% or more P.O.C.","Less than $51000"
"06037602509","Census Tract 6025.09, Los Angeles County, California",4457,68750,141,781,2,567,154,2786,3.2,17.5,0,12.7,3.5,62.5,96.8,1141,380,761,33.3,66.7,130,250,121,640,251,890,34.2,15.9,22,"75% or more P.O.C.","$51000 - $70000"
"06037602600","Census Tract 6026, Los Angeles County, California",8118,55882,475,5097,0,279,429,1381,5.9,62.8,0,3.4,5.3,17,94.1,2881,1789,1092,62.1,37.9,166,1623,139,953,305,2576,9.3,12.7,10.6,"75% or more P.O.C.","$51000 - $70000"
"06037602700","Census Tract 6027, Los Angeles County, California",3770,97288,215,2342,1,78,64,948,5.7,62.1,0,2.1,1.7,25.1,94.3,1276,1003,273,78.61,21.39,117,886,53,220,170,1106,11.7,19.4,13.3,"75% or more P.O.C.","$95000 or more"
"06037602801","Census Tract 6028.01, Los Angeles County, California",3718,38438,12,1447,0,30,0,2141,0.3,38.9,0,0.8,0,57.6,99.7,1247,423,824,33.92,66.08,113,310,41,783,154,1093,26.7,5,12.3,"75% or more P.O.C.","Less than $51000"
"06037602802","Census Tract 6028.02, Los Angeles County, California",5019,68097,33,2917,0,53,18,1986,0.7,58.1,0,1.1,0.4,39.6,99.3,1399,1153,246,82.42,17.58,195,958,0,246,195,1204,16.9,0,13.9,"75% or more P.O.C.","$51000 - $70000"
"06037602900","Census Tract 6029, Los Angeles County, California",4443,47353,136,615,0,233,0,3382,3.1,13.8,0,5.2,0,76.1,96.9,1316,690,626,52.43,47.57,112,578,150,476,262,1054,16.2,24,19.9,"75% or more P.O.C.","Less than $51000"
"06037603001","Census Tract 6030.01, Los Angeles County, California",7498,52656,213,2263,0,1760,0,3192,2.8,30.2,0,23.5,0,42.6,97.2,2421,791,1630,32.67,67.33,185,606,164,1466,349,2072,23.4,10.1,14.4,"75% or more P.O.C.","$51000 - $70000"
"06037603004","Census Tract 6030.04, Los Angeles County, California",1549,53889,69,424,0,591,0,458,4.5,27.4,0,38.2,0,29.6,95.5,634,163,471,25.71,74.29,9,154,21,450,30,604,5.5,4.5,4.7,"75% or more P.O.C.","$51000 - $70000"
"06037603005","Census Tract 6030.05, Los Angeles County, California",5928,50656,344,1810,0,1090,0,2518,5.8,30.5,0,18.4,0,42.5,94.2,1872,542,1330,28.95,71.05,69,473,160,1170,229,1643,12.7,12,12.2,"75% or more P.O.C.","Less than $51000"
"06037603006","Census Tract 6030.06, Los Angeles County, California",1898,58750,258,93,0,800,0,732,13.6,4.9,0,42.1,0,38.6,86.4,810,312,498,38.52,61.48,18,294,19,479,37,773,5.8,3.8,4.6,"75% or more P.O.C.","$51000 - $70000"
"06037603101","Census Tract 6031.01, Los Angeles County, California",4139,57188,553,569,0,1130,18,1738,13.4,13.7,0,27.3,0.4,42,86.6,1481,582,899,39.3,60.7,107,475,75,824,182,1299,18.4,8.3,12.3,"75% or more P.O.C.","$51000 - $70000"
"06037603102","Census Tract 6031.02, Los Angeles County, California",3664,58958,399,419,8,1051,0,1683,10.9,11.4,0.2,28.7,0,45.9,89.1,1318,416,902,31.56,68.44,101,315,76,826,177,1141,24.3,8.4,13.4,"75% or more P.O.C.","$51000 - $70000"
"06037603200","Census Tract 6032, Los Angeles County, California",3394,83899,396,435,0,1251,0,1166,11.7,12.8,0,36.9,0,34.4,88.3,1163,836,327,71.88,28.12,104,732,92,235,196,967,12.4,28.1,16.9,"75% or more P.O.C.","$70000 - $95000"
"06037603301","Census Tract 6033.01, Los Angeles County, California",3617,53226,407,134,0,1703,0,1144,11.3,3.7,0,47.1,0,31.6,88.7,1418,407,1011,28.7,71.3,27,380,39,972,66,1352,6.6,3.9,4.7,"75% or more P.O.C.","$51000 - $70000"
"06037603302","Census Tract 6033.02, Los Angeles County, California",4048,52722,428,243,51,1737,0,1501,10.6,6,1.3,42.9,0,37.1,89.4,1630,836,794,51.29,48.71,117,719,28,766,145,1485,14,3.5,8.9,"75% or more P.O.C.","$51000 - $70000"
"06037603400","Census Tract 6034, Los Angeles County, California",4113,63427,622,455,0,1040,208,1646,15.1,11.1,0,25.3,5.1,40,84.9,1421,823,598,57.92,42.08,93,730,106,492,199,1222,11.3,17.7,14,"75% or more P.O.C.","$51000 - $70000"
"06037603500","Census Tract 6035, Los Angeles County, California",3042,81797,388,347,0,732,9,1432,12.8,11.4,0,24.1,0.3,47.1,87.2,883,743,140,84.14,15.86,119,624,46,94,165,718,16,32.9,18.7,"75% or more P.O.C.","$70000 - $95000"
"06037603600","Census Tract 6036, Los Angeles County, California",4258,76447,922,375,0,1324,0,1500,21.7,8.8,0,31.1,0,35.2,78.3,1364,947,417,69.43,30.57,129,818,71,346,200,1164,13.6,17,14.7,"75% or more P.O.C.","$70000 - $95000"
"06037603702","Census Tract 6037.02, Los Angeles County, California",4777,81304,1493,104,0,1284,79,1745,31.3,2.2,0,26.9,1.7,36.5,68.7,1510,1275,235,84.44,15.56,207,1068,7,228,214,1296,16.2,3,14.2,"50% - 75% P.O.C.","$70000 - $95000"
"06037603703","Census Tract 6037.03, Los Angeles County, California",2491,93750,665,46,129,488,0,1032,26.7,1.8,5.2,19.6,0,41.4,73.3,806,710,96,88.09,11.91,114,596,4,92,118,688,16.1,4.2,14.6,"50% - 75% P.O.C.","$70000 - $95000"
"06037603704","Census Tract 6037.04, Los Angeles County, California",6609,52590,270,1683,0,286,0,4129,4.1,25.5,0,4.3,0,62.5,95.9,2112,344,1768,16.29,83.71,38,306,414,1354,452,1660,11,23.4,21.4,"75% or more P.O.C.","$51000 - $70000"
"06037603801","Census Tract 6038.01, Los Angeles County, California",4748,59085,546,810,23,434,15,2766,11.5,17.1,0.5,9.1,0.3,58.3,88.5,1500,328,1172,21.87,78.13,120,208,149,1023,269,1231,36.6,12.7,17.9,"75% or more P.O.C.","$51000 - $70000"
"06037603802","Census Tract 6038.02, Los Angeles County, California",4040,58716,499,272,10,498,169,2507,12.4,6.7,0.2,12.3,4.2,62.1,87.6,1154,454,700,39.34,60.66,69,385,186,514,255,899,15.2,26.6,22.1,"75% or more P.O.C.","$51000 - $70000"
"06037603900","Census Tract 6039, Los Angeles County, California",7666,51110,813,716,0,839,13,5139,10.6,9.3,0,10.9,0.2,67,89.4,2423,965,1458,39.83,60.17,133,832,220,1238,353,2070,13.8,15.1,14.6,"75% or more P.O.C.","$51000 - $70000"
"06037604001","Census Tract 6040.01, Los Angeles County, California",4207,67407,612,328,0,558,55,2600,14.5,7.8,0,13.3,1.3,61.8,85.5,1296,481,815,37.11,62.89,118,363,106,709,224,1072,24.5,13,17.3,"75% or more P.O.C.","$51000 - $70000"
"06037604002","Census Tract 6040.02, Los Angeles County, California",4856,61607,933,373,0,715,75,2670,19.2,7.7,0,14.7,1.5,55,80.8,1511,450,1061,29.78,70.22,116,334,187,874,303,1208,25.8,17.6,20.1,"75% or more P.O.C.","$51000 - $70000"
"06037604100","Census Tract 6041, Los Angeles County, California",7302,68740,1378,682,24,549,0,4513,18.9,9.3,0.3,7.5,0,61.8,81.1,2018,722,1296,35.78,64.22,124,598,335,961,459,1559,17.2,25.8,22.7,"75% or more P.O.C.","$51000 - $70000"
"06037609900","Census Tract 6099, Los Angeles County, California",2057,71071,532,49,0,131,2,1225,25.9,2.4,0,6.4,0.1,59.6,74.1,582,261,321,44.85,55.15,36,225,30,291,66,516,13.8,9.3,11.3,"50% - 75% P.O.C.","$70000 - $95000"
"06037620001","Census Tract 6200.01, Los Angeles County, California",4251,124844,2695,198,0,331,0,752,63.4,4.7,0,7.8,0,17.7,36.6,1400,679,721,48.5,51.5,139,540,20,701,159,1241,20.5,2.8,11.4,"25% - 50% P.O.C.","$95000 or more"
"06037620002","Census Tract 6200.02, Los Angeles County, California",3493,111688,2167,1,0,620,0,507,62,0,0,17.7,0,14.5,38,1449,455,994,31.4,68.6,50,405,7,987,57,1392,11,0.7,3.9,"25% - 50% P.O.C.","$95000 or more"
"06037620101","Census Tract 6201.01, Los Angeles County, California",5632,108170,3329,389,0,583,0,766,59.1,6.9,0,10.4,0,13.6,40.9,2115,1183,932,55.93,44.07,113,1070,57,875,170,1945,9.6,6.1,8,"25% - 50% P.O.C.","$95000 or more"
"06037620102","Census Tract 6201.02, Los Angeles County, California",3355,97396,2184,38,0,167,9,684,65.1,1.1,0,5,0.3,20.4,34.9,1453,475,978,32.69,67.31,45,430,43,935,88,1365,9.5,4.4,6.1,"25% - 50% P.O.C.","$95000 or more"
"06037620201","Census Tract 6202.01, Los Angeles County, California",1529,114886,1280,19,7,79,0,99,83.7,1.2,0.5,5.2,0,6.5,16.3,927,260,667,28.05,71.95,0,260,7,660,7,920,0,1,0.8,"Less than 25% P.O.C.","$95000 or more"
"06037620301","Census Tract 6203.01, Los Angeles County, California",4819,202333,3761,16,57,296,0,434,78,0.3,1.2,6.1,0,9,22,1634,1332,302,81.52,18.48,142,1190,35,267,177,1457,10.7,11.6,10.8,"Less than 25% P.O.C.","$95000 or more"
"06037620303","Census Tract 6203.03, Los Angeles County, California",4502,199408,3489,1,0,563,0,180,77.5,0,0,12.5,0,4,22.5,1553,1254,299,80.75,19.25,173,1081,22,277,195,1358,13.8,7.4,12.6,"Less than 25% P.O.C.","$95000 or more"
"06037620305","Census Tract 6203.05, Los Angeles County, California",5845,118542,4530,56,0,653,16,498,77.5,1,0,11.2,0.3,8.5,22.5,2430,1381,1049,56.83,43.17,129,1252,0,1049,129,2301,9.3,0,5.3,"Less than 25% P.O.C.","$95000 or more"
"06037620400","Census Tract 6204, Los Angeles County, California",5279,138906,3607,0,0,882,0,498,68.3,0,0,16.7,0,9.4,31.7,2041,1503,538,73.64,26.36,40,1463,25,513,65,1976,2.7,4.6,3.2,"25% - 50% P.O.C.","$95000 or more"
"06037620501","Census Tract 6205.01, Los Angeles County, California",5726,116602,3186,376,56,774,22,863,55.6,6.6,1,13.5,0.4,15.1,44.4,2085,1161,924,55.68,44.32,68,1093,111,813,179,1906,5.9,12,8.6,"25% - 50% P.O.C.","$95000 or more"
"06037620521","Census Tract 6205.21, Los Angeles County, California",3958,123050,2402,58,0,593,23,539,60.7,1.5,0,15,0.6,13.6,39.3,1547,693,854,44.8,55.2,34,659,46,808,80,1467,4.9,5.4,5.2,"25% - 50% P.O.C.","$95000 or more"
"06037620522","Census Tract 6205.22, Los Angeles County, California",5024,121000,2712,96,0,770,0,816,54,1.9,0,15.3,0,16.2,46,1822,907,915,49.78,50.22,24,883,67,848,91,1731,2.6,7.3,5,"25% - 50% P.O.C.","$95000 or more"
"06037620601","Census Tract 6206.01, Los Angeles County, California",5278,92684,2547,137,0,1033,0,1308,48.3,2.6,0,19.6,0,24.8,51.7,2201,1014,1187,46.07,53.93,34,980,48,1139,82,2119,3.4,4,3.7,"50% - 75% P.O.C.","$70000 - $95000"
"06037620602","Census Tract 6206.02, Los Angeles County, California",5040,129417,2981,0,14,823,0,977,59.1,0,0.3,16.3,0,19.4,40.9,1931,1533,398,79.39,20.61,22,1511,17,381,39,1892,1.4,4.3,2,"25% - 50% P.O.C.","$95000 or more"
"06037620701","Census Tract 6207.01, Los Angeles County, California",7211,107722,4257,482,43,825,0,1068,59,6.7,0.6,11.4,0,14.8,41,2820,1724,1096,61.13,38.87,102,1622,99,997,201,2619,5.9,9,7.1,"25% - 50% P.O.C.","$95000 or more"
"06037620702","Census Tract 6207.02, Los Angeles County, California",7375,155069,4475,209,0,1135,17,1088,60.7,2.8,0,15.4,0.2,14.8,39.3,2551,1824,727,71.5,28.5,93,1731,92,635,185,2366,5.1,12.7,7.3,"25% - 50% P.O.C.","$95000 or more"
"06037620800","Census Tract 6208, Los Angeles County, California",7844,156394,4946,40,0,1781,18,759,63.1,0.5,0,22.7,0.2,9.7,36.9,2717,2068,649,76.11,23.89,130,1938,48,601,178,2539,6.3,7.4,6.6,"25% - 50% P.O.C.","$95000 or more"
"06037620901","Census Tract 6209.01, Los Angeles County, California",2785,205750,1922,23,0,441,0,242,69,0.8,0,15.8,0,8.7,31,968,802,166,82.85,17.15,53,749,17,149,70,898,6.6,10.2,7.2,"25% - 50% P.O.C.","$95000 or more"
"06037620904","Census Tract 6209.04, Los Angeles County, California",2897,182831,2483,0,0,68,0,128,85.7,0,0,2.3,0,4.4,14.3,1157,744,413,64.3,35.7,50,694,11,402,61,1096,6.7,2.7,5.3,"Less than 25% P.O.C.","$95000 or more"
"06037621001","Census Tract 6210.01, Los Angeles County, California",4373,136285,3214,28,70,277,0,478,73.5,0.6,1.6,6.3,0,10.9,26.5,1883,1072,811,56.93,43.07,110,962,25,786,135,1748,10.3,3.1,7.2,"25% - 50% P.O.C.","$95000 or more"
"06037621002","Census Tract 6210.02, Los Angeles County, California",879,135991,782,6,0,55,0,29,89,0.7,0,6.3,0,3.3,11,481,197,284,40.96,59.04,12,185,0,284,12,469,6.1,0,2.5,"Less than 25% P.O.C.","$95000 or more"
"06037621004","Census Tract 6210.04, Los Angeles County, California",4086,124918,3337,3,0,196,0,387,81.7,0.1,0,4.8,0,9.5,18.3,2093,918,1175,43.86,56.14,73,845,42,1133,115,1978,8,3.6,5.5,"Less than 25% P.O.C.","$95000 or more"
"06037621102","Census Tract 6211.02, Los Angeles County, California",3069,179141,2211,18,30,169,0,325,72,0.6,1,5.5,0,10.6,28,1199,818,381,68.22,31.78,38,780,31,350,69,1130,4.6,8.1,5.8,"25% - 50% P.O.C.","$95000 or more"
"06037621104","Census Tract 6211.04, Los Angeles County, California",7132,139265,5691,137,19,316,0,612,79.8,1.9,0.3,4.4,0,8.6,20.2,3300,1240,2060,37.58,62.42,53,1187,58,2002,111,3189,4.3,2.8,3.4,"Less than 25% P.O.C.","$95000 or more"
"06037621201","Census Tract 6212.01, Los Angeles County, California",6724,120022,3821,42,37,692,0,1712,56.8,0.6,0.6,10.3,0,25.5,43.2,2489,1422,1067,57.13,42.87,69,1353,200,867,269,2220,4.9,18.7,10.8,"25% - 50% P.O.C.","$95000 or more"
"06037621204","Census Tract 6212.04, Los Angeles County, California",3052,109671,1974,159,0,443,1,342,64.7,5.2,0,14.5,0,11.2,35.3,1815,566,1249,31.18,68.82,0,566,0,1249,0,1815,0,0,0,"25% - 50% P.O.C.","$95000 or more"
"06037621301","Census Tract 6213.01, Los Angeles County, California",6973,113500,4601,228,0,978,0,749,66,3.3,0,14,0,10.7,34,2750,1440,1310,52.36,47.64,132,1308,18,1292,150,2600,9.2,1.4,5.5,"25% - 50% P.O.C.","$95000 or more"
"06037621324","Census Tract 6213.24, Los Angeles County, California",3740,92710,2531,95,0,440,0,418,67.7,2.5,0,11.8,0,11.2,32.3,2049,658,1391,32.11,67.89,0,658,0,1391,0,2049,0,0,0,"25% - 50% P.O.C.","$70000 - $95000"
"06037621326","Census Tract 6213.26, Los Angeles County, California",3017,102057,2196,52,0,183,0,437,72.8,1.7,0,6.1,0,14.5,27.2,1726,419,1307,24.28,75.72,9,410,0,1307,9,1717,2.1,0,0.5,"25% - 50% P.O.C.","$95000 or more"
"06037621400","Census Tract 6214, Los Angeles County, California",4305,107621,2996,177,33,412,0,454,69.6,4.1,0.8,9.6,0,10.5,30.4,1877,1004,873,53.49,46.51,104,900,23,850,127,1750,10.4,2.6,6.8,"25% - 50% P.O.C.","$95000 or more"
"06037650001","Census Tract 6500.01, Los Angeles County, California",5805,96250,1239,115,12,2505,0,1674,21.3,2,0.2,43.2,0,28.8,78.7,2094,1406,688,67.14,32.86,151,1255,60,628,211,1883,10.7,8.7,10.1,"75% or more P.O.C.","$95000 or more"
"06037650003","Census Tract 6500.03, Los Angeles County, California",3202,63906,743,186,0,824,7,1212,23.2,5.8,0,25.7,0.2,37.9,76.8,1163,371,792,31.9,68.1,65,306,38,754,103,1060,17.5,4.8,8.9,"75% or more P.O.C.","$51000 - $70000"
"06037650004","Census Tract 6500.04, Los Angeles County, California",4125,75994,1124,259,0,1687,0,811,27.2,6.3,0,40.9,0,19.7,72.8,1529,731,798,47.81,52.19,102,629,62,736,164,1365,14,7.8,10.7,"50% - 75% P.O.C.","$70000 - $95000"
"06037650101","Census Tract 6501.01, Los Angeles County, California",6018,112611,1072,79,20,3035,57,1381,17.8,1.3,0.3,50.4,0.9,22.9,82.2,2095,1653,442,78.9,21.1,138,1515,53,389,191,1904,8.3,12,9.1,"75% or more P.O.C.","$95000 or more"
"06037650102","Census Tract 6501.02, Los Angeles County, California",2211,90987,717,42,0,743,0,577,32.4,1.9,0,33.6,0,26.1,67.6,755,591,164,78.28,21.72,65,526,0,164,65,690,11,0,8.6,"50% - 75% P.O.C.","$70000 - $95000"
"06037650200","Census Tract 6502, Los Angeles County, California",5930,97054,2237,83,15,1628,9,1665,37.7,1.4,0.3,27.5,0.2,28.1,62.3,1895,1484,411,78.31,21.69,172,1312,60,351,232,1663,11.6,14.6,12.2,"50% - 75% P.O.C.","$95000 or more"
"06037650300","Census Tract 6503, Los Angeles County, California",6824,71250,2148,303,60,2159,56,1686,31.5,4.4,0.9,31.6,0.8,24.7,68.5,2520,1183,1337,46.94,53.06,99,1084,161,1176,260,2260,8.4,12,10.3,"50% - 75% P.O.C.","$70000 - $95000"
"06037650401","Census Tract 6504.01, Los Angeles County, California",4758,137024,2119,40,0,1605,0,743,44.5,0.8,0,33.7,0,15.6,55.5,1468,1132,336,77.11,22.89,108,1024,69,267,177,1291,9.5,20.5,12.1,"50% - 75% P.O.C.","$95000 or more"
"06037650501","Census Tract 6505.01, Los Angeles County, California",3044,115174,1564,0,12,851,0,459,51.4,0,0.4,28,0,15.1,48.6,1043,915,128,87.73,12.27,41,874,61,67,102,941,4.5,47.7,9.8,"25% - 50% P.O.C.","$95000 or more"
"06037650502","Census Tract 6505.02, Los Angeles County, California",4259,118558,1817,209,0,1158,0,936,42.7,4.9,0,27.2,0,22,57.3,1478,1018,460,68.88,31.12,116,902,52,408,168,1310,11.4,11.3,11.4,"50% - 75% P.O.C.","$95000 or more"
"06037650602","Census Tract 6506.02, Los Angeles County, California",7315,80379,1773,418,0,4102,18,819,24.2,5.7,0,56.1,0.2,11.2,75.8,2726,565,2161,20.73,79.27,52,513,91,2070,143,2583,9.2,4.2,5.2,"75% or more P.O.C.","$70000 - $95000"
"06037650603","Census Tract 6506.03, Los Angeles County, California",3849,87600,1673,223,0,1525,0,306,43.5,5.8,0,39.6,0,8,56.5,1492,878,614,58.85,41.15,75,803,48,566,123,1369,8.5,7.8,8.2,"50% - 75% P.O.C.","$70000 - $95000"
"06037650604","Census Tract 6506.04, Los Angeles County, California",5567,58413,1758,120,17,2440,357,769,31.6,2.2,0.3,43.8,6.4,13.8,68.4,2419,128,2291,5.29,94.71,0,128,81,2210,81,2338,0,3.5,3.3,"50% - 75% P.O.C.","$51000 - $70000"
"06037650605","Census Tract 6506.05, Los Angeles County, California",3064,80625,1079,38,21,1325,0,469,35.2,1.2,0.7,43.2,0,15.3,64.8,1120,342,778,30.54,69.46,0,342,49,729,49,1071,0,6.3,4.4,"50% - 75% P.O.C.","$70000 - $95000"
"06037650701","Census Tract 6507.01, Los Angeles County, California",2529,107500,1308,30,0,726,0,433,51.7,1.2,0,28.7,0,17.1,48.3,972,801,171,82.41,17.59,33,768,15,156,48,924,4.1,8.8,4.9,"25% - 50% P.O.C.","$95000 or more"
"06037650702","Census Tract 6507.02, Los Angeles County, California",4731,127429,2651,14,0,1036,0,764,56,0.3,0,21.9,0,16.1,44,1550,1352,198,87.23,12.77,137,1215,0,198,137,1413,10.1,0,8.8,"25% - 50% P.O.C.","$95000 or more"
"06037650800","Census Tract 6508, Los Angeles County, California",6423,89420,1605,116,0,3994,0,388,25,1.8,0,62.2,0,6,75,2758,1626,1132,58.96,41.04,34,1592,49,1083,83,2675,2.1,4.3,3,"75% or more P.O.C.","$70000 - $95000"
"06037650901","Census Tract 6509.01, Los Angeles County, California",5366,85025,2024,141,0,1254,0,1672,37.7,2.6,0,23.4,0,31.2,62.3,2342,1112,1230,47.48,52.52,84,1028,14,1216,98,2244,7.6,1.1,4.2,"50% - 75% P.O.C.","$70000 - $95000"
"06037650902","Census Tract 6509.02, Los Angeles County, California",6769,90857,1695,70,29,2557,0,2030,25,1,0.4,37.8,0,30,75,2629,1266,1363,48.16,51.84,54,1212,96,1267,150,2479,4.3,7,5.7,"75% or more P.O.C.","$70000 - $95000"
"06037651001","Census Tract 6510.01, Los Angeles County, California",5444,96101,1778,74,0,1352,110,1907,32.7,1.4,0,24.8,2,35,67.3,1799,1353,446,75.21,24.79,86,1267,99,347,185,1614,6.4,22.2,10.3,"50% - 75% P.O.C.","$95000 or more"
"06037651002","Census Tract 6510.02, Los Angeles County, California",4702,89507,1559,241,65,1634,13,977,33.2,5.1,1.4,34.8,0.3,20.8,66.8,1703,1066,637,62.6,37.4,121,945,40,597,161,1542,11.4,6.3,9.5,"50% - 75% P.O.C.","$70000 - $95000"
"06037651101","Census Tract 6511.01, Los Angeles County, California",5036,99750,1887,47,111,2468,0,375,37.5,0.9,2.2,49,0,7.4,62.5,1850,1045,805,56.49,43.51,55,990,56,749,111,1739,5.3,7,6,"50% - 75% P.O.C.","$95000 or more"
"06037651102","Census Tract 6511.02, Los Angeles County, California",3534,77350,1601,63,0,1224,0,536,45.3,1.8,0,34.6,0,15.2,54.7,1645,789,856,47.96,52.04,36,753,45,811,81,1564,4.6,5.3,4.9,"50% - 75% P.O.C.","$70000 - $95000"
"06037651201","Census Tract 6512.01, Los Angeles County, California",5018,139643,2972,54,0,968,59,729,59.2,1.1,0,19.3,1.2,14.5,40.8,1634,1498,136,91.68,8.32,172,1326,9,127,181,1453,11.5,6.6,11.1,"25% - 50% P.O.C.","$95000 or more"
"06037651221","Census Tract 6512.21, Los Angeles County, California",3697,92083,1057,193,10,1755,0,540,28.6,5.2,0.3,47.5,0,14.6,71.4,1395,413,982,29.61,70.39,0,413,90,892,90,1305,0,9.2,6.5,"50% - 75% P.O.C.","$70000 - $95000"
"06037651222","Census Tract 6512.22, Los Angeles County, California",6459,89207,2081,267,0,2882,0,1015,32.2,4.1,0,44.6,0,15.7,67.8,2329,691,1638,29.67,70.33,88,603,45,1593,133,2196,12.7,2.7,5.7,"50% - 75% P.O.C.","$70000 - $95000"
"06037651302","Census Tract 6513.02, Los Angeles County, California",6204,124844,3857,176,14,843,13,724,62.2,2.8,0.2,13.6,0.2,11.7,37.8,2287,1715,572,74.99,25.01,151,1564,23,549,174,2113,8.8,4,7.6,"25% - 50% P.O.C.","$95000 or more"
"06037651304","Census Tract 6513.04, Los Angeles County, California",4852,86690,3352,201,0,277,0,540,69.1,4.1,0,5.7,0,11.1,30.9,2327,1152,1175,49.51,50.49,31,1121,7,1168,38,2289,2.7,0.6,1.6,"25% - 50% P.O.C.","$70000 - $95000"
"06037651401","Census Tract 6514.01, Los Angeles County, California",2521,90938,1496,19,0,710,0,232,59.3,0.8,0,28.2,0,9.2,40.7,1127,751,376,66.64,33.36,40,711,15,361,55,1072,5.3,4,4.9,"25% - 50% P.O.C.","$70000 - $95000"
"06037651402","Census Tract 6514.02, Los Angeles County, California",6236,101341,2430,31,128,2459,0,700,39,0.5,2.1,39.4,0,11.2,61,2293,1392,901,60.71,39.29,140,1252,78,823,218,2075,10.1,8.7,9.5,"50% - 75% P.O.C.","$95000 or more"
"06037670001","Census Tract 6700.01, Los Angeles County, California",3406,69766,1280,275,0,511,0,1171,37.6,8.1,0,15,0,34.4,62.4,1335,865,470,64.79,35.21,56,809,39,431,95,1240,6.5,8.3,7.1,"50% - 75% P.O.C.","$51000 - $70000"
"06037670002","Census Tract 6700.02, Los Angeles County, California",3939,75662,1264,199,52,758,0,1518,32.1,5.1,1.3,19.2,0,38.5,67.9,1463,613,850,41.9,58.1,107,506,83,767,190,1273,17.5,9.8,13,"50% - 75% P.O.C.","$70000 - $95000"
"06037670003","Census Tract 6700.03, Los Angeles County, California",5707,76667,2716,131,0,917,69,1726,47.6,2.3,0,16.1,1.2,30.2,52.4,2266,1146,1120,50.57,49.43,156,990,0,1120,156,2110,13.6,0,6.9,"50% - 75% P.O.C.","$70000 - $95000"
"06037670100","Census Tract 6701, Los Angeles County, California",6642,62244,2456,648,0,1042,0,2018,37,9.8,0,15.7,0,30.4,63,2748,1058,1690,38.5,61.5,44,1014,69,1621,113,2635,4.2,4.1,4.1,"50% - 75% P.O.C.","$51000 - $70000"
"06037670201","Census Tract 6702.01, Los Angeles County, California",3820,146771,2445,26,0,823,0,402,64,0.7,0,21.5,0,10.5,36,1441,1174,267,81.47,18.53,133,1041,0,267,133,1308,11.3,0,9.2,"25% - 50% P.O.C.","$95000 or more"
"06037670202","Census Tract 6702.02, Los Angeles County, California",2637,192188,1473,25,0,534,0,481,55.9,0.9,0,20.3,0,18.2,44.1,889,846,43,95.16,4.84,68,778,2,41,70,819,8,4.7,7.9,"25% - 50% P.O.C.","$95000 or more"
"06037670324","Census Tract 6703.24, Los Angeles County, California",5091,214681,3776,29,0,743,0,396,74.2,0.6,0,14.6,0,7.8,25.8,1852,1600,252,86.39,13.61,172,1428,12,240,184,1668,10.8,4.8,9.9,"25% - 50% P.O.C.","$95000 or more"
"06037670326","Census Tract 6703.26, Los Angeles County, California",3613,158125,2147,0,2,1127,0,264,59.4,0,0.1,31.2,0,7.3,40.6,1338,1197,141,89.46,10.54,87,1110,32,109,119,1219,7.3,22.7,8.9,"25% - 50% P.O.C.","$95000 or more"
"06037670328","Census Tract 6703.28, Los Angeles County, California",4730,193262,2859,22,0,1213,0,385,60.4,0.5,0,25.6,0,8.1,39.6,1719,1435,284,83.48,16.52,167,1268,22,262,189,1530,11.6,7.7,11,"25% - 50% P.O.C.","$95000 or more"
"06037670403","Census Tract 6704.03, Los Angeles County, California",2733,153667,1422,26,0,1049,6,116,52,1,0,38.4,0.2,4.2,48,992,892,100,89.92,10.08,43,849,18,82,61,931,4.8,18,6.1,"25% - 50% P.O.C.","$95000 or more"
"06037670405","Census Tract 6704.05, Los Angeles County, California",2864,98533,1627,60,0,999,0,52,56.8,2.1,0,34.9,0,1.8,43.2,1127,885,242,78.53,21.47,63,822,0,242,63,1064,7.1,0,5.6,"25% - 50% P.O.C.","$95000 or more"
"06037670406","Census Tract 6704.06, Los Angeles County, California",1759,186667,752,94,6,806,0,21,42.8,5.3,0.3,45.8,0,1.2,57.2,660,629,31,95.3,4.7,56,573,0,31,56,604,8.9,0,8.5,"50% - 75% P.O.C.","$95000 or more"
"06037670407","Census Tract 6704.07, Los Angeles County, California",6269,94963,1907,193,0,3274,100,565,30.4,3.1,0,52.2,1.6,9,69.6,2345,1181,1164,50.36,49.64,100,1081,88,1076,188,2157,8.5,7.6,8,"50% - 75% P.O.C.","$70000 - $95000"
"06037670411","Census Tract 6704.11, Los Angeles County, California",4356,162614,2679,79,0,1037,98,214,61.5,1.8,0,23.8,2.2,4.9,38.5,1539,1370,169,89.02,10.98,109,1261,25,144,134,1405,8,14.8,8.7,"25% - 50% P.O.C.","$95000 or more"
"06037670413","Census Tract 6704.13, Los Angeles County, California",4433,143721,1886,37,0,2084,0,346,42.5,0.8,0,47,0,7.8,57.5,1710,1359,351,79.47,20.53,40,1319,53,298,93,1617,2.9,15.1,5.4,"50% - 75% P.O.C.","$95000 or more"
"06037670416","Census Tract 6704.16, Los Angeles County, California",4513,97788,1665,238,31,1567,0,726,36.9,5.3,0.7,34.7,0,16.1,63.1,1661,1030,631,62.01,37.99,50,980,134,497,184,1477,4.9,21.2,11.1,"50% - 75% P.O.C.","$95000 or more"
"06037670500","Census Tract 6705, Los Angeles County, California",1513,250001,1079,22,0,236,0,88,71.3,1.5,0,15.6,0,5.8,28.7,577,550,27,95.32,4.68,62,488,9,18,71,506,11.3,33.3,12.3,"25% - 50% P.O.C.","$95000 or more"
"06037670602","Census Tract 6706.02, Los Angeles County, California",6862,155688,4059,80,0,1553,0,554,59.2,1.2,0,22.6,0,8.1,40.8,2579,2156,423,83.6,16.4,139,2017,60,363,199,2380,6.4,14.2,7.7,"25% - 50% P.O.C.","$95000 or more"
"06037670701","Census Tract 6707.01, Los Angeles County, California",7185,132527,3592,29,16,1300,150,1841,50,0.4,0.2,18.1,2.1,25.6,50,2497,2053,444,82.22,17.78,159,1894,28,416,187,2310,7.7,6.3,7.5,"50% - 75% P.O.C.","$95000 or more"
"06037670702","Census Tract 6707.02, Los Angeles County, California",5649,200292,3871,63,24,851,13,476,68.5,1.1,0.4,15.1,0.2,8.4,31.5,2021,1899,122,93.96,6.04,214,1685,0,122,214,1807,11.3,0,10.6,"25% - 50% P.O.C.","$95000 or more"
"06037700101","Census Tract 7001.01, Los Angeles County, California",5200,57260,4218,179,4,121,50,544,81.1,3.4,0.1,2.3,1,10.5,18.9,3506,146,3360,4.16,95.84,0,146,5,3355,5,3501,0,0.1,0.1,"Less than 25% P.O.C.","$51000 - $70000"
"06037700102","Census Tract 7001.02, Los Angeles County, California",4506,43202,3150,250,0,292,0,591,69.9,5.5,0,6.5,0,13.1,30.1,2785,91,2694,3.27,96.73,0,91,31,2663,31,2754,0,1.2,1.1,"25% - 50% P.O.C.","Less than $51000"
"06037700200","Census Tract 7002, Los Angeles County, California",7446,70580,5457,361,43,362,0,738,73.3,4.8,0.6,4.9,0,9.9,26.7,4541,526,4015,11.58,88.42,0,526,0,4015,0,4541,0,0,0,"25% - 50% P.O.C.","$70000 - $95000"
"06037700300","Census Tract 7003, Los Angeles County, California",6223,94315,4919,161,0,271,0,482,79,2.6,0,4.4,0,7.7,21,4033,970,3063,24.05,75.95,0,970,0,3063,0,4033,0,0,0,"Less than 25% P.O.C.","$70000 - $95000"
"06037700400","Census Tract 7004, Los Angeles County, California",5162,104338,3986,77,0,353,0,386,77.2,1.5,0,6.8,0,7.5,22.8,3173,906,2267,28.55,71.45,0,906,0,2267,0,3173,0,0,0,"Less than 25% P.O.C.","$95000 or more"
"06037700501","Census Tract 7005.01, Los Angeles County, California",3526,76637,2306,227,0,340,49,482,65.4,6.4,0,9.6,1.4,13.7,34.6,2351,898,1453,38.2,61.8,0,898,0,1453,0,2351,0,0,0,"25% - 50% P.O.C.","$70000 - $95000"
"06037700502","Census Tract 7005.02, Los Angeles County, California",4387,73500,3444,49,0,305,0,523,78.5,1.1,0,7,0,11.9,21.5,2980,930,2050,31.21,68.79,16,914,0,2050,16,2964,1.7,0,0.5,"Less than 25% P.O.C.","$70000 - $95000"
"06037700600","Census Tract 7006, Los Angeles County, California",5021,191066,4500,33,0,75,0,146,89.6,0.7,0,1.5,0,2.9,10.4,1728,1609,119,93.11,6.89,204,1405,62,57,266,1462,12.7,52.1,15.4,"Less than 25% P.O.C.","$95000 or more"
"06037700700","Census Tract 7007, Los Angeles County, California",3575,184393,3081,3,17,117,0,167,86.2,0.1,0.5,3.3,0,4.7,13.8,1131,1043,88,92.22,7.78,220,823,31,57,251,880,21.1,35.2,22.2,"Less than 25% P.O.C.","$95000 or more"
"06037700801","Census Tract 7008.01, Los Angeles County, California",4610,83333,3349,76,0,654,0,311,72.6,1.6,0,14.2,0,6.7,27.4,2446,823,1623,33.65,66.35,38,785,0,1623,38,2408,4.6,0,1.6,"25% - 50% P.O.C.","$70000 - $95000"
"06037700802","Census Tract 7008.02, Los Angeles County, California",4092,85078,2808,318,0,446,0,441,68.6,7.8,0,10.9,0,10.8,31.4,1924,387,1537,20.11,79.89,24,363,48,1489,72,1852,6.2,3.1,3.7,"25% - 50% P.O.C.","$70000 - $95000"
"06037700901","Census Tract 7009.01, Los Angeles County, California",3600,86143,2662,42,0,460,0,242,73.9,1.2,0,12.8,0,6.7,26.1,1554,700,854,45.05,54.95,59,641,0,854,59,1495,8.4,0,3.8,"25% - 50% P.O.C.","$70000 - $95000"
"06037700902","Census Tract 7009.02, Los Angeles County, California",7352,90444,5470,127,0,936,0,504,74.4,1.7,0,12.7,0,6.9,25.6,3334,665,2669,19.95,80.05,69,596,62,2607,131,3203,10.4,2.3,3.9,"25% - 50% P.O.C.","$70000 - $95000"
"06037701000","Census Tract 7010, Los Angeles County, California",5936,100391,4731,66,45,409,0,206,79.7,1.1,0.8,6.9,0,3.5,20.3,2652,901,1751,33.97,66.03,122,779,0,1751,122,2530,13.5,0,4.6,"Less than 25% P.O.C.","$95000 or more"
"06037701100","Census Tract 7011, Los Angeles County, California",1101,45536,405,247,0,106,0,292,36.8,22.4,0,9.6,0,26.5,63.2,48,17,31,35.42,64.58,0,17,12,19,12,36,0,38.7,25,"50% - 75% P.O.C.","Less than $51000"
"06037701201","Census Tract 7012.01, Los Angeles County, California",4088,234519,3189,0,0,443,0,340,78,0,0,10.8,0,8.3,22,1437,1295,142,90.12,9.88,105,1190,14,128,119,1318,8.1,9.9,8.3,"Less than 25% P.O.C.","$95000 or more"
"06037701202","Census Tract 7012.02, Los Angeles County, California",3381,126875,2669,111,0,326,0,176,78.9,3.3,0,9.6,0,5.2,21.1,1684,567,1117,33.67,66.33,15,552,0,1117,15,1669,2.6,0,0.9,"Less than 25% P.O.C.","$95000 or more"
"06037701302","Census Tract 7013.02, Los Angeles County, California",4868,92023,3774,3,0,517,0,397,77.5,0.1,0,10.6,0,8.2,22.5,2775,510,2265,18.38,81.62,0,510,0,2265,0,2775,0,0,0,"Less than 25% P.O.C.","$70000 - $95000"
"06037701304","Census Tract 7013.04, Los Angeles County, California",6212,126713,4703,90,0,545,0,589,75.7,1.4,0,8.8,0,9.5,24.3,3012,1557,1455,51.69,48.31,180,1377,29,1426,209,2803,11.6,2,6.9,"Less than 25% P.O.C.","$95000 or more"
"06037701402","Census Tract 7014.02, Los Angeles County, California",5577,103590,4070,345,0,372,0,523,73,6.2,0,6.7,0,9.4,27,3558,428,3130,12.03,87.97,0,428,32,3098,32,3526,0,1,0.9,"25% - 50% P.O.C.","$95000 or more"
"06037701501","Census Tract 7015.01, Los Angeles County, California",5267,107621,3839,103,0,488,30,349,72.9,2,0,9.3,0.6,6.6,27.1,2669,510,2159,19.11,80.89,27,483,54,2105,81,2588,5.3,2.5,3,"25% - 50% P.O.C.","$95000 or more"
"06037701502","Census Tract 7015.02, Los Angeles County, California",3530,95417,2445,99,0,443,9,394,69.3,2.8,0,12.5,0.3,11.2,30.7,1731,352,1379,20.34,79.66,11,341,9,1370,20,1711,3.1,0.7,1.2,"25% - 50% P.O.C.","$95000 or more"
"06037701601","Census Tract 7016.01, Los Angeles County, California",4194,136500,3022,28,0,559,0,267,72.1,0.7,0,13.3,0,6.4,27.9,1730,963,767,55.66,44.34,70,893,0,767,70,1660,7.3,0,4,"25% - 50% P.O.C.","$95000 or more"
"06037701602","Census Tract 7016.02, Los Angeles County, California",3987,106923,2360,257,0,461,0,707,59.2,6.4,0,11.6,0,17.7,40.8,1874,613,1261,32.71,67.29,0,613,64,1197,64,1810,0,5.1,3.4,"25% - 50% P.O.C.","$95000 or more"
"06037701701","Census Tract 7017.01, Los Angeles County, California",3305,75417,1866,217,23,308,3,671,56.5,6.6,0.7,9.3,0.1,20.3,43.5,1742,465,1277,26.69,73.31,0,465,39,1238,39,1703,0,3.1,2.2,"25% - 50% P.O.C.","$70000 - $95000"
"06037701702","Census Tract 7017.02, Los Angeles County, California",3437,67619,1874,249,11,421,0,732,54.5,7.2,0.3,12.2,0,21.3,45.5,1808,214,1594,11.84,88.16,32,182,52,1542,84,1724,15,3.3,4.6,"25% - 50% P.O.C.","$51000 - $70000"
"06037701801","Census Tract 7018.01, Los Angeles County, California",7001,65888,2206,553,0,1460,17,2652,31.5,7.9,0,20.9,0.2,37.9,68.5,2771,489,2282,17.65,82.35,5,484,212,2070,217,2554,1,9.3,7.8,"50% - 75% P.O.C.","$51000 - $70000"
"06037701802","Census Tract 7018.02, Los Angeles County, California",4645,68828,1825,415,15,328,0,1784,39.3,8.9,0.3,7.1,0,38.4,60.7,1803,327,1476,18.14,81.86,29,298,92,1384,121,1682,8.9,6.2,6.7,"50% - 75% P.O.C.","$51000 - $70000"
"06037701902","Census Tract 7019.02, Los Angeles County, California",4659,67422,3085,614,0,289,0,391,66.2,13.2,0,6.2,0,8.4,33.8,3054,124,2930,4.06,95.94,0,124,0,2930,0,3054,0,0,0,"25% - 50% P.O.C.","$51000 - $70000"
"06037702002","Census Tract 7020.02, Los Angeles County, California",6443,91859,4050,441,0,315,0,1308,62.9,6.8,0,4.9,0,20.3,37.1,3465,828,2637,23.9,76.1,9,819,30,2607,39,3426,1.1,1.1,1.1,"25% - 50% P.O.C.","$70000 - $95000"
"06037702102","Census Tract 7021.02, Los Angeles County, California",6065,81727,4425,169,26,355,0,651,73,2.8,0.4,5.9,0,10.7,27,3677,768,2909,20.89,79.11,55,713,0,2909,55,3622,7.2,0,1.5,"25% - 50% P.O.C.","$70000 - $95000"
"06037702201","Census Tract 7022.01, Los Angeles County, California",4110,90769,2740,105,0,403,28,532,66.7,2.6,0,9.8,0.7,12.9,33.3,2044,801,1243,39.19,60.81,14,787,7,1236,21,2023,1.7,0.6,1,"25% - 50% P.O.C.","$70000 - $95000"
"06037702202","Census Tract 7022.02, Los Angeles County, California",3969,121719,2652,79,0,307,0,648,66.8,2,0,7.7,0,16.3,33.2,1658,885,773,53.38,46.62,69,816,16,757,85,1573,7.8,2.1,5.1,"25% - 50% P.O.C.","$95000 or more"
"06037702300","Census Tract 7023, Los Angeles County, California",6839,114514,4406,117,11,678,0,986,64.4,1.7,0.2,9.9,0,14.4,35.6,2817,1442,1375,51.19,48.81,32,1410,81,1294,113,2704,2.2,5.9,4,"25% - 50% P.O.C.","$95000 or more"
"06037702400","Census Tract 7024, Los Angeles County, California",4367,78594,1959,300,0,642,0,1239,44.9,6.9,0,14.7,0,28.4,55.1,1965,554,1411,28.19,71.81,59,495,0,1411,59,1906,10.6,0,3,"50% - 75% P.O.C.","$70000 - $95000"
"06037702501","Census Tract 7025.01, Los Angeles County, California",4965,111136,3070,132,0,635,0,912,61.8,2.7,0,12.8,0,18.4,38.2,1996,1096,900,54.91,45.09,22,1074,89,811,111,1885,2,9.9,5.6,"25% - 50% P.O.C.","$95000 or more"
"06037702502","Census Tract 7025.02, Los Angeles County, California",3757,86959,1912,621,0,523,0,602,50.9,16.5,0,13.9,0,16,49.1,2016,1255,761,62.25,37.75,0,1255,0,761,0,2016,0,0,0,"25% - 50% P.O.C.","$70000 - $95000"
"06037702600","Census Tract 7026, Los Angeles County, California",6389,120671,2963,472,0,1156,38,1247,46.4,7.4,0,18.1,0.6,19.5,53.6,2327,1771,556,76.11,23.89,68,1703,45,511,113,2214,3.8,8.1,4.9,"50% - 75% P.O.C.","$95000 or more"
"06037702700","Census Tract 7027, Los Angeles County, California",3435,135430,1765,85,0,548,0,706,51.4,2.5,0,16,0,20.6,48.6,1271,950,321,74.74,25.26,47,903,0,321,47,1224,4.9,0,3.7,"25% - 50% P.O.C.","$95000 or more"
"06037702801","Census Tract 7028.01, Los Angeles County, California",4679,62061,1782,178,8,891,0,1616,38.1,3.8,0.2,19,0,34.5,61.9,2048,737,1311,35.99,64.01,84,653,39,1272,123,1925,11.4,3,6,"50% - 75% P.O.C.","$51000 - $70000"
"06037702802","Census Tract 7028.02, Los Angeles County, California",2293,90438,1168,47,0,147,0,869,50.9,2,0,6.4,0,37.9,49.1,887,460,427,51.86,48.14,39,421,32,395,71,816,8.5,7.5,8,"25% - 50% P.O.C.","$70000 - $95000"
"06037702803","Census Tract 7028.03, Los Angeles County, California",3063,63485,1129,107,46,377,0,1251,36.9,3.5,1.5,12.3,0,40.8,63.1,1222,356,866,29.13,70.87,8,348,48,818,56,1166,2.2,5.5,4.6,"50% - 75% P.O.C.","$51000 - $70000"
"06037702901","Census Tract 7029.01, Los Angeles County, California",9852,118162,6560,730,0,1038,56,1068,66.6,7.4,0,10.5,0.6,10.8,33.4,5537,316,5221,5.71,94.29,0,316,0,5221,0,5537,0,0,0,"25% - 50% P.O.C.","$95000 or more"
"06037703001","Census Tract 7030.01, Los Angeles County, California",6503,109389,2250,1554,0,1474,0,849,34.6,23.9,0,22.7,0,13.1,65.4,3158,1658,1500,52.5,47.5,64,1594,14,1486,78,3080,3.9,0.9,2.5,"50% - 75% P.O.C.","$95000 or more"
"06037703002","Census Tract 7030.02, Los Angeles County, California",6721,101534,800,4874,0,283,0,363,11.9,72.5,0,4.2,0,5.4,88.1,2859,2115,744,73.98,26.02,178,1937,0,744,178,2681,8.4,0,6.2,"75% or more P.O.C.","$95000 or more"
"06037703100","Census Tract 7031, Los Angeles County, California",6068,93482,397,4565,82,119,18,500,6.5,75.2,1.4,2,0.3,8.2,93.5,2519,1793,726,71.18,28.82,93,1700,23,703,116,2403,5.2,3.2,4.6,"75% or more P.O.C.","$70000 - $95000"
"06037703200","Census Tract 7032, Los Angeles County, California",5688,91042,340,4601,0,157,0,445,6,80.9,0,2.8,0,7.8,94,2315,1844,471,79.65,20.35,51,1793,39,432,90,2225,2.8,8.3,3.9,"75% or more P.O.C.","$70000 - $95000"
"06037800101","Census Tract 8001.01, Los Angeles County, California",5738,142159,4612,62,0,367,0,212,80.4,1.1,0,6.4,0,3.7,19.6,1938,1764,174,91.02,8.98,167,1597,52,122,219,1719,9.5,29.9,11.3,"Less than 25% P.O.C.","$95000 or more"
"06037800102","Census Tract 8001.02, Los Angeles County, California",7213,130703,5675,90,111,358,0,774,78.7,1.2,1.5,5,0,10.7,21.3,2688,1946,742,72.4,27.6,76,1870,44,698,120,2568,3.9,5.9,4.5,"Less than 25% P.O.C.","$95000 or more"
"06037800202","Census Tract 8002.02, Los Angeles County, California",6065,162048,4827,26,0,405,0,604,79.6,0.4,0,6.7,0,10,20.4,2049,1785,264,87.12,12.88,118,1667,48,216,166,1883,6.6,18.2,8.1,"Less than 25% P.O.C.","$95000 or more"
"06037800203","Census Tract 8002.03, Los Angeles County, California",5533,146543,4483,60,0,370,0,504,81,1.1,0,6.7,0,9.1,19,1953,1387,566,71.02,28.98,175,1212,69,497,244,1709,12.6,12.2,12.5,"Less than 25% P.O.C.","$95000 or more"
"06037800204","Census Tract 8002.04, Los Angeles County, California",4495,138306,3432,28,79,389,0,464,76.4,0.6,1.8,8.7,0,10.3,23.6,1726,1328,398,76.94,23.06,85,1243,0,398,85,1641,6.4,0,4.9,"Less than 25% P.O.C.","$95000 or more"
"06037800324","Census Tract 8003.24, Los Angeles County, California",6966,143750,5317,197,0,586,0,676,76.3,2.8,0,8.4,0,9.7,23.7,2441,2160,281,88.49,11.51,159,2001,0,281,159,2282,7.4,0,6.5,"Less than 25% P.O.C.","$95000 or more"
"06037800325","Census Tract 8003.25, Los Angeles County, California",3573,133688,2985,53,0,158,0,239,83.5,1.5,0,4.4,0,6.7,16.5,1507,1227,280,81.42,18.58,66,1161,15,265,81,1426,5.4,5.4,5.4,"Less than 25% P.O.C.","$95000 or more"
"06037800326","Census Tract 8003.26, Los Angeles County, California",4741,133942,3686,206,0,337,0,464,77.7,4.3,0,7.1,0,9.8,22.3,1832,1536,296,83.84,16.16,110,1426,0,296,110,1722,7.2,0,6,"Less than 25% P.O.C.","$95000 or more"
"06037800327","Census Tract 8003.27, Los Angeles County, California",5827,92740,4003,214,0,485,0,871,68.7,3.7,0,8.3,0,14.9,31.3,2190,1226,964,55.98,44.02,126,1100,40,924,166,2024,10.3,4.1,7.6,"25% - 50% P.O.C.","$70000 - $95000"
"06037800328","Census Tract 8003.28, Los Angeles County, California",2733,105625,1828,53,0,413,0,357,66.9,1.9,0,15.1,0,13.1,33.1,975,498,477,51.08,48.92,33,465,47,430,80,895,6.6,9.9,8.2,"25% - 50% P.O.C.","$95000 or more"
"06037800329","Census Tract 8003.29, Los Angeles County, California",6953,94250,5358,174,0,480,0,654,77.1,2.5,0,6.9,0,9.4,22.9,2591,1628,963,62.83,37.17,98,1530,118,845,216,2375,6,12.3,8.3,"Less than 25% P.O.C.","$70000 - $95000"
"06037800330","Census Tract 8003.30, Los Angeles County, California",882,134250,811,8,7,0,0,39,92,0.9,0.8,0,0,4.4,8,327,277,50,84.71,15.29,22,255,3,47,25,302,7.9,6,7.6,"Less than 25% P.O.C.","$95000 or more"
"06037800331","Census Tract 8003.31, Los Angeles County, California",732,131375,405,7,6,161,0,136,55.3,1,0.8,22,0,18.6,44.7,217,158,59,72.81,27.19,9,149,17,42,26,191,5.7,28.8,12,"25% - 50% P.O.C.","$95000 or more"
"06037800332","Census Tract 8003.32, Los Angeles County, California",6543,139145,5039,38,0,575,0,526,77,0.6,0,8.8,0,8,23,2265,2051,214,90.55,9.45,170,1881,17,197,187,2078,8.3,7.9,8.3,"Less than 25% P.O.C.","$95000 or more"
"06037800406","Census Tract 8004.06, Los Angeles County, California",2529,145260,1766,95,15,88,0,355,69.8,3.8,0.6,3.5,0,14,30.2,981,711,270,72.48,27.52,18,693,8,262,26,955,2.5,3,2.7,"25% - 50% P.O.C.","$95000 or more"
"06037800408","Census Tract 8004.08, Los Angeles County, California",7274,149026,6017,21,0,78,0,836,82.7,0.3,0,1.1,0,11.5,17.3,3133,2685,448,85.7,14.3,95,2590,26,422,121,3012,3.5,5.8,3.9,"Less than 25% P.O.C.","$95000 or more"
"06037800410","Census Tract 8004.10, Los Angeles County, California",4031,116190,2411,177,23,591,9,608,59.8,4.4,0.6,14.7,0.2,15.1,40.2,592,458,134,77.36,22.64,23,435,14,120,37,555,5,10.4,6.2,"25% - 50% P.O.C.","$95000 or more"
"06037800504","Census Tract 8005.04, Los Angeles County, California",2334,168235,2004,60,0,106,27,94,85.9,2.6,0,4.5,1.2,4,14.1,1150,734,416,63.83,36.17,69,665,11,405,80,1070,9.4,2.6,7,"Less than 25% P.O.C.","$95000 or more"
"06037800506","Census Tract 8005.06, Los Angeles County, California",3270,169125,2670,47,0,243,0,181,81.7,1.4,0,7.4,0,5.5,18.3,1384,1082,302,78.18,21.82,30,1052,0,302,30,1354,2.8,0,2.2,"Less than 25% P.O.C.","$95000 or more"
"06037900102","Census Tract 9001.02, Los Angeles County, California",710,33750,325,5,3,12,0,316,45.8,0.7,0.4,1.7,0,44.5,54.2,274,175,99,63.87,36.13,23,152,17,82,40,234,13.1,17.2,14.6,"50% - 75% P.O.C.","Less than $51000"
"06037900103","Census Tract 9001.03, Los Angeles County, California",5939,38188,2178,614,0,25,0,3039,36.7,10.3,0,0.4,0,51.2,63.3,1672,984,688,58.85,41.15,249,735,110,578,359,1313,25.3,16,21.5,"50% - 75% P.O.C.","Less than $51000"
"06037900104","Census Tract 9001.04, Los Angeles County, California",5822,48444,1699,417,0,39,0,3595,29.2,7.2,0,0.7,0,61.7,70.8,1697,1277,420,75.25,24.75,260,1017,186,234,446,1251,20.4,44.3,26.3,"50% - 75% P.O.C.","Less than $51000"
"06037900201","Census Tract 9002.01, Los Angeles County, California",1129,49625,542,23,22,53,0,471,48,2,1.9,4.7,0,41.7,52,421,332,89,78.86,21.14,23,309,16,73,39,382,6.9,18,9.3,"50% - 75% P.O.C.","Less than $51000"
"06037900300","Census Tract 9003, Los Angeles County, California",5613,56757,1683,638,124,491,7,2549,30,11.4,2.2,8.7,0.1,45.4,70,1226,767,459,62.56,37.44,172,595,191,268,363,863,22.4,41.6,29.6,"50% - 75% P.O.C.","$51000 - $70000"
"06037900501","Census Tract 9005.01, Los Angeles County, California",7225,55166,1436,1765,0,319,0,3463,19.9,24.4,0,4.4,0,47.9,80.1,1969,1038,931,52.72,47.28,279,759,284,647,563,1406,26.9,30.5,28.6,"75% or more P.O.C.","$51000 - $70000"
"06037900504","Census Tract 9005.04, Los Angeles County, California",7261,58949,1578,1426,0,422,0,3731,21.7,19.6,0,5.8,0,51.4,78.3,2007,1243,764,61.93,38.07,342,901,168,596,510,1497,27.5,22,25.4,"75% or more P.O.C.","$51000 - $70000"
"06037900505","Census Tract 9005.05, Los Angeles County, California",3427,40556,974,815,0,79,0,1466,28.4,23.8,0,2.3,0,42.8,71.6,1142,663,479,58.06,41.94,106,557,63,416,169,973,16,13.2,14.8,"50% - 75% P.O.C.","Less than $51000"
"06037900506","Census Tract 9005.06, Los Angeles County, California",4188,56290,681,1465,28,12,0,1872,16.3,35,0.7,0.3,0,44.7,83.7,1282,667,615,52.03,47.97,77,590,134,481,211,1071,11.5,21.8,16.5,"75% or more P.O.C.","$51000 - $70000"
"06037900507","Census Tract 9005.07, Los Angeles County, California",7333,45196,2138,1214,0,531,0,3354,29.2,16.6,0,7.2,0,45.7,70.8,2266,1191,1075,52.56,47.44,170,1021,165,910,335,1931,14.3,15.3,14.8,"50% - 75% P.O.C.","Less than $51000"
"06037900508","Census Tract 9005.08, Los Angeles County, California",4016,71458,1017,847,5,62,0,1911,25.3,21.1,0.1,1.5,0,47.6,74.7,1049,630,419,60.06,39.94,149,481,138,281,287,762,23.7,32.9,27.4,"50% - 75% P.O.C.","$70000 - $95000"
"06037900602","Census Tract 9006.02, Los Angeles County, California",5542,36000,942,610,2,67,0,3776,17,11,0,1.2,0,68.1,83,1556,933,623,59.96,40.04,262,671,107,516,369,1187,28.1,17.2,23.7,"75% or more P.O.C.","Less than $51000"
"06037900605","Census Tract 9006.05, Los Angeles County, California",7539,38965,1587,1238,0,34,0,4618,21.1,16.4,0,0.5,0,61.3,78.9,2215,1398,817,63.12,36.88,229,1169,305,512,534,1681,16.4,37.3,24.1,"75% or more P.O.C.","Less than $51000"
"06037900606","Census Tract 9006.06, Los Angeles County, California",3532,32025,772,1497,46,57,0,1143,21.9,42.4,1.3,1.6,0,32.4,78.1,1115,342,773,30.67,69.33,47,295,148,625,195,920,13.7,19.1,17.5,"75% or more P.O.C.","Less than $51000"
"06037900607","Census Tract 9006.07, Los Angeles County, California",3651,39519,1209,529,14,128,0,1725,33.1,14.5,0.4,3.5,0,47.2,66.9,1160,568,592,48.97,51.03,133,435,90,502,223,937,23.4,15.2,19.2,"50% - 75% P.O.C.","Less than $51000"
"06037900608","Census Tract 9006.08, Los Angeles County, California",3445,55585,645,858,0,155,0,1718,18.7,24.9,0,4.5,0,49.9,81.3,984,575,409,58.43,41.57,154,421,98,311,252,732,26.8,24,25.6,"75% or more P.O.C.","$51000 - $70000"
"06037900609","Census Tract 9006.09, Los Angeles County, California",4978,34306,650,1502,12,93,0,2396,13.1,30.2,0.2,1.9,0,48.1,86.9,1464,643,821,43.92,56.08,129,514,144,677,273,1191,20.1,17.5,18.6,"75% or more P.O.C.","Less than $51000"
"06037900701","Census Tract 9007.01, Los Angeles County, California",5012,39341,1473,1458,25,123,14,1818,29.4,29.1,0.5,2.5,0.3,36.3,70.6,1715,624,1091,36.38,63.62,66,558,169,922,235,1480,10.6,15.5,13.7,"50% - 75% P.O.C.","Less than $51000"
"06037900703","Census Tract 9007.03, Los Angeles County, California",4349,40938,1054,1332,0,190,0,1629,24.2,30.6,0,4.4,0,37.5,75.8,1750,380,1370,21.71,78.29,71,309,58,1312,129,1621,18.7,4.2,7.4,"75% or more P.O.C.","Less than $51000"
"06037900704","Census Tract 9007.04, Los Angeles County, California",2910,42330,693,1279,8,303,38,530,23.8,44,0.3,10.4,1.3,18.2,76.2,1423,35,1388,2.46,97.54,0,35,91,1297,91,1332,0,6.6,6.4,"75% or more P.O.C.","Less than $51000"
"06037900705","Census Tract 9007.05, Los Angeles County, California",3980,47538,1782,643,106,76,0,1200,44.8,16.2,2.7,1.9,0,30.2,55.2,1731,639,1092,36.92,63.08,67,572,39,1053,106,1625,10.5,3.6,6.1,"50% - 75% P.O.C.","Less than $51000"
"06037900803","Census Tract 9008.03, Los Angeles County, California",8751,56144,2852,1371,0,306,0,3981,32.6,15.7,0,3.5,0,45.5,67.4,2428,1379,1049,56.8,43.2,211,1168,252,797,463,1965,15.3,24,19.1,"50% - 75% P.O.C.","$51000 - $70000"
"06037900804","Census Tract 9008.04, Los Angeles County, California",3359,40301,529,779,0,96,0,1920,15.7,23.2,0,2.9,0,57.2,84.3,1071,507,564,47.34,52.66,118,389,121,443,239,832,23.3,21.5,22.3,"75% or more P.O.C.","Less than $51000"
"06037900805","Census Tract 9008.05, Los Angeles County, California",4916,63574,1721,633,11,76,0,2354,35,12.9,0.2,1.5,0,47.9,65,1393,938,455,67.34,32.66,199,739,27,428,226,1167,21.2,5.9,16.2,"50% - 75% P.O.C.","$51000 - $70000"
"06037900806","Census Tract 9008.06, Los Angeles County, California",4634,21604,964,1818,0,237,0,1500,20.8,39.2,0,5.1,0,32.4,79.2,2029,212,1817,10.45,89.55,9,203,176,1641,185,1844,4.2,9.7,9.1,"75% or more P.O.C.","Less than $51000"
"06037900900","Census Tract 9009, Los Angeles County, California",4018,54066,2578,392,15,63,9,841,64.2,9.8,0.4,1.6,0.2,20.9,35.8,1405,1016,389,72.31,27.69,161,855,99,290,260,1145,15.8,25.4,18.5,"25% - 50% P.O.C.","$51000 - $70000"
"06037901003","Census Tract 9010.03, Los Angeles County, California",4895,NA,578,1448,41,80,33,1994,11.8,29.6,0.8,1.6,0.7,40.7,88.2,0,0,0,NA,NA,0,0,0,0,0,0,NA,NA,NA,"75% or more P.O.C.","N/A"
"06037901004","Census Tract 9010.04, Los Angeles County, California",12463,98694,4933,1600,0,1068,0,4651,39.6,12.8,0,8.6,0,37.3,60.4,3745,2797,948,74.69,25.31,432,2365,193,755,625,3120,15.4,20.4,16.7,"50% - 75% P.O.C.","$95000 or more"
"06037901007","Census Tract 9010.07, Los Angeles County, California",2094,88906,1144,55,26,93,0,625,54.6,2.6,1.2,4.4,0,29.8,45.4,637,454,183,71.27,28.73,64,390,40,143,104,533,14.1,21.9,16.3,"25% - 50% P.O.C.","$70000 - $95000"
"06037901008","Census Tract 9010.08, Los Angeles County, California",2744,60147,1007,365,0,254,0,1008,36.7,13.3,0,9.3,0,36.7,63.3,908,422,486,46.48,53.52,68,354,67,419,135,773,16.1,13.8,14.9,"50% - 75% P.O.C.","$51000 - $70000"
"06037901009","Census Tract 9010.09, Los Angeles County, California",5388,76938,2452,1055,14,258,18,1456,45.5,19.6,0.3,4.8,0.3,27,54.5,1819,1196,623,65.75,34.25,117,1079,80,543,197,1622,9.8,12.8,10.8,"50% - 75% P.O.C.","$70000 - $95000"
"06037901010","Census Tract 9010.10, Los Angeles County, California",5723,59899,2618,937,26,122,0,1944,45.7,16.4,0.5,2.1,0,34,54.3,1814,1008,806,55.57,44.43,213,795,150,656,363,1451,21.1,18.6,20,"50% - 75% P.O.C.","$51000 - $70000"
"06037901011","Census Tract 9010.11, Los Angeles County, California",5314,72917,2641,584,134,388,0,1300,49.7,11,2.5,7.3,0,24.5,50.3,1988,929,1059,46.73,53.27,85,844,104,955,189,1799,9.1,9.8,9.5,"50% - 75% P.O.C.","$70000 - $95000"
"06037901101","Census Tract 9011.01, Los Angeles County, California",5519,74743,2683,603,13,362,0,1613,48.6,10.9,0.2,6.6,0,29.2,51.4,1735,1133,602,65.3,34.7,88,1045,141,461,229,1506,7.8,23.4,13.2,"50% - 75% P.O.C.","$70000 - $95000"
"06037901102","Census Tract 9011.02, Los Angeles County, California",5337,85450,2840,409,181,186,23,1580,53.2,7.7,3.4,3.5,0.4,29.6,46.8,1829,1276,553,69.76,30.24,126,1150,52,501,178,1651,9.9,9.4,9.7,"25% - 50% P.O.C.","$70000 - $95000"
"06037901205","Census Tract 9012.05, Los Angeles County, California",10783,76971,5023,2139,0,568,0,2801,46.6,19.8,0,5.3,0,26,53.4,3720,2338,1382,62.85,37.15,350,1988,197,1185,547,3173,15,14.3,14.7,"50% - 75% P.O.C.","$70000 - $95000"
"06037901209","Census Tract 9012.09, Los Angeles County, California",1634,63365,922,55,11,45,0,540,56.4,3.4,0.7,2.8,0,33,43.6,566,426,140,75.27,24.73,38,388,45,95,83,483,8.9,32.1,14.7,"25% - 50% P.O.C.","$51000 - $70000"
"06037901210","Census Tract 9012.10, Los Angeles County, California",1631,63211,888,9,31,61,0,541,54.4,0.6,1.9,3.7,0,33.2,45.6,639,496,143,77.62,22.38,28,468,47,96,75,564,5.6,32.9,11.7,"25% - 50% P.O.C.","$51000 - $70000"
"06037901213","Census Tract 9012.13, Los Angeles County, California",3853,116742,2799,290,78,188,0,451,72.6,7.5,2,4.9,0,11.7,27.4,1260,1168,92,92.7,7.3,151,1017,20,72,171,1089,12.9,21.7,13.6,"25% - 50% P.O.C.","$95000 or more"
"06037910001","Census Tract 9100.01, Los Angeles County, California",6345,46576,1117,630,33,174,0,4278,17.6,9.9,0.5,2.7,0,67.4,82.4,1583,1091,492,68.92,31.08,357,734,136,356,493,1090,32.7,27.6,31.1,"75% or more P.O.C.","Less than $51000"
"06037910002","Census Tract 9100.02, Los Angeles County, California",7723,46875,2313,122,158,0,0,4995,29.9,1.6,2,0,0,64.7,70.1,1984,1321,663,66.58,33.42,316,1005,273,390,589,1395,23.9,41.2,29.7,"50% - 75% P.O.C.","Less than $51000"
"06037910101","Census Tract 9101.01, Los Angeles County, California",1863,44091,132,303,0,35,0,1355,7.1,16.3,0,1.9,0,72.7,92.9,446,197,249,44.17,55.83,73,124,95,154,168,278,37.1,38.2,37.7,"75% or more P.O.C.","Less than $51000"
"06037910201","Census Tract 9102.01, Los Angeles County, California",4063,57593,1280,254,0,153,0,2190,31.5,6.3,0,3.8,0,53.9,68.5,1364,818,546,59.97,40.03,134,684,119,427,253,1111,16.4,21.8,18.5,"50% - 75% P.O.C.","$51000 - $70000"
"06037910202","Census Tract 9102.02, Los Angeles County, California",5823,110692,3040,267,16,604,11,1690,52.2,4.6,0.3,10.4,0.2,29,47.8,1594,1438,156,90.21,9.79,340,1098,32,124,372,1222,23.6,20.5,23.3,"25% - 50% P.O.C.","$95000 or more"
"06037910205","Census Tract 9102.05, Los Angeles County, California",1225,65431,382,23,9,102,10,635,31.2,1.9,0.7,8.3,0.8,51.8,68.8,418,335,83,80.14,19.86,42,293,43,40,85,333,12.5,51.8,20.3,"50% - 75% P.O.C.","$51000 - $70000"
"06037910206","Census Tract 9102.06, Los Angeles County, California",3776,107344,1079,562,23,293,0,1706,28.6,14.9,0.6,7.8,0,45.2,71.4,1057,883,174,83.54,16.46,182,701,32,142,214,843,20.6,18.4,20.2,"50% - 75% P.O.C.","$95000 or more"
"06037910207","Census Tract 9102.07, Los Angeles County, California",6033,95821,1746,910,9,628,78,2510,28.9,15.1,0.1,10.4,1.3,41.6,71.1,1695,1301,394,76.76,23.24,276,1025,113,281,389,1306,21.2,28.7,22.9,"50% - 75% P.O.C.","$95000 or more"
"06037910208","Census Tract 9102.08, Los Angeles County, California",6210,72619,1360,555,0,561,0,3456,21.9,8.9,0,9,0,55.7,78.1,1890,1288,602,68.15,31.85,178,1110,127,475,305,1585,13.8,21.1,16.1,"75% or more P.O.C.","$70000 - $95000"
"06037910209","Census Tract 9102.09, Los Angeles County, California",5134,104900,2086,807,0,620,0,1558,40.6,15.7,0,12.1,0,30.3,59.4,1356,1112,244,82.01,17.99,218,894,100,144,318,1038,19.6,41,23.5,"50% - 75% P.O.C.","$95000 or more"
"06037910210","Census Tract 9102.10, Los Angeles County, California",7239,111333,3163,920,0,643,0,2425,43.7,12.7,0,8.9,0,33.5,56.3,2125,1730,395,81.41,18.59,385,1345,93,302,478,1647,22.3,23.5,22.5,"50% - 75% P.O.C.","$95000 or more"
"06037910301","Census Tract 9103.01, Los Angeles County, California",3874,99943,2269,228,14,48,0,1192,58.6,5.9,0.4,1.2,0,30.8,41.4,1413,1219,194,86.27,13.73,120,1099,20,174,140,1273,9.8,10.3,9.9,"25% - 50% P.O.C.","$95000 or more"
"06037910302","Census Tract 9103.02, Los Angeles County, California",5517,89290,2385,339,0,265,0,2302,43.2,6.1,0,4.8,0,41.7,56.8,1953,1512,441,77.42,22.58,171,1341,14,427,185,1768,11.3,3.2,9.5,"50% - 75% P.O.C.","$70000 - $95000"
"06037910401","Census Tract 9104.01, Los Angeles County, California",6359,80750,2184,352,61,682,0,2764,34.3,5.5,1,10.7,0,43.5,65.7,2167,1348,819,62.21,37.79,235,1113,100,719,335,1832,17.4,12.2,15.5,"50% - 75% P.O.C.","$70000 - $95000"
"06037910402","Census Tract 9104.02, Los Angeles County, California",3583,27420,340,432,180,39,0,2484,9.5,12.1,5,1.1,0,69.3,90.5,1007,288,719,28.6,71.4,75,213,110,609,185,822,26,15.3,18.4,"75% or more P.O.C.","Less than $51000"
"06037910403","Census Tract 9104.03, Los Angeles County, California",2278,25074,92,131,0,33,3,1967,4,5.8,0,1.4,0.1,86.3,96,562,45,517,8.01,91.99,8,37,212,305,220,342,17.8,41,39.1,"75% or more P.O.C.","Less than $51000"
"06037910404","Census Tract 9104.04, Los Angeles County, California",4284,58952,560,432,0,201,0,2996,13.1,10.1,0,4.7,0,69.9,86.9,1075,621,454,57.77,42.23,180,441,103,351,283,792,29,22.7,26.3,"75% or more P.O.C.","$51000 - $70000"
"06037910501","Census Tract 9105.01, Los Angeles County, California",5218,20608,479,1495,0,96,0,3113,9.2,28.7,0,1.8,0,59.7,90.8,2004,46,1958,2.3,97.7,17,29,204,1754,221,1783,37,10.4,11,"75% or more P.O.C.","Less than $51000"
"06037910502","Census Tract 9105.02, Los Angeles County, California",4537,38784,287,646,0,174,0,3361,6.3,14.2,0,3.8,0,74.1,93.7,1181,379,802,32.09,67.91,124,255,254,548,378,803,32.7,31.7,32,"75% or more P.O.C.","Less than $51000"
"06037910504","Census Tract 9105.04, Los Angeles County, California",4254,51082,620,343,0,95,30,3162,14.6,8.1,0,2.2,0.7,74.3,85.4,1186,737,449,62.14,37.86,187,550,96,353,283,903,25.4,21.4,23.9,"75% or more P.O.C.","$51000 - $70000"
"06037910505","Census Tract 9105.05, Los Angeles County, California",3217,68864,455,78,174,58,0,2392,14.1,2.4,5.4,1.8,0,74.4,85.9,814,652,162,80.1,19.9,167,485,49,113,216,598,25.6,30.2,26.5,"75% or more P.O.C.","$51000 - $70000"
"06037910601","Census Tract 9106.01, Los Angeles County, California",6726,41563,807,1087,0,25,59,4694,12,16.2,0,0.4,0.9,69.8,88,1564,1121,443,71.68,28.32,455,666,145,298,600,964,40.6,32.7,38.4,"75% or more P.O.C.","Less than $51000"
"06037910602","Census Tract 9106.02, Los Angeles County, California",4433,41538,735,682,78,142,33,2751,16.6,15.4,1.8,3.2,0.7,62.1,83.4,1357,557,800,41.05,58.95,153,404,117,683,270,1087,27.5,14.6,19.9,"75% or more P.O.C.","Less than $51000"
"06037910603","Census Tract 9106.03, Los Angeles County, California",6928,57824,1146,828,0,109,0,4783,16.5,12,0,1.6,0,69,83.5,2022,1157,865,57.22,42.78,302,855,135,730,437,1585,26.1,15.6,21.6,"75% or more P.O.C.","$51000 - $70000"
"06037910605","Census Tract 9106.05, Los Angeles County, California",4715,44665,644,428,0,217,0,3291,13.7,9.1,0,4.6,0,69.8,86.3,1229,762,467,62,38,217,545,163,304,380,849,28.5,34.9,30.9,"75% or more P.O.C.","Less than $51000"
"06037910606","Census Tract 9106.06, Los Angeles County, California",3121,53922,329,272,0,188,6,2276,10.5,8.7,0,6,0.2,72.9,89.5,795,521,274,65.53,34.47,177,344,84,190,261,534,34,30.7,32.8,"75% or more P.O.C.","$51000 - $70000"
"06037910705","Census Tract 9107.05, Los Angeles County, California",11613,76219,1434,1578,0,394,0,8153,12.3,13.6,0,3.4,0,70.2,87.7,2717,2257,460,83.07,16.93,751,1506,263,197,1014,1703,33.3,57.2,37.3,"75% or more P.O.C.","$70000 - $95000"
"06037910706","Census Tract 9107.06, Los Angeles County, California",6301,60094,651,894,0,265,22,4424,10.3,14.2,0,4.2,0.3,70.2,89.7,1473,1052,421,71.42,28.58,353,699,102,319,455,1018,33.6,24.2,30.9,"75% or more P.O.C.","$51000 - $70000"
"06037910707","Census Tract 9107.07, Los Angeles County, California",5420,53646,850,913,192,107,0,3309,15.7,16.8,3.5,2,0,61.1,84.3,1517,858,659,56.56,43.44,189,669,109,550,298,1219,22,16.5,19.6,"75% or more P.O.C.","$51000 - $70000"
"06037910709","Census Tract 9107.09, Los Angeles County, California",2039,87188,654,94,0,26,0,1248,32.1,4.6,0,1.3,0,61.2,67.9,532,485,47,91.17,8.83,119,366,37,10,156,376,24.5,78.7,29.3,"50% - 75% P.O.C.","$70000 - $95000"
"06037910711","Census Tract 9107.11, Los Angeles County, California",7655,62910,1328,747,0,450,0,5128,17.3,9.8,0,5.9,0,67,82.7,2199,1672,527,76.03,23.97,382,1290,101,426,483,1716,22.8,19.2,22,"75% or more P.O.C.","$51000 - $70000"
"06037910712","Census Tract 9107.12, Los Angeles County, California",2904,70884,379,446,0,56,0,1968,13.1,15.4,0,1.9,0,67.8,86.9,627,504,123,80.38,19.62,176,328,65,58,241,386,34.9,52.8,38.4,"75% or more P.O.C.","$70000 - $95000"
"06037910713","Census Tract 9107.13, Los Angeles County, California",5787,64472,574,663,12,173,0,4315,9.9,11.5,0.2,3,0,74.6,90.1,1416,1166,250,82.34,17.66,383,783,114,136,497,919,32.8,45.6,35.1,"75% or more P.O.C.","$51000 - $70000"
"06037910714","Census Tract 9107.14, Los Angeles County, California",3870,56652,253,532,0,54,0,2995,6.5,13.7,0,1.4,0,77.4,93.5,901,589,312,65.37,34.63,199,390,125,187,324,577,33.8,40.1,36,"75% or more P.O.C.","$51000 - $70000"
"06037910715","Census Tract 9107.15, Los Angeles County, California",6653,55118,802,1257,25,202,0,4327,12.1,18.9,0.4,3,0,65,87.9,1880,1294,586,68.83,31.17,380,914,103,483,483,1397,29.4,17.6,25.7,"75% or more P.O.C.","$51000 - $70000"
"06037910716","Census Tract 9107.16, Los Angeles County, California",5770,73466,1199,619,0,171,0,3697,20.8,10.7,0,3,0,64.1,79.2,1685,1205,480,71.51,28.49,173,1032,87,393,260,1425,14.4,18.1,15.4,"75% or more P.O.C.","$70000 - $95000"
"06037910804","Census Tract 9108.04, Los Angeles County, California",2964,97326,1994,33,0,57,0,869,67.3,1.1,0,1.9,0,29.3,32.7,1069,960,109,89.8,10.2,70,890,47,62,117,952,7.3,43.1,10.9,"25% - 50% P.O.C.","$95000 or more"
"06037910805","Census Tract 9108.05, Los Angeles County, California",4722,105263,3502,48,20,179,0,850,74.2,1,0.4,3.8,0,18,25.8,1554,1405,149,90.41,9.59,156,1249,9,140,165,1389,11.1,6,10.6,"25% - 50% P.O.C.","$95000 or more"
"06037910807","Census Tract 9108.07, Los Angeles County, California",6424,115685,3162,302,0,514,0,2284,49.2,4.7,0,8,0,35.6,50.8,1931,1447,484,74.94,25.06,258,1189,124,360,382,1549,17.8,25.6,19.8,"50% - 75% P.O.C.","$95000 or more"
"06037910808","Census Tract 9108.08, Los Angeles County, California",3445,117813,2206,188,0,19,0,876,64,5.5,0,0.6,0,25.4,36,1076,1021,55,94.89,5.11,157,864,12,43,169,907,15.4,21.8,15.7,"25% - 50% P.O.C.","$95000 or more"
"06037910809","Census Tract 9108.09, Los Angeles County, California",2070,147639,1640,14,0,86,0,264,79.2,0.7,0,4.2,0,12.8,20.8,711,685,26,96.34,3.66,87,598,0,26,87,624,12.7,0,12.2,"Less than 25% P.O.C.","$95000 or more"
"06037910810","Census Tract 9108.10, Los Angeles County, California",2599,147917,1431,175,103,263,8,474,55.1,6.7,4,10.1,0.3,18.2,44.9,716,645,71,90.08,9.92,182,463,0,71,182,534,28.2,0,25.4,"25% - 50% P.O.C.","$95000 or more"
"06037910811","Census Tract 9108.11, Los Angeles County, California",179,121771,129,16,0,0,0,28,72.1,8.9,0,0,0,15.6,27.9,41,41,0,100,0,4,37,0,0,4,37,9.8,NA,9.8,"25% - 50% P.O.C.","$95000 or more"
"06037910812","Census Tract 9108.12, Los Angeles County, California",363,81563,281,0,3,4,0,75,77.4,0,0.8,1.1,0,20.7,22.6,139,118,21,84.89,15.11,8,110,4,17,12,127,6.8,19,8.6,"Less than 25% P.O.C.","$70000 - $95000"
"06037910813","Census Tract 9108.13, Los Angeles County, California",4080,105703,3032,5,0,111,0,854,74.3,0.1,0,2.7,0,20.9,25.7,1265,1205,60,95.26,4.74,226,979,0,60,226,1039,18.8,0,17.9,"25% - 50% P.O.C.","$95000 or more"
"06037911001","Census Tract 9110.01, Los Angeles County, California",3926,53830,1913,175,0,51,0,1681,48.7,4.5,0,1.3,0,42.8,51.3,1516,1151,365,75.92,24.08,35,1116,158,207,193,1323,3,43.3,12.7,"50% - 75% P.O.C.","$51000 - $70000"
"06037920011","Census Tract 9200.11, Los Angeles County, California",172,67188,77,16,0,0,0,54,44.8,9.3,0,0,0,31.4,55.2,47,35,12,74.47,25.53,0,35,0,12,0,47,0,0,0,"50% - 75% P.O.C.","$51000 - $70000"
"06037920012","Census Tract 9200.12, Los Angeles County, California",1111,71591,818,0,0,9,0,214,73.6,0,0,0.8,0,19.3,26.4,464,332,132,71.55,28.45,18,314,4,128,22,442,5.4,3,4.7,"25% - 50% P.O.C.","$70000 - $95000"
"06037920013","Census Tract 9200.13, Los Angeles County, California",7174,131298,3040,298,19,1123,77,2368,42.4,4.2,0.3,15.7,1.1,33,57.6,2225,2050,175,92.13,7.87,308,1742,13,162,321,1904,15,7.4,14.4,"50% - 75% P.O.C.","$95000 or more"
"06037920015","Census Tract 9200.15, Los Angeles County, California",6578,145833,4232,180,0,478,0,1520,64.3,2.7,0,7.3,0,23.1,35.7,2012,1865,147,92.69,7.31,305,1560,12,135,317,1695,16.4,8.2,15.8,"25% - 50% P.O.C.","$95000 or more"
"06037920016","Census Tract 9200.16, Los Angeles County, California",3563,138125,2041,168,6,495,0,755,57.3,4.7,0.2,13.9,0,21.2,42.7,1171,1072,99,91.55,8.45,107,965,0,99,107,1064,10,0,9.1,"25% - 50% P.O.C.","$95000 or more"
"06037920017","Census Tract 9200.17, Los Angeles County, California",4309,113299,2384,7,6,214,0,1458,55.3,0.2,0.1,5,0,33.8,44.7,1251,1006,245,80.42,19.58,177,829,104,141,281,970,17.6,42.4,22.5,"25% - 50% P.O.C.","$95000 or more"
"06037920018","Census Tract 9200.18, Los Angeles County, California",2024,113750,1375,61,0,110,0,445,67.9,3,0,5.4,0,22,32.1,696,606,90,87.07,12.93,46,560,26,64,72,624,7.6,28.9,10.3,"25% - 50% P.O.C.","$95000 or more"
"06037920020","Census Tract 9200.20, Los Angeles County, California",6501,112969,3660,78,22,475,0,2042,56.3,1.2,0.3,7.3,0,31.4,43.7,1976,1813,163,91.75,8.25,446,1367,0,163,446,1530,24.6,0,22.6,"25% - 50% P.O.C.","$95000 or more"
"06037920023","Census Tract 9200.23, Los Angeles County, California",2615,80580,1107,130,7,0,0,1251,42.3,5,0.3,0,0,47.8,57.7,733,647,86,88.27,11.73,119,528,45,41,164,569,18.4,52.3,22.4,"50% - 75% P.O.C.","$70000 - $95000"
"06037920026","Census Tract 9200.26, Los Angeles County, California",386,84688,234,0,13,25,7,80,60.6,0,3.4,6.5,1.8,20.7,39.4,101,87,14,86.14,13.86,8,79,0,14,8,93,9.2,0,7.9,"25% - 50% P.O.C.","$70000 - $95000"
"06037920028","Census Tract 9200.28, Los Angeles County, California",7091,119744,2980,332,48,1142,0,2296,42,4.7,0.7,16.1,0,32.4,58,2114,1801,313,85.19,14.81,237,1564,62,251,299,1815,13.2,19.8,14.1,"50% - 75% P.O.C.","$95000 or more"
"06037920029","Census Tract 9200.29, Los Angeles County, California",5632,75972,2272,282,0,519,1,2390,40.3,5,0,9.2,0,42.4,59.7,1855,1058,797,57.04,42.96,155,903,68,729,223,1632,14.7,8.5,12,"50% - 75% P.O.C.","$70000 - $95000"
"06037920030","Census Tract 9200.30, Los Angeles County, California",5088,86649,1935,313,0,591,0,2073,38,6.2,0,11.6,0,40.7,62,1690,1430,260,84.62,15.38,137,1293,43,217,180,1510,9.6,16.5,10.7,"50% - 75% P.O.C.","$70000 - $95000"
"06037920031","Census Tract 9200.31, Los Angeles County, California",4343,65673,2213,219,19,328,0,1384,51,5,0.4,7.6,0,31.9,49,1994,1775,219,89.02,10.98,134,1641,0,219,134,1860,7.5,0,6.7,"25% - 50% P.O.C.","$51000 - $70000"
"06037920032","Census Tract 9200.32, Los Angeles County, California",3558,139514,2055,115,0,376,0,873,57.8,3.2,0,10.6,0,24.5,42.2,1031,981,50,95.15,4.85,166,815,6,44,172,859,16.9,12,16.7,"25% - 50% P.O.C.","$95000 or more"
"06037920033","Census Tract 9200.33, Los Angeles County, California",598,61250,303,37,0,8,0,228,50.7,6.2,0,1.3,0,38.1,49.3,156,136,20,87.18,12.82,14,122,0,20,14,142,10.3,0,9,"25% - 50% P.O.C.","$51000 - $70000"
"06037920034","Census Tract 9200.34, Los Angeles County, California",3790,85637,1425,37,17,423,0,1685,37.6,1,0.4,11.2,0,44.5,62.4,1084,859,225,79.24,20.76,204,655,21,204,225,859,23.7,9.3,20.8,"50% - 75% P.O.C.","$70000 - $95000"
"06037920035","Census Tract 9200.35, Los Angeles County, California",6895,76992,2288,95,0,765,0,3544,33.2,1.4,0,11.1,0,51.4,66.8,2127,1690,437,79.45,20.55,236,1454,84,353,320,1807,14,19.2,15,"50% - 75% P.O.C.","$70000 - $95000"
"06037920036","Census Tract 9200.36, Los Angeles County, California",3145,77652,857,45,9,170,3,1961,27.2,1.4,0.3,5.4,0.1,62.4,72.8,928,596,332,64.22,35.78,129,467,54,278,183,745,21.6,16.3,19.7,"50% - 75% P.O.C.","$70000 - $95000"
"06037920037","Census Tract 9200.37, Los Angeles County, California",10318,58868,1803,521,34,551,0,7085,17.5,5,0.3,5.3,0,68.7,82.5,3102,975,2127,31.43,68.57,70,905,509,1618,579,2523,7.2,23.9,18.7,"75% or more P.O.C.","$51000 - $70000"
"06037920038","Census Tract 9200.38, Los Angeles County, California",1710,55606,553,92,11,0,0,940,32.3,5.4,0.6,0,0,55,67.7,614,164,450,26.71,73.29,26,138,37,413,63,551,15.9,8.2,10.3,"50% - 75% P.O.C.","$51000 - $70000"
"06037920039","Census Tract 9200.39, Los Angeles County, California",2191,126310,936,246,0,58,0,796,42.7,11.2,0,2.6,0,36.3,57.3,638,472,166,73.98,26.02,96,376,16,150,112,526,20.3,9.6,17.6,"50% - 75% P.O.C.","$95000 or more"
"06037920040","Census Tract 9200.40, Los Angeles County, California",3979,99620,1867,201,0,482,0,1271,46.9,5.1,0,12.1,0,31.9,53.1,1241,845,396,68.09,31.91,99,746,91,305,190,1051,11.7,23,15.3,"50% - 75% P.O.C.","$95000 or more"
"06037920041","Census Tract 9200.41, Los Angeles County, California",1668,85147,417,42,0,125,0,1049,25,2.5,0,7.5,0,62.9,75,460,182,278,39.57,60.43,17,165,73,205,90,370,9.3,26.3,19.6,"75% or more P.O.C.","$70000 - $95000"
"06037920042","Census Tract 9200.42, Los Angeles County, California",6990,94706,3014,326,18,941,0,2250,43.1,4.7,0.3,13.5,0,32.2,56.9,2336,1341,995,57.41,42.59,199,1142,69,926,268,2068,14.8,6.9,11.5,"50% - 75% P.O.C.","$70000 - $95000"
"06037920043","Census Tract 9200.43, Los Angeles County, California",7130,146310,2761,330,0,1867,0,1829,38.7,4.6,0,26.2,0,25.7,61.3,2018,1695,323,83.99,16.01,409,1286,88,235,497,1521,24.1,27.2,24.6,"50% - 75% P.O.C.","$95000 or more"
"06037920044","Census Tract 9200.44, Los Angeles County, California",2399,98472,1190,24,0,277,0,802,49.6,1,0,11.5,0,33.4,50.4,832,741,91,89.06,10.94,65,676,0,91,65,767,8.8,0,7.8,"50% - 75% P.O.C.","$95000 or more"
"06037920045","Census Tract 9200.45, Los Angeles County, California",4282,141029,2715,102,0,556,4,846,63.4,2.4,0,13,0.1,19.8,36.6,1342,1192,150,88.82,11.18,129,1063,21,129,150,1192,10.8,14,11.2,"25% - 50% P.O.C.","$95000 or more"
"06037920102","Census Tract 9201.02, Los Angeles County, California",5466,90214,2692,129,0,264,8,1996,49.2,2.4,0,4.8,0.1,36.5,50.8,1806,1017,789,56.31,43.69,127,890,88,701,215,1591,12.5,11.2,11.9,"50% - 75% P.O.C.","$70000 - $95000"
"06037920104","Census Tract 9201.04, Los Angeles County, California",2933,127625,1850,31,0,101,11,751,63.1,1.1,0,3.4,0.4,25.6,36.9,850,801,49,94.24,5.76,179,622,18,31,197,653,22.3,36.7,23.2,"25% - 50% P.O.C.","$95000 or more"
"06037920106","Census Tract 9201.06, Los Angeles County, California",3381,89087,1095,65,0,95,0,2095,32.4,1.9,0,2.8,0,62,67.6,915,763,152,83.39,16.61,147,616,68,84,215,700,19.3,44.7,23.5,"50% - 75% P.O.C.","$70000 - $95000"
"06037920107","Census Tract 9201.07, Los Angeles County, California",6295,180500,3120,246,59,1597,0,1106,49.6,3.9,0.9,25.4,0,17.6,50.4,1672,1395,277,83.43,16.57,316,1079,68,209,384,1288,22.7,24.5,23,"50% - 75% P.O.C.","$95000 or more"
"06037920108","Census Tract 9201.08, Los Angeles County, California",5386,119289,2194,165,58,1597,0,835,40.7,3.1,1.1,29.7,0,15.5,59.3,1749,1317,432,75.3,24.7,159,1158,17,415,176,1573,12.1,3.9,10.1,"50% - 75% P.O.C.","$95000 or more"
"06037920109","Census Tract 9201.09, Los Angeles County, California",5696,112959,3277,407,0,715,0,1088,57.5,7.1,0,12.6,0,19.1,42.5,2079,1411,668,67.87,32.13,93,1318,76,592,169,1910,6.6,11.4,8.1,"25% - 50% P.O.C.","$95000 or more"
"06037920110","Census Tract 9201.10, Los Angeles County, California",3088,144886,1937,112,0,446,8,536,62.7,3.6,0,14.4,0.3,17.4,37.3,981,697,284,71.05,28.95,98,599,9,275,107,874,14.1,3.2,10.9,"25% - 50% P.O.C.","$95000 or more"
"06037920111","Census Tract 9201.11, Los Angeles County, California",2738,107132,1718,123,34,150,0,669,62.7,4.5,1.2,5.5,0,24.4,37.3,894,804,90,89.93,10.07,61,743,44,46,105,789,7.6,48.9,11.7,"25% - 50% P.O.C.","$95000 or more"
"06037920112","Census Tract 9201.12, Los Angeles County, California",4211,104559,2648,168,0,474,0,760,62.9,4,0,11.3,0,18,37.1,1478,1061,417,71.79,28.21,107,954,71,346,178,1300,10.1,17,12,"25% - 50% P.O.C.","$95000 or more"
"06037920114","Census Tract 9201.14, Los Angeles County, California",6518,120536,3763,166,0,1098,0,1268,57.7,2.5,0,16.8,0,19.5,42.3,2258,1167,1091,51.68,48.32,154,1013,25,1066,179,2079,13.2,2.3,7.9,"25% - 50% P.O.C.","$95000 or more"
"06037920115","Census Tract 9201.15, Los Angeles County, California",3957,117955,2240,92,44,774,0,626,56.6,2.3,1.1,19.6,0,15.8,43.4,1518,1119,399,73.72,26.28,127,992,16,383,143,1375,11.3,4,9.4,"25% - 50% P.O.C.","$95000 or more"
"06037920116","Census Tract 9201.16, Los Angeles County, California",5481,113720,2974,436,0,656,37,1206,54.3,8,0,12,0.7,22,45.7,1640,1508,132,91.95,8.05,340,1168,18,114,358,1282,22.5,13.6,21.8,"25% - 50% P.O.C.","$95000 or more"
"06037920118","Census Tract 9201.18, Los Angeles County, California",6035,126425,3275,212,27,825,0,1576,54.3,3.5,0.4,13.7,0,26.1,45.7,1803,1637,166,90.79,9.21,190,1447,65,101,255,1548,11.6,39.2,14.1,"25% - 50% P.O.C.","$95000 or more"
"06037920119","Census Tract 9201.19, Los Angeles County, California",1974,142321,1136,50,0,217,0,508,57.5,2.5,0,11,0,25.7,42.5,537,507,30,94.41,5.59,103,404,13,17,116,421,20.3,43.3,21.6,"25% - 50% P.O.C.","$95000 or more"
"06037920200","Census Tract 9202, Los Angeles County, California",5393,NA,723,963,0,67,18,3206,13.4,17.9,0,1.2,0.3,59.4,86.6,0,0,0,NA,NA,0,0,0,0,0,0,NA,NA,NA,"75% or more P.O.C.","N/A"
"06037920303","Census Tract 9203.03, Los Angeles County, California",1608,95714,688,8,0,244,0,430,42.8,0.5,0,15.2,0,26.7,57.2,622,280,342,45.02,54.98,31,249,4,338,35,587,11.1,1.2,5.6,"50% - 75% P.O.C.","$95000 or more"
"06037920312","Census Tract 9203.12, Los Angeles County, California",5826,79241,3128,302,20,343,33,1840,53.7,5.2,0.3,5.9,0.6,31.6,46.3,2101,997,1104,47.45,52.55,135,862,99,1005,234,1867,13.5,9,11.1,"25% - 50% P.O.C.","$70000 - $95000"
"06037920313","Census Tract 9203.13, Los Angeles County, California",4821,106974,2570,43,20,391,0,1739,53.3,0.9,0.4,8.1,0,36.1,46.7,1530,1252,278,81.83,18.17,118,1134,53,225,171,1359,9.4,19.1,11.2,"25% - 50% P.O.C.","$95000 or more"
"06037920314","Census Tract 9203.14, Los Angeles County, California",2920,100956,1788,49,0,180,0,817,61.2,1.7,0,6.2,0,28,38.8,935,663,272,70.91,29.09,91,572,59,213,150,785,13.7,21.7,16,"25% - 50% P.O.C.","$95000 or more"
"06037920322","Census Tract 9203.22, Los Angeles County, California",2854,110781,1896,157,0,80,0,589,66.4,5.5,0,2.8,0,20.6,33.6,996,788,208,79.12,20.88,68,720,30,178,98,898,8.6,14.4,9.8,"25% - 50% P.O.C.","$95000 or more"
"06037920326","Census Tract 9203.26, Los Angeles County, California",6324,112317,3047,354,0,1619,0,1167,48.2,5.6,0,25.6,0,18.5,51.8,2446,1219,1227,49.84,50.16,64,1155,62,1165,126,2320,5.3,5.1,5.2,"50% - 75% P.O.C.","$95000 or more"
"06037920328","Census Tract 9203.28, Los Angeles County, California",2036,111042,1204,42,13,390,7,243,59.1,2.1,0.6,19.2,0.3,11.9,40.9,835,403,432,48.26,51.74,20,383,6,426,26,809,5,1.4,3.1,"25% - 50% P.O.C.","$95000 or more"
"06037920329","Census Tract 9203.29, Los Angeles County, California",7152,91130,4726,238,0,565,0,1295,66.1,3.3,0,7.9,0,18.1,33.9,2942,1756,1186,59.69,40.31,68,1688,82,1104,150,2792,3.9,6.9,5.1,"25% - 50% P.O.C.","$70000 - $95000"
"06037920330","Census Tract 9203.30, Los Angeles County, California",3225,88571,1868,64,0,466,2,743,57.9,2,0,14.4,0.1,23,42.1,1538,796,742,51.76,48.24,47,749,30,712,77,1461,5.9,4,5,"25% - 50% P.O.C.","$70000 - $95000"
"06037920331","Census Tract 9203.31, Los Angeles County, California",3482,102225,2007,100,0,168,1,978,57.6,2.9,0,4.8,0,28.1,42.4,1247,953,294,76.42,23.58,78,875,15,279,93,1154,8.2,5.1,7.5,"25% - 50% P.O.C.","$95000 or more"
"06037920332","Census Tract 9203.32, Los Angeles County, California",2438,91667,1583,12,13,106,8,612,64.9,0.5,0.5,4.3,0.3,25.1,35.1,582,408,174,70.1,29.9,45,363,29,145,74,508,11,16.7,12.7,"25% - 50% P.O.C.","$70000 - $95000"
"06037920334","Census Tract 9203.34, Los Angeles County, California",6217,87273,3875,155,23,504,8,1417,62.3,2.5,0.4,8.1,0.1,22.8,37.7,2184,1371,813,62.77,37.23,109,1262,72,741,181,2003,8,8.9,8.3,"25% - 50% P.O.C.","$70000 - $95000"
"06037920336","Census Tract 9203.36, Los Angeles County, California",6881,56912,1050,26,0,244,0,5268,15.3,0.4,0,3.5,0,76.6,84.7,1644,459,1185,27.92,72.08,154,305,436,749,590,1054,33.6,36.8,35.9,"75% or more P.O.C.","$51000 - $70000"
"06037920337","Census Tract 9203.37, Los Angeles County, California",6943,56297,977,419,22,684,14,4722,14.1,6,0.3,9.9,0.2,68,85.9,1915,529,1386,27.62,72.38,111,418,328,1058,439,1476,21,23.7,22.9,"75% or more P.O.C.","$51000 - $70000"
"06037920338","Census Tract 9203.38, Los Angeles County, California",5711,156776,3038,245,0,1143,0,819,53.2,4.3,0,20,0,14.3,46.8,1741,1555,186,89.32,10.68,187,1368,38,148,225,1516,12,20.4,12.9,"25% - 50% P.O.C.","$95000 or more"
"06037920339","Census Tract 9203.39, Los Angeles County, California",7420,143047,3821,135,0,1952,0,884,51.5,1.8,0,26.3,0,11.9,48.5,2383,1792,591,75.2,24.8,255,1537,0,591,255,2128,14.2,0,10.7,"25% - 50% P.O.C.","$95000 or more"
"06037930101","Census Tract 9301.01, Los Angeles County, California",90,149063,64,0,0,15,0,0,71.1,0,0,16.7,0,0,28.9,35,24,11,68.57,31.43,0,24,0,11,0,35,0,0,0,"25% - 50% P.O.C.","$95000 or more"
"06037930200","Census Tract 9302, Los Angeles County, California",461,85972,244,24,0,13,0,175,52.9,5.2,0,2.8,0,38,47.1,147,121,26,82.31,17.69,25,96,0,26,25,122,20.7,0,17,"25% - 50% P.O.C.","$70000 - $95000"
"06037930301","Census Tract 9303.01, Los Angeles County, California",796,84219,446,65,0,14,6,185,56,8.2,0,1.8,0.8,23.2,44,195,176,19,90.26,9.74,0,176,0,19,0,195,0,0,0,"25% - 50% P.O.C.","$70000 - $95000"
"06037980001","Census Tract 9800.01, Los Angeles County, California",0,NA,0,0,0,0,0,0,NA,NA,NA,NA,NA,NA,NA,0,0,0,NA,NA,0,0,0,0,0,0,NA,NA,NA,"N/A","N/A"
"06037980002","Census Tract 9800.02, Los Angeles County, California",0,NA,0,0,0,0,0,0,NA,NA,NA,NA,NA,NA,NA,0,0,0,NA,NA,0,0,0,0,0,0,NA,NA,NA,"N/A","N/A"
"06037980003","Census Tract 9800.03, Los Angeles County, California",0,NA,0,0,0,0,0,0,NA,NA,NA,NA,NA,NA,NA,0,0,0,NA,NA,0,0,0,0,0,0,NA,NA,NA,"N/A","N/A"
"06037980004","Census Tract 9800.04, Los Angeles County, California",0,NA,0,0,0,0,0,0,NA,NA,NA,NA,NA,NA,NA,0,0,0,NA,NA,0,0,0,0,0,0,NA,NA,NA,"N/A","N/A"
"06037980005","Census Tract 9800.05, Los Angeles County, California",0,NA,0,0,0,0,0,0,NA,NA,NA,NA,NA,NA,NA,0,0,0,NA,NA,0,0,0,0,0,0,NA,NA,NA,"N/A","N/A"
"06037980006","Census Tract 9800.06, Los Angeles County, California",0,NA,0,0,0,0,0,0,NA,NA,NA,NA,NA,NA,NA,0,0,0,NA,NA,0,0,0,0,0,0,NA,NA,NA,"N/A","N/A"
"06037980007","Census Tract 9800.07, Los Angeles County, California",0,NA,0,0,0,0,0,0,NA,NA,NA,NA,NA,NA,NA,0,0,0,NA,NA,0,0,0,0,0,0,NA,NA,NA,"N/A","N/A"
"06037980008","Census Tract 9800.08, Los Angeles County, California",68,NA,0,0,0,0,0,68,0,0,0,0,0,100,100,17,0,17,0,100,0,0,0,17,0,17,NA,0,0,"75% or more P.O.C.","N/A"
"06037980009","Census Tract 9800.09, Los Angeles County, California",5,NA,0,0,0,1,0,4,0,0,0,20,0,80,100,0,0,0,NA,NA,0,0,0,0,0,0,NA,NA,NA,"75% or more P.O.C.","N/A"
"06037980010","Census Tract 9800.10, Los Angeles County, California",95,19167,24,1,0,37,0,33,25.3,1.1,0,38.9,0,34.7,74.7,56,24,32,42.86,57.14,0,24,0,32,0,56,0,0,0,"50% - 75% P.O.C.","Less than $51000"
"06037980013","Census Tract 9800.13, Los Angeles County, California",0,NA,0,0,0,0,0,0,NA,NA,NA,NA,NA,NA,NA,0,0,0,NA,NA,0,0,0,0,0,0,NA,NA,NA,"N/A","N/A"
"06037980014","Census Tract 9800.14, Los Angeles County, California",9,NA,4,0,0,0,0,5,44.4,0,0,0,0,55.6,55.6,5,0,5,0,100,0,0,0,5,0,5,NA,0,0,"50% - 75% P.O.C.","N/A"
"06037980015","Census Tract 9800.15, Los Angeles County, California",671,66000,63,238,0,132,1,191,9.4,35.5,0,19.7,0.1,28.5,90.6,350,0,350,0,100,0,0,3,347,3,347,NA,0.9,0.9,"75% or more P.O.C.","$51000 - $70000"
"06037980018","Census Tract 9800.18, Los Angeles County, California",0,NA,0,0,0,0,0,0,NA,NA,NA,NA,NA,NA,NA,0,0,0,NA,NA,0,0,0,0,0,0,NA,NA,NA,"N/A","N/A"
"06037980019","Census Tract 9800.19, Los Angeles County, California",138,231250,114,0,0,20,4,0,82.6,0,0,14.5,2.9,0,17.4,65,53,12,81.54,18.46,5,48,0,12,5,60,9.4,0,7.7,"Less than 25% P.O.C.","$95000 or more"
"06037980020","Census Tract 9800.20, Los Angeles County, California",0,NA,0,0,0,0,0,0,NA,NA,NA,NA,NA,NA,NA,0,0,0,NA,NA,0,0,0,0,0,0,NA,NA,NA,"N/A","N/A"
"06037980021","Census Tract 9800.21, Los Angeles County, California",33,NA,4,0,0,14,0,15,12.1,0,0,42.4,0,45.5,87.9,8,8,0,100,0,0,8,0,0,0,8,0,NA,0,"75% or more P.O.C.","N/A"
"06037980022","Census Tract 9800.22, Los Angeles County, California",0,NA,0,0,0,0,0,0,NA,NA,NA,NA,NA,NA,NA,0,0,0,NA,NA,0,0,0,0,0,0,NA,NA,NA,"N/A","N/A"
"06037980023","Census Tract 9800.23, Los Angeles County, California",0,NA,0,0,0,0,0,0,NA,NA,NA,NA,NA,NA,NA,0,0,0,NA,NA,0,0,0,0,0,0,NA,NA,NA,"N/A","N/A"
"06037980024","Census Tract 9800.24, Los Angeles County, California",223,150250,136,16,6,11,0,54,61,7.2,2.7,4.9,0,24.2,39,75,51,24,68,32,5,46,0,24,5,70,9.8,0,6.7,"25% - 50% P.O.C.","$95000 or more"
"06037980025","Census Tract 9800.25, Los Angeles County, California",0,NA,0,0,0,0,0,0,NA,NA,NA,NA,NA,NA,NA,0,0,0,NA,NA,0,0,0,0,0,0,NA,NA,NA,"N/A","N/A"
"06037980026","Census Tract 9800.26, Los Angeles County, California",26,NA,7,11,0,0,0,7,26.9,42.3,0,0,0,26.9,73.1,4,4,0,100,0,0,4,0,0,0,4,0,NA,0,"50% - 75% P.O.C.","N/A"
"06037980028","Census Tract 9800.28, Los Angeles County, California",0,NA,0,0,0,0,0,0,NA,NA,NA,NA,NA,NA,NA,0,0,0,NA,NA,0,0,0,0,0,0,NA,NA,NA,"N/A","N/A"
"06037980030","Census Tract 9800.30, Los Angeles County, California",0,NA,0,0,0,0,0,0,NA,NA,NA,NA,NA,NA,NA,0,0,0,NA,NA,0,0,0,0,0,0,NA,NA,NA,"N/A","N/A"
"06037980031","Census Tract 9800.31, Los Angeles County, California",1175,NA,393,232,26,36,24,387,33.4,19.7,2.2,3.1,2,32.9,66.6,24,0,24,0,100,0,0,0,24,0,24,NA,0,0,"50% - 75% P.O.C.","N/A"
"06037980033","Census Tract 9800.33, Los Angeles County, California",16,NA,0,0,16,0,0,0,0,0,100,0,0,0,100,16,0,16,0,100,0,0,0,16,0,16,NA,0,0,"75% or more P.O.C.","N/A"
"06037990100","Census Tract 9901, Los Angeles County, California",0,NA,0,0,0,0,0,0,NA,NA,NA,NA,NA,NA,NA,0,0,0,NA,NA,0,0,0,0,0,0,NA,NA,NA,"N/A","N/A"
"06037990200","Census Tract 9902, Los Angeles County, California",0,NA,0,0,0,0,0,0,NA,NA,NA,NA,NA,NA,NA,0,0,0,NA,NA,0,0,0,0,0,0,NA,NA,NA,"N/A","N/A"
"06037990300","Census Tract 9903, Los Angeles County, California",0,NA,0,0,0,0,0,0,NA,NA,NA,NA,NA,NA,NA,0,0,0,NA,NA,0,0,0,0,0,0,NA,NA,NA,"N/A","N/A"
"06059001101","Census Tract 11.01, Orange County, California",5031,100357,1896,90,34,414,0,2497,37.7,1.8,0.7,8.2,0,49.6,62.3,1460,1068,392,73.15,26.85,179,889,7,385,186,1274,16.8,1.8,12.7,"50% - 75% P.O.C.","$95000 or more"
"06059001102","Census Tract 11.02, Orange County, California",3237,86111,1074,115,0,479,0,1481,33.2,3.6,0,14.8,0,45.8,66.8,1060,611,449,57.64,42.36,82,529,40,409,122,938,13.4,8.9,11.5,"50% - 75% P.O.C.","$70000 - $95000"
"06059001103","Census Tract 11.03, Orange County, California",4594,72344,1192,178,13,514,0,2675,25.9,3.9,0.3,11.2,0,58.2,74.1,1369,571,798,41.71,58.29,108,463,71,727,179,1190,18.9,8.9,13.1,"50% - 75% P.O.C.","$70000 - $95000"
"06059001201","Census Tract 12.01, Orange County, California",5594,62033,725,23,30,224,0,4520,13,0.4,0.5,4,0,80.8,87,1427,526,901,36.86,63.14,93,433,309,592,402,1025,17.7,34.3,28.2,"75% or more P.O.C.","$51000 - $70000"
"06059001202","Census Tract 12.02, Orange County, California",3662,68024,452,0,0,66,0,3127,12.3,0,0,1.8,0,85.4,87.7,901,428,473,47.5,52.5,125,303,180,293,305,596,29.2,38.1,33.9,"75% or more P.O.C.","$51000 - $70000"
"06059001301","Census Tract 13.01, Orange County, California",6519,71579,1978,48,0,1206,0,3268,30.3,0.7,0,18.5,0,50.1,69.7,2618,1695,923,64.74,35.26,68,1627,40,883,108,2510,4,4.3,4.1,"50% - 75% P.O.C.","$70000 - $95000"
"06059001303","Census Tract 13.03, Orange County, California",5884,85343,1216,110,17,788,0,3655,20.7,1.9,0.3,13.4,0,62.1,79.3,1774,966,808,54.45,45.55,207,759,119,689,326,1448,21.4,14.7,18.4,"75% or more P.O.C.","$70000 - $95000"
"06059001304","Census Tract 13.04, Orange County, California",3982,68601,575,57,0,326,0,2982,14.4,1.4,0,8.2,0,74.9,85.6,1098,563,535,51.28,48.72,77,486,227,308,304,794,13.7,42.4,27.7,"75% or more P.O.C.","$51000 - $70000"
"06059001401","Census Tract 14.01, Orange County, California",4495,74688,1360,17,8,348,0,2607,30.3,0.4,0.2,7.7,0,58,69.7,1394,727,667,52.15,47.85,137,590,111,556,248,1146,18.8,16.6,17.8,"50% - 75% P.O.C.","$70000 - $95000"
"06059001402","Census Tract 14.02, Orange County, California",5023,90119,1565,56,28,350,0,2966,31.2,1.1,0.6,7,0,59,68.8,1484,769,715,51.82,48.18,89,680,145,570,234,1250,11.6,20.3,15.8,"50% - 75% P.O.C.","$70000 - $95000"
"06059001403","Census Tract 14.03, Orange County, California",3023,103611,1558,56,0,185,0,1140,51.5,1.9,0,6.1,0,37.7,48.5,964,864,100,89.63,10.37,112,752,33,67,145,819,13,33,15,"25% - 50% P.O.C.","$95000 or more"
"06059001404","Census Tract 14.04, Orange County, California",3934,60563,572,15,0,128,0,3189,14.5,0.4,0,3.3,0,81.1,85.5,955,563,392,58.95,41.05,180,383,131,261,311,644,32,33.4,32.6,"75% or more P.O.C.","$51000 - $70000"
"06059001501","Census Tract 15.01, Orange County, California",5792,91610,3071,2,0,1292,0,1294,53,0,0,22.3,0,22.3,47,2333,2139,194,91.68,8.32,86,2053,58,136,144,2189,4,29.9,6.2,"25% - 50% P.O.C.","$70000 - $95000"
"06059001503","Census Tract 15.03, Orange County, California",5049,93868,2385,71,49,593,80,1749,47.2,1.4,1,11.7,1.6,34.6,52.8,1676,921,755,54.95,45.05,124,797,91,664,215,1461,13.5,12.1,12.8,"50% - 75% P.O.C.","$70000 - $95000"
"06059001504","Census Tract 15.04, Orange County, California",4844,77824,1469,16,0,495,0,2755,30.3,0.3,0,10.2,0,56.9,69.7,1704,720,984,42.25,57.75,65,655,160,824,225,1479,9,16.3,13.2,"50% - 75% P.O.C.","$70000 - $95000"
"06059001505","Census Tract 15.05, Orange County, California",6931,126250,3374,170,0,1281,0,1709,48.7,2.5,0,18.5,0,24.7,51.3,2384,1794,590,75.25,24.75,134,1660,55,535,189,2195,7.5,9.3,7.9,"50% - 75% P.O.C.","$95000 or more"
"06059001506","Census Tract 15.06, Orange County, California",4286,88684,1859,44,0,1156,0,1175,43.4,1,0,27,0,27.4,56.6,1614,1072,542,66.42,33.58,92,980,83,459,175,1439,8.6,15.3,10.8,"50% - 75% P.O.C.","$70000 - $95000"
"06059001507","Census Tract 15.07, Orange County, California",4745,82969,2191,95,0,976,0,1386,46.2,2,0,20.6,0,29.2,53.8,1943,689,1254,35.46,64.54,68,621,37,1217,105,1838,9.9,3,5.4,"50% - 75% P.O.C.","$70000 - $95000"
"06059001601","Census Tract 16.01, Orange County, California",7986,113413,3682,121,0,1710,28,2296,46.1,1.5,0,21.4,0.4,28.8,53.9,2699,1852,847,68.62,31.38,159,1693,178,669,337,2362,8.6,21,12.5,"50% - 75% P.O.C.","$95000 or more"
"06059001602","Census Tract 16.02, Orange County, California",4924,129688,2483,14,18,1581,0,680,50.4,0.3,0.4,32.1,0,13.8,49.6,1768,1481,287,83.77,16.23,176,1305,31,256,207,1561,11.9,10.8,11.7,"25% - 50% P.O.C.","$95000 or more"
"06059001704","Census Tract 17.04, Orange County, California",8256,121079,1408,191,26,5693,0,703,17.1,2.3,0.3,69,0,8.5,82.9,2511,1629,882,64.87,35.13,278,1351,158,724,436,2075,17.1,17.9,17.4,"75% or more P.O.C.","$95000 or more"
"06059001705","Census Tract 17.05, Orange County, California",4002,98375,1412,44,36,786,0,1614,35.3,1.1,0.9,19.6,0,40.3,64.7,1269,877,392,69.11,30.89,132,745,78,314,210,1059,15.1,19.9,16.5,"50% - 75% P.O.C.","$95000 or more"
"06059001706","Census Tract 17.06, Orange County, California",3648,141597,1972,5,0,1180,0,329,54.1,0.1,0,32.3,0,9,45.9,1279,1079,200,84.36,15.64,116,963,11,189,127,1152,10.8,5.5,9.9,"25% - 50% P.O.C.","$95000 or more"
"06059001707","Census Tract 17.07, Orange County, California",7291,133993,999,73,19,4893,0,1125,13.7,1,0.3,67.1,0,15.4,86.3,2509,1975,534,78.72,21.28,173,1802,53,481,226,2283,8.8,9.9,9,"75% or more P.O.C.","$95000 or more"
"06059001708","Census Tract 17.08, Orange County, California",3619,93036,1407,0,8,1430,0,774,38.9,0,0.2,39.5,0,21.4,61.1,1226,1045,181,85.24,14.76,194,851,21,160,215,1011,18.6,11.6,17.5,"50% - 75% P.O.C.","$70000 - $95000"
"06059001801","Census Tract 18.01, Orange County, California",5510,63179,963,136,31,483,31,3773,17.5,2.5,0.6,8.8,0.6,68.5,82.5,1550,383,1167,24.71,75.29,40,343,303,864,343,1207,10.4,26,22.1,"75% or more P.O.C.","$51000 - $70000"
"06059001802","Census Tract 18.02, Orange County, California",7823,55236,1127,114,0,832,0,5618,14.4,1.5,0,10.6,0,71.8,85.6,2151,797,1354,37.05,62.95,168,629,390,964,558,1593,21.1,28.8,25.9,"75% or more P.O.C.","$51000 - $70000"
"06059001901","Census Tract 19.01, Orange County, California",2552,84583,714,51,0,436,8,1307,28,2,0,17.1,0.3,51.2,72,802,588,214,73.32,26.68,65,523,34,180,99,703,11.1,15.9,12.3,"50% - 75% P.O.C.","$70000 - $95000"
"06059001902","Census Tract 19.02, Orange County, California",3213,88750,827,142,0,507,39,1647,25.7,4.4,0,15.8,1.2,51.3,74.3,774,523,251,67.57,32.43,83,440,65,186,148,626,15.9,25.9,19.1,"50% - 75% P.O.C.","$70000 - $95000"
"06059001903","Census Tract 19.03, Orange County, California",3713,84375,639,46,0,620,0,2377,17.2,1.2,0,16.7,0,64,82.8,911,556,355,61.03,38.97,114,442,152,203,266,645,20.5,42.8,29.2,"75% or more P.O.C.","$70000 - $95000"
"06059011000","Census Tract 110, Orange County, California",6077,71910,2541,134,0,1074,0,2131,41.8,2.2,0,17.7,0,35.1,58.2,2445,1442,1003,58.98,41.02,88,1354,84,919,172,2273,6.1,8.4,7,"50% - 75% P.O.C.","$70000 - $95000"
"06059011101","Census Tract 111.01, Orange County, California",4191,73654,1191,53,64,417,36,2370,28.4,1.3,1.5,9.9,0.9,56.5,71.6,1312,688,624,52.44,47.56,116,572,113,511,229,1083,16.9,18.1,17.5,"50% - 75% P.O.C.","$70000 - $95000"
"06059011102","Census Tract 111.02, Orange County, California",4134,95326,1409,170,22,550,88,1743,34.1,4.1,0.5,13.3,2.1,42.2,65.9,1208,898,310,74.34,25.66,214,684,41,269,255,953,23.8,13.2,21.1,"50% - 75% P.O.C.","$95000 or more"
"06059011200","Census Tract 112, Orange County, California",4374,71337,1941,81,0,581,0,1536,44.4,1.9,0,13.3,0,35.1,55.6,1638,762,876,46.52,53.48,67,695,109,767,176,1462,8.8,12.4,10.7,"50% - 75% P.O.C.","$70000 - $95000"
"06059011300","Census Tract 113, Orange County, California",5153,82390,2767,300,75,557,0,1005,53.7,5.8,1.5,10.8,0,19.5,46.3,2137,491,1646,22.98,77.02,0,491,46,1600,46,2091,0,2.8,2.2,"25% - 50% P.O.C.","$70000 - $95000"
"06059011401","Census Tract 114.01, Orange County, California",2219,78500,1288,68,0,175,0,610,58,3.1,0,7.9,0,27.5,42,734,423,311,57.63,42.37,33,390,30,281,63,671,7.8,9.6,8.6,"25% - 50% P.O.C.","$70000 - $95000"
"06059011402","Census Tract 114.02, Orange County, California",2608,114500,1534,64,0,343,0,590,58.8,2.5,0,13.2,0,22.6,41.2,816,710,106,87.01,12.99,67,643,28,78,95,721,9.4,26.4,11.6,"25% - 50% P.O.C.","$95000 or more"
"06059011403","Census Tract 114.03, Orange County, California",6654,67604,1912,119,17,557,0,3740,28.7,1.8,0.3,8.4,0,56.2,71.3,1936,693,1243,35.8,64.2,164,529,235,1008,399,1537,23.7,18.9,20.6,"50% - 75% P.O.C.","$51000 - $70000"
"06059011502","Census Tract 115.02, Orange County, California",4485,70321,1401,139,0,743,0,2073,31.2,3.1,0,16.6,0,46.2,68.8,1440,571,869,39.65,60.35,84,487,159,710,243,1197,14.7,18.3,16.9,"50% - 75% P.O.C.","$70000 - $95000"
"06059011503","Census Tract 115.03, Orange County, California",1839,104625,1002,10,0,437,0,327,54.5,0.5,0,23.8,0,17.8,45.5,540,377,163,69.81,30.19,52,325,53,110,105,435,13.8,32.5,19.4,"25% - 50% P.O.C.","$95000 or more"
"06059011504","Census Tract 115.04, Orange County, California",5916,41319,2094,250,19,1258,0,2106,35.4,4.2,0.3,21.3,0,35.6,64.6,2016,220,1796,10.91,89.09,0,220,44,1752,44,1972,0,2.4,2.2,"50% - 75% P.O.C.","Less than $51000"
"06059011601","Census Tract 116.01, Orange County, California",8430,51780,986,449,27,499,21,6383,11.7,5.3,0.3,5.9,0.2,75.7,88.3,2302,420,1882,18.25,81.75,139,281,551,1331,690,1612,33.1,29.3,30,"75% or more P.O.C.","$51000 - $70000"
"06059011602","Census Tract 116.02, Orange County, California",5314,53556,679,94,0,247,0,4240,12.8,1.8,0,4.6,0,79.8,87.2,1449,581,868,40.1,59.9,73,508,263,605,336,1113,12.6,30.3,23.2,"75% or more P.O.C.","$51000 - $70000"
"06059011707","Census Tract 117.07, Orange County, California",5911,86006,3254,72,0,1362,0,885,55,1.2,0,23,0,15,45,2373,1475,898,62.16,37.84,117,1358,34,864,151,2222,7.9,3.8,6.4,"25% - 50% P.O.C.","$70000 - $95000"
"06059011708","Census Tract 117.08, Orange County, California",4566,63061,2189,119,0,830,0,1295,47.9,2.6,0,18.2,0,28.4,52.1,1648,415,1233,25.18,74.82,20,395,105,1128,125,1523,4.8,8.5,7.6,"50% - 75% P.O.C.","$51000 - $70000"
"06059011709","Census Tract 117.09, Orange County, California",4610,131607,2681,84,0,652,13,1028,58.2,1.8,0,14.1,0.3,22.3,41.8,1426,1247,179,87.45,12.55,130,1117,52,127,182,1244,10.4,29.1,12.8,"25% - 50% P.O.C.","$95000 or more"
"06059011710","Census Tract 117.10, Orange County, California",3455,110875,1849,38,11,591,0,785,53.5,1.1,0.3,17.1,0,22.7,46.5,1175,955,220,81.28,18.72,95,860,45,175,140,1035,9.9,20.5,11.9,"25% - 50% P.O.C.","$95000 or more"
"06059011711","Census Tract 117.11, Orange County, California",7878,64583,1915,245,19,743,57,4599,24.3,3.1,0.2,9.4,0.7,58.4,75.7,2644,515,2129,19.48,80.52,88,427,258,1871,346,2298,17.1,12.1,13.1,"75% or more P.O.C.","$51000 - $70000"
"06059011712","Census Tract 117.12, Orange County, California",4734,62167,1167,17,0,773,0,2543,24.7,0.4,0,16.3,0,53.7,75.3,1588,809,779,50.94,49.06,114,695,48,731,162,1426,14.1,6.2,10.2,"75% or more P.O.C.","$51000 - $70000"
"06059011714","Census Tract 117.14, Orange County, California",898,70769,248,76,0,128,0,388,27.6,8.5,0,14.3,0,43.2,72.4,394,10,384,2.54,97.46,0,10,4,380,4,390,0,1,1,"50% - 75% P.O.C.","$70000 - $95000"
"06059011715","Census Tract 117.15, Orange County, California",6437,90125,3601,147,0,1104,2,1459,55.9,2.3,0,17.2,0,22.7,44.1,2464,1723,741,69.93,30.07,103,1620,56,685,159,2305,6,7.6,6.5,"25% - 50% P.O.C.","$70000 - $95000"
"06059011716","Census Tract 117.16, Orange County, California",5223,149583,1563,11,0,2012,46,1466,29.9,0.2,0,38.5,0.9,28.1,70.1,1624,1358,266,83.62,16.38,162,1196,72,194,234,1390,11.9,27.1,14.4,"50% - 75% P.O.C.","$95000 or more"
"06059011717","Census Tract 117.17, Orange County, California",2680,93304,1640,43,0,362,0,574,61.2,1.6,0,13.5,0,21.4,38.8,903,670,233,74.2,25.8,71,599,22,211,93,810,10.6,9.4,10.3,"25% - 50% P.O.C.","$70000 - $95000"
"06059011718","Census Tract 117.18, Orange County, California",3458,117969,2000,3,0,454,0,787,57.8,0.1,0,13.1,0,22.8,42.2,1070,1003,67,93.74,6.26,98,905,15,52,113,957,9.8,22.4,10.6,"25% - 50% P.O.C.","$95000 or more"
"06059011720","Census Tract 117.20, Orange County, California",6573,46148,248,113,0,277,0,5839,3.8,1.7,0,4.2,0,88.8,96.2,1505,261,1244,17.34,82.66,128,133,446,798,574,931,49,35.9,38.1,"75% or more P.O.C.","Less than $51000"
"06059011721","Census Tract 117.21, Orange County, California",5364,64531,862,116,0,306,13,4025,16.1,2.2,0,5.7,0.2,75,83.9,1473,460,1013,31.23,68.77,104,356,258,755,362,1111,22.6,25.5,24.6,"75% or more P.O.C.","$51000 - $70000"
"06059011722","Census Tract 117.22, Orange County, California",2259,48929,937,56,0,426,0,820,41.5,2.5,0,18.9,0,36.3,58.5,1054,625,429,59.3,40.7,86,539,16,413,102,952,13.8,3.7,9.7,"50% - 75% P.O.C.","Less than $51000"
"06059021802","Census Tract 218.02, Orange County, California",6981,85121,4634,22,1,688,0,1509,66.4,0.3,0,9.9,0,21.6,33.6,2577,1352,1225,52.46,47.54,120,1232,95,1130,215,2362,8.9,7.8,8.3,"25% - 50% P.O.C.","$70000 - $95000"
"06059021807","Census Tract 218.07, Orange County, California",4438,104750,2283,61,12,466,0,1582,51.4,1.4,0.3,10.5,0,35.6,48.6,1362,1079,283,79.22,20.78,167,912,84,199,251,1111,15.5,29.7,18.4,"25% - 50% P.O.C.","$95000 or more"
"06059021809","Census Tract 218.09, Orange County, California",3188,135335,2066,29,10,463,0,453,64.8,0.9,0.3,14.5,0,14.2,35.2,1079,818,261,75.81,24.19,73,745,53,208,126,953,8.9,20.3,11.7,"25% - 50% P.O.C.","$95000 or more"
"06059021810","Census Tract 218.10, Orange County, California",3570,112546,2110,91,0,468,0,780,59.1,2.5,0,13.1,0,21.8,40.9,1167,987,180,84.58,15.42,109,878,11,169,120,1047,11,6.1,10.3,"25% - 50% P.O.C.","$95000 or more"
"06059021812","Census Tract 218.12, Orange County, California",6535,125500,3670,19,0,541,0,2092,56.2,0.3,0,8.3,0,32,43.8,2106,1481,625,70.32,29.68,313,1168,69,556,382,1724,21.1,11,18.1,"25% - 50% P.O.C.","$95000 or more"
"06059021813","Census Tract 218.13, Orange County, California",4,NA,0,0,0,0,0,4,0,0,0,0,0,100,100,4,4,0,100,0,0,4,0,0,0,4,0,NA,0,"75% or more P.O.C.","N/A"
"06059021814","Census Tract 218.14, Orange County, California",7192,96313,3334,387,0,1387,0,1763,46.4,5.4,0,19.3,0,24.5,53.6,2602,1538,1064,59.11,40.89,161,1377,37,1027,198,2404,10.5,3.5,7.6,"50% - 75% P.O.C.","$95000 or more"
"06059021815","Census Tract 218.15, Orange County, California",11591,129294,4512,270,42,4551,0,1779,38.9,2.3,0.4,39.3,0,15.3,61.1,3873,3108,765,80.25,19.75,348,2760,63,702,411,3462,11.2,8.2,10.6,"50% - 75% P.O.C.","$95000 or more"
"06059021816","Census Tract 218.16, Orange County, California",4966,113393,3269,0,0,365,0,1044,65.8,0,0,7.3,0,21,34.2,1724,1480,244,85.85,14.15,118,1362,67,177,185,1539,8,27.5,10.7,"25% - 50% P.O.C.","$95000 or more"
"06059021817","Census Tract 218.17, Orange County, California",3848,98846,2319,0,0,239,16,1099,60.3,0,0,6.2,0.4,28.6,39.7,1272,1023,249,80.42,19.58,98,925,81,168,179,1093,9.6,32.5,14.1,"25% - 50% P.O.C.","$95000 or more"
"06059021820","Census Tract 218.20, Orange County, California",4259,139948,2364,90,0,809,0,864,55.5,2.1,0,19,0,20.3,44.5,1407,1217,190,86.5,13.5,164,1053,10,180,174,1233,13.5,5.3,12.4,"25% - 50% P.O.C.","$95000 or more"
"06059021821","Census Tract 218.21, Orange County, California",7772,101023,3191,328,0,1728,0,2302,41.1,4.2,0,22.2,0,29.6,58.9,2578,1434,1144,55.62,44.38,171,1263,118,1026,289,2289,11.9,10.3,11.2,"50% - 75% P.O.C.","$95000 or more"
"06059021822","Census Tract 218.22, Orange County, California",9543,144817,4744,107,0,3398,13,1001,49.7,1.1,0,35.6,0.1,10.5,50.3,3002,2617,385,87.18,12.82,313,2304,71,314,384,2618,12,18.4,12.8,"50% - 75% P.O.C.","$95000 or more"
"06059021823","Census Tract 218.23, Orange County, California",4238,131515,2455,0,38,936,22,750,57.9,0,0.9,22.1,0.5,17.7,42.1,1316,1147,169,87.16,12.84,169,978,52,117,221,1095,14.7,30.8,16.8,"25% - 50% P.O.C.","$95000 or more"
"06059021824","Census Tract 218.24, Orange County, California",2782,153816,1820,0,0,318,0,408,65.4,0,0,11.4,0,14.7,34.6,850,773,77,90.94,9.06,120,653,20,57,140,710,15.5,26,16.5,"25% - 50% P.O.C.","$95000 or more"
"06059021825","Census Tract 218.25, Orange County, California",2940,123194,1736,51,0,674,0,403,59,1.7,0,22.9,0,13.7,41,1067,894,173,83.79,16.21,77,817,7,166,84,983,8.6,4,7.9,"25% - 50% P.O.C.","$95000 or more"
"06059021826","Census Tract 218.26, Orange County, California",2806,76019,1555,184,9,452,0,545,55.4,6.6,0.3,16.1,0,19.4,44.6,1070,510,560,47.66,52.34,33,477,15,545,48,1022,6.5,2.7,4.5,"25% - 50% P.O.C.","$70000 - $95000"
"06059021827","Census Tract 218.27, Orange County, California",3064,139706,1411,80,0,854,0,667,46.1,2.6,0,27.9,0,21.8,53.9,988,900,88,91.09,8.91,91,809,21,67,112,876,10.1,23.9,11.3,"50% - 75% P.O.C.","$95000 or more"
"06059021828","Census Tract 218.28, Orange County, California",4146,170909,2029,59,0,1083,20,861,48.9,1.4,0,26.1,0.5,20.8,51.1,1324,1305,19,98.56,1.44,123,1182,0,19,123,1201,9.4,0,9.3,"50% - 75% P.O.C.","$95000 or more"
"06059021829","Census Tract 218.29, Orange County, California",5278,170345,2791,28,0,1692,0,716,52.9,0.5,0,32.1,0,13.6,47.1,1742,1623,119,93.17,6.83,248,1375,14,105,262,1480,15.3,11.8,15,"25% - 50% P.O.C.","$95000 or more"
"06059021830","Census Tract 218.30, Orange County, California",5943,156667,3929,43,0,895,0,764,66.1,0.7,0,15.1,0,12.9,33.9,2036,1935,101,95.04,4.96,199,1736,0,101,199,1837,10.3,0,9.8,"25% - 50% P.O.C.","$95000 or more"
"06059021903","Census Tract 219.03, Orange County, California",3825,97083,1782,51,0,575,0,1284,46.6,1.3,0,15,0,33.6,53.4,1190,968,222,81.34,18.66,118,850,10,212,128,1062,12.2,4.5,10.8,"50% - 75% P.O.C.","$95000 or more"
"06059021905","Census Tract 219.05, Orange County, California",5145,120027,2860,179,0,756,9,1219,55.6,3.5,0,14.7,0.2,23.7,44.4,1757,1517,240,86.34,13.66,173,1344,19,221,192,1565,11.4,7.9,10.9,"25% - 50% P.O.C.","$95000 or more"
"06059021912","Census Tract 219.12, Orange County, California",4365,166719,2783,0,0,818,0,618,63.8,0,0,18.7,0,14.2,36.2,1487,1377,110,92.6,7.4,161,1216,11,99,172,1315,11.7,10,11.6,"25% - 50% P.O.C.","$95000 or more"
"06059021913","Census Tract 219.13, Orange County, California",7435,87477,1777,11,0,908,0,4682,23.9,0.1,0,12.2,0,63,76.1,1903,1170,733,61.48,38.52,240,930,227,506,467,1436,20.5,31,24.5,"75% or more P.O.C.","$70000 - $95000"
"06059021914","Census Tract 219.14, Orange County, California",4306,120189,2211,99,15,363,1,1471,51.3,2.3,0.3,8.4,0,34.2,48.7,1373,1036,337,75.46,24.54,100,936,72,265,172,1201,9.7,21.4,12.5,"25% - 50% P.O.C.","$95000 or more"
"06059021915","Census Tract 219.15, Orange County, California",3997,126778,2188,18,0,875,0,830,54.7,0.5,0,21.9,0,20.8,45.3,1402,1245,157,88.8,11.2,153,1092,11,146,164,1238,12.3,7,11.7,"25% - 50% P.O.C.","$95000 or more"
"06059021916","Census Tract 219.16, Orange County, California",3308,127500,2253,0,0,762,0,249,68.1,0,0,23,0,7.5,31.9,1304,1067,237,81.83,18.17,94,973,13,224,107,1197,8.8,5.5,8.2,"25% - 50% P.O.C.","$95000 or more"
"06059021917","Census Tract 219.17, Orange County, California",3221,139208,2386,31,0,270,0,405,74.1,1,0,8.4,0,12.6,25.9,1103,1016,87,92.11,7.89,99,917,0,87,99,1004,9.7,0,9,"25% - 50% P.O.C.","$95000 or more"
"06059021918","Census Tract 219.18, Orange County, California",4710,99795,2794,0,0,514,0,1208,59.3,0,0,10.9,0,25.6,40.7,1679,1465,214,87.25,12.75,156,1309,14,200,170,1509,10.6,6.5,10.1,"25% - 50% P.O.C.","$95000 or more"
"06059021919","Census Tract 219.19, Orange County, California",2825,134000,1869,28,0,379,0,387,66.2,1,0,13.4,0,13.7,33.8,982,822,160,83.71,16.29,59,763,20,140,79,903,7.2,12.5,8,"25% - 50% P.O.C.","$95000 or more"
"06059021920","Census Tract 219.20, Orange County, California",7041,123838,3848,67,0,1633,0,1243,54.7,1,0,23.2,0,17.7,45.3,2564,2209,355,86.15,13.85,133,2076,133,222,266,2298,6,37.5,10.4,"25% - 50% P.O.C.","$95000 or more"
"06059021921","Census Tract 219.21, Orange County, California",4217,170625,2319,135,0,1076,0,558,55,3.2,0,25.5,0,13.2,45,1455,1407,48,96.7,3.3,128,1279,38,10,166,1289,9.1,79.2,11.4,"25% - 50% P.O.C.","$95000 or more"
"06059021922","Census Tract 219.22, Orange County, California",4841,104844,2738,155,0,885,0,853,56.6,3.2,0,18.3,0,17.6,43.4,2250,1345,905,59.78,40.22,13,1332,16,889,29,2221,1,1.8,1.3,"25% - 50% P.O.C.","$95000 or more"
"06059021923","Census Tract 219.23, Orange County, California",7141,135659,3754,173,0,1550,0,1309,52.6,2.4,0,21.7,0,18.3,47.4,2401,1909,492,79.51,20.49,234,1675,0,492,234,2167,12.3,0,9.7,"25% - 50% P.O.C.","$95000 or more"
"06059021924","Census Tract 219.24, Orange County, California",4314,132386,2156,101,0,1056,16,781,50,2.3,0,24.5,0.4,18.1,50,1443,1002,441,69.44,30.56,105,897,25,416,130,1313,10.5,5.7,9,"50% - 75% P.O.C.","$95000 or more"
"06059032002","Census Tract 320.02, Orange County, California",6833,139949,4620,45,0,595,39,1284,67.6,0.7,0,8.7,0.6,18.8,32.4,2062,1637,425,79.39,20.61,191,1446,128,297,319,1743,11.7,30.1,15.5,"25% - 50% P.O.C.","$95000 or more"
"06059032003","Census Tract 320.03, Orange County, California",4824,147284,3349,27,75,474,0,725,69.4,0.6,1.6,9.8,0,15,30.6,1547,1471,76,95.09,4.91,171,1300,22,54,193,1354,11.6,28.9,12.5,"25% - 50% P.O.C.","$95000 or more"
"06059032011","Census Tract 320.11, Orange County, California",1639,102031,1281,6,0,10,0,301,78.2,0.4,0,0.6,0,18.4,21.8,663,593,70,89.44,10.56,52,541,8,62,60,603,8.8,11.4,9,"Less than 25% P.O.C.","$95000 or more"
"06059032012","Census Tract 320.12, Orange County, California",4104,131724,2800,19,8,298,0,828,68.2,0.5,0.2,7.3,0,20.2,31.8,1286,1093,193,84.99,15.01,92,1001,77,116,169,1117,8.4,39.9,13.1,"25% - 50% P.O.C.","$95000 or more"
"06059032013","Census Tract 320.13, Orange County, California",5275,95735,3476,130,0,567,0,672,65.9,2.5,0,10.7,0,12.7,34.1,2192,1044,1148,47.63,52.37,103,941,52,1096,155,2037,9.9,4.5,7.1,"25% - 50% P.O.C.","$95000 or more"
"06059032014","Census Tract 320.14, Orange County, California",6397,57352,2256,158,29,674,0,2969,35.3,2.5,0.5,10.5,0,46.4,64.7,2087,1398,689,66.99,33.01,178,1220,214,475,392,1695,12.7,31.1,18.8,"50% - 75% P.O.C.","$51000 - $70000"
"06059032015","Census Tract 320.15, Orange County, California",6679,130417,4087,48,0,1187,26,1041,61.2,0.7,0,17.8,0.4,15.6,38.8,1906,1623,283,85.15,14.85,250,1373,40,243,290,1616,15.4,14.1,15.2,"25% - 50% P.O.C.","$95000 or more"
"06059032020","Census Tract 320.20, Orange County, California",5890,142361,3852,56,0,688,0,1006,65.4,1,0,11.7,0,17.1,34.6,1917,1631,286,85.08,14.92,220,1411,58,228,278,1639,13.5,20.3,14.5,"25% - 50% P.O.C.","$95000 or more"
"06059032022","Census Tract 320.22, Orange County, California",6792,75781,2622,154,26,606,0,3252,38.6,2.3,0.4,8.9,0,47.9,61.4,2123,1005,1118,47.34,52.66,163,842,175,943,338,1785,16.2,15.7,15.9,"50% - 75% P.O.C.","$70000 - $95000"
"06059032023","Census Tract 320.23, Orange County, California",15339,163454,11329,245,36,915,0,2096,73.9,1.6,0.2,6,0,13.7,26.1,4898,4064,834,82.97,17.03,695,3369,97,737,792,4106,17.1,11.6,16.2,"25% - 50% P.O.C.","$95000 or more"
"06059032027","Census Tract 320.27, Orange County, California",6583,96500,2796,24,0,989,24,2453,42.5,0.4,0,15,0.4,37.3,57.5,2148,1239,909,57.68,42.32,56,1183,206,703,262,1886,4.5,22.7,12.2,"50% - 75% P.O.C.","$95000 or more"
"06059032028","Census Tract 320.28, Orange County, California",3247,92115,1725,47,0,403,18,960,53.1,1.4,0,12.4,0.6,29.6,46.9,1258,841,417,66.85,33.15,33,808,73,344,106,1152,3.9,17.5,8.4,"25% - 50% P.O.C.","$70000 - $95000"
"06059032029","Census Tract 320.29, Orange County, California",4297,114219,2607,29,11,522,0,971,60.7,0.7,0.3,12.1,0,22.6,39.3,1437,1183,254,82.32,17.68,71,1112,96,158,167,1270,6,37.8,11.6,"25% - 50% P.O.C.","$95000 or more"
"06059032030","Census Tract 320.30, Orange County, California",3971,114706,2542,19,0,364,0,948,64,0.5,0,9.2,0,23.9,36,1294,1112,182,85.94,14.06,56,1056,61,121,117,1177,5,33.5,9,"25% - 50% P.O.C.","$95000 or more"
"06059032031","Census Tract 320.31, Orange County, California",3641,129750,2363,63,0,441,0,650,64.9,1.7,0,12.1,0,17.9,35.1,1188,1026,162,86.36,13.64,163,863,30,132,193,995,15.9,18.5,16.2,"25% - 50% P.O.C.","$95000 or more"
"06059032032","Census Tract 320.32, Orange County, California",3065,121985,2003,0,0,319,0,535,65.4,0,0,10.4,0,17.5,34.6,1005,862,143,85.77,14.23,97,765,0,143,97,908,11.3,0,9.7,"25% - 50% P.O.C.","$95000 or more"
"06059032033","Census Tract 320.33, Orange County, California",3623,103125,2045,23,19,572,12,832,56.4,0.6,0.5,15.8,0.3,23,43.6,1419,704,715,49.61,50.39,0,704,71,644,71,1348,0,9.9,5,"25% - 50% P.O.C.","$95000 or more"
"06059032034","Census Tract 320.34, Orange County, California",5786,165946,3518,226,0,914,0,883,60.8,3.9,0,15.8,0,15.3,39.2,1822,1767,55,96.98,3.02,217,1550,18,37,235,1587,12.3,32.7,12.9,"25% - 50% P.O.C.","$95000 or more"
"06059032035","Census Tract 320.35, Orange County, California",2461,114792,1588,57,0,385,0,360,64.5,2.3,0,15.6,0,14.6,35.5,955,780,175,81.68,18.32,76,704,10,165,86,869,9.7,5.7,9,"25% - 50% P.O.C.","$95000 or more"
"06059032036","Census Tract 320.36, Orange County, California",3674,131902,2700,12,0,251,13,623,73.5,0.3,0,6.8,0.4,17,26.5,1290,1043,247,80.85,19.15,84,959,20,227,104,1186,8.1,8.1,8.1,"25% - 50% P.O.C.","$95000 or more"
"06059032037","Census Tract 320.37, Orange County, California",4882,69631,3803,147,0,574,0,293,77.9,3,0,11.8,0,6,22.1,2447,2138,309,87.37,12.63,110,2028,0,309,110,2337,5.1,0,4.5,"Less than 25% P.O.C.","$51000 - $70000"
"06059032038","Census Tract 320.38, Orange County, California",6361,137266,4169,0,0,956,33,797,65.5,0,0,15,0.5,12.5,34.5,2097,1988,109,94.8,5.2,109,1879,0,109,109,1988,5.5,0,5.2,"25% - 50% P.O.C.","$95000 or more"
"06059032039","Census Tract 320.39, Orange County, California",6762,133897,4324,0,0,843,0,1297,63.9,0,0,12.5,0,19.2,36.1,2133,1545,588,72.43,27.57,148,1397,135,453,283,1850,9.6,23,13.3,"25% - 50% P.O.C.","$95000 or more"
"06059032040","Census Tract 320.40, Orange County, California",2620,130833,1910,13,0,271,0,258,72.9,0.5,0,10.3,0,9.8,27.1,884,802,82,90.72,9.28,78,724,10,72,88,796,9.7,12.2,10,"25% - 50% P.O.C.","$95000 or more"
"06059032041","Census Tract 320.41, Orange County, California",1011,135917,719,2,4,93,0,140,71.1,0.2,0.4,9.2,0,13.8,28.9,365,283,82,77.53,22.47,16,267,12,70,28,337,5.7,14.6,7.7,"25% - 50% P.O.C.","$95000 or more"
"06059032042","Census Tract 320.42, Orange County, California",5355,152279,3948,51,49,265,0,842,73.7,1,0.9,4.9,0,15.7,26.3,1771,1510,261,85.26,14.74,216,1294,6,255,222,1549,14.3,2.3,12.5,"25% - 50% P.O.C.","$95000 or more"
"06059032043","Census Tract 320.43, Orange County, California",3736,217875,2846,61,0,250,0,400,76.2,1.6,0,6.7,0,10.7,23.8,1229,1130,99,91.94,8.06,92,1038,29,70,121,1108,8.1,29.3,9.8,"Less than 25% P.O.C.","$95000 or more"
"06059032044","Census Tract 320.44, Orange County, California",5700,216477,4472,127,17,443,16,439,78.5,2.2,0.3,7.8,0.3,7.7,21.5,1999,1881,118,94.1,5.9,240,1641,0,118,240,1759,12.8,0,12,"Less than 25% P.O.C.","$95000 or more"
"06059032045","Census Tract 320.45, Orange County, California",3352,164583,2606,15,0,198,15,424,77.7,0.4,0,5.9,0.4,12.6,22.3,1006,853,153,84.79,15.21,139,714,12,141,151,855,16.3,7.8,15,"Less than 25% P.O.C.","$95000 or more"
"06059032046","Census Tract 320.46, Orange County, California",6004,218281,4678,12,0,583,0,530,77.9,0.2,0,9.7,0,8.8,22.1,1905,1736,169,91.13,8.87,242,1494,36,133,278,1627,13.9,21.3,14.6,"Less than 25% P.O.C.","$95000 or more"
"06059032047","Census Tract 320.47, Orange County, California",4534,90985,2890,95,24,389,0,1014,63.7,2.1,0.5,8.6,0,22.4,36.3,2058,1026,1032,49.85,50.15,65,961,18,1014,83,1975,6.3,1.7,4,"25% - 50% P.O.C.","$70000 - $95000"
"06059032048","Census Tract 320.48, Orange County, California",5742,131295,3942,422,0,372,0,819,68.7,7.3,0,6.5,0,14.3,31.3,2209,1998,211,90.45,9.55,165,1833,0,211,165,2044,8.3,0,7.5,"25% - 50% P.O.C.","$95000 or more"
"06059032049","Census Tract 320.49, Orange County, California",9613,141397,5584,70,40,1779,0,1643,58.1,0.7,0.4,18.5,0,17.1,41.9,3081,2311,770,75.01,24.99,296,2015,45,725,341,2740,12.8,5.8,11.1,"25% - 50% P.O.C.","$95000 or more"
"06059032050","Census Tract 320.50, Orange County, California",5143,139664,3137,94,0,435,0,953,61,1.8,0,8.5,0,18.5,39,1726,1440,286,83.43,16.57,173,1267,31,255,204,1522,12,10.8,11.8,"25% - 50% P.O.C.","$95000 or more"
"06059032051","Census Tract 320.51, Orange County, California",4423,70306,2280,96,0,406,0,1485,51.5,2.2,0,9.2,0,33.6,48.5,1941,994,947,51.21,48.79,66,928,23,924,89,1852,6.6,2.4,4.6,"25% - 50% P.O.C.","$70000 - $95000"
"06059032053","Census Tract 320.53, Orange County, California",8131,124361,5295,295,0,1131,0,1150,65.1,3.6,0,13.9,0,14.1,34.9,3091,2281,810,73.79,26.21,208,2073,27,783,235,2856,9.1,3.3,7.6,"25% - 50% P.O.C.","$95000 or more"
"06059032054","Census Tract 320.54, Orange County, California",5452,82409,3112,176,0,448,0,1373,57.1,3.2,0,8.2,0,25.2,42.9,2328,856,1472,36.77,63.23,43,813,26,1446,69,2259,5,1.8,3,"25% - 50% P.O.C.","$70000 - $95000"
"06059032055","Census Tract 320.55, Orange County, California",3671,90417,1966,46,0,353,8,1159,53.6,1.3,0,9.6,0.2,31.6,46.4,1381,682,699,49.38,50.62,11,671,87,612,98,1283,1.6,12.4,7.1,"25% - 50% P.O.C.","$70000 - $95000"
"06059032056","Census Tract 320.56, Orange County, California",10803,146136,6748,219,0,1330,0,1856,62.5,2,0,12.3,0,17.2,37.5,3550,2893,657,81.49,18.51,342,2551,66,591,408,3142,11.8,10,11.5,"25% - 50% P.O.C.","$95000 or more"
"06059032057","Census Tract 320.57, Orange County, California",8499,168313,5466,0,100,896,106,1177,64.3,0,1.2,10.5,1.2,13.8,35.7,2759,1797,962,65.13,34.87,250,1547,117,845,367,2392,13.9,12.2,13.3,"25% - 50% P.O.C.","$95000 or more"
"06059032058","Census Tract 320.58, Orange County, California",8226,189464,6042,35,0,777,30,895,73.5,0.4,0,9.4,0.4,10.9,26.5,2380,1982,398,83.28,16.72,369,1613,128,270,497,1883,18.6,32.2,20.9,"25% - 50% P.O.C.","$95000 or more"
"06059032059","Census Tract 320.59, Orange County, California",10275,153873,6544,194,0,1705,0,1600,63.7,1.9,0,16.6,0,15.6,36.3,3025,2245,780,74.21,25.79,391,1854,70,710,461,2564,17.4,9,15.2,"25% - 50% P.O.C.","$95000 or more"
"06059032061","Census Tract 320.61, Orange County, California",5521,146563,4155,0,0,371,18,609,75.3,0,0,6.7,0.3,11,24.7,1923,1848,75,96.1,3.9,251,1597,27,48,278,1645,13.6,36,14.5,"Less than 25% P.O.C.","$95000 or more"
"06059042103","Census Tract 421.03, Orange County, California",8067,104167,6370,0,0,281,55,996,79,0,0,3.5,0.7,12.3,21,2968,1706,1262,57.48,42.52,129,1577,121,1141,250,2718,7.6,9.6,8.4,"Less than 25% P.O.C.","$95000 or more"
"06059042106","Census Tract 421.06, Orange County, California",1696,128333,1301,12,0,181,0,150,76.7,0.7,0,10.7,0,8.8,23.3,706,575,131,81.44,18.56,58,517,0,131,58,648,10.1,0,8.2,"Less than 25% P.O.C.","$95000 or more"
"06059042107","Census Tract 421.07, Orange County, California",3490,64565,2159,0,0,74,10,1207,61.9,0,0,2.1,0.3,34.6,38.1,1362,463,899,33.99,66.01,29,434,84,815,113,1249,6.3,9.3,8.3,"25% - 50% P.O.C.","$51000 - $70000"
"06059042108","Census Tract 421.08, Orange County, California",4997,76146,3700,42,0,98,0,1024,74,0.8,0,2,0,20.5,26,2380,477,1903,20.04,79.96,24,453,53,1850,77,2303,5,2.8,3.2,"25% - 50% P.O.C.","$70000 - $95000"
"06059042109","Census Tract 421.09, Orange County, California",5175,86853,3473,8,0,242,0,1232,67.1,0.2,0,4.7,0,23.8,32.9,2029,1371,658,67.57,32.43,112,1259,47,611,159,1870,8.2,7.1,7.8,"25% - 50% P.O.C.","$70000 - $95000"
"06059042111","Census Tract 421.11, Orange County, California",6004,139868,4956,0,25,100,21,823,82.5,0,0.4,1.7,0.3,13.7,17.5,2208,2116,92,95.83,4.17,154,1962,32,60,186,2022,7.3,34.8,8.4,"Less than 25% P.O.C.","$95000 or more"
"06059042112","Census Tract 421.12, Orange County, California",6700,154417,5130,19,88,481,0,842,76.6,0.3,1.3,7.2,0,12.6,23.4,2313,1972,341,85.26,14.74,136,1836,70,271,206,2107,6.9,20.5,8.9,"Less than 25% P.O.C.","$95000 or more"
"06059042113","Census Tract 421.13, Orange County, California",4294,113462,3464,32,28,115,0,509,80.7,0.7,0.7,2.7,0,11.9,19.3,1812,1489,323,82.17,17.83,107,1382,30,293,137,1675,7.2,9.3,7.6,"Less than 25% P.O.C.","$95000 or more"
"06059042114","Census Tract 421.14, Orange County, California",3636,89648,2735,11,0,90,0,609,75.2,0.3,0,2.5,0,16.7,24.8,1519,913,606,60.11,39.89,47,866,44,562,91,1428,5.1,7.3,6,"Less than 25% P.O.C.","$70000 - $95000"
"06059042201","Census Tract 422.01, Orange County, California",5207,86960,3729,73,0,111,24,1038,71.6,1.4,0,2.1,0.5,19.9,28.4,2397,1639,758,68.38,31.62,31,1608,18,740,49,2348,1.9,2.4,2,"25% - 50% P.O.C.","$70000 - $95000"
"06059042203","Census Tract 422.03, Orange County, California",7896,102458,6291,105,0,160,0,1170,79.7,1.3,0,2,0,14.8,20.3,3153,2660,493,84.36,15.64,247,2413,12,481,259,2894,9.3,2.4,8.2,"Less than 25% P.O.C.","$95000 or more"
"06059042205","Census Tract 422.05, Orange County, California",6813,136211,4833,48,0,286,0,1330,70.9,0.7,0,4.2,0,19.5,29.1,2467,1839,628,74.54,25.46,164,1675,122,506,286,2181,8.9,19.4,11.6,"25% - 50% P.O.C.","$95000 or more"
"06059042206","Census Tract 422.06, Orange County, California",3478,92078,2701,79,0,89,0,531,77.7,2.3,0,2.6,0,15.3,22.3,1549,914,635,59.01,40.99,42,872,19,616,61,1488,4.6,3,3.9,"Less than 25% P.O.C.","$70000 - $95000"
"06059042305","Census Tract 423.05, Orange County, California",3492,177344,2948,0,0,166,0,242,84.4,0,0,4.8,0,6.9,15.6,1365,1123,242,82.27,17.73,88,1035,7,235,95,1270,7.8,2.9,7,"Less than 25% P.O.C.","$95000 or more"
"06059042307","Census Tract 423.07, Orange County, California",7090,125709,3357,181,0,1369,0,1761,47.3,2.6,0,19.3,0,24.8,52.7,2205,1798,407,81.54,18.46,273,1525,82,325,355,1850,15.2,20.1,16.1,"50% - 75% P.O.C.","$95000 or more"
"06059042310","Census Tract 423.10, Orange County, California",8190,61757,4838,0,41,125,0,2706,59.1,0,0.5,1.5,0,33,40.9,3405,2391,1014,70.22,29.78,123,2268,131,883,254,3151,5.1,12.9,7.5,"25% - 50% P.O.C.","$51000 - $70000"
"06059042311","Census Tract 423.11, Orange County, California",6022,125347,4453,63,0,219,0,1121,73.9,1,0,3.6,0,18.6,26.1,2297,1950,347,84.89,15.11,59,1891,11,336,70,2227,3,3.2,3,"25% - 50% P.O.C.","$95000 or more"
"06059042312","Census Tract 423.12, Orange County, California",9752,62500,2668,14,30,241,0,6760,27.4,0.1,0.3,2.5,0,69.3,72.6,2464,1125,1339,45.66,54.34,347,778,554,785,901,1563,30.8,41.4,36.6,"50% - 75% P.O.C.","$51000 - $70000"
"06059042313","Census Tract 423.13, Orange County, California",6723,68125,4076,24,0,317,0,2158,60.6,0.4,0,4.7,0,32.1,39.4,2971,1084,1887,36.49,63.51,26,1058,210,1677,236,2735,2.4,11.1,7.9,"25% - 50% P.O.C.","$51000 - $70000"
"06059042315","Census Tract 423.15, Orange County, California",5824,99792,3945,186,0,640,0,837,67.7,3.2,0,11,0,14.4,32.3,2414,1746,668,72.33,27.67,131,1615,58,610,189,2225,7.5,8.7,7.8,"25% - 50% P.O.C.","$95000 or more"
"06059042317","Census Tract 423.17, Orange County, California",3156,121875,2597,22,0,181,0,228,82.3,0.7,0,5.7,0,7.2,17.7,1270,997,273,78.5,21.5,67,930,0,273,67,1203,6.7,0,5.3,"Less than 25% P.O.C.","$95000 or more"
"06059042319","Census Tract 423.19, Orange County, California",3448,127667,2476,14,0,420,28,295,71.8,0.4,0,12.2,0.8,8.6,28.2,1164,961,203,82.56,17.44,109,852,30,173,139,1025,11.3,14.8,11.9,"25% - 50% P.O.C.","$95000 or more"
"06059042320","Census Tract 423.20, Orange County, California",6011,84423,2972,87,0,628,0,2087,49.4,1.4,0,10.4,0,34.7,50.6,2532,1307,1225,51.62,48.38,20,1287,28,1197,48,2484,1.5,2.3,1.9,"50% - 75% P.O.C.","$70000 - $95000"
"06059042323","Census Tract 423.23, Orange County, California",4913,140918,4227,113,0,190,0,290,86,2.3,0,3.9,0,5.9,14,2248,1712,536,76.16,23.84,18,1694,88,448,106,2142,1.1,16.4,4.7,"Less than 25% P.O.C.","$95000 or more"
"06059042324","Census Tract 423.24, Orange County, California",4465,98654,3776,0,32,83,0,494,84.6,0,0.7,1.9,0,11.1,15.4,2264,1455,809,64.27,35.73,0,1455,0,809,0,2264,0,0,0,"Less than 25% P.O.C.","$95000 or more"
"06059042325","Census Tract 423.25, Orange County, California",3551,118411,2682,66,0,430,49,247,75.5,1.9,0,12.1,1.4,7,24.5,1523,1078,445,70.78,29.22,23,1055,0,445,23,1500,2.1,0,1.5,"Less than 25% P.O.C.","$95000 or more"
"06059042326","Census Tract 423.26, Orange County, California",4781,118468,3036,129,0,530,22,605,63.5,2.7,0,11.1,0.5,12.7,36.5,1794,1303,491,72.63,27.37,45,1258,68,423,113,1681,3.5,13.8,6.3,"25% - 50% P.O.C.","$95000 or more"
"06059042327","Census Tract 423.27, Orange County, California",5124,118167,3464,31,0,560,15,821,67.6,0.6,0,10.9,0.3,16,32.4,1674,1484,190,88.65,11.35,130,1354,92,98,222,1452,8.8,48.4,13.3,"25% - 50% P.O.C.","$95000 or more"
"06059042328","Census Tract 423.28, Orange County, California",2526,216818,1893,2,0,279,3,231,74.9,0.1,0,11,0.1,9.1,25.1,796,779,17,97.86,2.14,135,644,6,11,141,655,17.3,35.3,17.7,"25% - 50% P.O.C.","$95000 or more"
"06059042329","Census Tract 423.29, Orange County, California",4059,97000,3080,58,0,307,0,455,75.9,1.4,0,7.6,0,11.2,24.1,1462,1174,288,80.3,19.7,79,1095,17,271,96,1366,6.7,5.9,6.6,"Less than 25% P.O.C.","$95000 or more"
"06059042330","Census Tract 423.30, Orange County, California",6489,105043,3363,66,0,612,28,2247,51.8,1,0,9.4,0.4,34.6,48.2,2319,1098,1221,47.35,52.65,63,1035,252,969,315,2004,5.7,20.6,13.6,"25% - 50% P.O.C.","$95000 or more"
"06059042331","Census Tract 423.31, Orange County, California",6215,83125,3050,0,0,338,0,2430,49.1,0,0,5.4,0,39.1,50.9,2179,1153,1026,52.91,47.09,71,1082,163,863,234,1945,6.2,15.9,10.7,"50% - 75% P.O.C.","$70000 - $95000"
"06059042332","Census Tract 423.32, Orange County, California",5318,129676,3922,20,0,562,0,662,73.7,0.4,0,10.6,0,12.4,26.3,2233,1719,514,76.98,23.02,86,1633,23,491,109,2124,5,4.5,4.9,"25% - 50% P.O.C.","$95000 or more"
"06059042333","Census Tract 423.33, Orange County, California",4207,165000,3078,24,0,643,0,326,73.2,0.6,0,15.3,0,7.7,26.8,1534,1238,296,80.7,19.3,172,1066,0,296,172,1362,13.9,0,11.2,"25% - 50% P.O.C.","$95000 or more"
"06059042334","Census Tract 423.34, Orange County, California",5453,89475,3090,105,0,810,0,795,56.7,1.9,0,14.9,0,14.6,43.3,2023,1341,682,66.29,33.71,116,1225,167,515,283,1740,8.7,24.5,14,"25% - 50% P.O.C.","$70000 - $95000"
"06059042335","Census Tract 423.35, Orange County, California",6869,99464,4107,39,0,1064,49,1083,59.8,0.6,0,15.5,0.7,15.8,40.2,2550,1532,1018,60.08,39.92,105,1427,145,873,250,2300,6.9,14.2,9.8,"25% - 50% P.O.C.","$95000 or more"
"06059042336","Census Tract 423.36, Orange County, California",4201,142386,3297,28,0,430,0,253,78.5,0.7,0,10.2,0,6,21.5,1513,1265,248,83.61,16.39,89,1176,34,214,123,1390,7,13.7,8.1,"Less than 25% P.O.C.","$95000 or more"
"06059042337","Census Tract 423.37, Orange County, California",3352,138214,2494,12,0,324,0,397,74.4,0.4,0,9.7,0,11.8,25.6,1292,1085,207,83.98,16.02,40,1045,10,197,50,1242,3.7,4.8,3.9,"25% - 50% P.O.C.","$95000 or more"
"06059042338","Census Tract 423.38, Orange County, California",4603,107424,3632,175,17,190,0,415,78.9,3.8,0.4,4.1,0,9,21.1,1982,1446,536,72.96,27.04,84,1362,10,526,94,1888,5.8,1.9,4.7,"Less than 25% P.O.C.","$95000 or more"
"06059042339","Census Tract 423.39, Orange County, California",3472,100842,2457,24,0,168,0,687,70.8,0.7,0,4.8,0,19.8,29.2,1479,887,592,59.97,40.03,0,887,32,560,32,1447,0,5.4,2.2,"25% - 50% P.O.C.","$95000 or more"
"06059052404","Census Tract 524.04, Orange County, California",4220,142344,1280,19,0,2314,6,344,30.3,0.5,0,54.8,0.1,8.2,69.7,1250,894,356,71.52,28.48,111,783,32,324,143,1107,12.4,9,11.4,"50% - 75% P.O.C.","$95000 or more"
"06059052408","Census Tract 524.08, Orange County, California",6342,141716,4228,0,0,1082,0,860,66.7,0,0,17.1,0,13.6,33.3,2126,1795,331,84.43,15.57,144,1651,74,257,218,1908,8,22.4,10.3,"25% - 50% P.O.C.","$95000 or more"
"06059052410","Census Tract 524.10, Orange County, California",5452,73456,2728,91,0,1220,0,1178,50,1.7,0,22.4,0,21.6,50,2253,1534,719,68.09,31.91,136,1398,68,651,204,2049,8.9,9.5,9.1,"50% - 75% P.O.C.","$70000 - $95000"
"06059052411","Census Tract 524.11, Orange County, California",5264,116429,1945,122,0,881,9,2070,36.9,2.3,0,16.7,0.2,39.3,63.1,1350,1050,300,77.78,22.22,145,905,89,211,234,1116,13.8,29.7,17.3,"50% - 75% P.O.C.","$95000 or more"
"06059052415","Census Tract 524.15, Orange County, California",4110,150764,2950,0,7,475,0,596,71.8,0,0.2,11.6,0,14.5,28.2,1317,1207,110,91.65,8.35,121,1086,22,88,143,1174,10,20,10.9,"25% - 50% P.O.C.","$95000 or more"
"06059052416","Census Tract 524.16, Orange County, California",4318,113877,2053,27,68,390,0,1657,47.5,0.6,1.6,9,0,38.4,52.5,1315,983,332,74.75,25.25,148,835,121,211,269,1046,15.1,36.4,20.5,"50% - 75% P.O.C.","$95000 or more"
"06059052417","Census Tract 524.17, Orange County, California",7893,114554,3394,106,0,3403,53,576,43,1.3,0,43.1,0.7,7.3,57,2864,2140,724,74.72,25.28,79,2061,91,633,170,2694,3.7,12.6,5.9,"50% - 75% P.O.C.","$95000 or more"
"06059052418","Census Tract 524.18, Orange County, California",21717,96509,7186,716,20,11310,49,1548,33.1,3.3,0.1,52.1,0.2,7.1,66.9,8323,2751,5572,33.05,66.95,111,2640,254,5318,365,7958,4,4.6,4.4,"50% - 75% P.O.C.","$95000 or more"
"06059052419","Census Tract 524.19, Orange County, California",3434,165150,1592,13,0,1205,0,382,46.4,0.4,0,35.1,0,11.1,53.6,1107,960,147,86.72,13.28,135,825,21,126,156,951,14.1,14.3,14.1,"50% - 75% P.O.C.","$95000 or more"
"06059052420","Census Tract 524.20, Orange County, California",23390,135231,7433,74,0,13013,20,2192,31.8,0.3,0,55.6,0.1,9.4,68.2,7801,5549,2252,71.13,28.87,476,5073,226,2026,702,7099,8.6,10,9,"50% - 75% P.O.C.","$95000 or more"
"06059052421","Census Tract 524.21, Orange County, California",5447,121373,2220,0,0,2580,0,472,40.8,0,0,47.4,0,8.7,59.2,1974,1418,556,71.83,28.17,156,1262,52,504,208,1766,11,9.4,10.5,"50% - 75% P.O.C.","$95000 or more"
"06059052422","Census Tract 524.22, Orange County, California",8974,127640,3698,582,0,2818,0,1380,41.2,6.5,0,31.4,0,15.4,58.8,3254,2208,1046,67.85,32.15,215,1993,31,1015,246,3008,9.7,3,7.6,"50% - 75% P.O.C.","$95000 or more"
"06059052423","Census Tract 524.23, Orange County, California",5905,95793,2984,162,0,1017,0,1381,50.5,2.7,0,17.2,0,23.4,49.5,2249,880,1369,39.13,60.87,156,724,60,1309,216,2033,17.7,4.4,9.6,"25% - 50% P.O.C.","$95000 or more"
"06059052424","Census Tract 524.24, Orange County, California",4884,85000,2837,9,119,891,0,844,58.1,0.2,2.4,18.2,0,17.3,41.9,1942,1199,743,61.74,38.26,148,1051,8,735,156,1786,12.3,1.1,8,"25% - 50% P.O.C.","$70000 - $95000"
"06059052425","Census Tract 524.25, Orange County, California",5925,90240,3354,214,0,1032,11,1140,56.6,3.6,0,17.4,0.2,19.2,43.4,2321,1316,1005,56.7,43.3,96,1220,56,949,152,2169,7.3,5.6,6.5,"25% - 50% P.O.C.","$70000 - $95000"
"06059052426","Census Tract 524.26, Orange County, California",20544,131184,7208,162,68,10832,0,1280,35.1,0.8,0.3,52.7,0,6.2,64.9,7214,4341,2873,60.17,39.83,468,3873,242,2631,710,6504,10.8,8.4,9.8,"50% - 75% P.O.C.","$95000 or more"
"06059052427","Census Tract 524.27, Orange County, California",5662,131378,3277,141,0,1372,0,553,57.9,2.5,0,24.2,0,9.8,42.1,1818,1380,438,75.91,24.09,47,1333,105,333,152,1666,3.4,24,8.4,"25% - 50% P.O.C.","$95000 or more"
"06059052428","Census Tract 524.28, Orange County, California",6359,151385,4289,96,0,1020,22,723,67.4,1.5,0,16,0.3,11.4,32.6,2259,1961,298,86.81,13.19,131,1830,0,298,131,2128,6.7,0,5.8,"25% - 50% P.O.C.","$95000 or more"
"06059052502","Census Tract 525.02, Orange County, California",5951,115260,2853,58,0,1067,0,1668,47.9,1,0,17.9,0,28,52.1,1879,1539,340,81.91,18.09,167,1372,65,275,232,1647,10.9,19.1,12.3,"50% - 75% P.O.C.","$95000 or more"
"06059052505","Census Tract 525.05, Orange County, California",5283,70674,2011,116,0,2243,0,649,38.1,2.2,0,42.5,0,12.3,61.9,1915,1259,656,65.74,34.26,56,1203,89,567,145,1770,4.4,13.6,7.6,"50% - 75% P.O.C.","$70000 - $95000"
"06059052506","Census Tract 525.06, Orange County, California",2561,111250,1306,59,0,813,0,246,51,2.3,0,31.7,0,9.6,49,834,634,200,76.02,23.98,70,564,25,175,95,739,11,12.5,11.4,"25% - 50% P.O.C.","$95000 or more"
"06059052511","Census Tract 525.11, Orange County, California",6532,129531,3589,122,0,2031,0,532,54.9,1.9,0,31.1,0,8.1,45.1,2205,1450,755,65.76,34.24,144,1306,99,656,243,1962,9.9,13.1,11,"25% - 50% P.O.C.","$95000 or more"
"06059052513","Census Tract 525.13, Orange County, California",5728,104265,3354,82,0,1640,0,575,58.6,1.4,0,28.6,0,10,41.4,2190,1309,881,59.77,40.23,73,1236,66,815,139,2051,5.6,7.5,6.3,"25% - 50% P.O.C.","$95000 or more"
"06059052514","Census Tract 525.14, Orange County, California",5202,107500,2762,0,15,1358,0,784,53.1,0,0.3,26.1,0,15.1,46.9,2134,1038,1096,48.64,51.36,35,1003,21,1075,56,2078,3.4,1.9,2.6,"25% - 50% P.O.C.","$95000 or more"
"06059052515","Census Tract 525.15, Orange County, California",9253,116172,3742,70,0,4120,0,738,40.4,0.8,0,44.5,0,8,59.6,3125,1433,1692,45.86,54.14,76,1357,284,1408,360,2765,5.3,16.8,11.5,"50% - 75% P.O.C.","$95000 or more"
"06059052517","Census Tract 525.17, Orange County, California",10849,100455,3991,65,0,5423,0,755,36.8,0.6,0,50,0,7,63.2,4284,1964,2320,45.85,54.15,196,1768,104,2216,300,3984,10,4.5,7,"50% - 75% P.O.C.","$95000 or more"
"06059052518","Census Tract 525.18, Orange County, California",7589,99474,4110,90,0,2386,0,694,54.2,1.2,0,31.4,0,9.1,45.8,3808,28,3780,0.74,99.26,0,28,53,3727,53,3755,0,1.4,1.4,"25% - 50% P.O.C.","$95000 or more"
"06059052519","Census Tract 525.19, Orange County, California",4565,89297,2516,67,66,1179,0,447,55.1,1.5,1.4,25.8,0,9.8,44.9,1590,724,866,45.53,54.47,43,681,64,802,107,1483,5.9,7.4,6.7,"25% - 50% P.O.C.","$70000 - $95000"
"06059052520","Census Tract 525.20, Orange County, California",3665,102262,1897,12,0,956,0,515,51.8,0.3,0,26.1,0,14.1,48.2,1312,733,579,55.87,44.13,21,712,83,496,104,1208,2.9,14.3,7.9,"25% - 50% P.O.C.","$95000 or more"
"06059052521","Census Tract 525.21, Orange County, California",5147,84806,2524,161,0,1539,0,674,49,3.1,0,29.9,0,13.1,51,2185,300,1885,13.73,86.27,25,275,145,1740,170,2015,8.3,7.7,7.8,"50% - 75% P.O.C.","$70000 - $95000"
"06059052522","Census Tract 525.22, Orange County, California",4222,131895,1654,0,0,1863,0,505,39.2,0,0,44.1,0,12,60.8,1379,754,625,54.68,45.32,33,721,31,594,64,1315,4.4,5,4.6,"50% - 75% P.O.C.","$95000 or more"
"06059052523","Census Tract 525.23, Orange County, California",4510,135978,2012,74,0,1711,40,463,44.6,1.6,0,37.9,0.9,10.3,55.4,1504,713,791,47.41,52.59,80,633,64,727,144,1360,11.2,8.1,9.6,"50% - 75% P.O.C.","$95000 or more"
"06059052524","Census Tract 525.24, Orange County, California",7988,96596,2825,416,0,2590,0,1878,35.4,5.2,0,32.4,0,23.5,64.6,2808,1227,1581,43.7,56.3,176,1051,134,1447,310,2498,14.3,8.5,11,"50% - 75% P.O.C.","$95000 or more"
"06059052525","Census Tract 525.25, Orange County, California",19462,97515,6340,158,0,10031,76,1848,32.6,0.8,0,51.5,0.4,9.5,67.4,7087,3529,3558,49.8,50.2,411,3118,255,3303,666,6421,11.6,7.2,9.4,"50% - 75% P.O.C.","$95000 or more"
"06059052526","Census Tract 525.26, Orange County, California",4794,109333,1887,44,0,1655,0,876,39.4,0.9,0,34.5,0,18.3,60.6,1362,1073,289,78.78,21.22,199,874,101,188,300,1062,18.5,34.9,22,"50% - 75% P.O.C.","$95000 or more"
"06059052527","Census Tract 525.27, Orange County, California",8917,120127,3075,487,0,3673,282,679,34.5,5.5,0,41.2,3.2,7.6,65.5,2698,1953,745,72.39,27.61,262,1691,86,659,348,2350,13.4,11.5,12.9,"50% - 75% P.O.C.","$95000 or more"
"06059052528","Census Tract 525.28, Orange County, California",4059,116641,1542,40,13,1600,0,788,38,1,0.3,39.4,0,19.4,62,1273,745,528,58.52,41.48,51,694,117,411,168,1105,6.8,22.2,13.2,"50% - 75% P.O.C.","$95000 or more"
"06059062604","Census Tract 626.04, Orange County, California",15355,146472,8721,53,45,4780,0,1161,56.8,0.3,0.3,31.1,0,7.6,43.2,5846,3480,2366,59.53,40.47,144,3336,152,2214,296,5550,4.1,6.4,5.1,"25% - 50% P.O.C.","$95000 or more"
"06059062605","Census Tract 626.05, Orange County, California",3028,82231,2435,75,12,110,0,366,80.4,2.5,0.4,3.6,0,12.1,19.6,1718,527,1191,30.68,69.32,5,522,25,1166,30,1688,0.9,2.1,1.7,"Less than 25% P.O.C.","$70000 - $95000"
"06059062610","Census Tract 626.10, Orange County, California",10440,91691,5161,384,0,3602,0,1037,49.4,3.7,0,34.5,0,9.9,50.6,5563,1086,4477,19.52,80.48,0,1086,26,4451,26,5537,0,0.6,0.5,"50% - 75% P.O.C.","$70000 - $95000"
"06059062611","Census Tract 626.11, Orange County, California",4963,61023,1404,383,0,2222,0,831,28.3,7.7,0,44.8,0,16.7,71.7,1641,348,1293,21.21,78.79,19,329,208,1085,227,1414,5.5,16.1,13.8,"50% - 75% P.O.C.","$51000 - $70000"
"06059062612","Census Tract 626.12, Orange County, California",8225,124906,4987,84,0,2050,0,719,60.6,1,0,24.9,0,8.7,39.4,2914,1861,1053,63.86,36.14,207,1654,112,941,319,2595,11.1,10.6,10.9,"25% - 50% P.O.C.","$95000 or more"
"06059062614","Census Tract 626.14, Orange County, California",17197,36824,5982,249,29,5766,26,4203,34.8,1.4,0.2,33.5,0.2,24.4,65.2,3971,904,3067,22.77,77.23,68,836,53,3014,121,3850,7.5,1.7,3,"50% - 75% P.O.C.","Less than $51000"
"06059062619","Census Tract 626.19, Orange County, California",3867,136688,3317,24,0,68,0,251,85.8,0.6,0,1.8,0,6.5,14.2,1681,1235,446,73.47,26.53,58,1177,10,436,68,1613,4.7,2.2,4,"Less than 25% P.O.C.","$95000 or more"
"06059062620","Census Tract 626.20, Orange County, California",5053,160556,4180,65,0,216,0,351,82.7,1.3,0,4.3,0,6.9,17.3,2214,1702,512,76.87,23.13,124,1578,24,488,148,2066,7.3,4.7,6.7,"Less than 25% P.O.C.","$95000 or more"
"06059062621","Census Tract 626.21, Orange County, California",12331,111425,6356,194,0,3611,0,1557,51.5,1.6,0,29.3,0,12.6,48.5,4623,2360,2263,51.05,48.95,219,2141,120,2143,339,4284,9.3,5.3,7.3,"25% - 50% P.O.C.","$95000 or more"
"06059062622","Census Tract 626.22, Orange County, California",3868,44119,2748,14,0,736,0,305,71,0.4,0,19,0,7.9,29,2535,1787,748,70.49,29.51,0,1787,0,748,0,2535,0,0,0,"25% - 50% P.O.C.","Less than $51000"
"06059062625","Census Tract 626.25, Orange County, California",3975,45214,2038,11,0,513,0,1293,51.3,0.3,0,12.9,0,32.5,48.7,1960,1414,546,72.14,27.86,24,1390,85,461,109,1851,1.7,15.6,5.6,"25% - 50% P.O.C.","Less than $51000"
"06059062626","Census Tract 626.26, Orange County, California",3167,26750,969,62,0,1505,0,582,30.6,2,0,47.5,0,18.4,69.4,908,194,714,21.37,78.63,0,194,206,508,206,702,0,28.9,22.7,"50% - 75% P.O.C.","Less than $51000"
"06059062627","Census Tract 626.27, Orange County, California",3549,53316,1339,92,0,1596,15,387,37.7,2.6,0,45,0.4,10.9,62.3,1414,215,1199,15.21,84.79,0,215,148,1051,148,1266,0,12.3,10.5,"50% - 75% P.O.C.","$51000 - $70000"
"06059062628","Census Tract 626.28, Orange County, California",3812,93050,1579,72,97,1469,6,414,41.4,1.9,2.5,38.5,0.2,10.9,58.6,925,395,530,42.7,57.3,30,365,73,457,103,822,7.6,13.8,11.1,"50% - 75% P.O.C.","$70000 - $95000"
"06059062629","Census Tract 626.29, Orange County, California",2545,135000,1418,5,0,906,0,109,55.7,0.2,0,35.6,0,4.3,44.3,862,714,148,82.83,17.17,47,667,39,109,86,776,6.6,26.4,10,"25% - 50% P.O.C.","$95000 or more"
"06059062630","Census Tract 626.30, Orange County, California",1739,108553,978,38,0,411,0,246,56.2,2.2,0,23.6,0,14.1,43.8,722,554,168,76.73,23.27,18,536,11,157,29,693,3.2,6.5,4,"25% - 50% P.O.C.","$95000 or more"
"06059062631","Census Tract 626.31, Orange County, California",3182,164554,2006,0,18,916,0,116,63,0,0.6,28.8,0,3.6,37,1178,1072,106,91,9,101,971,0,106,101,1077,9.4,0,8.6,"25% - 50% P.O.C.","$95000 or more"
"06059062632","Census Tract 626.32, Orange County, California",4089,156875,3371,30,0,117,0,353,82.4,0.7,0,2.9,0,8.6,17.6,1703,1235,468,72.52,27.48,54,1181,32,436,86,1617,4.4,6.8,5,"Less than 25% P.O.C.","$95000 or more"
"06059062633","Census Tract 626.33, Orange County, California",6480,172422,4443,4,3,1184,0,682,68.6,0.1,0,18.3,0,10.5,31.4,1813,1620,193,89.35,10.65,253,1367,35,158,288,1525,15.6,18.1,15.9,"25% - 50% P.O.C.","$95000 or more"
"06059062634","Census Tract 626.34, Orange County, California",5121,122000,3350,111,0,747,0,685,65.4,2.2,0,14.6,0,13.4,34.6,1932,1473,459,76.24,23.76,92,1381,57,402,149,1783,6.2,12.4,7.7,"25% - 50% P.O.C.","$95000 or more"
"06059062635","Census Tract 626.35, Orange County, California",4160,128393,2566,39,80,777,16,599,61.7,0.9,1.9,18.7,0.4,14.4,38.3,1637,1320,317,80.64,19.36,86,1234,24,293,110,1527,6.5,7.6,6.7,"25% - 50% P.O.C.","$95000 or more"
"06059062636","Census Tract 626.36, Orange County, California",4067,106957,2108,142,0,493,0,1082,51.8,3.5,0,12.1,0,26.6,48.2,1412,576,836,40.79,59.21,70,506,86,750,156,1256,12.2,10.3,11,"25% - 50% P.O.C.","$95000 or more"
"06059062637","Census Tract 626.37, Orange County, California",5188,97426,3170,83,0,595,0,864,61.1,1.6,0,11.5,0,16.7,38.9,2327,545,1782,23.42,76.58,15,530,25,1757,40,2287,2.8,1.4,1.7,"25% - 50% P.O.C.","$95000 or more"
"06059062638","Census Tract 626.38, Orange County, California",6737,108687,3563,210,0,1455,28,1241,52.9,3.1,0,21.6,0.4,18.4,47.1,2403,1238,1165,51.52,48.48,109,1129,66,1099,175,2228,8.8,5.7,7.3,"25% - 50% P.O.C.","$95000 or more"
"06059062639","Census Tract 626.39, Orange County, California",7277,121474,4304,269,0,1045,0,993,59.1,3.7,0,14.4,0,13.6,40.9,2619,1731,888,66.09,33.91,174,1557,62,826,236,2383,10.1,7,9,"25% - 50% P.O.C.","$95000 or more"
"06059062640","Census Tract 626.40, Orange County, California",3741,98813,2365,185,0,440,0,616,63.2,4.9,0,11.8,0,16.5,36.8,1571,819,752,52.13,47.87,53,766,8,744,61,1510,6.5,1.1,3.9,"25% - 50% P.O.C.","$95000 or more"
"06059062641","Census Tract 626.41, Orange County, California",5376,88986,2970,74,0,955,0,1184,55.2,1.4,0,17.8,0,22,44.8,2024,1245,779,61.51,38.49,174,1071,72,707,246,1778,14,9.2,12.2,"25% - 50% P.O.C.","$70000 - $95000"
"06059062642","Census Tract 626.42, Orange County, California",2834,154344,2540,11,0,83,0,159,89.6,0.4,0,2.9,0,5.6,10.4,1293,1162,131,89.87,10.13,89,1073,9,122,98,1195,7.7,6.9,7.6,"Less than 25% P.O.C.","$95000 or more"
"06059062643","Census Tract 626.43, Orange County, California",7231,250001,4623,0,22,1808,15,322,63.9,0,0.3,25,0.2,4.5,36.1,2753,2582,171,93.79,6.21,160,2422,0,171,160,2593,6.2,0,5.8,"25% - 50% P.O.C.","$95000 or more"
"06059062644","Census Tract 626.44, Orange County, California",8487,156250,6966,0,0,676,0,751,82.1,0,0,8,0,8.8,17.9,3276,1592,1684,48.6,51.4,262,1330,97,1587,359,2917,16.5,5.8,11,"Less than 25% P.O.C.","$95000 or more"
"06059062645","Census Tract 626.45, Orange County, California",6527,148583,4880,19,0,1321,0,250,74.8,0.3,0,20.2,0,3.8,25.2,2593,1855,738,71.54,28.46,139,1716,21,717,160,2433,7.5,2.8,6.2,"25% - 50% P.O.C.","$95000 or more"
"06059062646","Census Tract 626.46, Orange County, California",3433,41875,2375,100,0,658,0,240,69.2,2.9,0,19.2,0,7,30.8,2425,2017,408,83.18,16.82,0,2017,0,408,0,2425,0,0,0,"25% - 50% P.O.C.","Less than $51000"
"06059062647","Census Tract 626.47, Orange County, California",4553,54327,2588,170,13,788,0,994,56.8,3.7,0.3,17.3,0,21.8,43.2,2351,1062,1289,45.17,54.83,0,1062,61,1228,61,2290,0,4.7,2.6,"25% - 50% P.O.C.","$51000 - $70000"
"06059062648","Census Tract 626.48, Orange County, California",2640,45000,1926,0,0,510,0,110,73,0,0,19.3,0,4.2,27,1862,1268,594,68.1,31.9,0,1268,0,594,0,1862,0,0,0,"25% - 50% P.O.C.","Less than $51000"
"06059062649","Census Tract 626.49, Orange County, California",3204,60254,2219,0,0,552,0,379,69.3,0,0,17.2,0,11.8,30.7,1866,1174,692,62.92,37.08,0,1174,24,668,24,1842,0,3.5,1.3,"25% - 50% P.O.C.","$51000 - $70000"
"06059062701","Census Tract 627.01, Orange County, California",2764,168125,2425,81,0,45,0,185,87.7,2.9,0,1.6,0,6.7,12.3,1364,910,454,66.72,33.28,37,873,21,433,58,1306,4.1,4.6,4.3,"Less than 25% P.O.C.","$95000 or more"
"06059062702","Census Tract 627.02, Orange County, California",4245,152923,3528,0,0,54,0,565,83.1,0,0,1.3,0,13.3,16.9,2068,1213,855,58.66,41.34,33,1180,27,828,60,2008,2.7,3.2,2.9,"Less than 25% P.O.C.","$95000 or more"
"06059062800","Census Tract 628, Orange County, California",3888,125275,3351,65,0,55,16,334,86.2,1.7,0,1.4,0.4,8.6,13.8,1669,806,863,48.29,51.71,12,794,37,826,49,1620,1.5,4.3,2.9,"Less than 25% P.O.C.","$95000 or more"
"06059062900","Census Tract 629, Orange County, California",1527,206250,1391,0,0,102,0,34,91.1,0,0,6.7,0,2.2,8.9,706,598,108,84.7,15.3,12,586,0,108,12,694,2,0,1.7,"Less than 25% P.O.C.","$95000 or more"
"06059063004","Census Tract 630.04, Orange County, California",6718,92214,5546,165,27,403,24,403,82.6,2.5,0.4,6,0.4,6,17.4,3271,1229,2042,37.57,62.43,88,1141,85,1957,173,3098,7.2,4.2,5.3,"Less than 25% P.O.C.","$70000 - $95000"
"06059063005","Census Tract 630.05, Orange County, California",1406,132000,1252,50,0,59,0,35,89,3.6,0,4.2,0,2.5,11,790,250,540,31.65,68.35,5,245,0,540,5,785,2,0,0.6,"Less than 25% P.O.C.","$95000 or more"
"06059063006","Census Tract 630.06, Orange County, California",2519,117969,2454,0,0,17,0,48,97.4,0,0,0.7,0,1.9,2.6,1295,804,491,62.08,37.92,18,786,20,471,38,1257,2.2,4.1,2.9,"Less than 25% P.O.C.","$95000 or more"
"06059063007","Census Tract 630.07, Orange County, California",6285,121620,5033,0,0,589,0,487,80.1,0,0,9.4,0,7.7,19.9,2844,1656,1188,58.23,41.77,120,1536,30,1158,150,2694,7.2,2.5,5.3,"Less than 25% P.O.C.","$95000 or more"
"06059063008","Census Tract 630.08, Orange County, California",1093,91250,954,0,0,123,0,16,87.3,0,0,11.3,0,1.5,12.7,653,185,468,28.33,71.67,0,185,0,468,0,653,0,0,0,"Less than 25% P.O.C.","$70000 - $95000"
"06059063009","Census Tract 630.09, Orange County, California",1835,160694,1600,0,0,143,0,43,87.2,0,0,7.8,0,2.3,12.8,721,644,77,89.32,10.68,40,604,7,70,47,674,6.2,9.1,6.5,"Less than 25% P.O.C.","$95000 or more"
"06059063010","Census Tract 630.10, Orange County, California",6275,100313,5124,143,0,347,0,448,81.7,2.3,0,5.5,0,7.1,18.3,3037,1238,1799,40.76,59.24,122,1116,0,1799,122,2915,9.9,0,4,"Less than 25% P.O.C.","$95000 or more"
"06059063101","Census Tract 631.01, Orange County, California",3236,92434,1815,174,9,193,0,964,56.1,5.4,0.3,6,0,29.8,43.9,1288,424,864,32.92,67.08,37,387,33,831,70,1218,8.7,3.8,5.4,"25% - 50% P.O.C.","$70000 - $95000"
"06059063102","Census Tract 631.02, Orange County, California",6971,103622,5259,12,3,254,0,1074,75.4,0.2,0,3.6,0,15.4,24.6,2806,1468,1338,52.32,47.68,49,1419,81,1257,130,2676,3.3,6.1,4.6,"Less than 25% P.O.C.","$95000 or more"
"06059063103","Census Tract 631.03, Orange County, California",2636,131477,1984,25,7,76,0,492,75.3,0.9,0.3,2.9,0,18.7,24.7,1053,756,297,71.79,28.21,50,706,0,297,50,1003,6.6,0,4.7,"Less than 25% P.O.C.","$95000 or more"
"06059063201","Census Tract 632.01, Orange County, California",4016,74514,2906,44,0,198,0,747,72.4,1.1,0,4.9,0,18.6,27.6,1641,628,1013,38.27,61.73,14,614,28,985,42,1599,2.2,2.8,2.6,"25% - 50% P.O.C.","$70000 - $95000"
"06059063202","Census Tract 632.02, Orange County, California",3768,112500,2654,21,0,144,0,642,70.4,0.6,0,3.8,0,17,29.6,1498,772,726,51.54,48.46,84,688,35,691,119,1379,10.9,4.8,7.9,"25% - 50% P.O.C.","$95000 or more"
"06059063301","Census Tract 633.01, Orange County, California",2946,102286,2427,45,0,56,20,377,82.4,1.5,0,1.9,0.7,12.8,17.6,1426,297,1129,20.83,79.17,8,289,10,1119,18,1408,2.7,0.9,1.3,"Less than 25% P.O.C.","$95000 or more"
"06059063302","Census Tract 633.02, Orange County, California",4457,127153,3636,38,0,216,0,472,81.6,0.9,0,4.8,0,10.6,18.4,1717,877,840,51.08,48.92,74,803,26,814,100,1617,8.4,3.1,5.8,"Less than 25% P.O.C.","$95000 or more"
"06059063400","Census Tract 634, Orange County, California",4906,150238,4239,16,11,276,0,235,86.4,0.3,0.2,5.6,0,4.8,13.6,1908,1316,592,68.97,31.03,122,1194,19,573,141,1767,9.3,3.2,7.4,"Less than 25% P.O.C.","$95000 or more"
"06059063500","Census Tract 635, Orange County, California",6360,108527,5072,0,0,108,70,972,79.7,0,0,1.7,1.1,15.3,20.3,2655,1008,1647,37.97,62.03,45,963,6,1641,51,2604,4.5,0.4,1.9,"Less than 25% P.O.C.","$95000 or more"
"06059063601","Census Tract 636.01, Orange County, California",3835,120057,2390,174,0,185,0,1006,62.3,4.5,0,4.8,0,26.2,37.7,1405,968,437,68.9,31.1,56,912,85,352,141,1264,5.8,19.5,10,"25% - 50% P.O.C.","$95000 or more"
"06059063603","Census Tract 636.03, Orange County, California",6173,99607,4495,2,6,339,0,1103,72.8,0,0.1,5.5,0,17.9,27.2,2934,1348,1586,45.94,54.06,24,1324,34,1552,58,2876,1.8,2.1,2,"25% - 50% P.O.C.","$95000 or more"
"06059063604","Census Tract 636.04, Orange County, California",4070,66940,1665,15,32,192,0,2003,40.9,0.4,0.8,4.7,0,49.2,59.1,1591,627,964,39.41,60.59,42,585,113,851,155,1436,6.7,11.7,9.7,"50% - 75% P.O.C.","$51000 - $70000"
"06059063605","Census Tract 636.05, Orange County, California",5387,48206,1076,46,0,62,0,4117,20,0.9,0,1.2,0,76.4,80,1425,215,1210,15.09,84.91,0,215,325,885,325,1100,0,26.9,22.8,"75% or more P.O.C.","Less than $51000"
"06059063701","Census Tract 637.01, Orange County, California",5930,54801,1002,67,0,349,0,4389,16.9,1.1,0,5.9,0,74,83.1,1621,224,1397,13.82,86.18,52,172,442,955,494,1127,23.2,31.6,30.5,"75% or more P.O.C.","$51000 - $70000"
"06059063702","Census Tract 637.02, Orange County, California",6583,69005,2456,11,0,212,0,3629,37.3,0.2,0,3.2,0,55.1,62.7,1981,470,1511,23.73,76.27,119,351,226,1285,345,1636,25.3,15,17.4,"50% - 75% P.O.C.","$51000 - $70000"
"06059063802","Census Tract 638.02, Orange County, California",2857,118000,1872,37,0,207,0,642,65.5,1.3,0,7.2,0,22.5,34.5,1000,747,253,74.7,25.3,45,702,38,215,83,917,6,15,8.3,"25% - 50% P.O.C.","$95000 or more"
"06059063803","Census Tract 638.03, Orange County, California",4416,103523,2577,33,25,220,62,1406,58.4,0.7,0.6,5,1.4,31.8,41.6,1698,1035,663,60.95,39.05,95,940,35,628,130,1568,9.2,5.3,7.7,"25% - 50% P.O.C.","$95000 or more"
"06059063805","Census Tract 638.05, Orange County, California",2615,122750,1818,0,0,193,0,543,69.5,0,0,7.4,0,20.8,30.5,876,686,190,78.31,21.69,63,623,53,137,116,760,9.2,27.9,13.2,"25% - 50% P.O.C.","$95000 or more"
"06059063806","Census Tract 638.06, Orange County, California",3836,109306,2454,0,0,248,16,949,64,0,0,6.5,0.4,24.7,36,1394,857,537,61.48,38.52,58,799,69,468,127,1267,6.8,12.8,9.1,"25% - 50% P.O.C.","$95000 or more"
"06059063807","Census Tract 638.07, Orange County, California",4910,70417,2707,176,0,370,0,1243,55.1,3.6,0,7.5,0,25.3,44.9,2107,279,1828,13.24,86.76,11,268,64,1764,75,2032,3.9,3.5,3.6,"25% - 50% P.O.C.","$70000 - $95000"
"06059063808","Census Tract 638.08, Orange County, California",6052,63146,1070,9,22,117,128,4654,17.7,0.1,0.4,1.9,2.1,76.9,82.3,1547,422,1125,27.28,72.72,71,351,427,698,498,1049,16.8,38,32.2,"75% or more P.O.C.","$51000 - $70000"
"06059063902","Census Tract 639.02, Orange County, California",6745,79698,3745,189,0,904,161,1550,55.5,2.8,0,13.4,2.4,23,44.5,2554,486,2068,19.03,80.97,53,433,66,2002,119,2435,10.9,3.2,4.7,"25% - 50% P.O.C.","$70000 - $95000"
"06059063903","Census Tract 639.03, Orange County, California",4019,105000,1597,31,59,766,143,1398,39.7,0.8,1.5,19.1,3.6,34.8,60.3,1074,697,377,64.9,35.1,128,569,123,254,251,823,18.4,32.6,23.4,"50% - 75% P.O.C.","$95000 or more"
"06059063904","Census Tract 639.04, Orange County, California",4492,77639,1673,48,17,660,10,1973,37.2,1.1,0.4,14.7,0.2,43.9,62.8,1262,686,576,54.36,45.64,73,613,225,351,298,964,10.6,39.1,23.6,"50% - 75% P.O.C.","$70000 - $95000"
"06059063905","Census Tract 639.05, Orange County, California",4254,86042,3093,60,0,257,53,514,72.7,1.4,0,6,1.2,12.1,27.3,1681,782,899,46.52,53.48,109,673,15,884,124,1557,13.9,1.7,7.4,"25% - 50% P.O.C.","$70000 - $95000"
"06059063906","Census Tract 639.06, Orange County, California",6334,78080,2450,62,0,384,98,3176,38.7,1,0,6.1,1.5,50.1,61.3,2279,682,1597,29.93,70.07,68,614,121,1476,189,2090,10,7.6,8.3,"50% - 75% P.O.C.","$70000 - $95000"
"06059063907","Census Tract 639.07, Orange County, California",8311,99250,3318,555,23,2149,155,1985,39.9,6.7,0.3,25.9,1.9,23.9,60.1,3534,988,2546,27.96,72.04,44,944,61,2485,105,3429,4.5,2.4,3,"50% - 75% P.O.C.","$95000 or more"
"06059063908","Census Tract 639.08, Orange County, California",5725,86884,2592,247,10,1092,0,1516,45.3,4.3,0.2,19.1,0,26.5,54.7,2511,692,1819,27.56,72.44,119,573,70,1749,189,2322,17.2,3.8,7.5,"50% - 75% P.O.C.","$70000 - $95000"
"06059074003","Census Tract 740.03, Orange County, California",4230,89688,881,130,0,527,5,2640,20.8,3.1,0,12.5,0.1,62.4,79.2,1328,341,987,25.68,74.32,87,254,122,865,209,1119,25.5,12.4,15.7,"75% or more P.O.C.","$70000 - $95000"
"06059074004","Census Tract 740.04, Orange County, California",7765,76536,1350,49,28,1226,0,4864,17.4,0.6,0.4,15.8,0,62.6,82.6,2286,1332,954,58.27,41.73,260,1072,251,703,511,1775,19.5,26.3,22.4,"75% or more P.O.C.","$70000 - $95000"
"06059074005","Census Tract 740.05, Orange County, California",7903,86250,828,67,24,881,173,5915,10.5,0.8,0.3,11.1,2.2,74.8,89.5,1578,713,865,45.18,54.82,291,422,417,448,708,870,40.8,48.2,44.9,"75% or more P.O.C.","$70000 - $95000"
"06059074006","Census Tract 740.06, Orange County, California",5778,62824,1032,262,23,474,83,3817,17.9,4.5,0.4,8.2,1.4,66.1,82.1,1983,601,1382,30.31,69.69,63,538,287,1095,350,1633,10.5,20.8,17.7,"75% or more P.O.C.","$51000 - $70000"
"06059074102","Census Tract 741.02, Orange County, California",6631,96711,556,16,0,661,0,5325,8.4,0.2,0,10,0,80.3,91.6,1362,1021,341,74.96,25.04,513,508,124,217,637,725,50.2,36.4,46.8,"75% or more P.O.C.","$95000 or more"
"06059074103","Census Tract 741.03, Orange County, California",5021,84939,143,0,18,132,0,4696,2.8,0,0.4,2.6,0,93.5,97.2,950,749,201,78.84,21.16,310,439,87,114,397,553,41.4,43.3,41.8,"75% or more P.O.C.","$70000 - $95000"
"06059074106","Census Tract 741.06, Orange County, California",6719,72985,1195,91,0,594,0,4791,17.8,1.4,0,8.8,0,71.3,82.2,1875,935,940,49.87,50.13,116,819,228,712,344,1531,12.4,24.3,18.3,"75% or more P.O.C.","$70000 - $95000"
"06059074107","Census Tract 741.07, Orange County, California",6671,74034,2284,96,0,1504,0,2461,34.2,1.4,0,22.5,0,36.9,65.8,2577,744,1833,28.87,71.13,85,659,129,1704,214,2363,11.4,7,8.3,"50% - 75% P.O.C.","$70000 - $95000"
"06059074108","Census Tract 741.08, Orange County, California",4939,84665,274,51,0,374,0,4240,5.5,1,0,7.6,0,85.8,94.5,911,613,298,67.29,32.71,281,332,174,124,455,456,45.8,58.4,49.9,"75% or more P.O.C.","$70000 - $95000"
"06059074109","Census Tract 741.09, Orange County, California",3358,72969,159,6,0,407,0,2781,4.7,0.2,0,12.1,0,82.8,95.3,690,363,327,52.61,47.39,141,222,156,171,297,393,38.8,47.7,43,"75% or more P.O.C.","$70000 - $95000"
"06059074110","Census Tract 741.10, Orange County, California",3910,92750,936,92,34,1093,0,1574,23.9,2.4,0.9,28,0,40.3,76.1,973,869,104,89.31,10.69,237,632,78,26,315,658,27.3,75,32.4,"75% or more P.O.C.","$70000 - $95000"
"06059074111","Census Tract 741.11, Orange County, California",5523,94132,728,30,0,1301,0,3464,13.2,0.5,0,23.6,0,62.7,86.8,1345,935,410,69.52,30.48,305,630,125,285,430,915,32.6,30.5,32,"75% or more P.O.C.","$70000 - $95000"
"06059074200","Census Tract 742, Orange County, California",9608,88825,322,0,7,74,37,9168,3.4,0,0.1,0.8,0.4,95.4,96.6,1758,1092,666,62.12,37.88,463,629,419,247,882,876,42.4,62.9,50.2,"75% or more P.O.C.","$70000 - $95000"
"06059074300","Census Tract 743, Orange County, California",4051,75333,172,0,0,90,0,3760,4.2,0,0,2.2,0,92.8,95.8,804,448,356,55.72,44.28,217,231,167,189,384,420,48.4,46.9,47.8,"75% or more P.O.C.","$70000 - $95000"
"06059074403","Census Tract 744.03, Orange County, California",6240,44772,195,0,27,80,90,5848,3.1,0,0.4,1.3,1.4,93.7,96.9,1331,122,1209,9.17,90.83,69,53,581,628,650,681,56.6,48.1,48.8,"75% or more P.O.C.","Less than $51000"
"06059074405","Census Tract 744.05, Orange County, California",6662,45778,478,59,0,131,8,5943,7.2,0.9,0,2,0.1,89.2,92.8,1644,266,1378,16.18,83.82,35,231,441,937,476,1168,13.2,32,29,"75% or more P.O.C.","Less than $51000"
"06059074406","Census Tract 744.06, Orange County, California",3693,58047,162,29,0,88,0,3375,4.4,0.8,0,2.4,0,91.4,95.6,785,280,505,35.67,64.33,112,168,154,351,266,519,40,30.5,33.9,"75% or more P.O.C.","$51000 - $70000"
"06059074407","Census Tract 744.07, Orange County, California",5648,48292,643,64,0,212,0,4679,11.4,1.1,0,3.8,0,82.8,88.6,1689,406,1283,24.04,75.96,94,312,208,1075,302,1387,23.2,16.2,17.9,"75% or more P.O.C.","Less than $51000"
"06059074408","Census Tract 744.08, Orange County, California",6300,55984,646,216,0,225,0,5035,10.3,3.4,0,3.6,0,79.9,89.7,1573,420,1153,26.7,73.3,112,308,358,795,470,1103,26.7,31,29.9,"75% or more P.O.C.","$51000 - $70000"
"06059074501","Census Tract 745.01, Orange County, California",7241,57026,91,24,32,629,0,6455,1.3,0.3,0.4,8.7,0,89.1,98.7,1387,305,1082,21.99,78.01,185,120,490,592,675,712,60.7,45.3,48.7,"75% or more P.O.C.","$51000 - $70000"
"06059074502","Census Tract 745.02, Orange County, California",5413,74766,132,0,0,253,0,5028,2.4,0,0,4.7,0,92.9,97.6,1012,593,419,58.6,41.4,253,340,247,172,500,512,42.7,58.9,49.4,"75% or more P.O.C.","$70000 - $95000"
"06059074601","Census Tract 746.01, Orange County, California",7602,68021,411,0,0,68,36,7031,5.4,0,0,0.9,0.5,92.5,94.6,1663,699,964,42.03,57.97,276,423,335,629,611,1052,39.5,34.8,36.7,"75% or more P.O.C.","$51000 - $70000"
"06059074602","Census Tract 746.02, Orange County, California",8382,63990,257,10,0,96,86,7818,3.1,0.1,0,1.1,1,93.3,96.9,1677,842,835,50.21,49.79,347,495,334,501,681,996,41.2,40,40.6,"75% or more P.O.C.","$51000 - $70000"
"06059074701","Census Tract 747.01, Orange County, California",8184,76389,160,5,0,431,0,7519,2,0.1,0,5.3,0,91.9,98,1440,880,560,61.11,38.89,509,371,358,202,867,573,57.8,63.9,60.2,"75% or more P.O.C.","$70000 - $95000"
"06059074702","Census Tract 747.02, Orange County, California",6078,74056,151,13,0,237,0,5623,2.5,0.2,0,3.9,0,92.5,97.5,1108,611,497,55.14,44.86,358,253,280,217,638,470,58.6,56.3,57.6,"75% or more P.O.C.","$70000 - $95000"
"06059074801","Census Tract 748.01, Orange County, California",5767,74219,95,100,0,267,0,5305,1.6,1.7,0,4.6,0,92,98.4,993,536,457,53.98,46.02,260,276,280,177,540,453,48.5,61.3,54.4,"75% or more P.O.C.","$70000 - $95000"
"06059074802","Census Tract 748.02, Orange County, California",6772,55500,62,35,0,831,11,5833,0.9,0.5,0,12.3,0.2,86.1,99.1,1222,663,559,54.26,45.74,358,305,321,238,679,543,54,57.4,55.6,"75% or more P.O.C.","$51000 - $70000"
"06059074803","Census Tract 748.03, Orange County, California",9166,78140,323,79,0,1847,11,6774,3.5,0.9,0,20.2,0.1,73.9,96.5,1896,1251,645,65.98,34.02,515,736,255,390,770,1126,41.2,39.5,40.6,"75% or more P.O.C.","$70000 - $95000"
"06059074805","Census Tract 748.05, Orange County, California",5288,49619,41,96,0,81,0,4914,0.8,1.8,0,1.5,0,92.9,99.2,985,246,739,24.97,75.03,98,148,375,364,473,512,39.8,50.7,48,"75% or more P.O.C.","Less than $51000"
"06059074806","Census Tract 748.06, Orange County, California",5205,59554,36,137,0,227,0,4805,0.7,2.6,0,4.4,0,92.3,99.3,905,442,463,48.84,51.16,246,196,293,170,539,366,55.7,63.3,59.6,"75% or more P.O.C.","$51000 - $70000"
"06059074901","Census Tract 749.01, Orange County, California",9933,50658,115,0,10,355,23,9430,1.2,0,0.1,3.6,0.2,94.9,98.8,1910,530,1380,27.75,72.25,270,260,595,785,865,1045,50.9,43.1,45.3,"75% or more P.O.C.","Less than $51000"
"06059074902","Census Tract 749.02, Orange County, California",6221,58913,86,3,0,60,0,6072,1.4,0,0,1,0,97.6,98.6,1220,306,914,25.08,74.92,149,157,495,419,644,576,48.7,54.2,52.8,"75% or more P.O.C.","$51000 - $70000"
"06059075002","Census Tract 750.02, Orange County, California",8236,38542,557,14,0,453,0,7191,6.8,0.2,0,5.5,0,87.3,93.2,2261,282,1979,12.47,87.53,66,216,437,1542,503,1758,23.4,22.1,22.2,"75% or more P.O.C.","Less than $51000"
"06059075003","Census Tract 750.03, Orange County, California",7500,39793,222,20,0,44,0,7164,3,0.3,0,0.6,0,95.5,97,1659,38,1621,2.29,97.71,18,20,734,887,752,907,47.4,45.3,45.3,"75% or more P.O.C.","Less than $51000"
"06059075004","Census Tract 750.04, Orange County, California",5267,44276,174,106,0,43,0,4944,3.3,2,0,0.8,0,93.9,96.7,1344,73,1271,5.43,94.57,31,42,396,875,427,917,42.5,31.2,31.8,"75% or more P.O.C.","Less than $51000"
"06059075100","Census Tract 751, Orange County, California",9934,59800,1761,138,37,500,26,7372,17.7,1.4,0.4,5,0.3,74.2,82.3,2052,881,1171,42.93,57.07,270,611,287,884,557,1495,30.6,24.5,27.1,"75% or more P.O.C.","$51000 - $70000"
"06059075201","Census Tract 752.01, Orange County, California",6089,60250,245,0,88,250,0,5506,4,0,1.4,4.1,0,90.4,96,1133,580,553,51.19,48.81,253,327,234,319,487,646,43.6,42.3,43,"75% or more P.O.C.","$51000 - $70000"
"06059075202","Census Tract 752.02, Orange County, California",5592,68148,121,18,32,222,0,5199,2.2,0.3,0.6,4,0,93,97.8,1156,756,400,65.4,34.6,308,448,189,211,497,659,40.7,47.2,43,"75% or more P.O.C.","$51000 - $70000"
"06059075301","Census Tract 753.01, Orange County, California",5751,73203,995,67,0,1093,0,3554,17.3,1.2,0,19,0,61.8,82.7,1593,884,709,55.49,44.51,140,744,244,465,384,1209,15.8,34.4,24.1,"75% or more P.O.C.","$70000 - $95000"
"06059075302","Census Tract 753.02, Orange County, California",5137,72500,614,41,0,205,42,4211,12,0.8,0,4,0.8,82,88,1138,657,481,57.73,42.27,150,507,235,246,385,753,22.8,48.9,33.8,"75% or more P.O.C.","$70000 - $95000"
"06059075303","Census Tract 753.03, Orange County, California",3372,100511,1476,18,9,212,45,1488,43.8,0.5,0.3,6.3,1.3,44.1,56.2,1221,892,329,73.05,26.95,56,836,53,276,109,1112,6.3,16.1,8.9,"50% - 75% P.O.C.","$95000 or more"
"06059075401","Census Tract 754.01, Orange County, California",4258,110042,1572,77,0,165,0,2313,36.9,1.8,0,3.9,0,54.3,63.1,1204,1023,181,84.97,15.03,277,746,59,122,336,868,27.1,32.6,27.9,"50% - 75% P.O.C.","$95000 or more"
"06059075403","Census Tract 754.03, Orange County, California",8105,69125,2024,90,22,762,0,5143,25,1.1,0.3,9.4,0,63.5,75,2639,1477,1162,55.97,44.03,217,1260,207,955,424,2215,14.7,17.8,16.1,"75% or more P.O.C.","$51000 - $70000"
"06059075404","Census Tract 754.04, Orange County, California",7202,87091,2125,771,20,706,0,3518,29.5,10.7,0.3,9.8,0,48.8,70.5,2035,970,1065,47.67,52.33,199,771,239,826,438,1597,20.5,22.4,21.5,"50% - 75% P.O.C.","$70000 - $95000"
"06059075405","Census Tract 754.05, Orange County, California",3448,68705,1176,32,0,201,0,1966,34.1,0.9,0,5.8,0,57,65.9,987,495,492,50.15,49.85,40,455,113,379,153,834,8.1,23,15.5,"50% - 75% P.O.C.","$51000 - $70000"
"06059075504","Census Tract 755.04, Orange County, California",3857,79931,2111,14,10,375,0,1177,54.7,0.4,0.3,9.7,0,30.5,45.3,1420,879,541,61.9,38.1,108,771,47,494,155,1265,12.3,8.7,10.9,"25% - 50% P.O.C.","$70000 - $95000"
"06059075505","Census Tract 755.05, Orange County, California",3355,79152,1505,101,9,245,80,1339,44.9,3,0.3,7.3,2.4,39.9,55.1,1243,624,619,50.2,49.8,57,567,15,604,72,1171,9.1,2.4,5.8,"50% - 75% P.O.C.","$70000 - $95000"
"06059075506","Census Tract 755.06, Orange County, California",3636,92850,1704,84,0,577,0,1178,46.9,2.3,0,15.9,0,32.4,53.1,1137,856,281,75.29,24.71,143,713,56,225,199,938,16.7,19.9,17.5,"50% - 75% P.O.C.","$70000 - $95000"
"06059075507","Census Tract 755.07, Orange County, California",5257,68967,1593,178,0,792,0,2522,30.3,3.4,0,15.1,0,48,69.7,1813,473,1340,26.09,73.91,54,419,190,1150,244,1569,11.4,14.2,13.5,"50% - 75% P.O.C.","$51000 - $70000"
"06059075512","Census Tract 755.12, Orange County, California",3866,76206,608,347,0,626,0,2159,15.7,9,0,16.2,0,55.8,84.3,1083,316,767,29.18,70.82,74,242,183,584,257,826,23.4,23.9,23.7,"75% or more P.O.C.","$70000 - $95000"
"06059075513","Census Tract 755.13, Orange County, California",5200,71875,891,79,21,998,0,2960,17.1,1.5,0.4,19.2,0,56.9,82.9,1507,654,853,43.4,56.6,107,547,158,695,265,1242,16.4,18.5,17.6,"75% or more P.O.C.","$70000 - $95000"
"06059075514","Census Tract 755.14, Orange County, California",4192,49970,475,97,0,469,0,3110,11.3,2.3,0,11.2,0,74.2,88.7,1147,199,948,17.35,82.65,68,131,248,700,316,831,34.2,26.2,27.6,"75% or more P.O.C.","Less than $51000"
"06059075515","Census Tract 755.15, Orange County, California",21127,88761,5771,347,0,8324,111,5999,27.3,1.6,0,39.4,0.5,28.4,72.7,7653,2281,5372,29.81,70.19,265,2016,647,4725,912,6741,11.6,12,11.9,"50% - 75% P.O.C.","$70000 - $95000"
"06059075603","Census Tract 756.03, Orange County, California",4120,121000,2885,5,66,319,0,812,70,0.1,1.6,7.7,0,19.7,30,1384,1092,292,78.9,21.1,79,1013,15,277,94,1290,7.2,5.1,6.8,"25% - 50% P.O.C.","$95000 or more"
"06059075604","Census Tract 756.04, Orange County, California",7867,151429,5484,0,0,1329,0,887,69.7,0,0,16.9,0,11.3,30.3,2788,2479,309,88.92,11.08,265,2214,24,285,289,2499,10.7,7.8,10.4,"25% - 50% P.O.C.","$95000 or more"
"06059075605","Census Tract 756.05, Orange County, California",6113,133492,3902,123,29,1008,0,666,63.8,2,0.5,16.5,0,10.9,36.2,2038,1742,296,85.48,14.52,193,1549,39,257,232,1806,11.1,13.2,11.4,"25% - 50% P.O.C.","$95000 or more"
"06059075606","Census Tract 756.06, Orange County, California",5911,229286,3938,0,0,1095,0,793,66.6,0,0,18.5,0,13.4,33.4,2058,1988,70,96.6,3.4,244,1744,0,70,244,1814,12.3,0,11.9,"25% - 50% P.O.C.","$95000 or more"
"06059075607","Census Tract 756.07, Orange County, California",6381,109592,3003,9,0,2312,0,863,47.1,0.1,0,36.2,0,13.5,52.9,2495,1288,1207,51.62,48.38,64,1224,70,1137,134,2361,5,5.8,5.4,"50% - 75% P.O.C.","$95000 or more"
"06059075701","Census Tract 757.01, Orange County, California",7155,117587,2887,69,98,598,0,3301,40.3,1,1.4,8.4,0,46.1,59.7,2023,1255,768,62.04,37.96,215,1040,295,473,510,1513,17.1,38.4,25.2,"50% - 75% P.O.C.","$95000 or more"
"06059075702","Census Tract 757.02, Orange County, California",3809,124741,2593,0,12,438,12,649,68.1,0,0.3,11.5,0.3,17,31.9,1236,1083,153,87.62,12.38,140,943,0,153,140,1096,12.9,0,11.3,"25% - 50% P.O.C.","$95000 or more"
"06059075703","Census Tract 757.03, Orange County, California",4508,166500,2878,38,17,493,0,870,63.8,0.8,0.4,10.9,0,19.3,36.2,1430,1344,86,93.99,6.01,222,1122,5,81,227,1203,16.5,5.8,15.9,"25% - 50% P.O.C.","$95000 or more"
"06059075805","Census Tract 758.05, Orange County, California",4147,90670,2052,15,11,96,0,1935,49.5,0.4,0.3,2.3,0,46.7,50.5,1250,681,569,54.48,45.52,113,568,134,435,247,1003,16.6,23.6,19.8,"50% - 75% P.O.C.","$70000 - $95000"
"06059075806","Census Tract 758.06, Orange County, California",6273,81250,3020,69,0,301,1,2830,48.1,1.1,0,4.8,0,45.1,51.9,2002,932,1070,46.55,53.45,170,762,173,897,343,1659,18.2,16.2,17.1,"50% - 75% P.O.C.","$70000 - $95000"
"06059075807","Census Tract 758.07, Orange County, California",4163,125574,2117,10,15,191,0,1813,50.9,0.2,0.4,4.6,0,43.6,49.1,1185,818,367,69.03,30.97,171,647,97,270,268,917,20.9,26.4,22.6,"25% - 50% P.O.C.","$95000 or more"
"06059075808","Census Tract 758.08, Orange County, California",3300,132098,2371,0,8,178,0,660,71.8,0,0.2,5.4,0,20,28.2,1097,998,99,90.98,9.02,72,926,44,55,116,981,7.2,44.4,10.6,"25% - 50% P.O.C.","$95000 or more"
"06059075809","Census Tract 758.09, Orange County, California",2822,196406,1988,11,0,391,0,357,70.4,0.4,0,13.9,0,12.7,29.6,1027,999,28,97.27,2.73,92,907,28,0,120,907,9.2,100,11.7,"25% - 50% P.O.C.","$95000 or more"
"06059075810","Census Tract 758.10, Orange County, California",3028,136875,1954,16,0,596,0,394,64.5,0.5,0,19.7,0,13,35.5,990,957,33,96.67,3.33,98,859,0,33,98,892,10.2,0,9.9,"25% - 50% P.O.C.","$95000 or more"
"06059075811","Census Tract 758.11, Orange County, California",3344,75526,1042,5,0,390,0,1851,31.2,0.1,0,11.7,0,55.4,68.8,830,460,370,55.42,44.58,102,358,120,250,222,608,22.2,32.4,26.7,"50% - 75% P.O.C.","$70000 - $95000"
"06059075812","Census Tract 758.12, Orange County, California",6477,70972,2742,14,0,309,126,3179,42.3,0.2,0,4.8,1.9,49.1,57.7,1869,992,877,53.08,46.92,129,863,222,655,351,1518,13,25.3,18.8,"50% - 75% P.O.C.","$70000 - $95000"
"06059075813","Census Tract 758.13, Orange County, California",5060,124722,2713,93,0,801,18,1201,53.6,1.8,0,15.8,0.4,23.7,46.4,1734,1485,249,85.64,14.36,205,1280,30,219,235,1499,13.8,12,13.6,"25% - 50% P.O.C.","$95000 or more"
"06059075814","Census Tract 758.14, Orange County, California",2915,130938,1372,50,0,879,16,460,47.1,1.7,0,30.2,0.5,15.8,52.9,1090,903,187,82.84,17.16,75,828,24,163,99,991,8.3,12.8,9.1,"50% - 75% P.O.C.","$95000 or more"
"06059075815","Census Tract 758.15, Orange County, California",5545,93967,2493,344,0,233,13,2370,45,6.2,0,4.2,0.2,42.7,55,1586,1087,499,68.54,31.46,156,931,213,286,369,1217,14.4,42.7,23.3,"50% - 75% P.O.C.","$70000 - $95000"
"06059075816","Census Tract 758.16, Orange County, California",3630,90455,1388,140,14,396,0,1596,38.2,3.9,0.4,10.9,0,44,61.8,1208,613,595,50.75,49.25,29,584,57,538,86,1122,4.7,9.6,7.1,"50% - 75% P.O.C.","$70000 - $95000"
"06059075901","Census Tract 759.01, Orange County, California",4011,68523,2077,17,0,263,38,1505,51.8,0.4,0,6.6,0.9,37.5,48.2,1513,491,1022,32.45,67.55,22,469,55,967,77,1436,4.5,5.4,5.1,"25% - 50% P.O.C.","$51000 - $70000"
"06059075902","Census Tract 759.02, Orange County, California",7308,68482,3465,134,18,450,0,3162,47.4,1.8,0.2,6.2,0,43.3,52.6,2704,710,1994,26.26,73.74,52,658,215,1779,267,2437,7.3,10.8,9.9,"50% - 75% P.O.C.","$51000 - $70000"
"06059076000","Census Tract 760, Orange County, California",9150,64194,2787,199,0,1109,54,4941,30.5,2.2,0,12.1,0.6,54,69.5,3139,1381,1758,43.99,56.01,202,1179,119,1639,321,2818,14.6,6.8,10.2,"50% - 75% P.O.C.","$51000 - $70000"
"06059076101","Census Tract 761.01, Orange County, California",9594,77062,3656,378,0,1216,272,3640,38.1,3.9,0,12.7,2.8,37.9,61.9,3749,877,2872,23.39,76.61,58,819,50,2822,108,3641,6.6,1.7,2.9,"50% - 75% P.O.C.","$70000 - $95000"
"06059076102","Census Tract 761.02, Orange County, California",8492,56189,2217,502,32,1282,5,4302,26.1,5.9,0.4,15.1,0.1,50.7,73.9,1813,173,1640,9.54,90.46,59,114,229,1411,288,1525,34.1,14,15.9,"50% - 75% P.O.C.","$51000 - $70000"
"06059076103","Census Tract 761.03, Orange County, California",9563,68814,1214,146,0,2117,0,6070,12.7,1.5,0,22.1,0,63.5,87.3,2523,821,1702,32.54,67.46,197,624,391,1311,588,1935,24,23,23.3,"75% or more P.O.C.","$51000 - $70000"
"06059076201","Census Tract 762.01, Orange County, California",7619,127500,3382,91,0,1826,0,2233,44.4,1.2,0,24,0,29.3,55.6,2410,1613,797,66.93,33.07,124,1489,157,640,281,2129,7.7,19.7,11.7,"50% - 75% P.O.C.","$95000 or more"
"06059076202","Census Tract 762.02, Orange County, California",6159,87521,2625,142,31,428,0,2833,42.6,2.3,0.5,6.9,0,46,57.4,1965,1161,804,59.08,40.92,77,1084,120,684,197,1768,6.6,14.9,10,"50% - 75% P.O.C.","$70000 - $95000"
"06059076204","Census Tract 762.04, Orange County, California",4639,63411,440,37,103,297,0,3702,9.5,0.8,2.2,6.4,0,79.8,90.5,1171,343,828,29.29,70.71,62,281,287,541,349,822,18.1,34.7,29.8,"75% or more P.O.C.","$51000 - $70000"
"06059076205","Census Tract 762.05, Orange County, California",7424,86071,3347,70,75,774,0,2836,45.1,0.9,1,10.4,0,38.2,54.9,1558,922,636,59.18,40.82,150,772,38,598,188,1370,16.3,6,12.1,"50% - 75% P.O.C.","$70000 - $95000"
"06059076206","Census Tract 762.06, Orange County, California",4692,77396,2537,9,0,280,0,1765,54.1,0.2,0,6,0,37.6,45.9,1548,1012,536,65.37,34.63,74,938,171,365,245,1303,7.3,31.9,15.8,"25% - 50% P.O.C.","$70000 - $95000"
"06059076208","Census Tract 762.08, Orange County, California",5412,89015,2690,67,0,646,15,1884,49.7,1.2,0,11.9,0.3,34.8,50.3,1680,970,710,57.74,42.26,88,882,170,540,258,1422,9.1,23.9,15.4,"50% - 75% P.O.C.","$70000 - $95000"
"06059086301","Census Tract 863.01, Orange County, California",7075,80172,1108,128,0,734,27,5049,15.7,1.8,0,10.4,0.4,71.4,84.3,1777,1082,695,60.89,39.11,390,692,134,561,524,1253,36,19.3,29.5,"75% or more P.O.C.","$70000 - $95000"
"06059086303","Census Tract 863.03, Orange County, California",7535,69263,2344,126,0,2905,0,1981,31.1,1.7,0,38.6,0,26.3,68.9,2845,909,1936,31.95,68.05,49,860,195,1741,244,2601,5.4,10.1,8.6,"50% - 75% P.O.C.","$51000 - $70000"
"06059086304","Census Tract 863.04, Orange County, California",4864,63917,1447,97,0,587,35,2612,29.7,2,0,12.1,0.7,53.7,70.3,1685,513,1172,30.45,69.55,91,422,110,1062,201,1484,17.7,9.4,11.9,"50% - 75% P.O.C.","$51000 - $70000"
"06059086305","Census Tract 863.05, Orange County, California",4266,104362,1388,44,0,860,40,1927,32.5,1,0,20.2,0.9,45.2,67.5,1090,931,159,85.41,14.59,178,753,90,69,268,822,19.1,56.6,24.6,"50% - 75% P.O.C.","$95000 or more"
"06059086306","Census Tract 863.06, Orange County, California",4773,79155,977,69,29,653,0,2810,20.5,1.4,0.6,13.7,0,58.9,79.5,1269,535,734,42.16,57.84,111,424,185,549,296,973,20.7,25.2,23.3,"75% or more P.O.C.","$70000 - $95000"
"06059086402","Census Tract 864.02, Orange County, California",6071,88897,975,21,10,655,0,4338,16.1,0.3,0.2,10.8,0,71.5,83.9,1403,927,476,66.07,33.93,291,636,241,235,532,871,31.4,50.6,37.9,"75% or more P.O.C.","$70000 - $95000"
"06059086404","Census Tract 864.04, Orange County, California",6350,77967,570,10,0,509,0,5211,9,0.2,0,8,0,82.1,91,1454,641,813,44.09,55.91,234,407,321,492,555,899,36.5,39.5,38.2,"75% or more P.O.C.","$70000 - $95000"
"06059086405","Census Tract 864.05, Orange County, California",7658,63269,911,102,0,747,0,5852,11.9,1.3,0,9.8,0,76.4,88.1,1730,673,1057,38.9,61.1,267,406,281,776,548,1182,39.7,26.6,31.7,"75% or more P.O.C.","$51000 - $70000"
"06059086406","Census Tract 864.06, Orange County, California",4189,61936,812,152,0,481,0,2605,19.4,3.6,0,11.5,0,62.2,80.6,1347,358,989,26.58,73.42,84,274,104,885,188,1159,23.5,10.5,14,"75% or more P.O.C.","$51000 - $70000"
"06059086407","Census Tract 864.07, Orange County, California",6379,61942,1242,26,19,629,133,4236,19.5,0.4,0.3,9.9,2.1,66.4,80.5,1974,875,1099,44.33,55.67,110,765,188,911,298,1676,12.6,17.1,15.1,"75% or more P.O.C.","$51000 - $70000"
"06059086501","Census Tract 865.01, Orange County, California",4254,51780,748,21,0,66,0,3384,17.6,0.5,0,1.6,0,79.5,82.4,1115,543,572,48.7,51.3,91,452,188,384,279,836,16.8,32.9,25,"75% or more P.O.C.","$51000 - $70000"
"06059086502","Census Tract 865.02, Orange County, California",6318,55182,274,12,0,44,0,5963,4.3,0.2,0,0.7,0,94.4,95.7,1393,456,937,32.74,67.26,156,300,470,467,626,767,34.2,50.2,44.9,"75% or more P.O.C.","$51000 - $70000"
"06059086601","Census Tract 866.01, Orange County, California",9185,60163,662,295,0,629,24,7502,7.2,3.2,0,6.8,0.3,81.7,92.8,2324,712,1612,30.64,69.36,197,515,430,1182,627,1697,27.7,26.7,27,"75% or more P.O.C.","$51000 - $70000"
"06059086602","Census Tract 866.02, Orange County, California",6447,58125,1124,136,0,727,0,4314,17.4,2.1,0,11.3,0,66.9,82.6,1696,499,1197,29.42,70.58,159,340,350,847,509,1187,31.9,29.2,30,"75% or more P.O.C.","$51000 - $70000"
"06059086701","Census Tract 867.01, Orange County, California",9054,82788,1626,55,0,2555,0,4736,18,0.6,0,28.2,0,52.3,82,2293,1377,916,60.05,39.95,346,1031,217,699,563,1730,25.1,23.7,24.6,"75% or more P.O.C.","$70000 - $95000"
"06059086702","Census Tract 867.02, Orange County, California",8069,66519,1049,247,125,786,0,5693,13,3.1,1.5,9.7,0,70.6,87,1901,680,1221,35.77,64.23,269,411,366,855,635,1266,39.6,30,33.4,"75% or more P.O.C.","$51000 - $70000"
"06059086801","Census Tract 868.01, Orange County, California",3878,72059,1037,136,0,910,46,1633,26.7,3.5,0,23.5,1.2,42.1,73.3,1038,654,384,63.01,36.99,153,501,116,268,269,769,23.4,30.2,25.9,"50% - 75% P.O.C.","$70000 - $95000"
"06059086802","Census Tract 868.02, Orange County, California",5874,72639,1051,172,0,1207,8,3383,17.9,2.9,0,20.5,0.1,57.6,82.1,1466,557,909,37.99,62.01,114,443,262,647,376,1090,20.5,28.8,25.6,"75% or more P.O.C.","$70000 - $95000"
"06059086803","Census Tract 868.03, Orange County, California",8751,63622,2309,304,0,2331,47,3633,26.4,3.5,0,26.6,0.5,41.5,73.6,2611,1049,1562,40.18,59.82,195,854,258,1304,453,2158,18.6,16.5,17.3,"50% - 75% P.O.C.","$51000 - $70000"
"06059086901","Census Tract 869.01, Orange County, California",8270,45085,1470,241,0,1999,102,4255,17.8,2.9,0,24.2,1.2,51.5,82.2,2493,459,2034,18.41,81.59,44,415,448,1586,492,2001,9.6,22,19.7,"75% or more P.O.C.","Less than $51000"
"06059086902","Census Tract 869.02, Orange County, California",5624,69013,1863,218,0,1730,0,1725,33.1,3.9,0,30.8,0,30.7,66.9,1649,833,816,50.52,49.48,133,700,128,688,261,1388,16,15.7,15.8,"50% - 75% P.O.C.","$51000 - $70000"
"06059086903","Census Tract 869.03, Orange County, California",7128,64938,1261,593,0,1127,88,4007,17.7,8.3,0,15.8,1.2,56.2,82.3,2041,556,1485,27.24,72.76,177,379,337,1148,514,1527,31.8,22.7,25.2,"75% or more P.O.C.","$51000 - $70000"
"06059087001","Census Tract 870.01, Orange County, California",5272,63139,771,537,0,1084,0,2703,14.6,10.2,0,20.6,0,51.3,85.4,1525,541,984,35.48,64.52,102,439,299,685,401,1124,18.9,30.4,26.3,"75% or more P.O.C.","$51000 - $70000"
"06059087002","Census Tract 870.02, Orange County, California",7887,69615,1801,362,30,1809,36,3710,22.8,4.6,0.4,22.9,0.5,47,77.2,2344,714,1630,30.46,69.54,186,528,298,1332,484,1860,26.1,18.3,20.6,"75% or more P.O.C.","$51000 - $70000"
"06059087101","Census Tract 871.01, Orange County, California",4741,54803,1199,236,0,1262,0,1980,25.3,5,0,26.6,0,41.8,74.7,1744,350,1394,20.07,79.93,102,248,93,1301,195,1549,29.1,6.7,11.2,"50% - 75% P.O.C.","$51000 - $70000"
"06059087102","Census Tract 871.02, Orange County, California",7084,64589,858,478,147,771,0,4701,12.1,6.7,2.1,10.9,0,66.4,87.9,1826,320,1506,17.52,82.48,49,271,538,968,587,1239,15.3,35.7,32.1,"75% or more P.O.C.","$51000 - $70000"
"06059087103","Census Tract 871.03, Orange County, California",8986,76731,2146,197,10,2559,102,3904,23.9,2.2,0.1,28.5,1.1,43.4,76.1,2244,1231,1013,54.86,45.14,259,972,343,670,602,1642,21,33.9,26.8,"75% or more P.O.C.","$70000 - $95000"
"06059087105","Census Tract 871.05, Orange County, California",4614,65548,1098,24,0,1082,0,2313,23.8,0.5,0,23.5,0,50.1,76.2,1467,576,891,39.26,60.74,142,434,120,771,262,1205,24.7,13.5,17.9,"75% or more P.O.C.","$51000 - $70000"
"06059087106","Census Tract 871.06, Orange County, California",4819,50583,891,112,0,571,0,3218,18.5,2.3,0,11.8,0,66.8,81.5,1484,455,1029,30.66,69.34,194,261,150,879,344,1140,42.6,14.6,23.2,"75% or more P.O.C.","Less than $51000"
"06059087200","Census Tract 872, Orange County, California",7725,58179,1909,252,0,712,58,4724,24.7,3.3,0,9.2,0.8,61.2,75.3,2589,1048,1541,40.48,59.52,266,782,88,1453,354,2235,25.4,5.7,13.7,"75% or more P.O.C.","$51000 - $70000"
"06059087300","Census Tract 873, Orange County, California",10714,65393,1586,99,0,1183,11,7706,14.8,0.9,0,11,0.1,71.9,85.2,3106,648,2458,20.86,79.14,106,542,584,1874,690,2416,16.4,23.8,22.2,"75% or more P.O.C.","$51000 - $70000"
"06059087401","Census Tract 874.01, Orange County, California",4946,104075,1051,77,1,1372,0,2295,21.2,1.6,0,27.7,0,46.4,78.8,1541,1279,262,83,17,192,1087,51,211,243,1298,15,19.5,15.8,"75% or more P.O.C.","$95000 or more"
"06059087403","Census Tract 874.03, Orange County, California",3701,49921,273,7,0,105,62,3232,7.4,0.2,0,2.8,1.7,87.3,92.6,794,301,493,37.91,62.09,105,196,163,330,268,526,34.9,33.1,33.8,"75% or more P.O.C.","Less than $51000"
"06059087404","Census Tract 874.04, Orange County, California",3891,54583,227,31,0,116,0,3517,5.8,0.8,0,3,0,90.4,94.2,877,210,667,23.95,76.05,57,153,262,405,319,558,27.1,39.3,36.4,"75% or more P.O.C.","$51000 - $70000"
"06059087405","Census Tract 874.05, Orange County, California",5627,47159,507,48,0,244,0,4828,9,0.9,0,4.3,0,85.8,91,1333,295,1038,22.13,77.87,77,218,434,604,511,822,26.1,41.8,38.3,"75% or more P.O.C.","Less than $51000"
"06059087503","Census Tract 875.03, Orange County, California",6011,62029,1226,71,0,760,0,3834,20.4,1.2,0,12.6,0,63.8,79.6,1690,632,1058,37.4,62.6,71,561,296,762,367,1323,11.2,28,21.7,"75% or more P.O.C.","$51000 - $70000"
"06059087504","Census Tract 875.04, Orange County, California",7286,42180,283,39,39,594,91,6210,3.9,0.5,0.5,8.2,1.2,85.2,96.1,1661,292,1369,17.58,82.42,108,184,511,858,619,1042,37,37.3,37.3,"75% or more P.O.C.","Less than $51000"
"06059087505","Census Tract 875.05, Orange County, California",4913,59375,736,116,0,557,40,3271,15,2.4,0,11.3,0.8,66.6,85,1372,497,875,36.22,63.78,54,443,308,567,362,1010,10.9,35.2,26.4,"75% or more P.O.C.","$51000 - $70000"
"06059087601","Census Tract 876.01, Orange County, California",5348,55494,1223,53,0,1018,0,2952,22.9,1,0,19,0,55.2,77.1,1425,456,969,32,68,83,373,305,664,388,1037,18.2,31.5,27.2,"75% or more P.O.C.","$51000 - $70000"
"06059087602","Census Tract 876.02, Orange County, California",8007,75207,1328,407,0,1446,0,4720,16.6,5.1,0,18.1,0,58.9,83.4,2158,923,1235,42.77,57.23,176,747,308,927,484,1674,19.1,24.9,22.4,"75% or more P.O.C.","$70000 - $95000"
"06059087701","Census Tract 877.01, Orange County, California",5901,81429,1534,160,0,1411,263,2359,26,2.7,0,23.9,4.5,40,74,1682,917,765,54.52,45.48,273,644,91,674,364,1318,29.8,11.9,21.6,"50% - 75% P.O.C.","$70000 - $95000"
"06059087703","Census Tract 877.03, Orange County, California",6222,65729,1172,55,12,1668,49,3202,18.8,0.9,0.2,26.8,0.8,51.5,81.2,1521,990,531,65.09,34.91,318,672,95,436,413,1108,32.1,17.9,27.2,"75% or more P.O.C.","$51000 - $70000"
"06059087704","Census Tract 877.04, Orange County, California",5411,87795,1379,82,22,1661,1,2032,25.5,1.5,0.4,30.7,0,37.6,74.5,1283,966,317,75.29,24.71,229,737,93,224,322,961,23.7,29.3,25.1,"50% - 75% P.O.C.","$70000 - $95000"
"06059087801","Census Tract 878.01, Orange County, California",5195,66688,1115,140,0,1311,0,2539,21.5,2.7,0,25.2,0,48.9,78.5,1667,882,785,52.91,47.09,122,760,132,653,254,1413,13.8,16.8,15.2,"75% or more P.O.C.","$51000 - $70000"
"06059087802","Census Tract 878.02, Orange County, California",7163,62882,1435,50,0,2268,0,3292,20,0.7,0,31.7,0,46,80,2151,1133,1018,52.67,47.33,273,860,298,720,571,1580,24.1,29.3,26.5,"75% or more P.O.C.","$51000 - $70000"
"06059087803","Census Tract 878.03, Orange County, California",5902,46101,467,56,0,1704,117,3438,7.9,0.9,0,28.9,2,58.3,92.1,1377,290,1087,21.06,78.94,130,160,400,687,530,847,44.8,36.8,38.5,"75% or more P.O.C.","Less than $51000"
"06059087805","Census Tract 878.05, Orange County, California",7494,66373,1311,378,0,1357,226,4138,17.5,5,0,18.1,3,55.2,82.5,1931,937,994,48.52,51.48,253,684,232,762,485,1446,27,23.3,25.1,"75% or more P.O.C.","$51000 - $70000"
"06059087806","Census Tract 878.06, Orange County, California",6654,45000,933,109,0,951,0,4359,14,1.6,0,14.3,0,65.5,86,1652,483,1169,29.24,70.76,268,215,234,935,502,1150,55.5,20,30.4,"75% or more P.O.C.","Less than $51000"
"06059087901","Census Tract 879.01, Orange County, California",4030,50875,699,30,0,1911,0,1318,17.3,0.7,0,47.4,0,32.7,82.7,1263,631,632,49.96,50.04,78,553,159,473,237,1026,12.4,25.2,18.8,"75% or more P.O.C.","Less than $51000"
"06059087902","Census Tract 879.02, Orange County, California",5408,48218,384,45,178,2068,22,2671,7.1,0.8,3.3,38.2,0.4,49.4,92.9,1289,638,651,49.5,50.5,252,386,202,449,454,835,39.5,31,35.2,"75% or more P.O.C.","Less than $51000"
"06059088001","Census Tract 880.01, Orange County, California",4527,75139,918,28,0,2156,205,1026,20.3,0.6,0,47.6,4.5,22.7,79.7,1183,736,447,62.21,37.79,165,571,68,379,233,950,22.4,15.2,19.7,"75% or more P.O.C.","$70000 - $95000"
"06059088002","Census Tract 880.02, Orange County, California",4157,66429,917,0,0,2111,0,1108,22.1,0,0,50.8,0,26.7,77.9,1118,684,434,61.18,38.82,139,545,135,299,274,844,20.3,31.1,24.5,"75% or more P.O.C.","$51000 - $70000"
"06059088101","Census Tract 881.01, Orange County, California",2285,74085,699,165,0,420,0,880,30.6,7.2,0,18.4,0,38.5,69.4,684,398,286,58.19,41.81,58,340,75,211,133,551,14.6,26.2,19.4,"50% - 75% P.O.C.","$70000 - $95000"
"06059088104","Census Tract 881.04, Orange County, California",4743,58445,1112,54,113,1356,0,2035,23.4,1.1,2.4,28.6,0,42.9,76.6,1586,732,854,46.15,53.85,153,579,142,712,295,1291,20.9,16.6,18.6,"75% or more P.O.C.","$51000 - $70000"
"06059088105","Census Tract 881.05, Orange County, California",4793,84356,838,48,0,2138,17,1647,17.5,1,0,44.6,0.4,34.4,82.5,1063,816,247,76.76,23.24,206,610,83,164,289,774,25.2,33.6,27.2,"75% or more P.O.C.","$70000 - $95000"
"06059088106","Census Tract 881.06, Orange County, California",5008,59081,946,25,0,2154,0,1820,18.9,0.5,0,43,0,36.3,81.1,1739,878,861,50.49,49.51,144,734,164,697,308,1431,16.4,19,17.7,"75% or more P.O.C.","$51000 - $70000"
"06059088107","Census Tract 881.07, Orange County, California",5977,54635,855,3,6,3760,18,1263,14.3,0.1,0.1,62.9,0.3,21.1,85.7,1710,840,870,49.12,50.88,161,679,196,674,357,1353,19.2,22.5,20.9,"75% or more P.O.C.","$51000 - $70000"
"06059088201","Census Tract 882.01, Orange County, California",4082,52404,935,41,0,1309,0,1790,22.9,1,0,32.1,0,43.9,77.1,1122,624,498,55.61,44.39,55,569,217,281,272,850,8.8,43.6,24.2,"75% or more P.O.C.","$51000 - $70000"
"06059088202","Census Tract 882.02, Orange County, California",3286,86950,1094,98,0,1164,0,874,33.3,3,0,35.4,0,26.6,66.7,877,597,280,68.07,31.93,137,460,91,189,228,649,22.9,32.5,26,"50% - 75% P.O.C.","$70000 - $95000"
"06059088203","Census Tract 882.03, Orange County, California",5530,61232,983,0,192,2514,0,1727,17.8,0,3.5,45.5,0,31.2,82.2,1510,590,920,39.07,60.93,148,442,275,645,423,1087,25.1,29.9,28,"75% or more P.O.C.","$51000 - $70000"
"06059088301","Census Tract 883.01, Orange County, California",6566,63942,1337,7,0,2235,26,2931,20.4,0.1,0,34,0.4,44.6,79.6,1698,927,771,54.59,45.41,248,679,176,595,424,1274,26.8,22.8,25,"75% or more P.O.C.","$51000 - $70000"
"06059088302","Census Tract 883.02, Orange County, California",6040,104444,1769,58,16,2544,39,1567,29.3,1,0.3,42.1,0.6,25.9,70.7,1768,1240,528,70.14,29.86,247,993,55,473,302,1466,19.9,10.4,17.1,"50% - 75% P.O.C.","$95000 or more"
"06059088401","Census Tract 884.01, Orange County, California",5393,93018,1118,56,13,1810,0,2287,20.7,1,0.2,33.6,0,42.4,79.3,1331,1070,261,80.39,19.61,308,762,123,138,431,900,28.8,47.1,32.4,"75% or more P.O.C.","$70000 - $95000"
"06059088402","Census Tract 884.02, Orange County, California",4700,59441,885,10,0,1522,0,2210,18.8,0.2,0,32.4,0,47,81.2,1243,578,665,46.5,53.5,102,476,171,494,273,970,17.6,25.7,22,"75% or more P.O.C.","$51000 - $70000"
"06059088403","Census Tract 884.03, Orange County, California",6923,87708,1101,71,0,2070,0,3587,15.9,1,0,29.9,0,51.8,84.1,1800,985,815,54.72,45.28,270,715,153,662,423,1377,27.4,18.8,23.5,"75% or more P.O.C.","$70000 - $95000"
"06059088501","Census Tract 885.01, Orange County, California",6883,67500,926,28,7,2157,19,3598,13.5,0.4,0.1,31.3,0.3,52.3,86.5,1836,870,966,47.39,52.61,181,689,210,756,391,1445,20.8,21.7,21.3,"75% or more P.O.C.","$51000 - $70000"
"06059088502","Census Tract 885.02, Orange County, California",5598,70134,559,0,0,1537,12,3423,10,0,0,27.5,0.2,61.1,90,1483,644,839,43.43,56.57,213,431,225,614,438,1045,33.1,26.8,29.5,"75% or more P.O.C.","$70000 - $95000"
"06059088601","Census Tract 886.01, Orange County, California",6742,63750,1380,15,0,2977,94,2098,20.5,0.2,0,44.2,1.4,31.1,79.5,2264,1063,1201,46.95,53.05,155,908,210,991,365,1899,14.6,17.5,16.1,"75% or more P.O.C.","$51000 - $70000"
"06059088602","Census Tract 886.02, Orange County, California",4488,69688,904,42,40,1784,0,1657,20.1,0.9,0.9,39.8,0,36.9,79.9,1297,633,664,48.8,51.2,187,446,173,491,360,937,29.5,26.1,27.8,"75% or more P.O.C.","$51000 - $70000"
"06059088701","Census Tract 887.01, Orange County, California",5935,46985,665,69,0,3115,0,1980,11.2,1.2,0,52.5,0,33.4,88.8,1939,581,1358,29.96,70.04,95,486,174,1184,269,1670,16.4,12.8,13.9,"75% or more P.O.C.","Less than $51000"
"06059088702","Census Tract 887.02, Orange County, California",6243,77171,592,61,18,3359,0,2102,9.5,1,0.3,53.8,0,33.7,90.5,1533,708,825,46.18,53.82,228,480,277,548,505,1028,32.2,33.6,32.9,"75% or more P.O.C.","$70000 - $95000"
"06059088801","Census Tract 888.01, Orange County, California",7689,51472,1200,360,36,4297,0,1627,15.6,4.7,0.5,55.9,0,21.2,84.4,2629,691,1938,26.28,73.72,60,631,207,1731,267,2362,8.7,10.7,10.2,"75% or more P.O.C.","$51000 - $70000"
"06059088802","Census Tract 888.02, Orange County, California",4984,59830,686,2,0,2752,3,1429,13.8,0,0,55.2,0.1,28.7,86.2,1447,662,785,45.75,54.25,128,534,127,658,255,1192,19.3,16.2,17.6,"75% or more P.O.C.","$51000 - $70000"
"06059088901","Census Tract 889.01, Orange County, California",7018,60917,877,104,25,5105,7,733,12.5,1.5,0.4,72.7,0.1,10.4,87.5,1747,908,839,51.97,48.03,270,638,160,679,430,1317,29.7,19.1,24.6,"75% or more P.O.C.","$51000 - $70000"
"06059088902","Census Tract 889.02, Orange County, California",5019,67875,202,10,75,3095,0,1609,4,0.2,1.5,61.7,0,32.1,96,1194,641,553,53.69,46.31,208,433,143,410,351,843,32.4,25.9,29.4,"75% or more P.O.C.","$51000 - $70000"
"06059088903","Census Tract 889.03, Orange County, California",8826,66357,774,0,0,5367,70,2470,8.8,0,0,60.8,0.8,28,91.2,2086,1193,893,57.19,42.81,368,825,264,629,632,1454,30.8,29.6,30.3,"75% or more P.O.C.","$51000 - $70000"
"06059088904","Census Tract 889.04, Orange County, California",5684,57250,747,0,0,4501,0,394,13.1,0,0,79.2,0,6.9,86.9,1488,938,550,63.04,36.96,319,619,118,432,437,1051,34,21.5,29.4,"75% or more P.O.C.","$51000 - $70000"
"06059088905","Census Tract 889.05, Orange County, California",4657,48291,412,154,0,3728,0,328,8.8,3.3,0,80.1,0,7,91.2,1329,614,715,46.2,53.8,166,448,117,598,283,1046,27,16.4,21.3,"75% or more P.O.C.","Less than $51000"
"06059089001","Census Tract 890.01, Orange County, California",7077,64757,223,0,0,4179,11,2629,3.2,0,0,59.1,0.2,37.1,96.8,1630,937,693,57.48,42.52,251,686,274,419,525,1105,26.8,39.5,32.2,"75% or more P.O.C.","$51000 - $70000"
"06059089003","Census Tract 890.03, Orange County, California",3856,63913,122,16,20,1437,0,2240,3.2,0.4,0.5,37.3,0,58.1,96.8,888,401,487,45.16,54.84,106,295,197,290,303,585,26.4,40.5,34.1,"75% or more P.O.C.","$51000 - $70000"
"06059089004","Census Tract 890.04, Orange County, California",6883,51522,448,0,0,2898,0,3462,6.5,0,0,42.1,0,50.3,93.5,1812,964,848,53.2,46.8,246,718,306,542,552,1260,25.5,36.1,30.5,"75% or more P.O.C.","$51000 - $70000"
"06059089102","Census Tract 891.02, Orange County, California",6686,71445,1041,85,10,2087,0,3414,15.6,1.3,0.1,31.2,0,51.1,84.4,1683,1162,521,69.04,30.96,346,816,156,365,502,1181,29.8,29.9,29.8,"75% or more P.O.C.","$70000 - $95000"
"06059089104","Census Tract 891.04, Orange County, California",6434,58173,164,38,15,1023,0,5186,2.5,0.6,0.2,15.9,0,80.6,97.5,1381,375,1006,27.15,72.85,150,225,367,639,517,864,40,36.5,37.4,"75% or more P.O.C.","$51000 - $70000"
"06059089105","Census Tract 891.05, Orange County, California",6889,62042,101,0,0,562,0,6226,1.5,0,0,8.2,0,90.4,98.5,1208,372,836,30.79,69.21,134,238,590,246,724,484,36,70.6,59.9,"75% or more P.O.C.","$51000 - $70000"
"06059089106","Census Tract 891.06, Orange County, California",4226,53936,330,4,0,806,5,3062,7.8,0.1,0,19.1,0.1,72.5,92.2,994,318,676,31.99,68.01,98,220,201,475,299,695,30.8,29.7,30.1,"75% or more P.O.C.","$51000 - $70000"
"06059089107","Census Tract 891.07, Orange County, California",5664,94934,682,0,0,2215,0,2739,12,0,0,39.1,0,48.4,88,1215,925,290,76.13,23.87,318,607,145,145,463,752,34.4,50,38.1,"75% or more P.O.C.","$70000 - $95000"
"06059099202","Census Tract 992.02, Orange County, California",8826,59572,768,42,0,3062,8,4717,8.7,0.5,0,34.7,0.1,53.4,91.3,2087,1268,819,60.76,39.24,452,816,133,686,585,1502,35.6,16.2,28,"75% or more P.O.C.","$51000 - $70000"
"06059099203","Census Tract 992.03, Orange County, California",6215,79671,795,14,0,3691,22,1583,12.8,0.2,0,59.4,0.4,25.5,87.2,1481,881,600,59.49,40.51,202,679,145,455,347,1134,22.9,24.2,23.4,"75% or more P.O.C.","$70000 - $95000"
"06059099204","Census Tract 992.04, Orange County, California",4582,66447,629,103,0,3074,13,611,13.7,2.2,0,67.1,0.3,13.3,86.3,1392,845,547,60.7,39.3,237,608,74,473,311,1081,28,13.5,22.3,"75% or more P.O.C.","$51000 - $70000"
"06059099212","Census Tract 992.12, Orange County, California",5524,80513,2268,108,45,846,8,1843,41.1,2,0.8,15.3,0.1,33.4,58.9,1740,808,932,46.44,53.56,54,754,211,721,265,1475,6.7,22.6,15.2,"50% - 75% P.O.C.","$70000 - $95000"
"06059099214","Census Tract 992.14, Orange County, California",3825,84583,2663,13,0,556,0,482,69.6,0.3,0,14.5,0,12.6,30.4,1390,1188,202,85.47,14.53,136,1052,42,160,178,1212,11.4,20.8,12.8,"25% - 50% P.O.C.","$70000 - $95000"
"06059099215","Census Tract 992.15, Orange County, California",5074,109111,2664,43,49,698,15,1294,52.5,0.8,1,13.8,0.3,25.5,47.5,1775,1199,576,67.55,32.45,68,1131,113,463,181,1594,5.7,19.6,10.2,"25% - 50% P.O.C.","$95000 or more"
"06059099216","Census Tract 992.16, Orange County, California",4658,91594,2782,33,0,609,176,910,59.7,0.7,0,13.1,3.8,19.5,40.3,1498,1134,364,75.7,24.3,87,1047,97,267,184,1314,7.7,26.6,12.3,"25% - 50% P.O.C.","$70000 - $95000"
"06059099217","Census Tract 992.17, Orange County, California",2454,120568,1882,44,0,243,0,216,76.7,1.8,0,9.9,0,8.8,23.3,865,759,106,87.75,12.25,66,693,5,101,71,794,8.7,4.7,8.2,"Less than 25% P.O.C.","$95000 or more"
"06059099220","Census Tract 992.20, Orange County, California",5770,98141,4151,207,44,543,0,567,71.9,3.6,0.8,9.4,0,9.8,28.1,2545,1303,1242,51.2,48.8,10,1293,26,1216,36,2509,0.8,2.1,1.4,"25% - 50% P.O.C.","$95000 or more"
"06059099222","Census Tract 992.22, Orange County, California",5346,64391,947,22,11,3341,0,890,17.7,0.4,0.2,62.5,0,16.6,82.3,1612,877,735,54.4,45.6,120,757,138,597,258,1354,13.7,18.8,16,"75% or more P.O.C.","$51000 - $70000"
"06059099223","Census Tract 992.23, Orange County, California",5095,51732,1109,0,69,3091,8,734,21.8,0,1.4,60.7,0.2,14.4,78.2,1719,831,888,48.34,51.66,209,622,21,867,230,1489,25.2,2.4,13.4,"75% or more P.O.C.","$51000 - $70000"
"06059099224","Census Tract 992.24, Orange County, California",3448,89938,1580,11,0,1436,0,321,45.8,0.3,0,41.6,0,9.3,54.2,1061,853,208,80.4,19.6,139,714,53,155,192,869,16.3,25.5,18.1,"50% - 75% P.O.C.","$70000 - $95000"
"06059099225","Census Tract 992.25, Orange County, California",3554,114803,1622,14,0,1478,0,310,45.6,0.4,0,41.6,0,8.7,54.4,1013,948,65,93.58,6.42,128,820,55,10,183,830,13.5,84.6,18.1,"50% - 75% P.O.C.","$95000 or more"
"06059099226","Census Tract 992.26, Orange County, California",3772,117996,1026,0,9,2340,0,397,27.2,0,0.2,62,0,10.5,72.8,1077,949,128,88.12,11.88,164,785,33,95,197,880,17.3,25.8,18.3,"50% - 75% P.O.C.","$95000 or more"
"06059099227","Census Tract 992.27, Orange County, California",5806,82143,1494,29,37,2355,0,1765,25.7,0.5,0.6,40.6,0,30.4,74.3,1866,1092,774,58.52,41.48,102,990,120,654,222,1644,9.3,15.5,11.9,"50% - 75% P.O.C.","$70000 - $95000"
"06059099229","Census Tract 992.29, Orange County, California",6176,74396,3015,31,0,1707,0,1097,48.8,0.5,0,27.6,0,17.8,51.2,2437,1321,1116,54.21,45.79,111,1210,80,1036,191,2246,8.4,7.2,7.8,"50% - 75% P.O.C.","$70000 - $95000"
"06059099230","Census Tract 992.30, Orange County, California",4717,100338,2652,13,0,1045,63,735,56.2,0.3,0,22.2,1.3,15.6,43.8,1456,1072,384,73.63,26.37,135,937,83,301,218,1238,12.6,21.6,15,"25% - 50% P.O.C.","$95000 or more"
"06059099231","Census Tract 992.31, Orange County, California",5431,142333,3084,52,0,1314,0,796,56.8,1,0,24.2,0,14.7,43.2,1746,1645,101,94.22,5.78,198,1447,19,82,217,1529,12,18.8,12.4,"25% - 50% P.O.C.","$95000 or more"
"06059099232","Census Tract 992.32, Orange County, California",5557,98182,3044,20,0,1566,14,581,54.8,0.4,0,28.2,0.3,10.5,45.2,1904,1662,242,87.29,12.71,103,1559,114,128,217,1687,6.2,47.1,11.4,"25% - 50% P.O.C.","$95000 or more"
"06059099233","Census Tract 992.33, Orange County, California",3074,88803,1610,30,0,1114,0,280,52.4,1,0,36.2,0,9.1,47.6,1037,859,178,82.84,17.16,107,752,29,149,136,901,12.5,16.3,13.1,"25% - 50% P.O.C.","$70000 - $95000"
"06059099234","Census Tract 992.34, Orange County, California",3499,96908,1788,0,0,1375,0,249,51.1,0,0,39.3,0,7.1,48.9,1147,815,332,71.05,28.95,85,730,99,233,184,963,10.4,29.8,16,"25% - 50% P.O.C.","$95000 or more"
"06059099235","Census Tract 992.35, Orange County, California",5123,71071,3053,99,22,508,0,1270,59.6,1.9,0.4,9.9,0,24.8,40.4,2192,1164,1028,53.1,46.9,95,1069,20,1008,115,2077,8.2,1.9,5.2,"25% - 50% P.O.C.","$70000 - $95000"
"06059099237","Census Tract 992.37, Orange County, California",3198,127375,2353,33,0,374,0,296,73.6,1,0,11.7,0,9.3,26.4,1149,930,219,80.94,19.06,84,846,6,213,90,1059,9,2.7,7.8,"25% - 50% P.O.C.","$95000 or more"
"06059099238","Census Tract 992.38, Orange County, California",3974,136250,2864,21,13,524,0,454,72.1,0.5,0.3,13.2,0,11.4,27.9,1366,1170,196,85.65,14.35,104,1066,77,119,181,1185,8.9,39.3,13.3,"25% - 50% P.O.C.","$95000 or more"
"06059099239","Census Tract 992.39, Orange County, California",3824,121771,2827,7,0,619,0,263,73.9,0.2,0,16.2,0,6.9,26.1,1284,1140,144,88.79,11.21,71,1069,24,120,95,1189,6.2,16.7,7.4,"25% - 50% P.O.C.","$95000 or more"
"06059099240","Census Tract 992.40, Orange County, California",5275,93750,3535,94,0,461,79,899,67,1.8,0,8.7,1.5,17,33,2040,1086,954,53.24,46.76,66,1020,0,954,66,1974,6.1,0,3.2,"25% - 50% P.O.C.","$70000 - $95000"
"06059099241","Census Tract 992.41, Orange County, California",4202,79674,1755,125,8,995,0,1082,41.8,3,0.2,23.7,0,25.7,58.2,1582,648,934,40.96,59.04,75,573,59,875,134,1448,11.6,6.3,8.5,"50% - 75% P.O.C.","$70000 - $95000"
"06059099242","Census Tract 992.42, Orange County, California",3647,92198,1713,85,28,576,73,1020,47,2.3,0.8,15.8,2,28,53,1161,640,521,55.12,44.88,98,542,58,463,156,1005,15.3,11.1,13.4,"50% - 75% P.O.C.","$70000 - $95000"
"06059099243","Census Tract 992.43, Orange County, California",4034,90882,2877,114,0,408,0,325,71.3,2.8,0,10.1,0,8.1,28.7,1738,1406,332,80.9,19.1,77,1329,41,291,118,1620,5.5,12.3,6.8,"25% - 50% P.O.C.","$70000 - $95000"
"06059099244","Census Tract 992.44, Orange County, California",3528,81099,2883,0,0,256,0,328,81.7,0,0,7.3,0,9.3,18.3,1733,1464,269,84.48,15.52,70,1394,0,269,70,1663,4.8,0,4,"Less than 25% P.O.C.","$70000 - $95000"
"06059099245","Census Tract 992.45, Orange County, California",2948,117750,2080,10,0,380,0,399,70.6,0.3,0,12.9,0,13.5,29.4,1088,889,199,81.71,18.29,44,845,24,175,68,1020,4.9,12.1,6.2,"25% - 50% P.O.C.","$95000 or more"
"06059099246","Census Tract 992.46, Orange County, California",3476,118333,2123,2,24,757,0,358,61.1,0.1,0.7,21.8,0,10.3,38.9,1220,1060,160,86.89,13.11,63,997,22,138,85,1135,5.9,13.8,7,"25% - 50% P.O.C.","$95000 or more"
"06059099247","Census Tract 992.47, Orange County, California",3330,63250,244,28,0,1598,0,1415,7.3,0.8,0,48,0,42.5,92.7,776,400,376,51.55,48.45,106,294,125,251,231,545,26.5,33.2,29.8,"75% or more P.O.C.","$51000 - $70000"
"06059099248","Census Tract 992.48, Orange County, California",5636,48315,286,0,14,1407,9,3909,5.1,0,0.2,25,0.2,69.4,94.9,1438,602,836,41.86,58.14,157,445,160,676,317,1121,26.1,19.1,22,"75% or more P.O.C.","Less than $51000"
"06059099249","Census Tract 992.49, Orange County, California",4356,58563,28,38,0,476,88,3709,0.6,0.9,0,10.9,2,85.1,99.4,854,274,580,32.08,67.92,70,204,350,230,420,434,25.5,60.3,49.2,"75% or more P.O.C.","$51000 - $70000"
"06059099250","Census Tract 992.50, Orange County, California",3046,90000,987,65,0,952,34,956,32.4,2.1,0,31.3,1.1,31.4,67.6,1044,536,508,51.34,48.66,56,480,88,420,144,900,10.4,17.3,13.8,"50% - 75% P.O.C.","$70000 - $95000"
"06059099251","Census Tract 992.51, Orange County, California",5767,74962,2253,2,18,1732,27,1332,39.1,0,0.3,30,0.5,23.1,60.9,2104,508,1596,24.14,75.86,102,406,178,1418,280,1824,20.1,11.2,13.3,"50% - 75% P.O.C.","$70000 - $95000"
"06059099305","Census Tract 993.05, Orange County, California",7490,82697,4362,44,0,471,70,2003,58.2,0.6,0,6.3,0.9,26.7,41.8,2972,870,2102,29.27,70.73,0,870,96,2006,96,2876,0,4.6,3.2,"25% - 50% P.O.C.","$70000 - $95000"
"06059099306","Census Tract 993.06, Orange County, California",5909,85584,4391,90,0,450,0,778,74.3,1.5,0,7.6,0,13.2,25.7,2674,835,1839,31.23,68.77,38,797,27,1812,65,2609,4.6,1.5,2.4,"25% - 50% P.O.C.","$70000 - $95000"
"06059099307","Census Tract 993.07, Orange County, California",2557,86779,1905,0,0,337,0,268,74.5,0,0,13.2,0,10.5,25.5,1197,789,408,65.91,34.09,25,764,11,397,36,1161,3.2,2.7,3,"25% - 50% P.O.C.","$70000 - $95000"
"06059099308","Census Tract 993.08, Orange County, California",5996,148828,3739,26,0,1213,49,827,62.4,0.4,0,20.2,0.8,13.8,37.6,2158,1962,196,90.92,9.08,238,1724,22,174,260,1898,12.1,11.2,12,"25% - 50% P.O.C.","$95000 or more"
"06059099309","Census Tract 993.09, Orange County, California",5072,95579,3573,82,18,315,45,885,70.4,1.6,0.4,6.2,0.9,17.4,29.6,2213,1105,1108,49.93,50.07,104,1001,28,1080,132,2081,9.4,2.5,6,"25% - 50% P.O.C.","$95000 or more"
"06059099310","Census Tract 993.10, Orange County, California",4057,103159,3195,0,0,418,0,351,78.8,0,0,10.3,0,8.7,21.2,1893,776,1117,40.99,59.01,17,759,42,1075,59,1834,2.2,3.8,3.1,"Less than 25% P.O.C.","$95000 or more"
"06059099311","Census Tract 993.11, Orange County, California",3425,102882,2709,11,23,48,0,514,79.1,0.3,0.7,1.4,0,15,20.9,1629,764,865,46.9,53.1,33,731,0,865,33,1596,4.3,0,2,"Less than 25% P.O.C.","$95000 or more"
"06059099402","Census Tract 994.02, Orange County, California",8190,61298,1667,34,327,613,18,5417,20.4,0.4,4,7.5,0.2,66.1,79.6,2118,532,1586,25.12,74.88,55,477,530,1056,585,1533,10.3,33.4,27.6,"75% or more P.O.C.","$51000 - $70000"
"06059099404","Census Tract 994.04, Orange County, California",4420,115717,3042,133,27,349,10,594,68.8,3,0.6,7.9,0.2,13.4,31.2,1651,1043,608,63.17,36.83,85,958,44,564,129,1522,8.1,7.2,7.8,"25% - 50% P.O.C.","$95000 or more"
"06059099405","Census Tract 994.05, Orange County, California",4335,102115,2521,162,0,561,0,898,58.2,3.7,0,12.9,0,20.7,41.8,1656,948,708,57.25,42.75,101,847,41,667,142,1514,10.7,5.8,8.6,"25% - 50% P.O.C.","$95000 or more"
"06059099406","Census Tract 994.06, Orange County, California",4779,96250,3136,178,29,604,0,567,65.6,3.7,0.6,12.6,0,11.9,34.4,1684,1009,675,59.92,40.08,45,964,109,566,154,1530,4.5,16.1,9.1,"25% - 50% P.O.C.","$95000 or more"
"06059099407","Census Tract 994.07, Orange County, California",2380,105417,1523,13,0,283,6,453,64,0.5,0,11.9,0.3,19,36,946,598,348,63.21,36.79,33,565,12,336,45,901,5.5,3.4,4.8,"25% - 50% P.O.C.","$95000 or more"
"06059099408","Census Tract 994.08, Orange County, California",4594,108478,3063,89,0,584,0,639,66.7,1.9,0,12.7,0,13.9,33.3,1674,1165,509,69.59,30.41,135,1030,30,479,165,1509,11.6,5.9,9.9,"25% - 50% P.O.C.","$95000 or more"
"06059099410","Census Tract 994.10, Orange County, California",4903,64077,1917,90,0,736,0,2010,39.1,1.8,0,15,0,41,60.9,1701,335,1366,19.69,80.31,21,314,156,1210,177,1524,6.3,11.4,10.4,"50% - 75% P.O.C.","$51000 - $70000"
"06059099411","Census Tract 994.11, Orange County, California",5851,68173,2339,143,11,356,106,2690,40,2.4,0.2,6.1,1.8,46,60,2037,405,1632,19.88,80.12,0,405,241,1391,241,1796,0,14.8,11.8,"50% - 75% P.O.C.","$51000 - $70000"
"06059099412","Census Tract 994.12, Orange County, California",4875,96509,3041,54,10,579,9,1059,62.4,1.1,0.2,11.9,0.2,21.7,37.6,1899,1086,813,57.19,42.81,70,1016,55,758,125,1774,6.4,6.8,6.6,"25% - 50% P.O.C.","$95000 or more"
"06059099413","Census Tract 994.13, Orange County, California",8633,84750,5087,35,23,1657,0,1590,58.9,0.4,0.3,19.2,0,18.4,41.1,3434,1767,1667,51.46,48.54,175,1592,106,1561,281,3153,9.9,6.4,8.2,"25% - 50% P.O.C.","$70000 - $95000"
"06059099415","Census Tract 994.15, Orange County, California",5338,138920,3936,30,49,618,18,547,73.7,0.6,0.9,11.6,0.3,10.2,26.3,1920,1623,297,84.53,15.47,124,1499,51,246,175,1745,7.6,17.2,9.1,"25% - 50% P.O.C.","$95000 or more"
"06059099416","Census Tract 994.16, Orange County, California",5536,92973,3508,66,0,485,0,1142,63.4,1.2,0,8.8,0,20.6,36.6,2373,442,1931,18.63,81.37,20,422,43,1888,63,2310,4.5,2.2,2.7,"25% - 50% P.O.C.","$70000 - $95000"
"06059099417","Census Tract 994.17, Orange County, California",4845,112596,3190,70,24,677,21,656,65.8,1.4,0.5,14,0.4,13.5,34.2,2055,1040,1015,50.61,49.39,68,972,22,993,90,1965,6.5,2.2,4.4,"25% - 50% P.O.C.","$95000 or more"
"06059099502","Census Tract 995.02, Orange County, California",621,67656,185,108,0,13,0,269,29.8,17.4,0,2.1,0,43.3,70.2,173,0,173,0,100,0,0,38,135,38,135,NA,22,22,"50% - 75% P.O.C.","$51000 - $70000"
"06059099504","Census Tract 995.04, Orange County, California",2679,126429,2052,0,11,214,0,220,76.6,0,0.4,8,0,8.2,23.4,978,896,82,91.62,8.38,119,777,0,82,119,859,13.3,0,12.2,"Less than 25% P.O.C.","$95000 or more"
"06059099506","Census Tract 995.06, Orange County, California",919,85000,779,6,13,26,15,69,84.8,0.7,1.4,2.8,1.6,7.5,15.2,480,181,299,37.71,62.29,13,168,10,289,23,457,7.2,3.3,4.8,"Less than 25% P.O.C.","$70000 - $95000"
"06059099508","Census Tract 995.08, Orange County, California",5116,81750,2957,60,14,700,0,1041,57.8,1.2,0.3,13.7,0,20.3,42.2,2052,890,1162,43.37,56.63,11,879,156,1006,167,1885,1.2,13.4,8.1,"25% - 50% P.O.C.","$70000 - $95000"
"06059099509","Census Tract 995.09, Orange County, California",3352,39471,2358,61,47,640,0,246,70.3,1.8,1.4,19.1,0,7.3,29.7,2321,2237,84,96.38,3.62,0,2237,0,84,0,2321,0,0,0,"25% - 50% P.O.C.","Less than $51000"
"06059099510","Census Tract 995.10, Orange County, California",4449,36884,3203,93,0,734,39,299,72,2.1,0,16.5,0.9,6.7,28,3259,3130,129,96.04,3.96,0,3130,0,129,0,3259,0,0,0,"25% - 50% P.O.C.","Less than $51000"
"06059099511","Census Tract 995.11, Orange County, California",3023,100069,2409,29,0,51,0,468,79.7,1,0,1.7,0,15.5,20.3,1709,557,1152,32.59,67.41,0,557,20,1132,20,1689,0,1.7,1.2,"Less than 25% P.O.C.","$95000 or more"
"06059099512","Census Tract 995.12, Orange County, California",2959,118958,2295,22,0,85,10,397,77.6,0.7,0,2.9,0.3,13.4,22.4,1457,567,890,38.92,61.08,0,567,9,881,9,1448,0,1,0.6,"Less than 25% P.O.C.","$95000 or more"
"06059099513","Census Tract 995.13, Orange County, California",2106,97974,1483,27,0,172,0,367,70.4,1.3,0,8.2,0,17.4,29.6,1135,896,239,78.94,21.06,12,884,28,211,40,1095,1.3,11.7,3.5,"25% - 50% P.O.C.","$95000 or more"
"06059099514","Census Tract 995.14, Orange County, California",4897,122143,3179,0,0,996,0,479,64.9,0,0,20.3,0,9.8,35.1,2134,1815,319,85.05,14.95,85,1730,0,319,85,2049,4.7,0,4,"25% - 50% P.O.C.","$95000 or more"
"06059099601","Census Tract 996.01, Orange County, California",7230,50492,1322,47,21,2941,191,2644,18.3,0.7,0.3,40.7,2.6,36.6,81.7,1977,705,1272,35.66,64.34,168,537,234,1038,402,1575,23.8,18.4,20.3,"75% or more P.O.C.","Less than $51000"
"06059099602","Census Tract 996.02, Orange County, California",3275,99838,1749,57,0,517,68,755,53.4,1.7,0,15.8,2.1,23.1,46.6,1119,625,494,55.85,44.15,64,561,42,452,106,1013,10.2,8.5,9.5,"25% - 50% P.O.C.","$95000 or more"
"06059099603","Census Tract 996.03, Orange County, California",7113,109922,3961,5,0,1285,0,1354,55.7,0.1,0,18.1,0,19,44.3,2327,1790,537,76.92,23.08,232,1558,37,500,269,2058,13,6.9,11.6,"25% - 50% P.O.C.","$95000 or more"
"06059099604","Census Tract 996.04, Orange County, California",3874,122917,2320,51,6,568,0,739,59.9,1.3,0.2,14.7,0,19.1,40.1,1194,978,216,81.91,18.09,136,842,37,179,173,1021,13.9,17.1,14.5,"25% - 50% P.O.C.","$95000 or more"
"06059099605","Census Tract 996.05, Orange County, California",4951,105313,2950,97,0,745,0,851,59.6,2,0,15,0,17.2,40.4,2011,991,1020,49.28,50.72,89,902,82,938,171,1840,9,8,8.5,"25% - 50% P.O.C.","$95000 or more"
"06059099701","Census Tract 997.01, Orange County, California",6441,57743,818,0,0,3874,72,1521,12.7,0,0,60.1,1.1,23.6,87.3,1766,713,1053,40.37,59.63,177,536,170,883,347,1419,24.8,16.1,19.6,"75% or more P.O.C.","$51000 - $70000"
"06059099702","Census Tract 997.02, Orange County, California",7897,59375,1857,77,0,4304,0,1577,23.5,1,0,54.5,0,20,76.5,2560,1461,1099,57.07,42.93,216,1245,200,899,416,2144,14.8,18.2,16.2,"75% or more P.O.C.","$51000 - $70000"
"06059099703","Census Tract 997.03, Orange County, California",6157,87793,2213,68,0,2684,0,911,35.9,1.1,0,43.6,0,14.8,64.1,2133,1151,982,53.96,46.04,233,918,21,961,254,1879,20.2,2.1,11.9,"50% - 75% P.O.C.","$70000 - $95000"
"06059099801","Census Tract 998.01, Orange County, California",5742,61392,893,70,44,2693,0,2018,15.6,1.2,0.8,46.9,0,35.1,84.4,1621,763,858,47.07,52.93,227,536,81,777,308,1313,29.8,9.4,19,"75% or more P.O.C.","$51000 - $70000"
"06059099802","Census Tract 998.02, Orange County, California",5472,35530,700,66,0,2281,14,2343,12.8,1.2,0,41.7,0.3,42.8,87.2,1856,281,1575,15.14,84.86,19,262,246,1329,265,1591,6.8,15.6,14.3,"75% or more P.O.C.","Less than $51000"
"06059099803","Census Tract 998.03, Orange County, California",5697,36572,914,8,56,3638,0,1014,16,0.1,1,63.9,0,17.8,84,1779,685,1094,38.5,61.5,221,464,153,941,374,1405,32.3,14,21,"75% or more P.O.C.","Less than $51000"
"06059099902","Census Tract 999.02, Orange County, California",4299,67188,1731,68,0,1064,0,1290,40.3,1.6,0,24.7,0,30,59.7,1270,826,444,65.04,34.96,143,683,66,378,209,1061,17.3,14.9,16.5,"50% - 75% P.O.C.","$51000 - $70000"
"06059099903","Census Tract 999.03, Orange County, California",5764,78451,1219,62,0,1978,14,2361,21.1,1.1,0,34.3,0.2,41,78.9,1491,720,771,48.29,51.71,189,531,231,540,420,1071,26.2,30,28.2,"75% or more P.O.C.","$70000 - $95000"
"06059099904","Census Tract 999.04, Orange County, California",6116,46912,1063,67,0,2576,0,2133,17.4,1.1,0,42.1,0,34.9,82.6,1918,610,1308,31.8,68.2,207,403,181,1127,388,1530,33.9,13.8,20.2,"75% or more P.O.C.","Less than $51000"
"06059099905","Census Tract 999.05, Orange County, California",4265,81694,1174,44,0,970,16,1874,27.5,1,0,22.7,0.4,43.9,72.5,1286,477,809,37.09,62.91,46,431,233,576,279,1007,9.6,28.8,21.7,"50% - 75% P.O.C.","$70000 - $95000"
"06059099906","Census Tract 999.06, Orange County, California",5270,129107,2677,356,0,1009,0,1106,50.8,6.8,0,19.1,0,21,49.2,1609,1412,197,87.76,12.24,133,1279,98,99,231,1378,9.4,49.7,14.4,"25% - 50% P.O.C.","$95000 or more"
"06059110001","Census Tract 1100.01, Orange County, California",4691,106875,2779,211,0,486,8,823,59.2,4.5,0,10.4,0.2,17.5,40.8,1543,1169,374,75.76,24.24,113,1056,66,308,179,1364,9.7,17.6,11.6,"25% - 50% P.O.C.","$95000 or more"
"06059110003","Census Tract 1100.03, Orange County, California",3141,115045,2075,35,15,554,0,436,66.1,1.1,0.5,17.6,0,13.9,33.9,1118,774,344,69.23,30.77,108,666,30,314,138,980,14,8.7,12.3,"25% - 50% P.O.C.","$95000 or more"
"06059110004","Census Tract 1100.04, Orange County, California",4953,109259,3123,23,0,829,0,811,63.1,0.5,0,16.7,0,16.4,36.9,1680,1443,237,85.89,14.11,197,1246,17,220,214,1466,13.7,7.2,12.7,"25% - 50% P.O.C.","$95000 or more"
"06059110005","Census Tract 1100.05, Orange County, California",2981,82569,1756,0,0,560,0,550,58.9,0,0,18.8,0,18.5,41.1,1120,998,122,89.11,10.89,89,909,37,85,126,994,8.9,30.3,11.2,"25% - 50% P.O.C.","$70000 - $95000"
"06059110006","Census Tract 1100.06, Orange County, California",3248,129342,2067,0,0,491,0,491,63.6,0,0,15.1,0,15.1,36.4,1156,945,211,81.75,18.25,36,909,17,194,53,1103,3.8,8.1,4.6,"25% - 50% P.O.C.","$95000 or more"
"06059110007","Census Tract 1100.07, Orange County, California",5148,128674,3629,117,0,539,13,718,70.5,2.3,0,10.5,0.3,13.9,29.5,1745,1630,115,93.41,6.59,174,1456,15,100,189,1556,10.7,13,10.8,"25% - 50% P.O.C.","$95000 or more"
"06059110008","Census Tract 1100.08, Orange County, California",4486,105227,2933,94,44,493,16,645,65.4,2.1,1,11,0.4,14.4,34.6,1696,1339,357,78.95,21.05,128,1211,38,319,166,1530,9.6,10.6,9.8,"25% - 50% P.O.C.","$95000 or more"
"06059110010","Census Tract 1100.10, Orange County, California",4801,132353,2265,17,18,1536,11,836,47.2,0.4,0.4,32,0.2,17.4,52.8,1394,1181,213,84.72,15.28,119,1062,58,155,177,1217,10.1,27.2,12.7,"50% - 75% P.O.C.","$95000 or more"
"06059110011","Census Tract 1100.11, Orange County, California",2799,101563,1177,57,4,863,18,538,42.1,2,0.1,30.8,0.6,19.2,57.9,1005,827,178,82.29,17.71,47,780,15,163,62,943,5.7,8.4,6.2,"50% - 75% P.O.C.","$95000 or more"
"06059110012","Census Tract 1100.12, Orange County, California",5131,141477,3300,79,0,794,0,817,64.3,1.5,0,15.5,0,15.9,35.7,1847,1491,356,80.73,19.27,84,1407,33,323,117,1730,5.6,9.3,6.3,"25% - 50% P.O.C.","$95000 or more"
"06059110014","Census Tract 1100.14, Orange County, California",5274,74318,1949,424,5,815,22,1784,37,8,0.1,15.5,0.4,33.8,63,1804,147,1657,8.15,91.85,0,147,150,1507,150,1654,0,9.1,8.3,"50% - 75% P.O.C.","$70000 - $95000"
"06059110015","Census Tract 1100.15, Orange County, California",3354,133250,2253,50,0,269,0,622,67.2,1.5,0,8,0,18.5,32.8,1144,1005,139,87.85,12.15,113,892,14,125,127,1017,11.2,10.1,11.1,"25% - 50% P.O.C.","$95000 or more"
"06059110102","Census Tract 1101.02, Orange County, California",5785,111169,1602,210,11,2764,0,961,27.7,3.6,0.2,47.8,0,16.6,72.3,1789,1197,592,66.91,33.09,148,1049,121,471,269,1520,12.4,20.4,15,"50% - 75% P.O.C.","$95000 or more"
"06059110104","Census Tract 1101.04, Orange County, California",5631,80536,2094,155,17,2092,0,972,37.2,2.8,0.3,37.2,0,17.3,62.8,1835,1112,723,60.6,39.4,152,960,142,581,294,1541,13.7,19.6,16,"50% - 75% P.O.C.","$70000 - $95000"
"06059110106","Census Tract 1101.06, Orange County, California",3670,94881,1597,81,0,1047,15,666,43.5,2.2,0,28.5,0.4,18.1,56.5,1178,900,278,76.4,23.6,98,802,86,192,184,994,10.9,30.9,15.6,"50% - 75% P.O.C.","$70000 - $95000"
"06059110108","Census Tract 1101.08, Orange County, California",2677,91597,1142,195,0,494,0,658,42.7,7.3,0,18.5,0,24.6,57.3,1035,542,493,52.37,47.63,40,502,55,438,95,940,7.4,11.2,9.2,"50% - 75% P.O.C.","$70000 - $95000"
"06059110109","Census Tract 1101.09, Orange County, California",5410,85104,1725,528,0,1933,88,933,31.9,9.8,0,35.7,1.6,17.2,68.1,1810,1037,773,57.29,42.71,90,947,106,667,196,1614,8.7,13.7,10.8,"50% - 75% P.O.C.","$70000 - $95000"
"06059110110","Census Tract 1101.10, Orange County, California",5809,83010,1643,130,0,1821,8,1968,28.3,2.2,0,31.3,0.1,33.9,71.7,1814,909,905,50.11,49.89,245,664,85,820,330,1484,27,9.4,18.2,"50% - 75% P.O.C.","$70000 - $95000"
"06059110111","Census Tract 1101.11, Orange County, California",6189,93313,1797,389,0,2441,0,1385,29,6.3,0,39.4,0,22.4,71,1907,1284,623,67.33,32.67,149,1135,144,479,293,1614,11.6,23.1,15.4,"50% - 75% P.O.C.","$70000 - $95000"
"06059110113","Census Tract 1101.13, Orange County, California",2110,109444,1042,41,22,424,0,463,49.4,1.9,1,20.1,0,21.9,50.6,710,551,159,77.61,22.39,53,498,33,126,86,624,9.6,20.8,12.1,"50% - 75% P.O.C.","$95000 or more"
"06059110114","Census Tract 1101.14, Orange County, California",4827,102180,2413,36,19,1007,0,1127,50,0.7,0.4,20.9,0,23.3,50,1447,1223,224,84.52,15.48,253,970,45,179,298,1149,20.7,20.1,20.6,"50% - 75% P.O.C.","$95000 or more"
"06059110115","Census Tract 1101.15, Orange County, California",3993,108100,805,242,12,1887,0,1025,20.2,6.1,0.3,47.3,0,25.7,79.8,1112,818,294,73.56,26.44,188,630,40,254,228,884,23,13.6,20.5,"75% or more P.O.C.","$95000 or more"
"06059110116","Census Tract 1101.16, Orange County, California",4698,115700,1045,259,0,2267,102,768,22.2,5.5,0,48.3,2.2,16.3,77.8,1432,981,451,68.51,31.49,153,828,80,371,233,1199,15.6,17.7,16.3,"75% or more P.O.C.","$95000 or more"
"06059110117","Census Tract 1101.17, Orange County, California",6393,88361,2242,186,0,2507,0,1240,35.1,2.9,0,39.2,0,19.4,64.9,2074,1223,851,58.97,41.03,166,1057,149,702,315,1759,13.6,17.5,15.2,"50% - 75% P.O.C.","$70000 - $95000"
"06059110118","Census Tract 1101.18, Orange County, California",2355,186875,592,130,0,1458,0,159,25.1,5.5,0,61.9,0,6.8,74.9,755,735,20,97.35,2.65,66,669,0,20,66,689,9,0,8.7,"50% - 75% P.O.C.","$95000 or more"
"06059110201","Census Tract 1102.01, Orange County, California",8236,62752,1971,334,0,3047,21,2572,23.9,4.1,0,37,0.3,31.2,76.1,2604,1374,1230,52.76,47.24,240,1134,169,1061,409,2195,17.5,13.7,15.7,"75% or more P.O.C.","$51000 - $70000"
"06059110202","Census Tract 1102.02, Orange County, California",8018,64904,2097,247,94,1857,287,3145,26.2,3.1,1.2,23.2,3.6,39.2,73.8,2292,838,1454,36.56,63.44,255,583,198,1256,453,1839,30.4,13.6,19.8,"50% - 75% P.O.C.","$51000 - $70000"
"06059110203","Census Tract 1102.03, Orange County, California",5512,98417,2663,88,0,1065,0,1434,48.3,1.6,0,19.3,0,26,51.7,1741,1183,558,67.95,32.05,133,1050,46,512,179,1562,11.2,8.2,10.3,"50% - 75% P.O.C.","$95000 or more"
"06059110301","Census Tract 1103.01, Orange County, California",6980,93173,2124,264,0,2405,18,1730,30.4,3.8,0,34.5,0.3,24.8,69.6,2079,1294,785,62.24,37.76,288,1006,103,682,391,1688,22.3,13.1,18.8,"50% - 75% P.O.C.","$70000 - $95000"
"06059110302","Census Tract 1103.02, Orange County, California",5975,89351,1323,5,52,1417,41,3025,22.1,0.1,0.9,23.7,0.7,50.6,77.9,1591,1071,520,67.32,32.68,260,811,34,486,294,1297,24.3,6.5,18.5,"75% or more P.O.C.","$70000 - $95000"
"06059110303","Census Tract 1103.03, Orange County, California",4661,92656,1608,68,14,1357,0,1435,34.5,1.5,0.3,29.1,0,30.8,65.5,1493,998,495,66.85,33.15,98,900,109,386,207,1286,9.8,22,13.9,"50% - 75% P.O.C.","$70000 - $95000"
"06059110304","Census Tract 1103.04, Orange County, California",4966,101691,1936,133,0,1522,0,1341,39,2.7,0,30.6,0,27,61,1301,1053,248,80.94,19.06,280,773,33,215,313,988,26.6,13.3,24.1,"50% - 75% P.O.C.","$95000 or more"
"06059110401","Census Tract 1104.01, Orange County, California",4906,97500,1274,115,0,1175,66,2098,26,2.3,0,24,1.3,42.8,74,1352,1077,275,79.66,20.34,279,798,49,226,328,1024,25.9,17.8,24.3,"50% - 75% P.O.C.","$95000 or more"
"06059110402","Census Tract 1104.02, Orange County, California",5588,76941,803,250,0,1357,3,3069,14.4,4.5,0,24.3,0.1,54.9,85.6,1401,672,729,47.97,52.03,165,507,244,485,409,992,24.6,33.5,29.2,"75% or more P.O.C.","$70000 - $95000"
"06059110500","Census Tract 1105, Orange County, California",8677,56303,1112,523,48,2042,275,4667,12.8,6,0.6,23.5,3.2,53.8,87.2,2442,692,1750,28.34,71.66,158,534,482,1268,640,1802,22.8,27.5,26.2,"75% or more P.O.C.","$51000 - $70000"
"06059110603","Census Tract 1106.03, Orange County, California",8669,59777,1477,85,18,1779,0,5229,17,1,0.2,20.5,0,60.3,83,2404,431,1973,17.93,82.07,37,394,348,1625,385,2019,8.6,17.6,16,"75% or more P.O.C.","$51000 - $70000"
"06059110604","Census Tract 1106.04, Orange County, California",7704,98125,1646,112,0,5123,0,668,21.4,1.5,0,66.5,0,8.7,78.6,2605,2213,392,84.95,15.05,182,2031,38,354,220,2385,8.2,9.7,8.4,"75% or more P.O.C.","$95000 or more"
"06059110605","Census Tract 1106.05, Orange County, California",6740,103533,1272,0,0,4603,46,637,18.9,0,0,68.3,0.7,9.5,81.1,2209,1414,795,64.01,35.99,164,1250,139,656,303,1906,11.6,17.5,13.7,"75% or more P.O.C.","$95000 or more"
"06059110606","Census Tract 1106.06, Orange County, California",4541,58750,333,357,0,1322,0,2488,7.3,7.9,0,29.1,0,54.8,92.7,1220,242,978,19.84,80.16,123,119,141,837,264,956,50.8,14.4,21.6,"75% or more P.O.C.","$51000 - $70000"
"06059110607","Census Tract 1106.07, Orange County, California",4254,85605,887,152,48,1641,0,1434,20.9,3.6,1.1,38.6,0,33.7,79.1,1321,663,658,50.19,49.81,97,566,30,628,127,1194,14.6,4.6,9.6,"75% or more P.O.C.","$70000 - $95000"
"06059980000","Census Tract 9800, Orange County, California",33,NA,0,0,0,6,0,27,0,0,0,18.2,0,81.8,100,0,0,0,NA,NA,0,0,0,0,0,0,NA,NA,NA,"75% or more P.O.C.","N/A"
"06059990100","Census Tract 9901, Orange County, California",0,NA,0,0,0,0,0,0,NA,NA,NA,NA,NA,NA,NA,0,0,0,NA,NA,0,0,0,0,0,0,NA,NA,NA,"N/A","N/A"
"06065030101","Census Tract 301.01, Riverside County, California",1201,56742,135,176,0,160,0,703,11.2,14.7,0,13.3,0,58.5,88.8,364,190,174,52.2,47.8,30,160,54,120,84,280,15.8,31,23.1,"75% or more P.O.C.","$51000 - $70000"
"06065030103","Census Tract 301.03, Riverside County, California",2277,66711,568,5,1,54,0,1599,24.9,0.2,0,2.4,0,70.2,75.1,602,282,320,46.84,53.16,83,199,46,274,129,473,29.4,14.4,21.4,"75% or more P.O.C.","$51000 - $70000"
"06065030104","Census Tract 301.04, Riverside County, California",7650,70270,1016,648,9,728,0,5068,13.3,8.5,0.1,9.5,0,66.2,86.7,1882,1197,685,63.6,36.4,349,848,109,576,458,1424,29.2,15.9,24.3,"75% or more P.O.C.","$70000 - $95000"
"06065030200","Census Tract 302, Riverside County, California",4469,75918,2297,156,7,80,0,1734,51.4,3.5,0.2,1.8,0,38.8,48.6,1768,854,914,48.3,51.7,17,837,71,843,88,1680,2,7.8,5,"25% - 50% P.O.C.","$70000 - $95000"
"06065030300","Census Tract 303, Riverside County, California",4071,32248,1411,440,8,65,7,2035,34.7,10.8,0.2,1.6,0.2,50,65.3,1637,181,1456,11.06,88.94,0,181,68,1388,68,1569,0,4.7,4.2,"50% - 75% P.O.C.","Less than $51000"
"06065030400","Census Tract 304, Riverside County, California",6741,45341,613,412,0,94,21,5601,9.1,6.1,0,1.4,0.3,83.1,90.9,1576,662,914,42.01,57.99,264,398,226,688,490,1086,39.9,24.7,31.1,"75% or more P.O.C.","Less than $51000"
"06065030501","Census Tract 305.01, Riverside County, California",4557,55616,700,600,0,353,0,2864,15.4,13.2,0,7.7,0,62.8,84.6,1327,631,696,47.55,52.45,150,481,113,583,263,1064,23.8,16.2,19.8,"75% or more P.O.C.","$51000 - $70000"
"06065030502","Census Tract 305.02, Riverside County, California",1963,36889,198,159,0,0,0,1602,10.1,8.1,0,0,0,81.6,89.9,508,188,320,37.01,62.99,64,124,53,267,117,391,34,16.6,23,"75% or more P.O.C.","Less than $51000"
"06065030503","Census Tract 305.03, Riverside County, California",3592,32394,240,196,0,8,0,3031,6.7,5.5,0,0.2,0,84.4,93.3,1040,149,891,14.33,85.67,22,127,165,726,187,853,14.8,18.5,18,"75% or more P.O.C.","Less than $51000"
"06065030601","Census Tract 306.01, Riverside County, California",5586,152011,3453,306,12,895,0,822,61.8,5.5,0.2,16,0,14.7,38.2,1788,1734,54,96.98,3.02,214,1520,11,43,225,1563,12.3,20.4,12.6,"25% - 50% P.O.C.","$95000 or more"
"06065030602","Census Tract 306.02, Riverside County, California",3229,106483,2196,180,17,175,0,558,68,5.6,0.5,5.4,0,17.3,32,1167,988,179,84.66,15.34,61,927,30,149,91,1076,6.2,16.8,7.8,"25% - 50% P.O.C.","$95000 or more"
"06065030603","Census Tract 306.03, Riverside County, California",3232,136333,2125,40,0,125,21,862,65.7,1.2,0,3.9,0.6,26.7,34.3,996,933,63,93.67,6.33,153,780,7,56,160,836,16.4,11.1,16.1,"25% - 50% P.O.C.","$95000 or more"
"06065030700","Census Tract 307, Riverside County, California",5927,71156,2752,216,0,56,0,2790,46.4,3.6,0,0.9,0,47.1,53.6,2015,1067,948,52.95,47.05,133,934,49,899,182,1833,12.5,5.2,9,"50% - 75% P.O.C.","$70000 - $95000"
"06065030800","Census Tract 308, Riverside County, California",7801,66419,3288,429,52,403,0,3627,42.1,5.5,0.7,5.2,0,46.5,57.9,2346,1568,778,66.84,33.16,291,1277,99,679,390,1956,18.6,12.7,16.6,"50% - 75% P.O.C.","$51000 - $70000"
"06065030900","Census Tract 309, Riverside County, California",3059,67688,652,143,8,192,0,2051,21.3,4.7,0.3,6.3,0,67,78.7,837,723,114,86.38,13.62,175,548,29,85,204,633,24.2,25.4,24.4,"75% or more P.O.C.","$51000 - $70000"
"06065031001","Census Tract 310.01, Riverside County, California",5872,75080,2097,312,38,45,0,3325,35.7,5.3,0.6,0.8,0,56.6,64.3,2143,1440,703,67.2,32.8,208,1232,0,703,208,1935,14.4,0,9.7,"50% - 75% P.O.C.","$70000 - $95000"
"06065031002","Census Tract 310.02, Riverside County, California",5202,59677,656,228,25,0,0,4156,12.6,4.4,0.5,0,0,79.9,87.4,1188,688,500,57.91,42.09,149,539,233,267,382,806,21.7,46.6,32.2,"75% or more P.O.C.","$51000 - $70000"
"06065031100","Census Tract 311, Riverside County, California",5726,65682,2415,482,32,85,0,2407,42.2,8.4,0.6,1.5,0,42,57.8,1658,965,693,58.2,41.8,173,792,27,666,200,1458,17.9,3.9,12.1,"50% - 75% P.O.C.","$51000 - $70000"
"06065031200","Census Tract 312, Riverside County, California",7184,77982,2901,52,0,250,0,3981,40.4,0.7,0,3.5,0,55.4,59.6,1970,1218,752,61.83,38.17,244,974,272,480,516,1454,20,36.2,26.2,"50% - 75% P.O.C.","$70000 - $95000"
"06065031300","Census Tract 313, Riverside County, California",3277,64837,54,30,0,18,0,3149,1.6,0.9,0,0.5,0,96.1,98.4,621,398,223,64.09,35.91,147,251,166,57,313,308,36.9,74.4,50.4,"75% or more P.O.C.","$51000 - $70000"
"06065031401","Census Tract 314.01, Riverside County, California",7635,51942,2430,733,0,73,0,4277,31.8,9.6,0,1,0,56,68.2,2131,825,1306,38.71,61.29,212,613,225,1081,437,1694,25.7,17.2,20.5,"50% - 75% P.O.C.","$51000 - $70000"
"06065031402","Census Tract 314.02, Riverside County, California",7793,54757,3211,278,7,141,0,3920,41.2,3.6,0.1,1.8,0,50.3,58.8,2245,900,1345,40.09,59.91,198,702,238,1107,436,1809,22,17.7,19.4,"50% - 75% P.O.C.","$51000 - $70000"
"06065031501","Census Tract 315.01, Riverside County, California",7993,69272,2742,357,133,391,70,4025,34.3,4.5,1.7,4.9,0.9,50.4,65.7,1479,684,795,46.25,53.75,229,455,135,660,364,1115,33.5,17,24.6,"50% - 75% P.O.C.","$51000 - $70000"
"06065031502","Census Tract 315.02, Riverside County, California",8357,39794,2367,759,26,101,0,4933,28.3,9.1,0.3,1.2,0,59,71.7,2738,1187,1551,43.35,56.65,307,880,113,1438,420,2318,25.9,7.3,15.3,"50% - 75% P.O.C.","Less than $51000"
"06065031601","Census Tract 316.01, Riverside County, California",4499,50757,1148,161,0,238,0,2931,25.5,3.6,0,5.3,0,65.1,74.5,1155,532,623,46.06,53.94,181,351,39,584,220,935,34,6.3,19,"50% - 75% P.O.C.","Less than $51000"
"06065031602","Census Tract 316.02, Riverside County, California",6311,49957,1051,137,18,109,44,4858,16.7,2.2,0.3,1.7,0.7,77,83.3,1675,683,992,40.78,59.22,84,599,300,692,384,1291,12.3,30.2,22.9,"75% or more P.O.C.","Less than $51000"
"06065031701","Census Tract 317.01, Riverside County, California",2403,54960,521,131,0,281,0,1446,21.7,5.5,0,11.7,0,60.2,78.3,741,467,274,63.02,36.98,96,371,7,267,103,638,20.6,2.6,13.9,"75% or more P.O.C.","$51000 - $70000"
"06065031702","Census Tract 317.02, Riverside County, California",2322,75565,879,52,0,154,12,1209,37.9,2.2,0,6.6,0.5,52.1,62.1,685,518,167,75.62,24.38,63,455,33,134,96,589,12.2,19.8,14,"50% - 75% P.O.C.","$70000 - $95000"
"06065031703","Census Tract 317.03, Riverside County, California",4115,75129,1167,83,11,239,0,2534,28.4,2,0.3,5.8,0,61.6,71.6,1131,662,469,58.53,41.47,193,469,97,372,290,841,29.2,20.7,25.6,"50% - 75% P.O.C.","$70000 - $95000"
"06065031704","Census Tract 317.04, Riverside County, California",5838,73352,1756,234,6,630,0,3119,30.1,4,0.1,10.8,0,53.4,69.9,1733,960,773,55.4,44.6,223,737,146,627,369,1364,23.2,18.9,21.3,"50% - 75% P.O.C.","$70000 - $95000"
"06065040101","Census Tract 401.01, Riverside County, California",4542,80889,572,477,0,0,0,3475,12.6,10.5,0,0,0,76.5,87.4,946,709,237,74.95,25.05,303,406,92,145,395,551,42.7,38.8,41.8,"75% or more P.O.C.","$70000 - $95000"
"06065040102","Census Tract 401.02, Riverside County, California",4810,71655,1252,153,16,138,0,3180,26,3.2,0.3,2.9,0,66.1,74,1030,660,370,64.08,35.92,229,431,164,206,393,637,34.7,44.3,38.2,"50% - 75% P.O.C.","$70000 - $95000"
"06065040201","Census Tract 402.01, Riverside County, California",6340,73980,1071,186,16,178,8,4806,16.9,2.9,0.3,2.8,0.1,75.8,83.1,1598,1113,485,69.65,30.35,297,816,106,379,403,1195,26.7,21.9,25.2,"75% or more P.O.C.","$70000 - $95000"
"06065040202","Census Tract 402.02, Riverside County, California",3342,67708,994,15,29,12,14,2248,29.7,0.4,0.9,0.4,0.4,67.3,70.3,799,641,158,80.23,19.77,147,494,64,94,211,588,22.9,40.5,26.4,"50% - 75% P.O.C.","$51000 - $70000"
"06065040203","Census Tract 402.03, Riverside County, California",4422,42214,213,81,0,5,0,4123,4.8,1.8,0,0.1,0,93.2,95.2,915,351,564,38.36,61.64,127,224,238,326,365,550,36.2,42.2,39.9,"75% or more P.O.C.","Less than $51000"
"06065040204","Census Tract 402.04, Riverside County, California",4160,38984,217,215,0,0,0,3702,5.2,5.2,0,0,0,89,94.8,825,333,492,40.36,59.64,147,186,161,331,308,517,44.1,32.7,37.3,"75% or more P.O.C.","Less than $51000"
"06065040301","Census Tract 403.01, Riverside County, California",8542,45287,1007,395,0,77,20,7043,11.8,4.6,0,0.9,0.2,82.5,88.2,1902,971,931,51.05,48.95,489,482,276,655,765,1137,50.4,29.6,40.2,"75% or more P.O.C.","Less than $51000"
"06065040302","Census Tract 403.02, Riverside County, California",7414,84269,2383,148,0,771,0,3964,32.1,2,0,10.4,0,53.5,67.9,1957,1736,221,88.71,11.29,333,1403,115,106,448,1509,19.2,52,22.9,"50% - 75% P.O.C.","$70000 - $95000"
"06065040303","Census Tract 403.03, Riverside County, California",4321,72688,894,203,0,296,0,2872,20.7,4.7,0,6.9,0,66.5,79.3,859,599,260,69.73,30.27,270,329,121,139,391,468,45.1,46.5,45.5,"75% or more P.O.C.","$70000 - $95000"
"06065040402","Census Tract 404.02, Riverside County, California",4373,59718,1005,6,20,6,0,3336,23,0.1,0.5,0.1,0,76.3,77,958,707,251,73.8,26.2,164,543,106,145,270,688,23.2,42.2,28.2,"75% or more P.O.C.","$51000 - $70000"
"06065040403","Census Tract 404.03, Riverside County, California",5723,85919,1100,47,0,0,0,4525,19.2,0.8,0,0,0,79.1,80.8,1275,960,315,75.29,24.71,366,594,114,201,480,795,38.1,36.2,37.6,"75% or more P.O.C.","$70000 - $95000"
"06065040404","Census Tract 404.04, Riverside County, California",2972,81941,692,69,0,293,34,1759,23.3,2.3,0,9.9,1.1,59.2,76.7,815,645,170,79.14,20.86,129,516,18,152,147,668,20,10.6,18,"75% or more P.O.C.","$70000 - $95000"
"06065040405","Census Tract 404.05, Riverside County, California",6404,94900,2345,325,0,289,0,3369,36.6,5.1,0,4.5,0,52.6,63.4,1540,1288,252,83.64,16.36,351,937,25,227,376,1164,27.3,9.9,24.4,"50% - 75% P.O.C.","$70000 - $95000"
"06065040501","Census Tract 405.01, Riverside County, California",7327,68073,1303,32,0,119,0,5778,17.8,0.4,0,1.6,0,78.9,82.2,1699,1275,424,75.04,24.96,450,825,148,276,598,1101,35.3,34.9,35.2,"75% or more P.O.C.","$51000 - $70000"
"06065040502","Census Tract 405.02, Riverside County, California",6650,54968,979,398,5,124,0,5077,14.7,6,0.1,1.9,0,76.3,85.3,1609,746,863,46.36,53.64,308,438,176,687,484,1125,41.3,20.4,30.1,"75% or more P.O.C.","$51000 - $70000"
"06065040503","Census Tract 405.03, Riverside County, California",4155,41904,1052,390,0,99,0,2597,25.3,9.4,0,2.4,0,62.5,74.7,1661,490,1171,29.5,70.5,171,319,36,1135,207,1454,34.9,3.1,12.5,"50% - 75% P.O.C.","Less than $51000"
"06065040603","Census Tract 406.03, Riverside County, California",3346,79130,389,0,0,365,0,2592,11.6,0,0,10.9,0,77.5,88.4,674,503,171,74.63,25.37,181,322,105,66,286,388,36,61.4,42.4,"75% or more P.O.C.","$70000 - $95000"
"06065040604","Census Tract 406.04, Riverside County, California",5363,92569,2040,1,28,67,0,3050,38,0,0.5,1.2,0,56.9,62,1265,1090,175,86.17,13.83,241,849,44,131,285,980,22.1,25.1,22.5,"50% - 75% P.O.C.","$70000 - $95000"
"06065040605","Census Tract 406.05, Riverside County, California",3208,60764,335,0,0,10,16,2841,10.4,0,0,0.3,0.5,88.6,89.6,717,406,311,56.62,43.38,148,258,161,150,309,408,36.5,51.8,43.1,"75% or more P.O.C.","$51000 - $70000"
"06065040606","Census Tract 406.06, Riverside County, California",3746,67375,390,0,0,54,12,3259,10.4,0,0,1.4,0.3,87,89.6,750,428,322,57.07,42.93,171,257,175,147,346,404,40,54.3,46.1,"75% or more P.O.C.","$51000 - $70000"
"06065040607","Census Tract 406.07, Riverside County, California",12853,103421,2802,643,0,2370,36,6446,21.8,5,0,18.4,0.3,50.2,78.2,3312,2471,841,74.61,25.39,638,1833,167,674,805,2507,25.8,19.9,24.3,"75% or more P.O.C.","$95000 or more"
"06065040609","Census Tract 406.09, Riverside County, California",14774,111744,3414,979,0,5050,0,4468,23.1,6.6,0,34.2,0,30.2,76.9,3586,2994,592,83.49,16.51,732,2262,267,325,999,2587,24.4,45.1,27.9,"75% or more P.O.C.","$95000 or more"
"06065040611","Census Tract 406.11, Riverside County, California",8054,136281,2008,624,20,1614,0,3403,24.9,7.7,0.2,20,0,42.3,75.1,1805,1456,349,80.66,19.34,411,1045,204,145,615,1190,28.2,58.5,34.1,"75% or more P.O.C.","$95000 or more"
"06065040613","Census Tract 406.13, Riverside County, California",11946,131875,2478,783,0,3164,0,4941,20.7,6.6,0,26.5,0,41.4,79.3,2798,2108,690,75.34,24.66,580,1528,343,347,923,1875,27.5,49.7,33,"75% or more P.O.C.","$95000 or more"
"06065040615","Census Tract 406.15, Riverside County, California",10810,138651,2626,951,0,2194,26,4074,24.3,8.8,0,20.3,0.2,37.7,75.7,2349,1761,588,74.97,25.03,484,1277,378,210,862,1487,27.5,64.3,36.7,"75% or more P.O.C.","$95000 or more"
"06065040616","Census Tract 406.16, Riverside County, California",8333,124091,1421,1017,0,2618,22,3009,17.1,12.2,0,31.4,0.3,36.1,82.9,2024,1661,363,82.07,17.93,372,1289,142,221,514,1510,22.4,39.1,25.4,"75% or more P.O.C.","$95000 or more"
"06065040701","Census Tract 407.01, Riverside County, California",2417,115948,1543,107,0,99,0,638,63.8,4.4,0,4.1,0,26.4,36.2,706,655,51,92.78,7.22,118,537,8,43,126,580,18,15.7,17.8,"25% - 50% P.O.C.","$95000 or more"
"06065040702","Census Tract 407.02, Riverside County, California",2614,94922,1622,12,0,29,0,894,62.1,0.5,0,1.1,0,34.2,37.9,865,751,114,86.82,13.18,83,668,28,86,111,754,11.1,24.6,12.8,"25% - 50% P.O.C.","$70000 - $95000"
"06065040703","Census Tract 407.03, Riverside County, California",2643,74329,1615,6,0,71,0,883,61.1,0.2,0,2.7,0,33.4,38.9,928,731,197,78.77,21.23,99,632,10,187,109,819,13.5,5.1,11.7,"25% - 50% P.O.C.","$70000 - $95000"
"06065040806","Census Tract 408.06, Riverside County, California",3202,105523,1735,16,16,154,0,1241,54.2,0.5,0.5,4.8,0,38.8,45.8,874,760,114,86.96,13.04,120,640,39,75,159,715,15.8,34.2,18.2,"25% - 50% P.O.C.","$95000 or more"
"06065040807","Census Tract 408.07, Riverside County, California",3543,104732,1281,130,0,140,23,1816,36.2,3.7,0,4,0.6,51.3,63.8,1023,901,122,88.07,11.93,154,747,60,62,214,809,17.1,49.2,20.9,"50% - 75% P.O.C.","$95000 or more"
"06065040808","Census Tract 408.08, Riverside County, California",8774,54578,1762,639,0,608,13,5405,20.1,7.3,0,6.9,0.1,61.6,79.9,2199,1060,1139,48.2,51.8,317,743,298,841,615,1584,29.9,26.2,28,"75% or more P.O.C.","$51000 - $70000"
"06065040809","Census Tract 408.09, Riverside County, California",4262,74704,1051,274,0,620,0,2286,24.7,6.4,0,14.5,0,53.6,75.3,1141,788,353,69.06,30.94,171,617,194,159,365,776,21.7,55,32,"75% or more P.O.C.","$70000 - $95000"
"06065040812","Census Tract 408.12, Riverside County, California",4059,90530,2294,0,0,14,0,1678,56.5,0,0,0.3,0,41.3,43.5,1086,790,296,72.74,27.26,194,596,66,230,260,826,24.6,22.3,23.9,"25% - 50% P.O.C.","$70000 - $95000"
"06065040813","Census Tract 408.13, Riverside County, California",6377,107616,3529,149,0,794,0,1822,55.3,2.3,0,12.5,0,28.6,44.7,1874,1639,235,87.46,12.54,305,1334,60,175,365,1509,18.6,25.5,19.5,"25% - 50% P.O.C.","$95000 or more"
"06065040814","Census Tract 408.14, Riverside County, California",5152,62639,1615,386,31,659,26,2218,31.3,7.5,0.6,12.8,0.5,43.1,68.7,1625,578,1047,35.57,64.43,49,529,204,843,253,1372,8.5,19.5,15.6,"50% - 75% P.O.C.","$51000 - $70000"
"06065040815","Census Tract 408.15, Riverside County, California",3960,84291,930,522,0,973,0,1413,23.5,13.2,0,24.6,0,35.7,76.5,1269,672,597,52.96,47.04,135,537,13,584,148,1121,20.1,2.2,11.7,"75% or more P.O.C.","$70000 - $95000"
"06065040816","Census Tract 408.16, Riverside County, California",2446,93250,804,282,2,370,0,866,32.9,11.5,0.1,15.1,0,35.4,67.1,853,558,295,65.42,34.58,98,460,12,283,110,743,17.6,4.1,12.9,"50% - 75% P.O.C.","$70000 - $95000"
"06065040821","Census Tract 408.21, Riverside County, California",5973,74037,2068,574,43,906,38,2135,34.6,9.6,0.7,15.2,0.6,35.7,65.4,2019,694,1325,34.37,65.63,81,613,159,1166,240,1779,11.7,12,11.9,"50% - 75% P.O.C.","$70000 - $95000"
"06065040901","Census Tract 409.01, Riverside County, California",8029,77253,1753,583,36,1317,0,4062,21.8,7.3,0.4,16.4,0,50.6,78.2,2249,910,1339,40.46,59.54,209,701,197,1142,406,1843,23,14.7,18.1,"75% or more P.O.C.","$70000 - $95000"
"06065040902","Census Tract 409.02, Riverside County, California",6486,88750,2069,91,7,634,58,3287,31.9,1.4,0.1,9.8,0.9,50.7,68.1,1612,1241,371,76.99,23.01,210,1031,120,251,330,1282,16.9,32.3,20.5,"50% - 75% P.O.C.","$70000 - $95000"
"06065040903","Census Tract 409.03, Riverside County, California",2889,68594,732,132,0,115,0,1762,25.3,4.6,0,4,0,61,74.7,739,474,265,64.14,35.86,62,412,92,173,154,585,13.1,34.7,20.8,"50% - 75% P.O.C.","$51000 - $70000"
"06065040904","Census Tract 409.04, Riverside County, California",4365,84042,1165,129,5,177,29,2837,26.7,3,0.1,4.1,0.7,65,73.3,977,645,332,66.02,33.98,184,461,146,186,330,647,28.5,44,33.8,"50% - 75% P.O.C.","$70000 - $95000"
"06065041001","Census Tract 410.01, Riverside County, California",2750,41875,586,292,36,27,0,1809,21.3,10.6,1.3,1,0,65.8,78.7,721,278,443,38.56,61.44,80,198,101,342,181,540,28.8,22.8,25.1,"75% or more P.O.C.","Less than $51000"
"06065041002","Census Tract 410.02, Riverside County, California",3551,74485,366,159,0,61,0,2932,10.3,4.5,0,1.7,0,82.6,89.7,813,631,182,77.61,22.39,233,398,67,115,300,513,36.9,36.8,36.9,"75% or more P.O.C.","$70000 - $95000"
"06065041003","Census Tract 410.03, Riverside County, California",2814,82500,660,117,0,136,0,1865,23.5,4.2,0,4.8,0,66.3,76.5,686,475,211,69.24,30.76,181,294,46,165,227,459,38.1,21.8,33.1,"75% or more P.O.C.","$70000 - $95000"
"06065041004","Census Tract 410.04, Riverside County, California",4798,66520,898,238,0,275,0,3213,18.7,5,0,5.7,0,67,81.3,1357,664,693,48.93,51.07,128,536,69,624,197,1160,19.3,10,14.5,"75% or more P.O.C.","$51000 - $70000"
"06065041101","Census Tract 411.01, Riverside County, California",6247,33709,481,58,0,0,0,5684,7.7,0.9,0,0,0,91,92.3,1223,243,980,19.87,80.13,148,95,369,611,517,706,60.9,37.7,42.3,"75% or more P.O.C.","Less than $51000"
"06065041102","Census Tract 411.02, Riverside County, California",4689,61176,821,90,7,202,0,3488,17.5,1.9,0.1,4.3,0,74.4,82.5,994,613,381,61.67,38.33,144,469,190,191,334,660,23.5,49.9,33.6,"75% or more P.O.C.","$51000 - $70000"
"06065041201","Census Tract 412.01, Riverside County, California",4370,57500,812,233,4,344,0,2977,18.6,5.3,0.1,7.9,0,68.1,81.4,1186,643,543,54.22,45.78,227,416,61,482,288,898,35.3,11.2,24.3,"75% or more P.O.C.","$51000 - $70000"
"06065041202","Census Tract 412.02, Riverside County, California",4683,62518,633,40,29,115,0,3849,13.5,0.9,0.6,2.5,0,82.2,86.5,995,761,234,76.48,23.52,228,533,143,91,371,624,30,61.1,37.3,"75% or more P.O.C.","$51000 - $70000"
"06065041203","Census Tract 412.03, Riverside County, California",3499,64231,340,104,0,197,0,2816,9.7,3,0,5.6,0,80.5,90.3,908,438,470,48.24,51.76,175,263,78,392,253,655,40,16.6,27.9,"75% or more P.O.C.","$51000 - $70000"
"06065041301","Census Tract 413.01, Riverside County, California",3902,64063,367,70,0,183,2,3244,9.4,1.8,0,4.7,0.1,83.1,90.6,799,460,339,57.57,42.43,190,270,125,214,315,484,41.3,36.9,39.4,"75% or more P.O.C.","$51000 - $70000"
"06065041302","Census Tract 413.02, Riverside County, California",4786,58144,385,105,14,176,13,4077,8,2.2,0.3,3.7,0.3,85.2,92,1023,520,503,50.83,49.17,196,324,217,286,413,610,37.7,43.1,40.4,"75% or more P.O.C.","$51000 - $70000"
"06065041403","Census Tract 414.03, Riverside County, California",4106,77500,1255,235,9,647,0,1828,30.6,5.7,0.2,15.8,0,44.5,69.4,1340,871,469,65,35,188,683,11,458,199,1141,21.6,2.3,14.9,"50% - 75% P.O.C.","$70000 - $95000"
"06065041404","Census Tract 414.04, Riverside County, California",3927,84286,986,250,3,288,15,2195,25.1,6.4,0.1,7.3,0.4,55.9,74.9,926,816,110,88.12,11.88,176,640,16,94,192,734,21.6,14.5,20.7,"50% - 75% P.O.C.","$70000 - $95000"
"06065041405","Census Tract 414.05, Riverside County, California",4478,71928,1186,311,77,293,23,2514,26.5,6.9,1.7,6.5,0.5,56.1,73.5,1287,831,456,64.57,35.43,107,724,89,367,196,1091,12.9,19.5,15.2,"50% - 75% P.O.C.","$70000 - $95000"
"06065041406","Census Tract 414.06, Riverside County, California",5974,68214,1592,499,0,562,53,3079,26.6,8.4,0,9.4,0.9,51.5,73.4,1816,620,1196,34.14,65.86,187,433,109,1087,296,1520,30.2,9.1,16.3,"50% - 75% P.O.C.","$51000 - $70000"
"06065041407","Census Tract 414.07, Riverside County, California",5873,58750,1166,371,0,297,66,3883,19.9,6.3,0,5.1,1.1,66.1,80.1,1702,634,1068,37.25,62.75,77,557,246,822,323,1379,12.1,23,19,"75% or more P.O.C.","$51000 - $70000"
"06065041408","Census Tract 414.08, Riverside County, California",4581,55993,1003,279,0,197,0,2843,21.9,6.1,0,4.3,0,62.1,78.1,1319,324,995,24.56,75.44,83,241,119,876,202,1117,25.6,12,15.3,"75% or more P.O.C.","$51000 - $70000"
"06065041409","Census Tract 414.09, Riverside County, California",16512,117292,6875,1076,93,2665,10,5498,41.6,6.5,0.6,16.1,0.1,33.3,58.4,4728,4135,593,87.46,12.54,620,3515,124,469,744,3984,15,20.9,15.7,"50% - 75% P.O.C.","$95000 or more"
"06065041410","Census Tract 414.10, Riverside County, California",2949,37548,70,9,41,8,0,2821,2.4,0.3,1.4,0.3,0,95.7,97.6,675,312,363,46.22,53.78,91,221,171,192,262,413,29.2,47.1,38.8,"75% or more P.O.C.","Less than $51000"
"06065041411","Census Tract 414.11, Riverside County, California",2697,48819,536,58,0,72,0,2006,19.9,2.2,0,2.7,0,74.4,80.1,804,701,103,87.19,12.81,111,590,49,54,160,644,15.8,47.6,19.9,"75% or more P.O.C.","Less than $51000"
"06065041412","Census Tract 414.12, Riverside County, California",5542,64054,1385,327,19,536,0,3267,25,5.9,0.3,9.7,0,58.9,75,1469,1158,311,78.83,21.17,306,852,97,214,403,1066,26.4,31.2,27.4,"75% or more P.O.C.","$51000 - $70000"
"06065041500","Census Tract 415, Riverside County, California",3263,60735,664,180,58,161,30,2153,20.3,5.5,1.8,4.9,0.9,66,79.7,1094,181,913,16.54,83.46,44,137,98,815,142,952,24.3,10.7,13,"75% or more P.O.C.","$51000 - $70000"
"06065041600","Census Tract 416, Riverside County, California",6511,45776,487,108,0,141,27,5652,7.5,1.7,0,2.2,0.4,86.8,92.5,1818,436,1382,23.98,76.02,106,330,299,1083,405,1413,24.3,21.6,22.3,"75% or more P.O.C.","Less than $51000"
"06065041702","Census Tract 417.02, Riverside County, California",5185,79283,1629,113,0,95,0,3304,31.4,2.2,0,1.8,0,63.7,68.6,1369,1018,351,74.36,25.64,234,784,48,303,282,1087,23,13.7,20.6,"50% - 75% P.O.C.","$70000 - $95000"
"06065041703","Census Tract 417.03, Riverside County, California",6378,39294,998,275,23,56,0,4962,15.6,4.3,0.4,0.9,0,77.8,84.4,1770,405,1365,22.88,77.12,126,279,282,1083,408,1362,31.1,20.7,23.1,"75% or more P.O.C.","Less than $51000"
"06065041704","Census Tract 417.04, Riverside County, California",3815,46417,317,42,0,128,0,3300,8.3,1.1,0,3.4,0,86.5,91.7,979,357,622,36.47,63.53,48,309,200,422,248,731,13.4,32.2,25.3,"75% or more P.O.C.","Less than $51000"
"06065041803","Census Tract 418.03, Riverside County, California",7092,113152,3177,308,0,1237,11,2011,44.8,4.3,0,17.4,0.2,28.4,55.2,1968,1679,289,85.32,14.68,261,1418,97,192,358,1610,15.5,33.6,18.2,"50% - 75% P.O.C.","$95000 or more"
"06065041804","Census Tract 418.04, Riverside County, California",4826,121535,2365,164,0,520,44,1683,49,3.4,0,10.8,0.9,34.9,51,1318,1194,124,90.59,9.41,245,949,21,103,266,1052,20.5,16.9,20.2,"50% - 75% P.O.C.","$95000 or more"
"06065041805","Census Tract 418.05, Riverside County, California",6205,81927,1826,262,0,529,10,3301,29.4,4.2,0,8.5,0.2,53.2,70.6,2012,1046,966,51.99,48.01,153,893,100,866,253,1759,14.6,10.4,12.6,"50% - 75% P.O.C.","$70000 - $95000"
"06065041806","Census Tract 418.06, Riverside County, California",4858,138424,1760,519,0,640,177,1625,36.2,10.7,0,13.2,3.6,33.4,63.8,1221,1150,71,94.19,5.81,250,900,27,44,277,944,21.7,38,22.7,"50% - 75% P.O.C.","$95000 or more"
"06065041807","Census Tract 418.07, Riverside County, California",2329,108188,1005,52,0,85,0,1121,43.2,2.2,0,3.6,0,48.1,56.8,669,620,49,92.68,7.32,94,526,9,40,103,566,15.2,18.4,15.4,"50% - 75% P.O.C.","$95000 or more"
"06065041808","Census Tract 418.08, Riverside County, California",6728,117852,3107,295,0,1089,0,2100,46.2,4.4,0,16.2,0,31.2,53.8,2078,1602,476,77.09,22.91,337,1265,25,451,362,1716,21,5.3,17.4,"50% - 75% P.O.C.","$95000 or more"
"06065041809","Census Tract 418.09, Riverside County, California",5815,67880,2938,448,0,232,39,2048,50.5,7.7,0,4,0.7,35.2,49.5,2141,1241,900,57.96,42.04,68,1173,39,861,107,2034,5.5,4.3,5,"25% - 50% P.O.C.","$51000 - $70000"
"06065041810","Census Tract 418.10, Riverside County, California",6192,137604,2911,395,0,697,31,1944,47,6.4,0,11.3,0.5,31.4,53,1667,1505,162,90.28,9.72,268,1237,105,57,373,1294,17.8,64.8,22.4,"50% - 75% P.O.C.","$95000 or more"
"06065041812","Census Tract 418.12, Riverside County, California",3336,91667,1435,139,9,270,0,1468,43,4.2,0.3,8.1,0,44,57,1044,918,126,87.93,12.07,139,779,45,81,184,860,15.1,35.7,17.6,"50% - 75% P.O.C.","$70000 - $95000"
"06065041813","Census Tract 418.13, Riverside County, California",7165,46018,2032,214,5,306,0,4562,28.4,3,0.1,4.3,0,63.7,71.6,2051,1141,910,55.63,44.37,239,902,134,776,373,1678,20.9,14.7,18.2,"50% - 75% P.O.C.","Less than $51000"
"06065041904","Census Tract 419.04, Riverside County, California",5391,107880,2208,69,0,467,19,2620,41,1.3,0,8.7,0.4,48.6,59,1352,1206,146,89.2,10.8,304,902,23,123,327,1025,25.2,15.8,24.2,"50% - 75% P.O.C.","$95000 or more"
"06065041905","Census Tract 419.05, Riverside County, California",3391,63977,941,208,32,94,15,1971,27.7,6.1,0.9,2.8,0.4,58.1,72.3,983,379,604,38.56,61.44,66,313,108,496,174,809,17.4,17.9,17.7,"50% - 75% P.O.C.","$51000 - $70000"
"06065041906","Census Tract 419.06, Riverside County, California",6583,57652,1679,169,0,251,0,4317,25.5,2.6,0,3.8,0,65.6,74.5,1985,1240,745,62.47,37.53,276,964,85,660,361,1624,22.3,11.4,18.2,"50% - 75% P.O.C.","$51000 - $70000"
"06065041909","Census Tract 419.09, Riverside County, California",5622,88594,1926,54,0,344,0,3146,34.3,1,0,6.1,0,56,65.7,1505,1155,350,76.74,23.26,214,941,38,312,252,1253,18.5,10.9,16.7,"50% - 75% P.O.C.","$70000 - $95000"
"06065041910","Census Tract 419.10, Riverside County, California",7685,94599,3221,679,31,614,0,2890,41.9,8.8,0.4,8,0,37.6,58.1,2637,1872,765,70.99,29.01,206,1666,87,678,293,2344,11,11.4,11.1,"50% - 75% P.O.C.","$70000 - $95000"
"06065041911","Census Tract 419.11, Riverside County, California",13750,119211,5619,1293,0,2108,0,4117,40.9,9.4,0,15.3,0,29.9,59.1,3915,3325,590,84.93,15.07,714,2611,120,470,834,3081,21.5,20.3,21.3,"50% - 75% P.O.C.","$95000 or more"
"06065041912","Census Tract 419.12, Riverside County, California",6797,102903,2994,112,24,1590,22,1741,44,1.6,0.4,23.4,0.3,25.6,56,2058,1542,516,74.93,25.07,265,1277,47,469,312,1746,17.2,9.1,15.2,"50% - 75% P.O.C.","$95000 or more"
"06065041913","Census Tract 419.13, Riverside County, California",5414,80406,2550,159,24,693,58,1771,47.1,2.9,0.4,12.8,1.1,32.7,52.9,2020,1335,685,66.09,33.91,128,1207,64,621,192,1828,9.6,9.3,9.5,"50% - 75% P.O.C.","$70000 - $95000"
"06065042003","Census Tract 420.03, Riverside County, California",6776,103690,3042,426,13,656,6,2443,44.9,6.3,0.2,9.7,0.1,36.1,55.1,1738,1622,116,93.33,6.67,373,1249,36,80,409,1329,23,31,23.5,"50% - 75% P.O.C.","$95000 or more"
"06065042004","Census Tract 420.04, Riverside County, California",3722,107321,2045,197,0,39,27,1349,54.9,5.3,0,1,0.7,36.2,45.1,1035,935,100,90.34,9.66,145,790,10,90,155,880,15.5,10,15,"25% - 50% P.O.C.","$95000 or more"
"06065042005","Census Tract 420.05, Riverside County, California",5821,125417,2486,357,0,841,0,1907,42.7,6.1,0,14.4,0,32.8,57.3,1558,1324,234,84.98,15.02,255,1069,48,186,303,1255,19.3,20.5,19.4,"50% - 75% P.O.C.","$95000 or more"
"06065042007","Census Tract 420.07, Riverside County, California",5058,89839,3123,386,27,158,0,1163,61.7,7.6,0.5,3.1,0,23,38.3,1612,1243,369,77.11,22.89,123,1120,47,322,170,1442,9.9,12.7,10.5,"25% - 50% P.O.C.","$70000 - $95000"
"06065042008","Census Tract 420.08, Riverside County, California",8902,110605,3797,471,37,505,0,3894,42.7,5.3,0.4,5.7,0,43.7,57.3,2349,2232,117,95.02,4.98,532,1700,47,70,579,1770,23.8,40.2,24.6,"50% - 75% P.O.C.","$95000 or more"
"06065042009","Census Tract 420.09, Riverside County, California",8126,76488,1879,582,33,466,0,4981,23.1,7.2,0.4,5.7,0,61.3,76.9,1811,1433,378,79.13,20.87,332,1101,165,213,497,1314,23.2,43.7,27.4,"75% or more P.O.C.","$70000 - $95000"
"06065042010","Census Tract 420.10, Riverside County, California",6179,48242,543,705,0,0,0,4888,8.8,11.4,0,0,0,79.1,91.2,1357,883,474,65.07,34.93,307,576,166,308,473,884,34.8,35,34.9,"75% or more P.O.C.","Less than $51000"
"06065042012","Census Tract 420.12, Riverside County, California",6956,90028,2780,730,5,538,0,2556,40,10.5,0.1,7.7,0,36.7,60,1875,1019,856,54.35,45.65,144,875,171,685,315,1560,14.1,20,16.8,"50% - 75% P.O.C.","$70000 - $95000"
"06065042013","Census Tract 420.13, Riverside County, California",7811,121132,4060,474,0,1385,45,1309,52,6.1,0,17.7,0.6,16.8,48,2219,2006,213,90.4,9.6,310,1696,46,167,356,1863,15.5,21.6,16,"25% - 50% P.O.C.","$95000 or more"
"06065042014","Census Tract 420.14, Riverside County, California",11624,133237,4687,1279,0,1081,108,4119,40.3,11,0,9.3,0.9,35.4,59.7,2815,2242,573,79.64,20.36,538,1704,236,337,774,2041,24,41.2,27.5,"50% - 75% P.O.C.","$95000 or more"
"06065042206","Census Tract 422.06, Riverside County, California",5820,57366,2771,514,90,374,48,1816,47.6,8.8,1.5,6.4,0.8,31.2,52.4,2554,763,1791,29.87,70.13,31,732,154,1637,185,2369,4.1,8.6,7.2,"50% - 75% P.O.C.","$51000 - $70000"
"06065042207","Census Tract 422.07, Riverside County, California",2889,129779,1657,141,5,210,0,698,57.4,4.9,0.2,7.3,0,24.2,42.6,1133,876,257,77.32,22.68,75,801,15,242,90,1043,8.6,5.8,7.9,"25% - 50% P.O.C.","$95000 or more"
"06065042208","Census Tract 422.08, Riverside County, California",2635,130625,1529,38,0,187,1,708,58,1.4,0,7.1,0,26.9,42,869,796,73,91.6,8.4,120,676,21,52,141,728,15.1,28.8,16.2,"25% - 50% P.O.C.","$95000 or more"
"06065042209","Census Tract 422.09, Riverside County, California",5439,34457,1043,558,152,978,0,2573,19.2,10.3,2.8,18,0,47.3,80.8,1370,289,1081,21.09,78.91,43,246,211,870,254,1116,14.9,19.5,18.5,"75% or more P.O.C.","Less than $51000"
"06065042210","Census Tract 422.10, Riverside County, California",4856,35929,1304,353,58,696,0,2207,26.9,7.3,1.2,14.3,0,45.4,73.1,1674,69,1605,4.12,95.88,0,69,78,1527,78,1596,0,4.9,4.7,"50% - 75% P.O.C.","Less than $51000"
"06065042212","Census Tract 422.12, Riverside County, California",6511,77115,1637,1039,0,629,0,3035,25.1,16,0,9.7,0,46.6,74.9,1868,1277,591,68.36,31.64,245,1032,117,474,362,1506,19.2,19.8,19.4,"50% - 75% P.O.C.","$70000 - $95000"
"06065042213","Census Tract 422.13, Riverside County, California",4271,66429,1911,86,15,936,0,1151,44.7,2,0.4,21.9,0,26.9,55.3,1454,744,710,51.17,48.83,46,698,90,620,136,1318,6.2,12.7,9.4,"50% - 75% P.O.C.","$51000 - $70000"
"06065042214","Census Tract 422.14, Riverside County, California",6933,92576,2120,888,0,622,0,3172,30.6,12.8,0,9,0,45.8,69.4,1778,1331,447,74.86,25.14,243,1088,145,302,388,1390,18.3,32.4,21.8,"50% - 75% P.O.C.","$70000 - $95000"
"06065042217","Census Tract 422.17, Riverside County, California",5377,99762,3046,529,0,106,0,1255,56.6,9.8,0,2,0,23.3,43.4,1956,1339,617,68.46,31.54,113,1226,0,617,113,1843,8.4,0,5.8,"25% - 50% P.O.C.","$95000 or more"
"06065042300","Census Tract 423, Riverside County, California",8827,57475,2175,276,43,726,48,5472,24.6,3.1,0.5,8.2,0.5,62,75.4,2351,1366,985,58.1,41.9,333,1033,101,884,434,1917,24.4,10.3,18.5,"75% or more P.O.C.","$51000 - $70000"
"06065042401","Census Tract 424.01, Riverside County, California",2090,116513,1033,71,13,32,0,893,49.4,3.4,0.6,1.5,0,42.7,50.6,551,452,99,82.03,17.97,87,365,17,82,104,447,19.2,17.2,18.9,"50% - 75% P.O.C.","$95000 or more"
"06065042402","Census Tract 424.02, Riverside County, California",4944,71250,1010,736,22,343,0,2768,20.4,14.9,0.4,6.9,0,56,79.6,1236,1001,235,80.99,19.01,213,788,112,123,325,911,21.3,47.7,26.3,"75% or more P.O.C.","$70000 - $95000"
"06065042403","Census Tract 424.03, Riverside County, California",4122,97350,902,520,0,144,0,2504,21.9,12.6,0,3.5,0,60.7,78.1,969,797,172,82.25,17.75,252,545,74,98,326,643,31.6,43,33.6,"75% or more P.O.C.","$95000 or more"
"06065042404","Census Tract 424.04, Riverside County, California",2214,60022,419,144,0,16,5,1544,18.9,6.5,0,0.7,0.2,69.7,81.1,569,260,309,45.69,54.31,57,203,104,205,161,408,21.9,33.7,28.3,"75% or more P.O.C.","$51000 - $70000"
"06065042405","Census Tract 424.05, Riverside County, California",5324,42878,497,1459,125,108,0,3113,9.3,27.4,2.3,2,0,58.5,90.7,1593,180,1413,11.3,88.7,71,109,230,1183,301,1292,39.4,16.3,18.9,"75% or more P.O.C.","Less than $51000"
"06065042406","Census Tract 424.06, Riverside County, California",4675,65833,778,573,7,363,0,2853,16.6,12.3,0.1,7.8,0,61,83.4,1208,819,389,67.8,32.2,140,679,118,271,258,950,17.1,30.3,21.4,"75% or more P.O.C.","$51000 - $70000"
"06065042407","Census Tract 424.07, Riverside County, California",3411,73056,1013,124,0,88,0,2123,29.7,3.6,0,2.6,0,62.2,70.3,806,612,194,75.93,24.07,153,459,48,146,201,605,25,24.7,24.9,"50% - 75% P.O.C.","$70000 - $95000"
"06065042408","Census Tract 424.08, Riverside County, California",3437,79766,843,334,0,336,93,1814,24.5,9.7,0,9.8,2.7,52.8,75.5,839,646,193,77,23,206,440,76,117,282,557,31.9,39.4,33.6,"75% or more P.O.C.","$70000 - $95000"
"06065042409","Census Tract 424.09, Riverside County, California",3467,72619,880,547,0,119,0,1896,25.4,15.8,0,3.4,0,54.7,74.6,926,606,320,65.44,34.56,84,522,116,204,200,726,13.9,36.2,21.6,"50% - 75% P.O.C.","$70000 - $95000"
"06065042410","Census Tract 424.10, Riverside County, California",5627,85000,1173,1002,18,557,0,2686,20.8,17.8,0.3,9.9,0,47.7,79.2,1398,1042,356,74.54,25.46,283,759,148,208,431,967,27.2,41.6,30.8,"75% or more P.O.C.","$70000 - $95000"
"06065042411","Census Tract 424.11, Riverside County, California",2327,78500,617,419,0,79,0,1145,26.5,18,0,3.4,0,49.2,73.5,702,527,175,75.07,24.93,97,430,17,158,114,588,18.4,9.7,16.2,"50% - 75% P.O.C.","$70000 - $95000"
"06065042412","Census Tract 424.12, Riverside County, California",4965,91944,1917,701,0,74,0,2069,38.6,14.1,0,1.5,0,41.7,61.4,1370,1216,154,88.76,11.24,195,1021,40,114,235,1135,16,26,17.2,"50% - 75% P.O.C.","$70000 - $95000"
"06065042505","Census Tract 425.05, Riverside County, California",3542,35893,215,367,0,26,7,2922,6.1,10.4,0,0.7,0.2,82.5,93.9,804,294,510,36.57,63.43,127,167,160,350,287,517,43.2,31.4,35.7,"75% or more P.O.C.","Less than $51000"
"06065042506","Census Tract 425.06, Riverside County, California",9138,58301,1291,2369,12,920,24,4276,14.1,25.9,0.1,10.1,0.3,46.8,85.9,2519,893,1626,35.45,64.55,240,653,191,1435,431,2088,26.9,11.7,17.1,"75% or more P.O.C.","$51000 - $70000"
"06065042507","Census Tract 425.07, Riverside County, California",4797,77713,348,638,41,423,4,3313,7.3,13.3,0.9,8.8,0.1,69.1,92.7,1067,788,279,73.85,26.15,222,566,94,185,316,751,28.2,33.7,29.6,"75% or more P.O.C.","$70000 - $95000"
"06065042508","Census Tract 425.08, Riverside County, California",5486,53385,320,515,0,151,0,4482,5.8,9.4,0,2.8,0,81.7,94.2,1235,787,448,63.72,36.28,333,454,105,343,438,797,42.3,23.4,35.5,"75% or more P.O.C.","$51000 - $70000"
"06065042509","Census Tract 425.09, Riverside County, California",3325,49219,476,263,6,63,0,2484,14.3,7.9,0.2,1.9,0,74.7,85.7,806,546,260,67.74,32.26,154,392,101,159,255,551,28.2,38.8,31.6,"75% or more P.O.C.","Less than $51000"
"06065042510","Census Tract 425.10, Riverside County, California",5473,56713,386,688,3,313,81,3885,7.1,12.6,0.1,5.7,1.5,71,92.9,1149,800,349,69.63,30.37,268,532,182,167,450,699,33.5,52.1,39.2,"75% or more P.O.C.","$51000 - $70000"
"06065042511","Census Tract 425.11, Riverside County, California",3357,46173,364,398,0,55,0,2467,10.8,11.9,0,1.6,0,73.5,89.2,790,396,394,50.13,49.87,127,269,164,230,291,499,32.1,41.6,36.8,"75% or more P.O.C.","Less than $51000"
"06065042512","Census Tract 425.12, Riverside County, California",3378,51875,199,546,0,128,11,2466,5.9,16.2,0,3.8,0.3,73,94.1,858,313,545,36.48,63.52,96,217,131,414,227,631,30.7,24,26.5,"75% or more P.O.C.","$51000 - $70000"
"06065042513","Census Tract 425.13, Riverside County, California",2973,62875,501,127,0,68,26,2209,16.9,4.3,0,2.3,0.9,74.3,83.1,777,615,162,79.15,20.85,125,490,32,130,157,620,20.3,19.8,20.2,"75% or more P.O.C.","$51000 - $70000"
"06065042514","Census Tract 425.14, Riverside County, California",3467,47254,584,624,1,369,2,1861,16.8,18,0,10.6,0.1,53.7,83.2,845,327,518,38.7,61.3,90,237,165,353,255,590,27.5,31.9,30.2,"75% or more P.O.C.","Less than $51000"
"06065042515","Census Tract 425.15, Riverside County, California",3795,31956,372,868,0,101,15,2439,9.8,22.9,0,2.7,0.4,64.3,90.2,977,206,771,21.08,78.92,13,193,203,568,216,761,6.3,26.3,22.1,"75% or more P.O.C.","Less than $51000"
"06065042516","Census Tract 425.16, Riverside County, California",4378,47058,317,745,0,204,0,3009,7.2,17,0,4.7,0,68.7,92.8,1043,394,649,37.78,62.22,65,329,327,322,392,651,16.5,50.4,37.6,"75% or more P.O.C.","Less than $51000"
"06065042517","Census Tract 425.17, Riverside County, California",3335,56130,454,368,0,93,0,2344,13.6,11,0,2.8,0,70.3,86.4,809,591,218,73.05,26.95,190,401,48,170,238,571,32.1,22,29.4,"75% or more P.O.C.","$51000 - $70000"
"06065042518","Census Tract 425.18, Riverside County, California",3497,60655,435,699,9,161,0,2158,12.4,20,0.3,4.6,0,61.7,87.6,875,488,387,55.77,44.23,119,369,120,267,239,636,24.4,31,27.3,"75% or more P.O.C.","$51000 - $70000"
"06065042519","Census Tract 425.19, Riverside County, California",1873,43724,157,447,8,14,0,1241,8.4,23.9,0.4,0.7,0,66.3,91.6,492,118,374,23.98,76.02,57,61,45,329,102,390,48.3,12,20.7,"75% or more P.O.C.","Less than $51000"
"06065042520","Census Tract 425.20, Riverside County, California",4928,44028,417,424,8,179,0,3825,8.5,8.6,0.2,3.6,0,77.6,91.5,1269,474,795,37.35,62.65,245,229,135,660,380,889,51.7,17,29.9,"75% or more P.O.C.","Less than $51000"
"06065042521","Census Tract 425.21, Riverside County, California",5338,51624,614,748,10,90,0,3798,11.5,14,0.2,1.7,0,71.2,88.5,1187,709,478,59.73,40.27,218,491,108,370,326,861,30.7,22.6,27.5,"75% or more P.O.C.","$51000 - $70000"
"06065042617","Census Tract 426.17, Riverside County, California",11457,61298,608,1127,0,376,0,9238,5.3,9.8,0,3.3,0,80.6,94.7,2557,1618,939,63.28,36.72,545,1073,341,598,886,1671,33.7,36.3,34.6,"75% or more P.O.C.","$51000 - $70000"
"06065042618","Census Tract 426.18, Riverside County, California",8788,57135,609,589,4,54,0,7530,6.9,6.7,0,0.6,0,85.7,93.1,1779,1144,635,64.31,35.69,513,631,284,351,797,982,44.8,44.7,44.8,"75% or more P.O.C.","$51000 - $70000"
"06065042619","Census Tract 426.19, Riverside County, California",12354,72662,1759,1604,20,563,18,7935,14.2,13,0.2,4.6,0.1,64.2,85.8,2780,1896,884,68.2,31.8,607,1289,284,600,891,1889,32,32.1,32.1,"75% or more P.O.C.","$70000 - $95000"
"06065042620","Census Tract 426.20, Riverside County, California",14520,75853,1225,1956,0,1155,0,10060,8.4,13.5,0,8,0,69.3,91.6,3253,2585,668,79.47,20.53,804,1781,297,371,1101,2152,31.1,44.5,33.8,"75% or more P.O.C.","$70000 - $95000"
"06065042621","Census Tract 426.21, Riverside County, California",7938,79395,948,1321,0,808,0,4704,11.9,16.6,0,10.2,0,59.3,88.1,1763,1253,510,71.07,28.93,474,779,173,337,647,1116,37.8,33.9,36.7,"75% or more P.O.C.","$70000 - $95000"
"06065042622","Census Tract 426.22, Riverside County, California",4827,73715,479,1309,0,328,0,2370,9.9,27.1,0,6.8,0,49.1,90.1,1331,806,525,60.56,39.44,267,539,45,480,312,1019,33.1,8.6,23.4,"75% or more P.O.C.","$70000 - $95000"
"06065042623","Census Tract 426.23, Riverside County, California",3939,88579,719,1129,0,429,0,1472,18.3,28.7,0,10.9,0,37.4,81.7,1213,867,346,71.48,28.52,70,797,119,227,189,1024,8.1,34.4,15.6,"75% or more P.O.C.","$70000 - $95000"
"06065042624","Census Tract 426.24, Riverside County, California",4390,95926,907,653,0,331,78,2226,20.7,14.9,0,7.5,1.8,50.7,79.3,1022,779,243,76.22,23.78,292,487,140,103,432,590,37.5,57.6,42.3,"75% or more P.O.C.","$95000 or more"
"06065042706","Census Tract 427.06, Riverside County, California",8416,59863,392,1107,0,238,0,6533,4.7,13.2,0,2.8,0,77.6,95.3,1861,1005,856,54,46,342,663,364,492,706,1155,34,42.5,37.9,"75% or more P.O.C.","$51000 - $70000"
"06065042708","Census Tract 427.08, Riverside County, California",5149,69531,2570,107,0,233,105,2063,49.9,2.1,0,4.5,2,40.1,50.1,1452,1077,375,74.17,25.83,186,891,38,337,224,1228,17.3,10.1,15.4,"50% - 75% P.O.C.","$51000 - $70000"
"06065042709","Census Tract 427.09, Riverside County, California",4674,48152,2629,61,169,69,0,1654,56.2,1.3,3.6,1.5,0,35.4,43.8,1915,1487,428,77.65,22.35,209,1278,0,428,209,1706,14.1,0,10.9,"25% - 50% P.O.C.","Less than $51000"
"06065042711","Census Tract 427.11, Riverside County, California",4134,38906,2976,541,23,50,17,394,72,13.1,0.6,1.2,0.4,9.5,28,2423,1576,847,65.04,34.96,15,1561,0,847,15,2408,1,0,0.6,"25% - 50% P.O.C.","Less than $51000"
"06065042714","Census Tract 427.14, Riverside County, California",3519,100597,2808,0,18,354,21,163,79.8,0,0.5,10.1,0.6,4.6,20.2,1372,1092,280,79.59,20.41,93,999,21,259,114,1258,8.5,7.5,8.3,"Less than 25% P.O.C.","$95000 or more"
"06065042715","Census Tract 427.15, Riverside County, California",14869,90888,5687,721,0,1237,12,6674,38.2,4.8,0,8.3,0.1,44.9,61.8,4213,3156,1057,74.91,25.09,803,2353,235,822,1038,3175,25.4,22.2,24.6,"50% - 75% P.O.C.","$70000 - $95000"
"06065042716","Census Tract 427.16, Riverside County, California",5275,95500,3827,0,15,48,0,1274,72.5,0,0.3,0.9,0,24.2,27.5,1864,1432,432,76.82,23.18,118,1314,46,386,164,1700,8.2,10.6,8.8,"25% - 50% P.O.C.","$95000 or more"
"06065042717","Census Tract 427.17, Riverside County, California",5181,57684,2096,0,0,121,0,2814,40.5,0,0,2.3,0,54.3,59.5,1477,1105,372,74.81,25.19,151,954,69,303,220,1257,13.7,18.5,14.9,"50% - 75% P.O.C.","$51000 - $70000"
"06065042719","Census Tract 427.19, Riverside County, California",5470,59500,1404,274,0,7,0,3749,25.7,5,0,0.1,0,68.5,74.3,1474,941,533,63.84,36.16,135,806,201,332,336,1138,14.3,37.7,22.8,"50% - 75% P.O.C.","$51000 - $70000"
"06065042720","Census Tract 427.20, Riverside County, California",5371,54185,1797,25,0,30,206,3169,33.5,0.5,0,0.6,3.8,59,66.5,1419,907,512,63.92,36.08,220,687,64,448,284,1135,24.3,12.5,20,"50% - 75% P.O.C.","$51000 - $70000"
"06065042723","Census Tract 427.23, Riverside County, California",6537,49500,2508,248,51,31,13,3651,38.4,3.8,0.8,0.5,0.2,55.9,61.6,1984,1320,664,66.53,33.47,160,1160,126,538,286,1698,12.1,19,14.4,"50% - 75% P.O.C.","Less than $51000"
"06065042724","Census Tract 427.24, Riverside County, California",4054,100673,1665,272,11,290,0,1678,41.1,6.7,0.3,7.2,0,41.4,58.9,1061,820,241,77.29,22.71,198,622,59,182,257,804,24.1,24.5,24.2,"50% - 75% P.O.C.","$95000 or more"
"06065042726","Census Tract 427.26, Riverside County, California",9300,103000,3173,726,44,618,93,4233,34.1,7.8,0.5,6.6,1,45.5,65.9,2404,2126,278,88.44,11.56,546,1580,77,201,623,1781,25.7,27.7,25.9,"50% - 75% P.O.C.","$95000 or more"
"06065042728","Census Tract 427.28, Riverside County, California",2229,74554,960,46,25,35,4,1096,43.1,2.1,1.1,1.6,0.2,49.2,56.9,629,543,86,86.33,13.67,89,454,27,59,116,513,16.4,31.4,18.4,"50% - 75% P.O.C.","$70000 - $95000"
"06065042729","Census Tract 427.29, Riverside County, California",9987,53373,4765,988,28,785,0,2914,47.7,9.9,0.3,7.9,0,29.2,52.3,3890,2704,1186,69.51,30.49,311,2393,127,1059,438,3452,11.5,10.7,11.3,"50% - 75% P.O.C.","$51000 - $70000"
"06065042730","Census Tract 427.30, Riverside County, California",5684,48401,1208,11,0,44,38,4348,21.3,0.2,0,0.8,0.7,76.5,78.7,1345,937,408,69.67,30.33,266,671,154,254,420,925,28.4,37.7,31.2,"75% or more P.O.C.","Less than $51000"
"06065042731","Census Tract 427.31, Riverside County, California",8161,74458,2321,565,0,215,0,4908,28.4,6.9,0,2.6,0,60.1,71.6,1987,1665,322,83.79,16.21,498,1167,175,147,673,1314,29.9,54.3,33.9,"50% - 75% P.O.C.","$70000 - $95000"
"06065042732","Census Tract 427.32, Riverside County, California",6571,89263,2306,394,9,288,0,3416,35.1,6,0.1,4.4,0,52,64.9,1683,1553,130,92.28,7.72,391,1162,17,113,408,1275,25.2,13.1,24.2,"50% - 75% P.O.C.","$70000 - $95000"
"06065042733","Census Tract 427.33, Riverside County, California",11856,94936,5245,1146,11,956,33,3896,44.2,9.7,0.1,8.1,0.3,32.9,55.8,3232,2949,283,91.24,8.76,665,2284,62,221,727,2505,22.6,21.9,22.5,"50% - 75% P.O.C.","$70000 - $95000"
"06065042737","Census Tract 427.37, Riverside County, California",2766,106129,1270,290,39,232,31,835,45.9,10.5,1.4,8.4,1.1,30.2,54.1,728,567,161,77.88,22.12,151,416,46,115,197,531,26.6,28.6,27.1,"50% - 75% P.O.C.","$95000 or more"
"06065042738","Census Tract 427.38, Riverside County, California",8614,89500,4060,577,42,569,262,2871,47.1,6.7,0.5,6.6,3,33.3,52.9,2494,1582,912,63.43,36.57,280,1302,178,734,458,2036,17.7,19.5,18.4,"50% - 75% P.O.C.","$70000 - $95000"
"06065042739","Census Tract 427.39, Riverside County, California",7631,110150,3324,625,16,783,0,2437,43.6,8.2,0.2,10.3,0,31.9,56.4,1936,1712,224,88.43,11.57,376,1336,36,188,412,1524,22,16.1,21.3,"50% - 75% P.O.C.","$95000 or more"
"06065042740","Census Tract 427.40, Riverside County, California",1858,40089,1467,154,0,76,0,89,79,8.3,0,4.1,0,4.8,21,1070,880,190,82.24,17.76,0,880,0,190,0,1070,0,0,0,"Less than 25% P.O.C.","Less than $51000"
"06065042741","Census Tract 427.41, Riverside County, California",2087,30061,1618,64,7,80,0,286,77.5,3.1,0.3,3.8,0,13.7,22.5,1351,924,427,68.39,31.61,6,918,0,427,6,1345,0.6,0,0.4,"Less than 25% P.O.C.","Less than $51000"
"06065042742","Census Tract 427.42, Riverside County, California",4846,95396,2446,168,2,125,0,1991,50.5,3.5,0,2.6,0,41.1,49.5,1323,1094,229,82.69,17.31,173,921,48,181,221,1102,15.8,21,16.7,"25% - 50% P.O.C.","$95000 or more"
"06065042743","Census Tract 427.43, Riverside County, California",3528,101650,2086,142,0,228,10,949,59.1,4,0,6.5,0.3,26.9,40.9,939,781,158,83.17,16.83,154,627,37,121,191,748,19.7,23.4,20.3,"25% - 50% P.O.C.","$95000 or more"
"06065042744","Census Tract 427.44, Riverside County, California",4573,88272,1618,0,6,1,0,2852,35.4,0,0.1,0,0,62.4,64.6,1015,717,298,70.64,29.36,226,491,103,195,329,686,31.5,34.6,32.4,"50% - 75% P.O.C.","$70000 - $95000"
"06065042745","Census Tract 427.45, Riverside County, California",5413,54726,2772,271,0,206,0,2062,51.2,5,0,3.8,0,38.1,48.8,2025,1596,429,78.81,21.19,149,1447,89,340,238,1787,9.3,20.7,11.8,"25% - 50% P.O.C.","$51000 - $70000"
"06065042800","Census Tract 428, Riverside County, California",9515,40923,798,288,36,105,0,8216,8.4,3,0.4,1.1,0,86.3,91.6,2263,767,1496,33.89,66.11,386,381,434,1062,820,1443,50.3,29,36.2,"75% or more P.O.C.","Less than $51000"
"06065042901","Census Tract 429.01, Riverside County, California",7591,48047,1076,286,8,57,0,6140,14.2,3.8,0.1,0.8,0,80.9,85.8,1799,1130,669,62.81,37.19,317,813,148,521,465,1334,28.1,22.1,25.8,"75% or more P.O.C.","Less than $51000"
"06065042902","Census Tract 429.02, Riverside County, California",5095,50726,1159,50,26,101,0,3753,22.7,1,0.5,2,0,73.7,77.3,1246,764,482,61.32,38.68,197,567,188,294,385,861,25.8,39,30.9,"75% or more P.O.C.","Less than $51000"
"06065042903","Census Tract 429.03, Riverside County, California",6126,63009,906,102,14,116,0,4987,14.8,1.7,0.2,1.9,0,81.4,85.2,1397,885,512,63.35,36.65,250,635,195,317,445,952,28.2,38.1,31.9,"75% or more P.O.C.","$51000 - $70000"
"06065042904","Census Tract 429.04, Riverside County, California",10637,50568,785,941,0,335,0,8512,7.4,8.8,0,3.1,0,80,92.6,2204,1572,632,71.32,28.68,638,934,303,329,941,1263,40.6,47.9,42.7,"75% or more P.O.C.","Less than $51000"
"06065043001","Census Tract 430.01, Riverside County, California",7090,44654,1814,720,0,316,46,4078,25.6,10.2,0,4.5,0.6,57.5,74.4,2027,1126,901,55.55,44.45,189,937,184,717,373,1654,16.8,20.4,18.4,"50% - 75% P.O.C.","Less than $51000"
"06065043003","Census Tract 430.03, Riverside County, California",7243,42576,1518,319,48,326,0,4703,21,4.4,0.7,4.5,0,64.9,79,1902,734,1168,38.59,61.41,209,525,268,900,477,1425,28.5,22.9,25.1,"75% or more P.O.C.","Less than $51000"
"06065043005","Census Tract 430.05, Riverside County, California",5960,56400,1480,104,0,76,0,3849,24.8,1.7,0,1.3,0,64.6,75.2,1560,864,696,55.38,44.62,178,686,244,452,422,1138,20.6,35.1,27.1,"75% or more P.O.C.","$51000 - $70000"
"06065043006","Census Tract 430.06, Riverside County, California",5402,45156,899,298,0,97,30,3993,16.6,5.5,0,1.8,0.6,73.9,83.4,1365,497,868,36.41,63.59,102,395,305,563,407,958,20.5,35.1,29.8,"75% or more P.O.C.","Less than $51000"
"06065043007","Census Tract 430.07, Riverside County, California",7420,111179,3265,428,40,442,19,3082,44,5.8,0.5,6,0.3,41.5,56,2075,1800,275,86.75,13.25,401,1399,41,234,442,1633,22.3,14.9,21.3,"50% - 75% P.O.C.","$95000 or more"
"06065043008","Census Tract 430.08, Riverside County, California",7427,73991,2718,271,16,296,0,3987,36.6,3.6,0.2,4,0,53.7,63.4,1900,1282,618,67.47,32.53,251,1031,187,431,438,1462,19.6,30.3,23.1,"50% - 75% P.O.C.","$70000 - $95000"
"06065043009","Census Tract 430.09, Riverside County, California",5712,98203,2145,135,22,340,0,3006,37.6,2.4,0.4,6,0,52.6,62.4,1499,1282,217,85.52,14.48,340,942,52,165,392,1107,26.5,24,26.2,"50% - 75% P.O.C.","$95000 or more"
"06065043010","Census Tract 430.10, Riverside County, California",5956,76083,2190,126,98,150,43,3177,36.8,2.1,1.6,2.5,0.7,53.3,63.2,1581,1294,287,81.85,18.15,282,1012,72,215,354,1227,21.8,25.1,22.4,"50% - 75% P.O.C.","$70000 - $95000"
"06065043206","Census Tract 432.06, Riverside County, California",7966,70174,3804,186,27,891,53,2415,47.8,2.3,0.3,11.2,0.7,30.3,52.2,2544,1009,1535,39.66,60.34,151,858,230,1305,381,2163,15,15,15,"50% - 75% P.O.C.","$70000 - $95000"
"06065043211","Census Tract 432.11, Riverside County, California",5519,102283,2722,245,46,313,5,2096,49.3,4.4,0.8,5.7,0.1,38,50.7,1540,1260,280,81.82,18.18,227,1033,64,216,291,1249,18,22.9,18.9,"50% - 75% P.O.C.","$95000 or more"
"06065043216","Census Tract 432.16, Riverside County, California",6105,69250,3368,277,0,370,20,1902,55.2,4.5,0,6.1,0.3,31.2,44.8,2090,695,1395,33.25,66.75,76,619,69,1326,145,1945,10.9,4.9,6.9,"25% - 50% P.O.C.","$51000 - $70000"
"06065043217","Census Tract 432.17, Riverside County, California",3336,98750,1723,122,0,90,0,1188,51.6,3.7,0,2.7,0,35.6,48.4,1043,810,233,77.66,22.34,65,745,76,157,141,902,8,32.6,13.5,"25% - 50% P.O.C.","$95000 or more"
"06065043218","Census Tract 432.18, Riverside County, California",5338,92156,2936,120,0,547,0,1677,55,2.2,0,10.2,0,31.4,45,1711,1477,234,86.32,13.68,147,1330,13,221,160,1551,10,5.6,9.4,"25% - 50% P.O.C.","$70000 - $95000"
"06065043220","Census Tract 432.20, Riverside County, California",4610,57569,2108,216,0,376,0,1792,45.7,4.7,0,8.2,0,38.9,54.3,1631,481,1150,29.49,70.51,65,416,126,1024,191,1440,13.5,11,11.7,"50% - 75% P.O.C.","$51000 - $70000"
"06065043222","Census Tract 432.22, Riverside County, California",5029,102554,3113,36,0,455,23,1020,61.9,0.7,0,9,0.5,20.3,38.1,1542,1158,384,75.1,24.9,220,938,68,316,288,1254,19,17.7,18.7,"25% - 50% P.O.C.","$95000 or more"
"06065043227","Census Tract 432.27, Riverside County, California",7895,98679,3047,820,0,721,18,2346,38.6,10.4,0,9.1,0.2,29.7,61.4,2273,1324,949,58.25,41.75,282,1042,111,838,393,1880,21.3,11.7,17.3,"50% - 75% P.O.C.","$95000 or more"
"06065043228","Census Tract 432.28, Riverside County, California",3842,71500,1910,124,22,102,0,1551,49.7,3.2,0.6,2.7,0,40.4,50.3,1352,630,722,46.6,53.4,61,569,68,654,129,1223,9.7,9.4,9.5,"50% - 75% P.O.C.","$70000 - $95000"
"06065043229","Census Tract 432.29, Riverside County, California",5110,52772,3622,60,0,238,0,1090,70.9,1.2,0,4.7,0,21.3,29.1,2265,1891,374,83.49,16.51,56,1835,46,328,102,2163,3,12.3,4.5,"25% - 50% P.O.C.","$51000 - $70000"
"06065043235","Census Tract 432.35, Riverside County, California",10588,113571,4394,1049,21,1641,310,2658,41.5,9.9,0.2,15.5,2.9,25.1,58.5,2504,2051,453,81.91,18.09,519,1532,298,155,817,1687,25.3,65.8,32.6,"50% - 75% P.O.C.","$95000 or more"
"06065043239","Census Tract 432.39, Riverside County, California",7763,100556,4751,183,17,89,30,2331,61.2,2.4,0.2,1.1,0.4,30,38.8,2324,1839,485,79.13,20.87,399,1440,121,364,520,1804,21.7,24.9,22.4,"25% - 50% P.O.C.","$95000 or more"
"06065043240","Census Tract 432.40, Riverside County, California",12415,116354,5708,1269,33,1013,340,3661,46,10.2,0.3,8.2,2.7,29.5,54,3199,2151,1048,67.24,32.76,508,1643,221,827,729,2470,23.6,21.1,22.8,"50% - 75% P.O.C.","$95000 or more"
"06065043242","Census Tract 432.42, Riverside County, California",9531,105674,3850,424,166,1341,81,2880,40.4,4.4,1.7,14.1,0.8,30.2,59.6,2533,2040,493,80.54,19.46,505,1535,80,413,585,1948,24.8,16.2,23.1,"50% - 75% P.O.C.","$95000 or more"
"06065043244","Census Tract 432.44, Riverside County, California",9755,94170,4830,671,0,817,84,2611,49.5,6.9,0,8.4,0.9,26.8,50.5,2889,2152,737,74.49,25.51,300,1852,182,555,482,2407,13.9,24.7,16.7,"50% - 75% P.O.C.","$70000 - $95000"
"06065043246","Census Tract 432.46, Riverside County, California",5803,110536,3588,141,23,418,0,1222,61.8,2.4,0.4,7.2,0,21.1,38.2,1677,1344,333,80.14,19.86,238,1106,113,220,351,1326,17.7,33.9,20.9,"25% - 50% P.O.C.","$95000 or more"
"06065043247","Census Tract 432.47, Riverside County, California",14002,115078,6535,839,66,1538,9,4523,46.7,6,0.5,11,0.1,32.3,53.3,3263,2528,735,77.47,22.53,523,2005,259,476,782,2481,20.7,35.2,24,"50% - 75% P.O.C.","$95000 or more"
"06065043248","Census Tract 432.48, Riverside County, California",4670,120611,2368,65,9,691,0,1385,50.7,1.4,0.2,14.8,0,29.7,49.3,1280,1026,254,80.16,19.84,171,855,52,202,223,1057,16.7,20.5,17.4,"25% - 50% P.O.C.","$95000 or more"
"06065043250","Census Tract 432.50, Riverside County, California",10048,97182,4718,322,64,1324,329,2768,47,3.2,0.6,13.2,3.3,27.5,53,2775,1707,1068,61.51,38.49,528,1179,120,948,648,2127,30.9,11.2,23.4,"50% - 75% P.O.C.","$95000 or more"
"06065043252","Census Tract 432.52, Riverside County, California",9584,118920,5091,484,188,987,96,2011,53.1,5.1,2,10.3,1,21,46.9,2527,1931,596,76.41,23.59,472,1459,70,526,542,1985,24.4,11.7,21.4,"25% - 50% P.O.C.","$95000 or more"
"06065043254","Census Tract 432.54, Riverside County, California",5193,84621,2737,141,75,385,14,1698,52.7,2.7,1.4,7.4,0.3,32.7,47.3,1574,1361,213,86.47,13.53,136,1225,34,179,170,1404,10,16,10.8,"25% - 50% P.O.C.","$70000 - $95000"
"06065043256","Census Tract 432.56, Riverside County, California",3783,92964,1387,396,10,538,0,1326,36.7,10.5,0.3,14.2,0,35.1,63.3,1009,779,230,77.21,22.79,119,660,62,168,181,828,15.3,27,17.9,"50% - 75% P.O.C.","$70000 - $95000"
"06065043257","Census Tract 432.57, Riverside County, California",9318,113125,4682,357,169,1267,47,2154,50.2,3.8,1.8,13.6,0.5,23.1,49.8,2662,2040,622,76.63,23.37,345,1695,181,441,526,2136,16.9,29.1,19.8,"25% - 50% P.O.C.","$95000 or more"
"06065043262","Census Tract 432.62, Riverside County, California",5287,110543,3549,103,0,158,0,1312,67.1,1.9,0,3,0,24.8,32.9,1644,1335,309,81.2,18.8,155,1180,60,249,215,1429,11.6,19.4,13.1,"25% - 50% P.O.C.","$95000 or more"
"06065043264","Census Tract 432.64, Riverside County, California",7862,104265,4509,418,0,687,5,2007,57.4,5.3,0,8.7,0.1,25.5,42.6,2264,1891,373,83.52,16.48,243,1648,140,233,383,1881,12.9,37.5,16.9,"25% - 50% P.O.C.","$95000 or more"
"06065043265","Census Tract 432.65, Riverside County, California",8221,111528,4907,268,31,502,51,1997,59.7,3.3,0.4,6.1,0.6,24.3,40.3,2366,1598,768,67.54,32.46,234,1364,126,642,360,2006,14.6,16.4,15.2,"25% - 50% P.O.C.","$95000 or more"
"06065043266","Census Tract 432.66, Riverside County, California",5763,72927,1638,421,0,565,6,2538,28.4,7.3,0,9.8,0.1,44,71.6,1674,481,1193,28.73,71.27,69,412,248,945,317,1357,14.3,20.8,18.9,"50% - 75% P.O.C.","$70000 - $95000"
"06065043267","Census Tract 432.67, Riverside County, California",6185,101250,4228,102,41,337,0,1281,68.4,1.6,0.7,5.4,0,20.7,31.6,2132,1833,299,85.98,14.02,169,1664,83,216,252,1880,9.2,27.8,11.8,"25% - 50% P.O.C.","$95000 or more"
"06065043270","Census Tract 432.70, Riverside County, California",6071,102091,2806,516,0,515,7,2034,46.2,8.5,0,8.5,0.1,33.5,53.8,1599,1171,428,73.23,26.77,294,877,96,332,390,1209,25.1,22.4,24.4,"50% - 75% P.O.C.","$95000 or more"
"06065043271","Census Tract 432.71, Riverside County, California",3977,76914,1945,42,8,18,14,1913,48.9,1.1,0.2,0.5,0.4,48.1,51.1,1037,779,258,75.12,24.88,210,569,88,170,298,739,27,34.1,28.7,"50% - 75% P.O.C.","$70000 - $95000"
"06065043272","Census Tract 432.72, Riverside County, California",4957,111813,3588,84,56,127,0,1053,72.4,1.7,1.1,2.6,0,21.2,27.6,1738,1542,196,88.72,11.28,163,1379,12,184,175,1563,10.6,6.1,10.1,"25% - 50% P.O.C.","$95000 or more"
"06065043274","Census Tract 432.74, Riverside County, California",2383,85335,951,21,135,68,0,1164,39.9,0.9,5.7,2.9,0,48.8,60.1,603,476,127,78.94,21.06,105,371,34,93,139,464,22.1,26.8,23.1,"50% - 75% P.O.C.","$70000 - $95000"
"06065043276","Census Tract 432.76, Riverside County, California",3855,104274,1893,193,68,462,50,1043,49.1,5,1.8,12,1.3,27.1,50.9,1000,850,150,85,15,239,611,52,98,291,709,28.1,34.7,29.1,"50% - 75% P.O.C.","$95000 or more"
"06065043278","Census Tract 432.78, Riverside County, California",6360,121359,3903,185,0,378,26,1368,61.4,2.9,0,5.9,0.4,21.5,38.6,1827,1493,334,81.72,18.28,287,1206,33,301,320,1507,19.2,9.9,17.5,"25% - 50% P.O.C.","$95000 or more"
"06065043279","Census Tract 432.79, Riverside County, California",5075,73393,3226,47,21,111,0,1563,63.6,0.9,0.4,2.2,0,30.8,36.4,1507,1293,214,85.8,14.2,160,1133,30,184,190,1317,12.4,14,12.6,"25% - 50% P.O.C.","$70000 - $95000"
"06065043291","Census Tract 432.91, Riverside County, California",9081,71203,4514,391,88,1253,0,2455,49.7,4.3,1,13.8,0,27,50.3,2968,1804,1164,60.78,39.22,210,1594,138,1026,348,2620,11.6,11.9,11.7,"50% - 75% P.O.C.","$70000 - $95000"
"06065043304","Census Tract 433.04, Riverside County, California",7688,61589,4723,100,3,354,0,2171,61.4,1.3,0,4.6,0,28.2,38.6,2745,2466,279,89.84,10.16,343,2123,0,279,343,2402,13.9,0,12.5,"25% - 50% P.O.C.","$51000 - $70000"
"06065043306","Census Tract 433.06, Riverside County, California",5142,56187,2190,149,60,157,0,2447,42.6,2.9,1.2,3.1,0,47.6,57.4,1591,1035,556,65.05,34.95,162,873,147,409,309,1282,15.7,26.4,19.4,"50% - 75% P.O.C.","$51000 - $70000"
"06065043307","Census Tract 433.07, Riverside County, California",6764,38094,2867,793,0,348,81,2623,42.4,11.7,0,5.1,1.2,38.8,57.6,2342,1319,1023,56.32,43.68,68,1251,104,919,172,2170,5.2,10.2,7.3,"50% - 75% P.O.C.","Less than $51000"
"06065043308","Census Tract 433.08, Riverside County, California",2892,36528,680,311,32,6,0,1829,23.5,10.8,1.1,0.2,0,63.2,76.5,934,271,663,29.01,70.99,61,210,69,594,130,804,22.5,10.4,13.9,"75% or more P.O.C.","Less than $51000"
"06065043309","Census Tract 433.09, Riverside County, California",2837,35000,990,245,39,61,139,1283,34.9,8.6,1.4,2.2,4.9,45.2,65.1,862,285,577,33.06,66.94,32,253,110,467,142,720,11.2,19.1,16.5,"50% - 75% P.O.C.","Less than $51000"
"06065043310","Census Tract 433.10, Riverside County, California",3534,37703,922,348,0,57,152,1999,26.1,9.8,0,1.6,4.3,56.6,73.9,1061,392,669,36.95,63.05,86,306,65,604,151,910,21.9,9.7,14.2,"50% - 75% P.O.C.","Less than $51000"
"06065043311","Census Tract 433.11, Riverside County, California",2548,50536,1279,26,0,125,0,1105,50.2,1,0,4.9,0,43.4,49.8,723,479,244,66.25,33.75,72,407,78,166,150,573,15,32,20.7,"25% - 50% P.O.C.","Less than $51000"
"06065043312","Census Tract 433.12, Riverside County, California",4559,47279,882,121,0,108,0,3361,19.3,2.7,0,2.4,0,73.7,80.7,1175,540,635,45.96,54.04,92,448,293,342,385,790,17,46.1,32.8,"75% or more P.O.C.","Less than $51000"
"06065043313","Census Tract 433.13, Riverside County, California",4046,41531,1205,260,110,138,0,2192,29.8,6.4,2.7,3.4,0,54.2,70.2,1058,564,494,53.31,46.69,111,453,158,336,269,789,19.7,32,25.4,"50% - 75% P.O.C.","Less than $51000"
"06065043314","Census Tract 433.14, Riverside County, California",3482,62586,1777,50,109,44,3,1334,51,1.4,3.1,1.3,0.1,38.3,49,1064,705,359,66.26,33.74,66,639,82,277,148,916,9.4,22.8,13.9,"25% - 50% P.O.C.","$51000 - $70000"
"06065043315","Census Tract 433.15, Riverside County, California",2887,83359,1562,59,6,7,0,1223,54.1,2,0.2,0.2,0,42.4,45.9,712,558,154,78.37,21.63,116,442,55,99,171,541,20.8,35.7,24,"25% - 50% P.O.C.","$70000 - $95000"
"06065043316","Census Tract 433.16, Riverside County, California",3872,40417,2214,358,0,158,3,768,57.2,9.2,0,4.1,0.1,19.8,42.8,1492,1154,338,77.35,22.65,67,1087,102,236,169,1323,5.8,30.2,11.3,"25% - 50% P.O.C.","Less than $51000"
"06065043317","Census Tract 433.17, Riverside County, California",8443,78511,3212,552,176,250,21,4030,38,6.5,2.1,3,0.2,47.7,62,2389,1851,538,77.48,22.52,415,1436,84,454,499,1890,22.4,15.6,20.9,"50% - 75% P.O.C.","$70000 - $95000"
"06065043401","Census Tract 434.01, Riverside County, California",6883,33904,2205,559,88,27,0,3983,32,8.1,1.3,0.4,0,57.9,68,1868,697,1171,37.31,62.69,204,493,244,927,448,1420,29.3,20.8,24,"50% - 75% P.O.C.","Less than $51000"
"06065043403","Census Tract 434.03, Riverside County, California",2741,31505,944,209,0,37,0,1467,34.4,7.6,0,1.3,0,53.5,65.6,891,452,439,50.73,49.27,57,395,78,361,135,756,12.6,17.8,15.2,"50% - 75% P.O.C.","Less than $51000"
"06065043404","Census Tract 434.04, Riverside County, California",2689,28299,1305,160,0,22,0,1147,48.5,6,0,0.8,0,42.7,51.5,1239,685,554,55.29,44.71,35,650,0,554,35,1204,5.1,0,2.8,"50% - 75% P.O.C.","Less than $51000"
"06065043405","Census Tract 434.05, Riverside County, California",4831,24887,1711,522,0,0,0,2514,35.4,10.8,0,0,0,52,64.6,1877,961,916,51.2,48.8,40,921,168,748,208,1669,4.2,18.3,11.1,"50% - 75% P.O.C.","Less than $51000"
"06065043503","Census Tract 435.03, Riverside County, California",3875,36628,1819,125,0,94,15,1772,46.9,3.2,0,2.4,0.4,45.7,53.1,1781,896,885,50.31,49.69,0,896,35,850,35,1746,0,4,2,"50% - 75% P.O.C.","Less than $51000"
"06065043504","Census Tract 435.04, Riverside County, California",8208,48688,3848,488,0,404,20,3121,46.9,5.9,0,4.9,0.2,38,53.1,2465,2082,383,84.46,15.54,368,1714,168,215,536,1929,17.7,43.9,21.7,"50% - 75% P.O.C.","Less than $51000"
"06065043505","Census Tract 435.05, Riverside County, California",3148,32036,1708,285,40,44,0,1010,54.3,9.1,1.3,1.4,0,32.1,45.7,1552,550,1002,35.44,64.56,34,516,25,977,59,1493,6.2,2.5,3.8,"25% - 50% P.O.C.","Less than $51000"
"06065043506","Census Tract 435.06, Riverside County, California",6592,47930,2916,296,0,160,0,3038,44.2,4.5,0,2.4,0,46.1,55.8,2071,1697,374,81.94,18.06,268,1429,90,284,358,1713,15.8,24.1,17.3,"50% - 75% P.O.C.","Less than $51000"
"06065043507","Census Tract 435.07, Riverside County, California",6676,35982,1567,726,0,379,0,3916,23.5,10.9,0,5.7,0,58.7,76.5,2179,629,1550,28.87,71.13,64,565,155,1395,219,1960,10.2,10,10.1,"75% or more P.O.C.","Less than $51000"
"06065043508","Census Tract 435.08, Riverside County, California",6814,44055,3352,319,125,36,2,2908,49.2,4.7,1.8,0.5,0,42.7,50.8,2221,1436,785,64.66,35.34,321,1115,58,727,379,1842,22.4,7.4,17.1,"50% - 75% P.O.C.","Less than $51000"
"06065043509","Census Tract 435.09, Riverside County, California",5404,52110,1989,209,88,68,0,3020,36.8,3.9,1.6,1.3,0,55.9,63.2,1656,1167,489,70.47,29.53,186,981,105,384,291,1365,15.9,21.5,17.6,"50% - 75% P.O.C.","$51000 - $70000"
"06065043512","Census Tract 435.12, Riverside County, California",7618,53417,2069,943,37,390,11,3738,27.2,12.4,0.5,5.1,0.1,49.1,72.8,2098,1322,776,63.01,36.99,222,1100,295,481,517,1581,16.8,38,24.6,"50% - 75% P.O.C.","$51000 - $70000"
"06065043513","Census Tract 435.13, Riverside County, California",3532,47250,1126,80,21,46,0,2134,31.9,2.3,0.6,1.3,0,60.4,68.1,933,765,168,81.99,18.01,151,614,71,97,222,711,19.7,42.3,23.8,"50% - 75% P.O.C.","Less than $51000"
"06065043517","Census Tract 435.17, Riverside County, California",7811,69940,2476,523,0,487,0,4075,31.7,6.7,0,6.2,0,52.2,68.3,1645,1147,498,69.73,30.27,485,662,231,267,716,929,42.3,46.4,43.5,"50% - 75% P.O.C.","$51000 - $70000"
"06065043601","Census Tract 436.01, Riverside County, California",5198,39509,748,474,97,48,0,3754,14.4,9.1,1.9,0.9,0,72.2,85.6,1283,469,814,36.55,63.45,57,412,257,557,314,969,12.2,31.6,24.5,"75% or more P.O.C.","Less than $51000"
"06065043602","Census Tract 436.02, Riverside County, California",3389,40950,523,130,0,109,0,2541,15.4,3.8,0,3.2,0,75,84.6,1021,416,605,40.74,59.26,89,327,97,508,186,835,21.4,16,18.2,"75% or more P.O.C.","Less than $51000"
"06065043701","Census Tract 437.01, Riverside County, California",4328,44223,2323,148,73,85,0,1521,53.7,3.4,1.7,2,0,35.1,46.3,1547,1279,268,82.68,17.32,202,1077,0,268,202,1345,15.8,0,13.1,"25% - 50% P.O.C.","Less than $51000"
"06065043702","Census Tract 437.02, Riverside County, California",4760,52083,2380,74,39,76,0,2098,50,1.6,0.8,1.6,0,44.1,50,1577,1112,465,70.51,29.49,116,996,133,332,249,1328,10.4,28.6,15.8,"50% - 75% P.O.C.","$51000 - $70000"
"06065043703","Census Tract 437.03, Riverside County, California",3145,57237,1520,166,6,34,0,1362,48.3,5.3,0.2,1.1,0,43.3,51.7,954,606,348,63.52,36.48,54,552,102,246,156,798,8.9,29.3,16.4,"50% - 75% P.O.C.","$51000 - $70000"
"06065043802","Census Tract 438.02, Riverside County, California",5996,65160,3497,53,13,150,0,2092,58.3,0.9,0.2,2.5,0,34.9,41.7,1967,1636,331,83.17,16.83,291,1345,60,271,351,1616,17.8,18.1,17.8,"25% - 50% P.O.C.","$51000 - $70000"
"06065043807","Census Tract 438.07, Riverside County, California",7040,65565,2599,720,254,382,0,2999,36.9,10.2,3.6,5.4,0,42.6,63.1,1973,1234,739,62.54,37.46,313,921,126,613,439,1534,25.4,17.1,22.3,"50% - 75% P.O.C.","$51000 - $70000"
"06065043809","Census Tract 438.09, Riverside County, California",4046,52955,2716,340,13,55,0,843,67.1,8.4,0.3,1.4,0,20.8,32.9,1694,1526,168,90.08,9.92,44,1482,10,158,54,1640,2.9,6,3.2,"25% - 50% P.O.C.","$51000 - $70000"
"06065043810","Census Tract 438.10, Riverside County, California",4952,74154,2342,308,16,385,0,1817,47.3,6.2,0.3,7.8,0,36.7,52.7,1920,1716,204,89.38,10.62,162,1554,53,151,215,1705,9.4,26,11.2,"50% - 75% P.O.C.","$70000 - $95000"
"06065043811","Census Tract 438.11, Riverside County, California",4031,63013,2755,171,0,109,0,867,68.3,4.2,0,2.7,0,21.5,31.7,1403,1147,256,81.75,18.25,108,1039,7,249,115,1288,9.4,2.7,8.2,"25% - 50% P.O.C.","$51000 - $70000"
"06065043812","Census Tract 438.12, Riverside County, California",6526,54125,5238,144,0,276,0,793,80.3,2.2,0,4.2,0,12.2,19.7,3912,3544,368,90.59,9.41,33,3511,0,368,33,3879,0.9,0,0.8,"Less than 25% P.O.C.","$51000 - $70000"
"06065043813","Census Tract 438.13, Riverside County, California",4912,44967,1861,87,959,113,0,1796,37.9,1.8,19.5,2.3,0,36.6,62.1,1642,1038,604,63.22,36.78,125,913,111,493,236,1406,12,18.4,14.4,"50% - 75% P.O.C.","Less than $51000"
"06065043814","Census Tract 438.14, Riverside County, California",944,46164,678,18,37,26,0,185,71.8,1.9,3.9,2.8,0,19.6,28.2,473,445,28,94.08,5.92,0,445,0,28,0,473,0,0,0,"25% - 50% P.O.C.","Less than $51000"
"06065043818","Census Tract 438.18, Riverside County, California",4567,82157,964,467,9,772,0,2281,21.1,10.2,0.2,16.9,0,49.9,78.9,1179,842,337,71.42,28.58,187,655,95,242,282,897,22.2,28.2,23.9,"75% or more P.O.C.","$70000 - $95000"
"06065043820","Census Tract 438.20, Riverside County, California",4870,83712,1757,687,0,577,0,1656,36.1,14.1,0,11.8,0,34,63.9,1628,1462,166,89.8,10.2,199,1263,45,121,244,1384,13.6,27.1,15,"50% - 75% P.O.C.","$70000 - $95000"
"06065043821","Census Tract 438.21, Riverside County, California",5389,74000,1395,697,0,356,59,2835,25.9,12.9,0,6.6,1.1,52.6,74.1,1458,1018,440,69.82,30.18,228,790,158,282,386,1072,22.4,35.9,26.5,"50% - 75% P.O.C.","$70000 - $95000"
"06065043822","Census Tract 438.22, Riverside County, California",2898,98646,1117,23,0,133,0,1525,38.5,0.8,0,4.6,0,52.6,61.5,733,583,150,79.54,20.46,141,442,75,75,216,517,24.2,50,29.5,"50% - 75% P.O.C.","$95000 or more"
"06065043823","Census Tract 438.23, Riverside County, California",10092,119984,3480,693,139,1196,0,4298,34.5,6.9,1.4,11.9,0,42.6,65.5,2715,2366,349,87.15,12.85,498,1868,126,223,624,2091,21,36.1,23,"50% - 75% P.O.C.","$95000 or more"
"06065043900","Census Tract 439, Riverside County, California",6698,62602,2547,178,3,75,0,3812,38,2.7,0,1.1,0,56.9,62,1878,1227,651,65.34,34.66,313,914,144,507,457,1421,25.5,22.1,24.3,"50% - 75% P.O.C.","$51000 - $70000"
"06065044000","Census Tract 440, Riverside County, California",1734,43333,392,124,0,22,0,1113,22.6,7.2,0,1.3,0,64.2,77.4,548,108,440,19.71,80.29,20,88,75,365,95,453,18.5,17,17.3,"75% or more P.O.C.","Less than $51000"
"06065044101","Census Tract 441.01, Riverside County, California",3409,40254,610,80,253,193,0,2244,17.9,2.3,7.4,5.7,0,65.8,82.1,996,465,531,46.69,53.31,98,367,109,422,207,789,21.1,20.5,20.8,"75% or more P.O.C.","Less than $51000"
"06065044102","Census Tract 441.02, Riverside County, California",2907,37622,802,167,0,16,0,1807,27.6,5.7,0,0.6,0,62.2,72.4,843,474,369,56.23,43.77,70,404,44,325,114,729,14.8,11.9,13.5,"50% - 75% P.O.C.","Less than $51000"
"06065044103","Census Tract 441.03, Riverside County, California",5735,36828,2264,512,0,505,5,2271,39.5,8.9,0,8.8,0.1,39.6,60.5,2187,1429,758,65.34,34.66,85,1344,141,617,226,1961,5.9,18.6,10.3,"50% - 75% P.O.C.","Less than $51000"
"06065044104","Census Tract 441.04, Riverside County, California",2983,72045,1301,109,0,45,12,1477,43.6,3.7,0,1.5,0.4,49.5,56.4,904,605,299,66.92,33.08,60,545,42,257,102,802,9.9,14,11.3,"50% - 75% P.O.C.","$70000 - $95000"
"06065044200","Census Tract 442, Riverside County, California",6541,40000,1042,901,480,287,0,3690,15.9,13.8,7.3,4.4,0,56.4,84.1,1710,830,880,48.54,51.46,160,670,254,626,414,1296,19.3,28.9,24.2,"75% or more P.O.C.","Less than $51000"
"06065044300","Census Tract 443, Riverside County, California",4847,42896,1178,531,82,210,0,2753,24.3,11,1.7,4.3,0,56.8,75.7,1293,694,599,53.67,46.33,95,599,43,556,138,1155,13.7,7.2,10.7,"75% or more P.O.C.","Less than $51000"
"06065044402","Census Tract 444.02, Riverside County, California",5266,50674,4162,47,0,61,0,924,79,0.9,0,1.2,0,17.5,21,1913,1578,335,82.49,17.51,224,1354,38,297,262,1651,14.2,11.3,13.7,"Less than 25% P.O.C.","Less than $51000"
"06065044403","Census Tract 444.03, Riverside County, California",4114,45398,2433,41,186,257,44,973,59.1,1,4.5,6.2,1.1,23.7,40.9,1481,1110,371,74.95,25.05,71,1039,90,281,161,1320,6.4,24.3,10.9,"25% - 50% P.O.C.","Less than $51000"
"06065044404","Census Tract 444.04, Riverside County, California",1122,60341,859,106,0,25,0,125,76.6,9.4,0,2.2,0,11.1,23.4,493,348,145,70.59,29.41,8,340,11,134,19,474,2.3,7.6,3.9,"Less than 25% P.O.C.","$51000 - $70000"
"06065044405","Census Tract 444.05, Riverside County, California",1463,82448,1115,9,11,36,0,292,76.2,0.6,0.8,2.5,0,20,23.8,717,523,194,72.94,27.06,0,523,0,194,0,717,0,0,0,"Less than 25% P.O.C.","$70000 - $95000"
"06065044505","Census Tract 445.05, Riverside County, California",5781,52240,2673,9,0,30,0,3059,46.2,0.2,0,0.5,0,52.9,53.8,2176,1579,597,72.56,27.44,90,1489,117,480,207,1969,5.7,19.6,9.5,"50% - 75% P.O.C.","$51000 - $70000"
"06065044507","Census Tract 445.07, Riverside County, California",6817,30169,1494,516,0,257,0,4374,21.9,7.6,0,3.8,0,64.2,78.1,2341,967,1374,41.31,58.69,146,821,125,1249,271,2070,15.1,9.1,11.6,"75% or more P.O.C.","Less than $51000"
"06065044509","Census Tract 445.09, Riverside County, California",3693,26806,1116,460,0,49,0,2040,30.2,12.5,0,1.3,0,55.2,69.8,1537,461,1076,29.99,70.01,49,412,29,1047,78,1459,10.6,2.7,5.1,"50% - 75% P.O.C.","Less than $51000"
"06065044510","Census Tract 445.10, Riverside County, California",6649,30035,1865,849,81,164,0,3611,28,12.8,1.2,2.5,0,54.3,72,2261,536,1725,23.71,76.29,53,483,266,1459,319,1942,9.9,15.4,14.1,"50% - 75% P.O.C.","Less than $51000"
"06065044515","Census Tract 445.15, Riverside County, California",3971,31778,958,265,93,112,0,2522,24.1,6.7,2.3,2.8,0,63.5,75.9,1305,946,359,72.49,27.51,128,818,80,279,208,1097,13.5,22.3,15.9,"75% or more P.O.C.","Less than $51000"
"06065044516","Census Tract 445.16, Riverside County, California",6109,40720,1546,218,0,67,0,4060,25.3,3.6,0,1.1,0,66.5,74.7,2183,1155,1028,52.91,47.09,185,970,169,859,354,1829,16,16.4,16.2,"50% - 75% P.O.C.","Less than $51000"
"06065044517","Census Tract 445.17, Riverside County, California",2435,72010,1858,61,19,93,0,369,76.3,2.5,0.8,3.8,0,15.2,23.7,1117,856,261,76.63,23.37,2,854,0,261,2,1115,0.2,0,0.2,"Less than 25% P.O.C.","$70000 - $95000"
"06065044518","Census Tract 445.18, Riverside County, California",5302,45944,2237,526,0,126,22,2206,42.2,9.9,0,2.4,0.4,41.6,57.8,1849,1292,557,69.88,30.12,68,1224,133,424,201,1648,5.3,23.9,10.9,"50% - 75% P.O.C.","Less than $51000"
"06065044520","Census Tract 445.20, Riverside County, California",1424,46750,687,16,30,56,0,635,48.2,1.1,2.1,3.9,0,44.6,51.8,600,485,115,80.83,19.17,58,427,20,95,78,522,12,17.4,13,"50% - 75% P.O.C.","Less than $51000"
"06065044521","Census Tract 445.21, Riverside County, California",1332,38514,564,79,0,49,0,610,42.3,5.9,0,3.7,0,45.8,57.7,431,308,123,71.46,28.54,12,296,37,86,49,382,3.9,30.1,11.4,"50% - 75% P.O.C.","Less than $51000"
"06065044522","Census Tract 445.22, Riverside County, California",3812,26150,1749,132,0,73,0,1750,45.9,3.5,0,1.9,0,45.9,54.1,1771,1210,561,68.32,31.68,61,1149,45,516,106,1665,5,8,6,"50% - 75% P.O.C.","Less than $51000"
"06065044602","Census Tract 446.02, Riverside County, California",2907,52560,1899,110,0,146,0,659,65.3,3.8,0,5,0,22.7,34.7,1441,721,720,50.03,49.97,34,687,0,720,34,1407,4.7,0,2.4,"25% - 50% P.O.C.","$51000 - $70000"
"06065044604","Census Tract 446.04, Riverside County, California",4151,63264,2445,114,43,240,0,1279,58.9,2.7,1,5.8,0,30.8,41.1,1843,1390,453,75.42,24.58,63,1327,86,367,149,1694,4.5,19,8.1,"25% - 50% P.O.C.","$51000 - $70000"
"06065044605","Census Tract 446.05, Riverside County, California",6107,36827,1944,849,0,248,0,2946,31.8,13.9,0,4.1,0,48.2,68.2,2380,1367,1013,57.44,42.56,138,1229,111,902,249,2131,10.1,11,10.5,"50% - 75% P.O.C.","Less than $51000"
"06065044606","Census Tract 446.06, Riverside County, California",2734,61136,1485,48,0,72,0,933,54.3,1.8,0,2.6,0,34.1,45.7,1328,715,613,53.84,46.16,34,681,0,613,34,1294,4.8,0,2.6,"25% - 50% P.O.C.","$51000 - $70000"
"06065044701","Census Tract 447.01, Riverside County, California",4039,36922,2012,50,26,211,21,1647,49.8,1.2,0.6,5.2,0.5,40.8,50.2,1884,652,1232,34.61,65.39,0,652,164,1068,164,1720,0,13.3,8.7,"50% - 75% P.O.C.","Less than $51000"
"06065044702","Census Tract 447.02, Riverside County, California",1738,33013,310,43,0,30,46,1259,17.8,2.5,0,1.7,2.6,72.4,82.2,581,395,186,67.99,32.01,29,366,86,100,115,466,7.3,46.2,19.8,"75% or more P.O.C.","Less than $51000"
"06065044804","Census Tract 448.04, Riverside County, California",2704,44242,845,19,6,558,0,1232,31.2,0.7,0.2,20.6,0,45.6,68.8,1032,607,425,58.82,41.18,48,559,82,343,130,902,7.9,19.3,12.6,"50% - 75% P.O.C.","Less than $51000"
"06065044805","Census Tract 448.05, Riverside County, California",1590,66389,1276,16,0,36,15,183,80.3,1,0,2.3,0.9,11.5,19.7,980,699,281,71.33,28.67,0,699,0,281,0,980,0,0,0,"Less than 25% P.O.C.","$51000 - $70000"
"06065044806","Census Tract 448.06, Riverside County, California",2081,37528,1437,0,22,11,0,602,69.1,0,1.1,0.5,0,28.9,30.9,1229,578,651,47.03,52.97,0,578,45,606,45,1184,0,6.9,3.7,"25% - 50% P.O.C.","Less than $51000"
"06065044807","Census Tract 448.07, Riverside County, California",1642,60417,1138,61,0,109,5,329,69.3,3.7,0,6.6,0.3,20,30.7,930,382,548,41.08,58.92,0,382,0,548,0,930,0,0,0,"25% - 50% P.O.C.","$51000 - $70000"
"06065044904","Census Tract 449.04, Riverside County, California",5192,57401,1787,312,216,398,3,2287,34.4,6,4.2,7.7,0.1,44,65.6,1749,1205,544,68.9,31.1,218,987,61,483,279,1470,18.1,11.2,16,"50% - 75% P.O.C.","$51000 - $70000"
"06065044907","Census Tract 449.07, Riverside County, California",5461,34871,470,9,0,69,16,4897,8.6,0.2,0,1.3,0.3,89.7,91.4,1481,394,1087,26.6,73.4,69,325,315,772,384,1097,17.5,29,25.9,"75% or more P.O.C.","Less than $51000"
"06065044911","Census Tract 449.11, Riverside County, California",4194,42679,3104,122,0,211,0,638,74,2.9,0,5,0,15.2,26,2204,1215,989,55.13,44.87,0,1215,34,955,34,2170,0,3.4,1.5,"25% - 50% P.O.C.","Less than $51000"
"06065044915","Census Tract 449.15, Riverside County, California",6799,30922,587,108,18,352,0,5700,8.6,1.6,0.3,5.2,0,83.8,91.4,2089,386,1703,18.48,81.52,66,320,383,1320,449,1640,17.1,22.5,21.5,"75% or more P.O.C.","Less than $51000"
"06065044916","Census Tract 449.16, Riverside County, California",5334,44365,2025,213,0,250,18,2762,38,4,0,4.7,0.3,51.8,62,2174,1196,978,55.01,44.99,17,1179,187,791,204,1970,1.4,19.1,9.4,"50% - 75% P.O.C.","Less than $51000"
"06065044917","Census Tract 449.17, Riverside County, California",5033,82097,4498,85,120,0,0,330,89.4,1.7,2.4,0,0,6.6,10.6,2602,2446,156,94,6,0,2446,0,156,0,2602,0,0,0,"Less than 25% P.O.C.","$70000 - $95000"
"06065044918","Census Tract 449.18, Riverside County, California",2919,72125,2519,33,10,80,0,228,86.3,1.1,0.3,2.7,0,7.8,13.7,1634,1223,411,74.85,25.15,25,1198,7,404,32,1602,2,1.7,2,"Less than 25% P.O.C.","$70000 - $95000"
"06065044919","Census Tract 449.19, Riverside County, California",5011,44896,4247,197,62,63,28,277,84.8,3.9,1.2,1.3,0.6,5.5,15.2,2767,2368,399,85.58,14.42,22,2346,0,399,22,2745,0.9,0,0.8,"Less than 25% P.O.C.","Less than $51000"
"06065044921","Census Tract 449.21, Riverside County, California",2448,116875,1991,12,11,297,0,117,81.3,0.5,0.4,12.1,0,4.8,18.7,1109,954,155,86.02,13.98,18,936,10,145,28,1081,1.9,6.5,2.5,"Less than 25% P.O.C.","$95000 or more"
"06065044922","Census Tract 449.22, Riverside County, California",5812,96875,3692,184,9,544,0,1042,63.5,3.2,0.2,9.4,0,17.9,36.5,2517,1530,987,60.79,39.21,105,1425,14,973,119,2398,6.9,1.4,4.7,"25% - 50% P.O.C.","$95000 or more"
"06065044923","Census Tract 449.23, Riverside County, California",4122,68631,1545,14,0,290,0,2186,37.5,0.3,0,7,0,53,62.5,1251,957,294,76.5,23.5,177,780,88,206,265,986,18.5,29.9,21.2,"50% - 75% P.O.C.","$51000 - $70000"
"06065044924","Census Tract 449.24, Riverside County, California",3998,61486,1105,32,0,297,59,2456,27.6,0.8,0,7.4,1.5,61.4,72.4,1190,765,425,64.29,35.71,123,642,66,359,189,1001,16.1,15.5,15.9,"50% - 75% P.O.C.","$51000 - $70000"
"06065044925","Census Tract 449.25, Riverside County, California",3978,77000,1130,30,0,307,0,2507,28.4,0.8,0,7.7,0,63,71.6,1074,910,164,84.73,15.27,234,676,38,126,272,802,25.7,23.2,25.3,"50% - 75% P.O.C.","$70000 - $95000"
"06065044926","Census Tract 449.26, Riverside County, California",5407,39965,574,200,0,632,0,3710,10.6,3.7,0,11.7,0,68.6,89.4,1492,816,676,54.69,45.31,216,600,73,603,289,1203,26.5,10.8,19.4,"75% or more P.O.C.","Less than $51000"
"06065044927","Census Tract 449.27, Riverside County, California",3619,65135,2551,163,0,148,13,735,70.5,4.5,0,4.1,0.4,20.3,29.5,1840,1205,635,65.49,34.51,4,1201,3,632,7,1833,0.3,0.5,0.4,"25% - 50% P.O.C.","$51000 - $70000"
"06065044928","Census Tract 449.28, Riverside County, California",3342,82850,2815,0,0,66,0,341,84.2,0,0,2,0,10.2,15.8,1681,1393,288,82.87,17.13,0,1393,0,288,0,1681,0,0,0,"Less than 25% P.O.C.","$70000 - $95000"
"06065044929","Census Tract 449.29, Riverside County, California",3627,71328,2814,86,0,144,0,583,77.6,2.4,0,4,0,16.1,22.4,1928,1209,719,62.71,37.29,20,1189,18,701,38,1890,1.7,2.5,2,"Less than 25% P.O.C.","$70000 - $95000"
"06065044930","Census Tract 449.30, Riverside County, California",3606,62337,1611,216,7,229,0,1494,44.7,6,0.2,6.4,0,41.4,55.3,1345,718,627,53.38,46.62,52,666,144,483,196,1149,7.2,23,14.6,"50% - 75% P.O.C.","$51000 - $70000"
"06065044931","Census Tract 449.31, Riverside County, California",2093,48750,674,44,11,192,0,1160,32.2,2.1,0.5,9.2,0,55.4,67.8,642,561,81,87.38,12.62,49,512,13,68,62,580,8.7,16,9.7,"50% - 75% P.O.C.","Less than $51000"
"06065044932","Census Tract 449.32, Riverside County, California",2883,74871,1273,72,0,271,0,1236,44.2,2.5,0,9.4,0,42.9,55.8,1126,800,326,71.05,28.95,82,718,0,326,82,1044,10.2,0,7.3,"50% - 75% P.O.C.","$70000 - $95000"
"06065045000","Census Tract 450, Riverside County, California",3314,42744,1796,88,0,10,7,1371,54.2,2.7,0,0.3,0.2,41.4,45.8,1506,806,700,53.52,46.48,10,796,71,629,81,1425,1.2,10.1,5.4,"25% - 50% P.O.C.","Less than $51000"
"06065045103","Census Tract 451.03, Riverside County, California",3557,51458,2351,220,31,188,0,767,66.1,6.2,0.9,5.3,0,21.6,33.9,1770,1133,637,64.01,35.99,57,1076,0,637,57,1713,5,0,3.2,"25% - 50% P.O.C.","$51000 - $70000"
"06065045108","Census Tract 451.08, Riverside County, California",6767,44078,3292,131,29,266,10,2982,48.6,1.9,0.4,3.9,0.1,44.1,51.4,2517,944,1573,37.5,62.5,41,903,209,1364,250,2267,4.3,13.3,9.9,"50% - 75% P.O.C.","Less than $51000"
"06065045109","Census Tract 451.09, Riverside County, California",4137,61199,1939,108,17,38,26,1742,46.9,2.6,0.4,0.9,0.6,42.1,53.1,1437,1106,331,76.97,23.03,176,930,32,299,208,1229,15.9,9.7,14.5,"50% - 75% P.O.C.","$51000 - $70000"
"06065045110","Census Tract 451.10, Riverside County, California",6290,60789,2286,95,0,14,0,3827,36.3,1.5,0,0.2,0,60.8,63.7,2064,1496,568,72.48,27.52,213,1283,98,470,311,1753,14.2,17.3,15.1,"50% - 75% P.O.C.","$51000 - $70000"
"06065045114","Census Tract 451.14, Riverside County, California",2153,77708,1825,24,0,62,0,210,84.8,1.1,0,2.9,0,9.8,15.2,1121,907,214,80.91,19.09,17,890,0,214,17,1104,1.9,0,1.5,"Less than 25% P.O.C.","$70000 - $95000"
"06065045115","Census Tract 451.15, Riverside County, California",1890,97292,1695,0,0,43,8,123,89.7,0,0,2.3,0.4,6.5,10.3,958,883,75,92.17,7.83,6,877,11,64,17,941,0.7,14.7,1.8,"Less than 25% P.O.C.","$95000 or more"
"06065045116","Census Tract 451.16, Riverside County, California",1479,60441,1002,0,0,52,0,420,67.7,0,0,3.5,0,28.4,32.3,758,429,329,56.6,43.4,0,429,9,320,9,749,0,2.7,1.2,"25% - 50% P.O.C.","$51000 - $70000"
"06065045117","Census Tract 451.17, Riverside County, California",4053,57102,2831,340,0,93,0,729,69.8,8.4,0,2.3,0,18,30.2,1779,899,880,50.53,49.47,29,870,23,857,52,1727,3.2,2.6,2.9,"25% - 50% P.O.C.","$51000 - $70000"
"06065045118","Census Tract 451.18, Riverside County, California",2636,43647,1154,18,0,93,0,1165,43.8,0.7,0,3.5,0,44.2,56.2,1292,647,645,50.08,49.92,19,628,32,613,51,1241,2.9,5,3.9,"50% - 75% P.O.C.","Less than $51000"
"06065045119","Census Tract 451.19, Riverside County, California",2772,62179,1706,41,14,325,0,641,61.5,1.5,0.5,11.7,0,23.1,38.5,1070,816,254,76.26,23.74,36,780,30,224,66,1004,4.4,11.8,6.2,"25% - 50% P.O.C.","$51000 - $70000"
"06065045120","Census Tract 451.20, Riverside County, California",4788,52292,1877,41,0,89,0,2754,39.2,0.9,0,1.9,0,57.5,60.8,1723,936,787,54.32,45.68,70,866,156,631,226,1497,7.5,19.8,13.1,"50% - 75% P.O.C.","$51000 - $70000"
"06065045121","Census Tract 451.21, Riverside County, California",6454,69932,4225,197,0,321,0,1606,65.5,3.1,0,5,0,24.9,34.5,2924,1925,999,65.83,34.17,56,1869,124,875,180,2744,2.9,12.4,6.2,"25% - 50% P.O.C.","$51000 - $70000"
"06065045122","Census Tract 451.22, Riverside County, California",1514,88542,1336,9,0,45,15,109,88.2,0.6,0,3,1,7.2,11.8,791,564,227,71.3,28.7,44,520,0,227,44,747,7.8,0,5.6,"Less than 25% P.O.C.","$70000 - $95000"
"06065045123","Census Tract 451.23, Riverside County, California",2428,96190,1733,0,0,145,0,466,71.4,0,0,6,0,19.2,28.6,1132,1019,113,90.02,9.98,45,974,10,103,55,1077,4.4,8.8,4.9,"25% - 50% P.O.C.","$95000 or more"
"06065045124","Census Tract 451.24, Riverside County, California",2157,63062,1394,0,0,204,0,551,64.6,0,0,9.5,0,25.5,35.4,1080,486,594,45,55,9,477,0,594,9,1071,1.9,0,0.8,"25% - 50% P.O.C.","$51000 - $70000"
"06065045125","Census Tract 451.25, Riverside County, California",3159,123792,2803,39,0,100,0,156,88.7,1.2,0,3.2,0,4.9,11.3,1439,1279,160,88.88,11.12,20,1259,44,116,64,1375,1.6,27.5,4.4,"Less than 25% P.O.C.","$95000 or more"
"06065045207","Census Tract 452.07, Riverside County, California",5449,34527,911,4,0,66,0,4403,16.7,0.1,0,1.2,0,80.8,83.3,2008,851,1157,42.38,57.62,103,748,122,1035,225,1783,12.1,10.5,11.2,"75% or more P.O.C.","Less than $51000"
"06065045209","Census Tract 452.09, Riverside County, California",5946,39636,949,244,0,27,0,4703,16,4.1,0,0.5,0,79.1,84,1944,1007,937,51.8,48.2,241,766,38,899,279,1665,23.9,4.1,14.4,"75% or more P.O.C.","Less than $51000"
"06065045212","Census Tract 452.12, Riverside County, California",2601,56142,1590,290,0,20,0,688,61.1,11.1,0,0.8,0,26.5,38.9,1185,1044,141,88.1,11.9,48,996,48,93,96,1089,4.6,34,8.1,"25% - 50% P.O.C.","$51000 - $70000"
"06065045213","Census Tract 452.13, Riverside County, California",6526,57962,1470,481,0,221,0,4270,22.5,7.4,0,3.4,0,65.4,77.5,2122,1740,382,82,18,212,1528,86,296,298,1824,12.2,22.5,14,"75% or more P.O.C.","$51000 - $70000"
"06065045214","Census Tract 452.14, Riverside County, California",5112,76974,3574,88,0,171,0,1204,69.9,1.7,0,3.3,0,23.6,30.1,2080,1478,602,71.06,28.94,87,1391,57,545,144,1936,5.9,9.5,6.9,"25% - 50% P.O.C.","$70000 - $95000"
"06065045215","Census Tract 452.15, Riverside County, California",9761,102845,5162,68,0,785,0,3224,52.9,0.7,0,8,0,33,47.1,3300,2539,761,76.94,23.06,319,2220,143,618,462,2838,12.6,18.8,14,"25% - 50% P.O.C.","$95000 or more"
"06065045216","Census Tract 452.16, Riverside County, California",2407,67458,2065,45,0,75,0,200,85.8,1.9,0,3.1,0,8.3,14.2,1279,1128,151,88.19,11.81,0,1128,10,141,10,1269,0,6.6,0.8,"Less than 25% P.O.C.","$51000 - $70000"
"06065045217","Census Tract 452.17, Riverside County, California",8275,46189,1311,531,0,62,0,6324,15.8,6.4,0,0.7,0,76.4,84.2,2447,1803,644,73.68,26.32,410,1393,196,448,606,1841,22.7,30.4,24.8,"75% or more P.O.C.","Less than $51000"
"06065045222","Census Tract 452.22, Riverside County, California",2686,51619,1156,30,0,357,0,1123,43,1.1,0,13.3,0,41.8,57,1031,836,195,81.09,18.91,69,767,38,157,107,924,8.3,19.5,10.4,"50% - 75% P.O.C.","$51000 - $70000"
"06065045224","Census Tract 452.24, Riverside County, California",5878,70759,2377,76,52,258,0,3033,40.4,1.3,0.9,4.4,0,51.6,59.6,2195,1819,376,82.87,17.13,135,1684,60,316,195,2000,7.4,16,8.9,"50% - 75% P.O.C.","$70000 - $95000"
"06065045226","Census Tract 452.26, Riverside County, California",8410,48586,331,95,0,0,0,7984,3.9,1.1,0,0,0,94.9,96.1,2479,2313,166,93.3,6.7,538,1775,22,144,560,1919,23.3,13.3,22.6,"75% or more P.O.C.","Less than $51000"
"06065045228","Census Tract 452.28, Riverside County, California",6517,81348,3763,22,0,158,0,2520,57.7,0.3,0,2.4,0,38.7,42.3,2288,2064,224,90.21,9.79,185,1879,29,195,214,2074,9,12.9,9.4,"25% - 50% P.O.C.","$70000 - $95000"
"06065045233","Census Tract 452.33, Riverside County, California",4367,59939,2218,102,0,106,0,1829,50.8,2.3,0,2.4,0,41.9,49.2,1747,699,1048,40.01,59.99,98,601,82,966,180,1567,14,7.8,10.3,"25% - 50% P.O.C.","$51000 - $70000"
"06065045302","Census Tract 453.02, Riverside County, California",4027,50729,374,0,0,13,0,3587,9.3,0,0,0.3,0,89.1,90.7,1330,989,341,74.36,25.64,129,860,47,294,176,1154,13,13.8,13.2,"75% or more P.O.C.","Less than $51000"
"06065045303","Census Tract 453.03, Riverside County, California",2639,25944,109,0,0,80,0,2450,4.1,0,0,3,0,92.8,95.9,893,363,530,40.65,59.35,36,327,118,412,154,739,9.9,22.3,17.2,"75% or more P.O.C.","Less than $51000"
"06065045304","Census Tract 453.04, Riverside County, California",10800,81204,3298,310,104,255,0,6627,30.5,2.9,1,2.4,0,61.4,69.5,3426,2828,598,82.55,17.45,424,2404,195,403,619,2807,15,32.6,18.1,"50% - 75% P.O.C.","$70000 - $95000"
"06065045501","Census Tract 455.01, Riverside County, California",5936,44236,367,364,0,6,0,5153,6.2,6.1,0,0.1,0,86.8,93.8,1831,893,938,48.77,51.23,90,803,127,811,217,1614,10.1,13.5,11.9,"75% or more P.O.C.","Less than $51000"
"06065045502","Census Tract 455.02, Riverside County, California",3788,35357,423,135,0,83,0,3080,11.2,3.6,0,2.2,0,81.3,88.8,1240,562,678,45.32,54.68,109,453,21,657,130,1110,19.4,3.1,10.5,"75% or more P.O.C.","Less than $51000"
"06065045604","Census Tract 456.04, Riverside County, California",11044,24956,271,0,0,1,0,10756,2.5,0,0,0,0,97.4,97.5,3163,2147,1016,67.88,32.12,404,1743,378,638,782,2381,18.8,37.2,24.7,"75% or more P.O.C.","Less than $51000"
"06065045605","Census Tract 456.05, Riverside County, California",6734,30063,1595,49,68,107,0,4887,23.7,0.7,1,1.6,0,72.6,76.3,2643,2190,453,82.86,17.14,169,2021,189,264,358,2285,7.7,41.7,13.5,"75% or more P.O.C.","Less than $51000"
"06065045606","Census Tract 456.06, Riverside County, California",2648,75060,1689,36,0,39,0,832,63.8,1.4,0,1.5,0,31.4,36.2,1399,1131,268,80.84,19.16,15,1116,8,260,23,1376,1.3,3,1.6,"25% - 50% P.O.C.","$70000 - $95000"
"06065045608","Census Tract 456.08, Riverside County, California",2686,151806,2407,16,8,130,0,97,89.6,0.6,0.3,4.8,0,3.6,10.4,1351,1266,85,93.71,6.29,11,1255,10,75,21,1330,0.9,11.8,1.6,"Less than 25% P.O.C.","$95000 or more"
"06065045609","Census Tract 456.09, Riverside County, California",4318,29940,193,23,0,0,0,4102,4.5,0.5,0,0,0,95,95.5,1358,1012,346,74.52,25.48,228,784,111,235,339,1019,22.5,32.1,25,"75% or more P.O.C.","Less than $51000"
"06065045703","Census Tract 457.03, Riverside County, California",6332,31819,75,0,0,24,0,6215,1.2,0,0,0.4,0,98.2,98.8,2293,1992,301,86.87,13.13,208,1784,57,244,265,2028,10.4,18.9,11.6,"75% or more P.O.C.","Less than $51000"
"06065045704","Census Tract 457.04, Riverside County, California",2723,23250,38,0,0,0,0,2685,1.4,0,0,0,0,98.6,98.6,1081,550,531,50.88,49.12,72,478,46,485,118,963,13.1,8.7,10.9,"75% or more P.O.C.","Less than $51000"
"06065045705","Census Tract 457.05, Riverside County, California",9353,31582,98,26,17,56,0,9156,1,0.3,0.2,0.6,0,97.9,99,3249,1418,1831,43.64,56.36,160,1258,379,1452,539,2710,11.3,20.7,16.6,"75% or more P.O.C.","Less than $51000"
"06065045706","Census Tract 457.06, Riverside County, California",4821,30417,48,0,0,0,0,4773,1,0,0,0,0,99,99,1536,902,634,58.72,41.28,197,705,127,507,324,1212,21.8,20,21.1,"75% or more P.O.C.","Less than $51000"
"06065045707","Census Tract 457.07, Riverside County, California",6493,30063,61,33,0,0,0,6399,0.9,0.5,0,0,0,98.6,99.1,2382,1714,668,71.96,28.04,215,1499,148,520,363,2019,12.5,22.2,15.2,"75% or more P.O.C.","Less than $51000"
"06065045900","Census Tract 459, Riverside County, California",1645,53385,681,80,0,14,0,812,41.4,4.9,0,0.9,0,49.4,58.6,593,386,207,65.09,34.91,41,345,23,184,64,529,10.6,11.1,10.8,"50% - 75% P.O.C.","$51000 - $70000"
"06065046101","Census Tract 461.01, Riverside County, California",3320,49656,934,285,0,82,0,1833,28.1,8.6,0,2.5,0,55.2,71.9,1205,552,653,45.81,54.19,95,457,90,563,185,1020,17.2,13.8,15.4,"50% - 75% P.O.C.","Less than $51000"
"06065046102","Census Tract 461.02, Riverside County, California",1881,26157,332,161,0,5,0,1321,17.7,8.6,0,0.3,0,70.2,82.3,725,165,560,22.76,77.24,7,158,23,537,30,695,4.2,4.1,4.1,"75% or more P.O.C.","Less than $51000"
"06065046103","Census Tract 461.03, Riverside County, California",3532,78843,1416,42,0,156,12,1840,40.1,1.2,0,4.4,0.3,52.1,59.9,1145,829,316,72.4,27.6,125,704,70,246,195,950,15.1,22.2,17,"50% - 75% P.O.C.","$70000 - $95000"
"06065046200","Census Tract 462, Riverside County, California",2871,25778,435,401,0,0,0,1942,15.2,14,0,0,0,67.6,84.8,1172,606,566,51.71,48.29,84,522,67,499,151,1021,13.9,11.8,12.9,"75% or more P.O.C.","Less than $51000"
"06065046401","Census Tract 464.01, Riverside County, California",3575,72310,1821,41,0,120,0,1582,50.9,1.1,0,3.4,0,44.3,49.1,1175,881,294,74.98,25.02,75,806,57,237,132,1043,8.5,19.4,11.2,"25% - 50% P.O.C.","$70000 - $95000"
"06065046402","Census Tract 464.02, Riverside County, California",5762,48650,2631,121,10,106,0,2757,45.7,2.1,0.2,1.8,0,47.8,54.3,1542,822,720,53.31,46.69,305,517,108,612,413,1129,37.1,15,26.8,"50% - 75% P.O.C.","Less than $51000"
"06065046403","Census Tract 464.03, Riverside County, California",7457,57461,2584,50,0,424,0,4115,34.7,0.7,0,5.7,0,55.2,65.3,2141,1453,688,67.87,32.13,370,1083,129,559,499,1642,25.5,18.8,23.3,"50% - 75% P.O.C.","$51000 - $70000"
"06065046404","Census Tract 464.04, Riverside County, California",6661,55833,2521,245,1,400,0,3266,37.8,3.7,0,6,0,49,62.2,1804,973,831,53.94,46.06,199,774,261,570,460,1344,20.5,31.4,25.5,"50% - 75% P.O.C.","$51000 - $70000"
"06065046405","Census Tract 464.05, Riverside County, California",3710,77550,1667,99,0,105,16,1782,44.9,2.7,0,2.8,0.4,48,55.1,1055,850,205,80.57,19.43,136,714,26,179,162,893,16,12.7,15.4,"50% - 75% P.O.C.","$70000 - $95000"
"06065046500","Census Tract 465, Riverside County, California",9412,22675,1807,673,25,2902,88,3316,19.2,7.2,0.3,30.8,0.9,35.2,80.8,1107,45,1062,4.07,95.93,0,45,84,978,84,1023,0,7.9,7.6,"75% or more P.O.C.","Less than $51000"
"06065046601","Census Tract 466.01, Riverside County, California",3385,84750,955,857,7,109,39,1162,28.2,25.3,0.2,3.2,1.2,34.3,71.8,227,133,94,58.59,41.41,7,126,7,87,14,213,5.3,7.4,6.2,"50% - 75% P.O.C.","$70000 - $95000"
"06065046602","Census Tract 466.02, Riverside County, California",3963,124680,2458,57,34,13,0,1341,62,1.4,0.9,0.3,0,33.8,38,1047,933,114,89.11,10.89,216,717,20,94,236,811,23.2,17.5,22.5,"25% - 50% P.O.C.","$95000 or more"
"06065046700","Census Tract 467, Riverside County, California",4721,43556,792,405,0,71,0,3424,16.8,8.6,0,1.5,0,72.5,83.2,1351,226,1125,16.73,83.27,85,141,248,877,333,1018,37.6,22,24.6,"75% or more P.O.C.","Less than $51000"
"06065046800","Census Tract 468, Riverside County, California",6788,68505,1370,1516,16,284,95,3444,20.2,22.3,0.2,4.2,1.4,50.7,79.8,1387,899,488,64.82,35.18,324,575,234,254,558,829,36,48,40.2,"75% or more P.O.C.","$51000 - $70000"
"06065046900","Census Tract 469, Riverside County, California",1631,40887,588,15,0,0,0,1011,36.1,0.9,0,0,0,62,63.9,568,456,112,80.28,19.72,39,417,2,110,41,527,8.6,1.8,7.2,"50% - 75% P.O.C.","Less than $51000"
"06065047000","Census Tract 470, Riverside County, California",1675,41307,812,82,7,62,0,690,48.5,4.9,0.4,3.7,0,41.2,51.5,630,432,198,68.57,31.43,30,402,36,162,66,564,6.9,18.2,10.5,"50% - 75% P.O.C.","Less than $51000"
"06065047201","Census Tract 472.01, Riverside County, California",1848,26578,1138,0,0,10,0,700,61.6,0,0,0.5,0,37.9,38.4,1003,801,202,79.86,20.14,16,785,29,173,45,958,2,14.4,4.5,"25% - 50% P.O.C.","Less than $51000"
"06065047202","Census Tract 472.02, Riverside County, California",1656,39063,1128,0,0,34,0,486,68.1,0,0,2.1,0,29.3,31.9,725,614,111,84.69,15.31,29,585,5,106,34,691,4.7,4.5,4.7,"25% - 50% P.O.C.","Less than $51000"
"06065047900","Census Tract 479, Riverside County, California",12628,132795,6291,904,20,2148,41,2601,49.8,7.2,0.2,17,0.3,20.6,50.2,3377,2921,456,86.5,13.5,789,2132,83,373,872,2505,27,18.2,25.8,"50% - 75% P.O.C.","$95000 or more"
"06065048100","Census Tract 481, Riverside County, California",7365,128457,3417,561,6,1243,0,2053,46.4,7.6,0.1,16.9,0,27.9,53.6,1957,1670,287,85.33,14.67,393,1277,118,169,511,1446,23.5,41.1,26.1,"50% - 75% P.O.C.","$95000 or more"
"06065048200","Census Tract 482, Riverside County, California",4522,103571,1407,79,0,827,20,2055,31.1,1.7,0,18.3,0.4,45.4,68.9,1258,1125,133,89.43,10.57,304,821,24,109,328,930,27,18,26.1,"50% - 75% P.O.C.","$95000 or more"
"06065048300","Census Tract 483, Riverside County, California",6632,88598,699,1502,0,443,0,3787,10.5,22.6,0,6.7,0,57.1,89.5,1655,1302,353,78.67,21.33,267,1035,156,197,423,1232,20.5,44.2,25.6,"75% or more P.O.C.","$70000 - $95000"
"06065048700","Census Tract 487, Riverside County, California",4872,83125,474,989,0,670,0,2445,9.7,20.3,0,13.8,0,50.2,90.3,1078,905,173,83.95,16.05,334,571,41,132,375,703,36.9,23.7,34.8,"75% or more P.O.C.","$70000 - $95000"
"06065048800","Census Tract 488, Riverside County, California",4917,67747,814,1347,0,263,0,2457,16.6,27.4,0,5.3,0,50,83.4,1081,729,352,67.44,32.56,183,546,126,226,309,772,25.1,35.8,28.6,"75% or more P.O.C.","$51000 - $70000"
"06065048901","Census Tract 489.01, Riverside County, California",4000,64873,559,452,0,253,0,2666,14,11.3,0,6.3,0,66.6,86,946,693,253,73.26,26.74,165,528,47,206,212,734,23.8,18.6,22.4,"75% or more P.O.C.","$51000 - $70000"
"06065048902","Census Tract 489.02, Riverside County, California",7835,50899,925,873,0,200,124,5580,11.8,11.1,0,2.6,1.6,71.2,88.2,1868,949,919,50.8,49.2,303,646,222,697,525,1343,31.9,24.2,28.1,"75% or more P.O.C.","Less than $51000"
"06065049000","Census Tract 490, Riverside County, California",10135,93007,1957,2382,0,693,11,4772,19.3,23.5,0,6.8,0.1,47.1,80.7,2342,2076,266,88.64,11.36,660,1416,25,241,685,1657,31.8,9.4,29.2,"75% or more P.O.C.","$70000 - $95000"
"06065049100","Census Tract 491, Riverside County, California",5339,54127,2990,185,0,102,0,2038,56,3.5,0,1.9,0,38.2,44,2778,1994,784,71.78,28.22,62,1932,0,784,62,2716,3.1,0,2.2,"25% - 50% P.O.C.","$51000 - $70000"
"06065049400","Census Tract 494, Riverside County, California",3067,60897,1734,26,0,35,0,1272,56.5,0.8,0,1.1,0,41.5,43.5,1419,1024,395,72.16,27.84,21,1003,115,280,136,1283,2.1,29.1,9.6,"25% - 50% P.O.C.","$51000 - $70000"
"06065049500","Census Tract 495, Riverside County, California",7220,31009,697,34,0,0,0,6482,9.7,0.5,0,0,0,89.8,90.3,2750,1617,1133,58.8,41.2,290,1327,125,1008,415,2335,17.9,11,15.1,"75% or more P.O.C.","Less than $51000"
"06065049600","Census Tract 496, Riverside County, California",8220,92262,4082,391,12,984,0,2417,49.7,4.8,0.1,12,0,29.4,50.3,2478,1009,1469,40.72,59.28,214,795,213,1256,427,2051,21.2,14.5,17.2,"50% - 75% P.O.C.","$70000 - $95000"
"06065049700","Census Tract 497, Riverside County, California",9342,138750,6051,154,27,735,0,2004,64.8,1.6,0.3,7.9,0,21.5,35.2,2446,2065,381,84.42,15.58,486,1579,81,300,567,1879,23.5,21.3,23.2,"25% - 50% P.O.C.","$95000 or more"
"06065049800","Census Tract 498, Riverside County, California",4621,70625,2068,18,0,310,14,2049,44.8,0.4,0,6.7,0.3,44.3,55.2,1485,793,692,53.4,46.6,95,698,83,609,178,1307,12,12,12,"50% - 75% P.O.C.","$70000 - $95000"
"06065050300","Census Tract 503, Riverside County, California",13390,103333,5105,1095,135,1921,108,4147,38.1,8.2,1,14.3,0.8,31,61.9,3026,2259,767,74.65,25.35,647,1612,327,440,974,2052,28.6,42.6,32.2,"50% - 75% P.O.C.","$95000 or more"
"06065050400","Census Tract 504, Riverside County, California",10943,95330,5089,291,0,781,181,4098,46.5,2.7,0,7.1,1.7,37.4,53.5,2825,1774,1051,62.8,37.2,522,1252,128,923,650,2175,29.4,12.2,23,"50% - 75% P.O.C.","$95000 or more"
"06065050500","Census Tract 505, Riverside County, California",15912,94861,5692,1300,77,1818,78,6175,35.8,8.2,0.5,11.4,0.5,38.8,64.2,4184,2251,1933,53.8,46.2,459,1792,417,1516,876,3308,20.4,21.6,20.9,"50% - 75% P.O.C.","$70000 - $95000"
"06065050600","Census Tract 506, Riverside County, California",7748,89479,4325,777,41,127,34,2171,55.8,10,0.5,1.6,0.4,28,44.2,2284,1518,766,66.46,33.54,308,1210,86,680,394,1890,20.3,11.2,17.3,"25% - 50% P.O.C.","$70000 - $95000"
"06065050700","Census Tract 507, Riverside County, California",12772,95104,5669,1209,0,981,122,3662,44.4,9.5,0,7.7,1,28.7,55.6,3172,2198,974,69.29,30.71,704,1494,241,733,945,2227,32,24.7,29.8,"50% - 75% P.O.C.","$95000 or more"
"06065050900","Census Tract 509, Riverside County, California",4682,81583,1827,363,101,637,0,1414,39,7.8,2.2,13.6,0,30.2,61,1756,653,1103,37.19,62.81,69,584,77,1026,146,1610,10.6,7,8.3,"50% - 75% P.O.C.","$70000 - $95000"
"06065051100","Census Tract 511, Riverside County, California",7242,76313,900,2286,0,819,0,3140,12.4,31.6,0,11.3,0,43.4,87.6,1760,996,764,56.59,43.41,281,715,255,509,536,1224,28.2,33.4,30.5,"75% or more P.O.C.","$70000 - $95000"
"06065051200","Census Tract 512, Riverside County, California",5113,67348,2011,92,23,323,0,2604,39.3,1.8,0.4,6.3,0,50.9,60.7,1634,675,959,41.31,58.69,122,553,109,850,231,1403,18.1,11.4,14.1,"50% - 75% P.O.C.","$51000 - $70000"
"06065051300","Census Tract 513, Riverside County, California",9719,52598,4341,312,195,381,0,4279,44.7,3.2,2,3.9,0,44,55.3,2735,2005,730,73.31,26.69,469,1536,83,647,552,2183,23.4,11.4,20.2,"50% - 75% P.O.C.","$51000 - $70000"
"06065051400","Census Tract 514, Riverside County, California",6755,60221,6072,241,0,23,0,271,89.9,3.6,0,0.3,0,4,10.1,3958,3510,448,88.68,11.32,0,3510,0,448,0,3958,0,0,0,"Less than 25% P.O.C.","$51000 - $70000"
"06065940100","Census Tract 9401, Riverside County, California",171,38958,130,0,0,12,5,24,76,0,0,7,2.9,14,24,97,92,5,94.85,5.15,0,92,0,5,0,97,0,0,0,"Less than 25% P.O.C.","Less than $51000"
"06065940400","Census Tract 9404, Riverside County, California",6818,41129,148,71,21,13,12,6516,2.2,1,0.3,0.2,0.2,95.6,97.8,2124,1951,173,91.85,8.15,313,1638,57,116,370,1754,16,32.9,17.4,"75% or more P.O.C.","Less than $51000"
"06065940500","Census Tract 9405, Riverside County, California",2150,98750,1916,22,13,37,4,128,89.1,1,0.6,1.7,0.2,6,10.9,1262,963,299,76.31,23.69,0,963,3,296,3,1259,0,1,0.2,"Less than 25% P.O.C.","$95000 or more"
"06065940600","Census Tract 9406, Riverside County, California",3183,84028,2449,51,29,166,0,389,76.9,1.6,0.9,5.2,0,12.2,23.1,1596,1443,153,90.41,9.59,34,1409,2,151,36,1560,2.4,1.3,2.3,"Less than 25% P.O.C.","$70000 - $95000"
"06065940700","Census Tract 9407, Riverside County, California",2798,61940,2133,48,23,108,3,443,76.2,1.7,0.8,3.9,0.1,15.8,23.8,1495,983,512,65.75,34.25,2,981,20,492,22,1473,0.2,3.9,1.5,"Less than 25% P.O.C.","$51000 - $70000"
"06065940800","Census Tract 9408, Riverside County, California",2748,61010,2285,25,14,70,5,299,83.2,0.9,0.5,2.5,0.2,10.9,16.8,1659,1223,436,73.72,26.28,6,1217,2,434,8,1651,0.5,0.5,0.5,"Less than 25% P.O.C.","$51000 - $70000"
"06065940900","Census Tract 9409, Riverside County, California",2097,54444,1708,47,5,57,11,233,81.4,2.2,0.2,2.7,0.5,11.1,18.6,1210,1006,204,83.14,16.86,5,1001,6,198,11,1199,0.5,2.9,0.9,"Less than 25% P.O.C.","$51000 - $70000"
"06065941000","Census Tract 9410, Riverside County, California",3832,42642,2912,150,126,41,16,491,76,3.9,3.3,1.1,0.4,12.8,24,2288,1761,527,76.97,23.03,16,1745,21,506,37,2251,0.9,4,1.6,"Less than 25% P.O.C.","Less than $51000"
"06065941100","Census Tract 9411, Riverside County, California",2072,41761,1871,6,2,30,0,140,90.3,0.3,0.1,1.4,0,6.8,9.7,1284,1159,125,90.26,9.74,4,1155,2,123,6,1278,0.3,1.6,0.5,"Less than 25% P.O.C.","Less than $51000"
"06065941200","Census Tract 9412, Riverside County, California",2735,80438,2014,84,5,131,14,412,73.6,3.1,0.2,4.8,0.5,15.1,26.4,1409,1177,232,83.53,16.47,14,1163,12,220,26,1383,1.2,5.2,1.8,"25% - 50% P.O.C.","$70000 - $95000"
"06065941300","Census Tract 9413, Riverside County, California",3366,60214,2205,240,20,132,27,691,65.5,7.1,0.6,3.9,0.8,20.5,34.5,1714,1182,532,68.96,31.04,16,1166,35,497,51,1663,1.4,6.6,3,"25% - 50% P.O.C.","$51000 - $70000"
"06065941400","Census Tract 9414, Riverside County, California",3872,46621,2268,232,14,173,0,1091,58.6,6,0.4,4.5,0,28.2,41.4,2069,859,1210,41.52,58.48,0,859,37,1173,37,2032,0,3.1,1.8,"25% - 50% P.O.C.","Less than $51000"
"06065941500","Census Tract 9415, Riverside County, California",5080,61875,1896,449,331,19,0,2295,37.3,8.8,6.5,0.4,0,45.2,62.7,1460,1131,329,77.47,22.53,211,920,129,200,340,1120,18.7,39.2,23.3,"50% - 75% P.O.C.","$51000 - $70000"
"06065980004","Census Tract 9800.04, Riverside County, California",0,NA,0,0,0,0,0,0,NA,NA,NA,NA,NA,NA,NA,0,0,0,NA,NA,0,0,0,0,0,0,NA,NA,NA,"N/A","N/A"
"06065981000","Census Tract 9810, Riverside County, California",6196,NA,1045,1136,79,161,49,3572,16.9,18.3,1.3,2.6,0.8,57.7,83.1,0,0,0,NA,NA,0,0,0,0,0,0,NA,NA,NA,"75% or more P.O.C.","N/A"
"06071000103","Census Tract 1.03, San Bernardino County, California",4438,89183,1153,167,0,1703,0,1322,26,3.8,0,38.4,0,29.8,74,1633,1084,549,66.38,33.62,74,1010,17,532,91,1542,6.8,3.1,5.6,"50% - 75% P.O.C.","$70000 - $95000"
"06071000104","Census Tract 1.04, San Bernardino County, California",6928,109105,1598,331,0,3351,0,1570,23.1,4.8,0,48.4,0,22.7,76.9,2126,1479,647,69.57,30.43,148,1331,128,519,276,1850,10,19.8,13,"75% or more P.O.C.","$95000 or more"
"06071000105","Census Tract 1.05, San Bernardino County, California",6392,120842,1711,343,150,2429,0,1609,26.8,5.4,2.3,38,0,25.2,73.2,1975,1390,585,70.38,29.62,164,1226,66,519,230,1745,11.8,11.3,11.6,"50% - 75% P.O.C.","$95000 or more"
"06071000107","Census Tract 1.07, San Bernardino County, California",3062,105250,1350,83,0,599,0,1011,44.1,2.7,0,19.6,0,33,55.9,989,761,228,76.95,23.05,97,664,16,212,113,876,12.7,7,11.4,"50% - 75% P.O.C.","$95000 or more"
"06071000108","Census Tract 1.08, San Bernardino County, California",5923,92981,1902,261,0,1761,15,1846,32.1,4.4,0,29.7,0.3,31.2,67.9,1893,1145,748,60.49,39.51,247,898,44,704,291,1602,21.6,5.9,15.4,"50% - 75% P.O.C.","$70000 - $95000"
"06071000109","Census Tract 1.09, San Bernardino County, California",6953,112931,3378,87,0,1032,0,2360,48.6,1.3,0,14.8,0,33.9,51.4,2216,2001,215,90.3,9.7,266,1735,64,151,330,1886,13.3,29.8,14.9,"50% - 75% P.O.C.","$95000 or more"
"06071000111","Census Tract 1.11, San Bernardino County, California",2721,120833,1359,193,36,649,0,430,49.9,7.1,1.3,23.9,0,15.8,50.1,854,764,90,89.46,10.54,85,679,32,58,117,737,11.1,35.6,13.7,"50% - 75% P.O.C.","$95000 or more"
"06071000113","Census Tract 1.13, San Bernardino County, California",12332,80386,2803,183,13,3029,0,5836,22.7,1.5,0.1,24.6,0,47.3,77.3,3601,2554,1047,70.92,29.08,543,2011,144,903,687,2914,21.3,13.8,19.1,"75% or more P.O.C.","$70000 - $95000"
"06071000115","Census Tract 1.15, San Bernardino County, California",8187,102935,2042,98,24,2778,0,2940,24.9,1.2,0.3,33.9,0,35.9,75.1,2578,1785,793,69.24,30.76,226,1559,28,765,254,2324,12.7,3.5,9.9,"75% or more P.O.C.","$95000 or more"
"06071000116","Census Tract 1.16, San Bernardino County, California",12989,110927,4061,889,15,5120,40,2505,31.3,6.8,0.1,39.4,0.3,19.3,68.7,3878,2998,880,77.31,22.69,359,2639,137,743,496,3382,12,15.6,12.8,"50% - 75% P.O.C.","$95000 or more"
"06071000117","Census Tract 1.17, San Bernardino County, California",6956,114481,1843,158,25,3277,0,1192,26.5,2.3,0.4,47.1,0,17.1,73.5,2308,1768,540,76.6,23.4,198,1570,52,488,250,2058,11.2,9.6,10.8,"50% - 75% P.O.C.","$95000 or more"
"06071000118","Census Tract 1.18, San Bernardino County, California",4697,132976,1014,67,12,2545,30,896,21.6,1.4,0.3,54.2,0.6,19.1,78.4,1496,1407,89,94.05,5.95,191,1216,9,80,200,1296,13.6,10.1,13.4,"75% or more P.O.C.","$95000 or more"
"06071000201","Census Tract 2.01, San Bernardino County, California",5240,61661,785,193,13,574,0,3503,15,3.7,0.2,11,0,66.9,85,1632,520,1112,31.86,68.14,126,394,207,905,333,1299,24.2,18.6,20.4,"75% or more P.O.C.","$51000 - $70000"
"06071000203","Census Tract 2.03, San Bernardino County, California",4349,78016,480,56,60,404,11,3295,11,1.3,1.4,9.3,0.3,75.8,89,1158,848,310,73.23,26.77,227,621,84,226,311,847,26.8,27.1,26.9,"75% or more P.O.C.","$70000 - $95000"
"06071000205","Census Tract 2.05, San Bernardino County, California",5449,69367,1043,97,28,442,14,3559,19.1,1.8,0.5,8.1,0.3,65.3,80.9,1440,1032,408,71.67,28.33,283,749,67,341,350,1090,27.4,16.4,24.3,"75% or more P.O.C.","$51000 - $70000"
"06071000207","Census Tract 2.07, San Bernardino County, California",4456,68750,799,80,0,391,0,3116,17.9,1.8,0,8.8,0,69.9,82.1,1084,713,371,65.77,34.23,256,457,87,284,343,741,35.9,23.5,31.6,"75% or more P.O.C.","$51000 - $70000"
"06071000208","Census Tract 2.08, San Bernardino County, California",4808,81607,716,38,67,151,75,3672,14.9,0.8,1.4,3.1,1.6,76.4,85.1,1107,818,289,73.89,26.11,273,545,118,171,391,716,33.4,40.8,35.3,"75% or more P.O.C.","$70000 - $95000"
"06071000301","Census Tract 3.01, San Bernardino County, California",9434,38258,269,571,0,1219,0,7283,2.9,6.1,0,12.9,0,77.2,97.1,2420,446,1974,18.43,81.57,90,356,592,1382,682,1738,20.2,30,28.2,"75% or more P.O.C.","Less than $51000"
"06071000303","Census Tract 3.03, San Bernardino County, California",7837,57773,498,24,0,512,0,6760,6.4,0.3,0,6.5,0,86.3,93.6,1824,1141,683,62.55,37.45,387,754,298,385,685,1139,33.9,43.6,37.6,"75% or more P.O.C.","$51000 - $70000"
"06071000304","Census Tract 3.04, San Bernardino County, California",6223,61835,935,162,50,732,0,4187,15,2.6,0.8,11.8,0,67.3,85,1631,1022,609,62.66,37.34,257,765,146,463,403,1228,25.1,24,24.7,"75% or more P.O.C.","$51000 - $70000"
"06071000401","Census Tract 4.01, San Bernardino County, California",6350,88264,1930,241,7,561,0,3306,30.4,3.8,0.1,8.8,0,52.1,69.6,1765,1177,588,66.69,33.31,208,969,176,412,384,1381,17.7,29.9,21.8,"50% - 75% P.O.C.","$70000 - $95000"
"06071000403","Census Tract 4.03, San Bernardino County, California",4261,72222,1175,95,6,342,231,2412,27.6,2.2,0.1,8,5.4,56.6,72.4,1280,956,324,74.69,25.31,168,788,33,291,201,1079,17.6,10.2,15.7,"50% - 75% P.O.C.","$70000 - $95000"
"06071000404","Census Tract 4.04, San Bernardino County, California",4048,52021,1074,158,0,403,0,2288,26.5,3.9,0,10,0,56.5,73.5,1684,626,1058,37.17,62.83,152,474,32,1026,184,1500,24.3,3,10.9,"50% - 75% P.O.C.","$51000 - $70000"
"06071000501","Census Tract 5.01, San Bernardino County, California",6286,68187,1598,175,0,722,0,3722,25.4,2.8,0,11.5,0,59.2,74.6,1771,1192,579,67.31,32.69,276,916,94,485,370,1401,23.2,16.2,20.9,"50% - 75% P.O.C.","$51000 - $70000"
"06071000503","Census Tract 5.03, San Bernardino County, California",4698,76559,947,90,0,558,20,2939,20.2,1.9,0,11.9,0.4,62.6,79.8,1344,573,771,42.63,57.37,79,494,240,531,319,1025,13.8,31.1,23.7,"75% or more P.O.C.","$70000 - $95000"
"06071000504","Census Tract 5.04, San Bernardino County, California",4530,88056,1415,56,2,427,0,2564,31.2,1.2,0,9.4,0,56.6,68.8,1362,1130,232,82.97,17.03,216,914,26,206,242,1120,19.1,11.2,17.8,"50% - 75% P.O.C.","$70000 - $95000"
"06071000603","Census Tract 6.03, San Bernardino County, California",5508,77056,1184,333,0,410,13,3509,21.5,6,0,7.4,0.2,63.7,78.5,1562,733,829,46.93,53.07,114,619,252,577,366,1196,15.6,30.4,23.4,"75% or more P.O.C.","$70000 - $95000"
"06071000604","Census Tract 6.04, San Bernardino County, California",5436,64303,1571,124,0,234,0,3358,28.9,2.3,0,4.3,0,61.8,71.1,1659,937,722,56.48,43.52,122,815,175,547,297,1362,13,24.2,17.9,"50% - 75% P.O.C.","$51000 - $70000"
"06071000605","Census Tract 6.05, San Bernardino County, California",5087,47708,376,40,0,202,0,4465,7.4,0.8,0,4,0,87.8,92.6,1175,506,669,43.06,56.94,189,317,182,487,371,804,37.4,27.2,31.6,"75% or more P.O.C.","Less than $51000"
"06071000606","Census Tract 6.06, San Bernardino County, California",4119,76463,632,104,0,416,0,2935,15.3,2.5,0,10.1,0,71.3,84.7,1032,477,555,46.22,53.78,100,377,185,370,285,747,21,33.3,27.6,"75% or more P.O.C.","$70000 - $95000"
"06071000804","Census Tract 8.04, San Bernardino County, California",3191,91897,1924,1,15,295,0,886,60.3,0,0.5,9.2,0,27.8,39.7,1179,1005,174,85.24,14.76,64,941,6,168,70,1109,6.4,3.4,5.9,"25% - 50% P.O.C.","$70000 - $95000"
"06071000808","Census Tract 8.08, San Bernardino County, California",6084,77578,2459,212,0,343,0,2914,40.4,3.5,0,5.6,0,47.9,59.6,1884,1393,491,73.94,26.06,243,1150,98,393,341,1543,17.4,20,18.1,"50% - 75% P.O.C.","$70000 - $95000"
"06071000812","Census Tract 8.12, San Bernardino County, California",3812,96722,2003,140,12,205,0,1359,52.5,3.7,0.3,5.4,0,35.7,47.5,1372,1130,242,82.36,17.64,66,1064,35,207,101,1271,5.8,14.5,7.4,"25% - 50% P.O.C.","$95000 or more"
"06071000813","Census Tract 8.13, San Bernardino County, California",3254,96746,1677,66,0,479,0,895,51.5,2,0,14.7,0,27.5,48.5,1221,1040,181,85.18,14.82,63,977,25,156,88,1133,6.1,13.8,7.2,"25% - 50% P.O.C.","$95000 or more"
"06071000814","Census Tract 8.14, San Bernardino County, California",3940,129688,2331,51,0,302,0,961,59.2,1.3,0,7.7,0,24.4,40.8,1301,1217,84,93.54,6.46,161,1056,28,56,189,1112,13.2,33.3,14.5,"25% - 50% P.O.C.","$95000 or more"
"06071000815","Census Tract 8.15, San Bernardino County, California",3491,147786,1663,124,30,551,0,1046,47.6,3.6,0.9,15.8,0,30,52.4,1210,1105,105,91.32,8.68,96,1009,29,76,125,1085,8.7,27.6,10.3,"50% - 75% P.O.C.","$95000 or more"
"06071000816","Census Tract 8.16, San Bernardino County, California",4205,122083,2347,186,0,346,0,1188,55.8,4.4,0,8.2,0,28.3,44.2,1380,1218,162,88.26,11.74,185,1033,41,121,226,1154,15.2,25.3,16.4,"25% - 50% P.O.C.","$95000 or more"
"06071000817","Census Tract 8.17, San Bernardino County, California",3897,77167,1763,122,0,583,3,1284,45.2,3.1,0,15,0.1,32.9,54.8,1356,1017,339,75,25,145,872,31,308,176,1180,14.3,9.1,13,"50% - 75% P.O.C.","$70000 - $95000"
"06071000818","Census Tract 8.18, San Bernardino County, California",5228,88641,2374,347,10,340,63,1901,45.4,6.6,0.2,6.5,1.2,36.4,54.6,1855,1354,501,72.99,27.01,127,1227,81,420,208,1647,9.4,16.2,11.2,"50% - 75% P.O.C.","$70000 - $95000"
"06071000819","Census Tract 8.19, San Bernardino County, California",5013,127833,2358,198,20,980,0,1399,47,3.9,0.4,19.5,0,27.9,53,1872,1357,515,72.49,27.51,130,1227,36,479,166,1706,9.6,7,8.9,"50% - 75% P.O.C.","$95000 or more"
"06071000820","Census Tract 8.20, San Bernardino County, California",3874,137115,2359,116,25,433,0,698,60.9,3,0.6,11.2,0,18,39.1,1294,1180,114,91.19,8.81,46,1134,24,90,70,1224,3.9,21.1,5.4,"25% - 50% P.O.C.","$95000 or more"
"06071000821","Census Tract 8.21, San Bernardino County, California",4017,67301,878,310,19,597,0,1829,21.9,7.7,0.5,14.9,0,45.5,78.1,1667,86,1581,5.16,94.84,10,76,102,1479,112,1555,11.6,6.5,6.7,"75% or more P.O.C.","$51000 - $70000"
"06071000823","Census Tract 8.23, San Bernardino County, California",6604,59071,2337,460,0,510,6,3051,35.4,7,0,7.7,0.1,46.2,64.6,2588,680,1908,26.28,73.72,29,651,135,1773,164,2424,4.3,7.1,6.3,"50% - 75% P.O.C.","$51000 - $70000"
"06071000824","Census Tract 8.24, San Bernardino County, California",5645,48545,1578,608,0,201,0,3080,28,10.8,0,3.6,0,54.6,72,1911,442,1469,23.13,76.87,37,405,211,1258,248,1663,8.4,14.4,13,"50% - 75% P.O.C.","Less than $51000"
"06071000825","Census Tract 8.25, San Bernardino County, California",4129,53349,691,487,0,189,0,2663,16.7,11.8,0,4.6,0,64.5,83.3,1547,318,1229,20.56,79.44,31,287,134,1095,165,1382,9.7,10.9,10.7,"75% or more P.O.C.","$51000 - $70000"
"06071000826","Census Tract 8.26, San Bernardino County, California",4158,65034,1396,112,0,314,0,2229,33.6,2.7,0,7.6,0,53.6,66.4,1384,860,524,62.14,37.86,83,777,83,441,166,1218,9.7,15.8,12,"50% - 75% P.O.C.","$51000 - $70000"
"06071000901","Census Tract 9.01, San Bernardino County, California",5051,61938,1605,191,18,169,0,2943,31.8,3.8,0.4,3.3,0,58.3,68.2,1745,678,1067,38.85,61.15,75,603,115,952,190,1555,11.1,10.8,10.9,"50% - 75% P.O.C.","$51000 - $70000"
"06071000903","Census Tract 9.03, San Bernardino County, California",4344,47120,854,542,0,316,0,2523,19.7,12.5,0,7.3,0,58.1,80.3,1533,290,1243,18.92,81.08,32,258,217,1026,249,1284,11,17.5,16.2,"75% or more P.O.C.","Less than $51000"
"06071000904","Census Tract 9.04, San Bernardino County, California",3662,53138,858,101,0,235,0,2439,23.4,2.8,0,6.4,0,66.6,76.6,1203,553,650,45.97,54.03,15,538,99,551,114,1089,2.7,15.2,9.5,"75% or more P.O.C.","$51000 - $70000"
"06071001001","Census Tract 10.01, San Bernardino County, California",5557,58567,915,590,0,395,0,3495,16.5,10.6,0,7.1,0,62.9,83.5,1612,774,838,48.01,51.99,219,555,123,715,342,1270,28.3,14.7,21.2,"75% or more P.O.C.","$51000 - $70000"
"06071001002","Census Tract 10.02, San Bernardino County, California",5929,53420,517,444,0,67,0,4873,8.7,7.5,0,1.1,0,82.2,91.3,1543,594,949,38.5,61.5,206,388,268,681,474,1069,34.7,28.2,30.7,"75% or more P.O.C.","$51000 - $70000"
"06071001101","Census Tract 11.01, San Bernardino County, California",4173,56196,540,24,0,371,0,3176,12.9,0.6,0,8.9,0,76.1,87.1,1222,510,712,41.73,58.27,142,368,137,575,279,943,27.8,19.2,22.8,"75% or more P.O.C.","$51000 - $70000"
"06071001103","Census Tract 11.03, San Bernardino County, California",4426,79278,1642,12,22,71,0,2679,37.1,0.3,0.5,1.6,0,60.5,62.9,1388,993,395,71.54,28.46,134,859,93,302,227,1161,13.5,23.5,16.4,"50% - 75% P.O.C.","$70000 - $95000"
"06071001104","Census Tract 11.04, San Bernardino County, California",6140,71667,1461,105,176,127,0,4119,23.8,1.7,2.9,2.1,0,67.1,76.2,1754,1054,700,60.09,39.91,196,858,102,598,298,1456,18.6,14.6,17,"75% or more P.O.C.","$70000 - $95000"
"06071001200","Census Tract 12, San Bernardino County, California",4905,84459,1872,96,0,50,41,2726,38.2,2,0,1,0.8,55.6,61.8,1626,1221,405,75.09,24.91,164,1057,51,354,215,1411,13.4,12.6,13.2,"50% - 75% P.O.C.","$70000 - $95000"
"06071001305","Census Tract 13.05, San Bernardino County, California",5788,46818,366,30,120,313,0,4938,6.3,0.5,2.1,5.4,0,85.3,93.7,1450,591,859,40.76,59.24,183,408,306,553,489,961,31,35.6,33.7,"75% or more P.O.C.","Less than $51000"
"06071001307","Census Tract 13.07, San Bernardino County, California",4212,70607,632,139,0,177,1,3238,15,3.3,0,4.2,0,76.9,85,1027,799,228,77.8,22.2,233,566,97,131,330,697,29.2,42.5,32.1,"75% or more P.O.C.","$70000 - $95000"
"06071001308","Census Tract 13.08, San Bernardino County, California",4643,62727,649,11,93,117,0,3746,14,0.2,2,2.5,0,80.7,86,1272,619,653,48.66,51.34,159,460,148,505,307,965,25.7,22.7,24.1,"75% or more P.O.C.","$51000 - $70000"
"06071001309","Census Tract 13.09, San Bernardino County, California",4658,77992,449,398,0,214,0,3480,9.6,8.5,0,4.6,0,74.7,90.4,1191,636,555,53.4,46.6,160,476,153,402,313,878,25.2,27.6,26.3,"75% or more P.O.C.","$70000 - $95000"
"06071001310","Census Tract 13.10, San Bernardino County, California",6193,67212,958,44,11,13,5,5000,15.5,0.7,0.2,0.2,0.1,80.7,84.5,1563,1052,511,67.31,32.69,268,784,195,316,463,1100,25.5,38.2,29.6,"75% or more P.O.C.","$51000 - $70000"
"06071001311","Census Tract 13.11, San Bernardino County, California",3350,84364,744,232,9,884,0,1430,22.2,6.9,0.3,26.4,0,42.7,77.8,1020,774,246,75.88,24.12,109,665,61,185,170,850,14.1,24.8,16.7,"75% or more P.O.C.","$70000 - $95000"
"06071001312","Census Tract 13.12, San Bernardino County, California",5127,75308,596,530,23,391,0,3288,11.6,10.3,0.4,7.6,0,64.1,88.4,1463,960,503,65.62,34.38,235,725,161,342,396,1067,24.5,32,27.1,"75% or more P.O.C.","$70000 - $95000"
"06071001400","Census Tract 14, San Bernardino County, California",2863,40670,673,438,14,149,0,1571,23.5,15.3,0.5,5.2,0,54.9,76.5,1285,113,1172,8.79,91.21,13,100,64,1108,77,1208,11.5,5.5,6,"75% or more P.O.C.","Less than $51000"
"06071001501","Census Tract 15.01, San Bernardino County, California",4218,52778,349,0,0,32,0,3837,8.3,0,0,0.8,0,91,91.7,1056,430,626,40.72,59.28,91,339,227,399,318,738,21.2,36.3,30.1,"75% or more P.O.C.","$51000 - $70000"
"06071001503","Census Tract 15.03, San Bernardino County, California",4126,42123,230,70,11,107,0,3649,5.6,1.7,0.3,2.6,0,88.4,94.4,982,310,672,31.57,68.43,111,199,271,401,382,600,35.8,40.3,38.9,"75% or more P.O.C.","Less than $51000"
"06071001504","Census Tract 15.04, San Bernardino County, California",6006,54074,347,614,0,658,0,4298,5.8,10.2,0,11,0,71.6,94.2,1812,433,1379,23.9,76.1,113,320,304,1075,417,1395,26.1,22,23,"75% or more P.O.C.","$51000 - $70000"
"06071001600","Census Tract 16, San Bernardino County, California",5363,42429,123,30,0,6,0,5165,2.3,0.6,0,0.1,0,96.3,97.7,1404,565,839,40.24,59.76,219,346,180,659,399,1005,38.8,21.5,28.4,"75% or more P.O.C.","Less than $51000"
"06071001702","Census Tract 17.02, San Bernardino County, California",5300,65513,1294,527,34,192,0,3127,24.4,9.9,0.6,3.6,0,59,75.6,1686,958,728,56.82,43.18,152,806,161,567,313,1373,15.9,22.1,18.6,"75% or more P.O.C.","$51000 - $70000"
"06071001703","Census Tract 17.03, San Bernardino County, California",5680,85938,1828,107,0,534,0,3061,32.2,1.9,0,9.4,0,53.9,67.8,1656,1367,289,82.55,17.45,230,1137,46,243,276,1380,16.8,15.9,16.7,"50% - 75% P.O.C.","$70000 - $95000"
"06071001704","Census Tract 17.04, San Bernardino County, California",5273,76900,745,172,0,424,63,3798,14.1,3.3,0,8,1.2,72,85.9,1392,841,551,60.42,39.58,132,709,231,320,363,1029,15.7,41.9,26.1,"75% or more P.O.C.","$70000 - $95000"
"06071001706","Census Tract 17.06, San Bernardino County, California",6283,60697,702,332,0,315,0,4741,11.2,5.3,0,5,0,75.5,88.8,1914,781,1133,40.8,59.2,97,684,276,857,373,1541,12.4,24.4,19.5,"75% or more P.O.C.","$51000 - $70000"
"06071001707","Census Tract 17.07, San Bernardino County, California",6525,79736,730,206,0,502,38,4896,11.2,3.2,0,7.7,0.6,75,88.8,1523,1047,476,68.75,31.25,386,661,251,225,637,886,36.9,52.7,41.8,"75% or more P.O.C.","$70000 - $95000"
"06071001803","Census Tract 18.03, San Bernardino County, California",3263,54237,722,73,9,282,0,2168,22.1,2.2,0.3,8.6,0,66.4,77.9,1207,719,488,59.57,40.43,104,615,57,431,161,1046,14.5,11.7,13.3,"75% or more P.O.C.","$51000 - $70000"
"06071001804","Census Tract 18.04, San Bernardino County, California",5250,79097,1114,272,31,662,0,3099,21.2,5.2,0.6,12.6,0,59,78.8,1493,1148,345,76.89,23.11,215,933,118,227,333,1160,18.7,34.2,22.3,"75% or more P.O.C.","$70000 - $95000"
"06071001806","Census Tract 18.06, San Bernardino County, California",4797,95436,947,186,1,511,0,3065,19.7,3.9,0,10.7,0,63.9,80.3,1307,1106,201,84.62,15.38,219,887,92,109,311,996,19.8,45.8,23.8,"75% or more P.O.C.","$95000 or more"
"06071001808","Census Tract 18.08, San Bernardino County, California",4644,81949,827,443,1,137,0,3104,17.8,9.5,0,3,0,66.8,82.2,1221,748,473,61.26,38.74,123,625,116,357,239,982,16.4,24.5,19.6,"75% or more P.O.C.","$70000 - $95000"
"06071001809","Census Tract 18.09, San Bernardino County, California",4975,79042,795,78,0,31,0,4012,16,1.6,0,0.6,0,80.6,84,1209,986,223,81.56,18.44,306,680,76,147,382,827,31,34.1,31.6,"75% or more P.O.C.","$70000 - $95000"
"06071001810","Census Tract 18.10, San Bernardino County, California",5273,63859,409,234,0,143,29,4421,7.8,4.4,0,2.7,0.5,83.8,92.2,1247,772,475,61.91,38.09,239,533,100,375,339,908,31,21.1,27.2,"75% or more P.O.C.","$51000 - $70000"
"06071001812","Census Tract 18.12, San Bernardino County, California",3477,48531,274,88,1,137,0,2957,7.9,2.5,0,3.9,0,85,92.1,1089,315,774,28.93,71.07,121,194,111,663,232,857,38.4,14.3,21.3,"75% or more P.O.C.","Less than $51000"
"06071001813","Census Tract 18.13, San Bernardino County, California",4855,61591,149,156,15,100,0,4417,3.1,3.2,0.3,2.1,0,91,96.9,1012,465,547,45.95,54.05,212,253,273,274,485,527,45.6,49.9,47.9,"75% or more P.O.C.","$51000 - $70000"
"06071001901","Census Tract 19.01, San Bernardino County, California",4664,106168,1319,230,2,671,0,2372,28.3,4.9,0,14.4,0,50.9,71.7,1395,1222,173,87.6,12.4,173,1049,68,105,241,1154,14.2,39.3,17.3,"50% - 75% P.O.C.","$95000 or more"
"06071001903","Census Tract 19.03, San Bernardino County, California",13753,96783,3303,678,34,4849,236,3984,24,4.9,0.2,35.3,1.7,29,76,3537,2153,1384,60.87,39.13,351,1802,353,1031,704,2833,16.3,25.5,19.9,"75% or more P.O.C.","$95000 or more"
"06071001905","Census Tract 19.05, San Bernardino County, California",6981,100919,1449,212,29,1203,0,3886,20.8,3,0.4,17.2,0,55.7,79.2,1948,1224,724,62.83,37.17,205,1019,198,526,403,1545,16.7,27.3,20.7,"75% or more P.O.C.","$95000 or more"
"06071001906","Census Tract 19.06, San Bernardino County, California",10032,83475,1953,854,0,1741,0,5081,19.5,8.5,0,17.4,0,50.6,80.5,3084,1963,1121,63.65,36.35,313,1650,249,872,562,2522,15.9,22.2,18.2,"75% or more P.O.C.","$70000 - $95000"
"06071002010","Census Tract 20.10, San Bernardino County, California",10458,126233,3490,1050,15,1751,0,3694,33.4,10,0.1,16.7,0,35.3,66.6,2851,2647,204,92.84,7.16,750,1897,38,166,788,2063,28.3,18.6,27.6,"50% - 75% P.O.C.","$95000 or more"
"06071002011","Census Tract 20.11, San Bernardino County, California",4233,134375,2708,85,0,167,0,1079,64,2,0,3.9,0,25.5,36,1243,1183,60,95.17,4.83,266,917,8,52,274,969,22.5,13.3,22,"25% - 50% P.O.C.","$95000 or more"
"06071002013","Census Tract 20.13, San Bernardino County, California",4084,103385,2469,229,0,156,0,1161,60.5,5.6,0,3.8,0,28.4,39.5,1553,982,571,63.23,36.77,125,857,0,571,125,1428,12.7,0,8,"25% - 50% P.O.C.","$95000 or more"
"06071002014","Census Tract 20.14, San Bernardino County, California",4801,125867,2728,284,2,226,0,1434,56.8,5.9,0,4.7,0,29.9,43.2,1538,1503,35,97.72,2.28,235,1268,0,35,235,1303,15.6,0,15.3,"25% - 50% P.O.C.","$95000 or more"
"06071002015","Census Tract 20.15, San Bernardino County, California",4533,89250,1961,126,26,500,0,1854,43.3,2.8,0.6,11,0,40.9,56.7,1488,1045,443,70.23,29.77,102,943,50,393,152,1336,9.8,11.3,10.2,"50% - 75% P.O.C.","$70000 - $95000"
"06071002016","Census Tract 20.16, San Bernardino County, California",3660,76136,1648,32,9,262,0,1506,45,0.9,0.2,7.2,0,41.1,55,1208,810,398,67.05,32.95,74,736,75,323,149,1059,9.1,18.8,12.3,"50% - 75% P.O.C.","$70000 - $95000"
"06071002017","Census Tract 20.17, San Bernardino County, California",5599,143170,3322,86,0,580,0,1559,59.3,1.5,0,10.4,0,27.8,40.7,1763,1715,48,97.28,2.72,263,1452,31,17,294,1469,15.3,64.6,16.7,"25% - 50% P.O.C.","$95000 or more"
"06071002018","Census Tract 20.18, San Bernardino County, California",4607,90645,2453,139,0,475,13,1356,53.2,3,0,10.3,0.3,29.4,46.8,1570,1227,343,78.15,21.85,151,1076,43,300,194,1376,12.3,12.5,12.4,"25% - 50% P.O.C.","$70000 - $95000"
"06071002019","Census Tract 20.19, San Bernardino County, California",5579,80000,1804,714,0,850,0,1946,32.3,12.8,0,15.2,0,34.9,67.7,1714,851,863,49.65,50.35,134,717,213,650,347,1367,15.7,24.7,20.2,"50% - 75% P.O.C.","$70000 - $95000"
"06071002021","Census Tract 20.21, San Bernardino County, California",5402,133864,2215,315,6,800,15,1762,41,5.8,0.1,14.8,0.3,32.6,59,1642,1337,305,81.43,18.57,144,1193,108,197,252,1390,10.8,35.4,15.3,"50% - 75% P.O.C.","$95000 or more"
"06071002022","Census Tract 20.22, San Bernardino County, California",13434,152740,4875,880,12,3029,0,3982,36.3,6.6,0.1,22.5,0,29.6,63.7,3650,3346,304,91.67,8.33,700,2646,93,211,793,2857,20.9,30.6,21.7,"50% - 75% P.O.C.","$95000 or more"
"06071002023","Census Tract 20.23, San Bernardino County, California",5846,63777,2305,402,31,356,0,2431,39.4,6.9,0.5,6.1,0,41.6,60.6,2281,793,1488,34.77,65.23,19,774,220,1268,239,2042,2.4,14.8,10.5,"50% - 75% P.O.C.","$51000 - $70000"
"06071002025","Census Tract 20.25, San Bernardino County, California",5211,88750,2828,161,0,229,0,1792,54.3,3.1,0,4.4,0,34.4,45.7,1772,1509,263,85.16,14.84,251,1258,35,228,286,1486,16.6,13.3,16.1,"25% - 50% P.O.C.","$70000 - $95000"
"06071002027","Census Tract 20.27, San Bernardino County, California",5415,68988,1683,474,0,350,0,2752,31.1,8.8,0,6.5,0,50.8,68.9,1985,1413,572,71.18,28.82,222,1191,47,525,269,1716,15.7,8.2,13.6,"50% - 75% P.O.C.","$51000 - $70000"
"06071002028","Census Tract 20.28, San Bernardino County, California",5229,76681,2192,381,0,282,323,1948,41.9,7.3,0,5.4,6.2,37.3,58.1,1631,1178,453,72.23,27.77,164,1014,46,407,210,1421,13.9,10.2,12.9,"50% - 75% P.O.C.","$70000 - $95000"
"06071002029","Census Tract 20.29, San Bernardino County, California",5886,107708,2803,453,0,648,0,1865,47.6,7.7,0,11,0,31.7,52.4,1825,1593,232,87.29,12.71,229,1364,105,127,334,1491,14.4,45.3,18.3,"50% - 75% P.O.C.","$95000 or more"
"06071002031","Census Tract 20.31, San Bernardino County, California",6262,120714,2357,453,0,1064,0,2189,37.6,7.2,0,17,0,35,62.4,1834,1574,260,85.82,14.18,204,1370,61,199,265,1569,13,23.5,14.4,"50% - 75% P.O.C.","$95000 or more"
"06071002033","Census Tract 20.33, San Bernardino County, California",7734,99972,2491,631,0,1374,0,3162,32.2,8.2,0,17.8,0,40.9,67.8,2419,1982,437,81.93,18.07,251,1731,69,368,320,2099,12.7,15.8,13.2,"50% - 75% P.O.C.","$95000 or more"
"06071002034","Census Tract 20.34, San Bernardino County, California",15502,108145,3808,1775,1,3322,0,5896,24.6,11.5,0,21.4,0,38,75.4,4555,2653,1902,58.24,41.76,788,1865,134,1768,922,3633,29.7,7,20.2,"75% or more P.O.C.","$95000 or more"
"06071002035","Census Tract 20.35, San Bernardino County, California",7445,89650,2664,577,0,1077,30,2837,35.8,7.8,0,14.5,0.4,38.1,64.2,2411,1633,778,67.73,32.27,267,1366,118,660,385,2026,16.4,15.2,16,"50% - 75% P.O.C.","$70000 - $95000"
"06071002036","Census Tract 20.36, San Bernardino County, California",14218,80802,3395,3423,218,2464,0,4497,23.9,24.1,1.5,17.3,0,31.6,76.1,4796,1070,3726,22.31,77.69,94,976,649,3077,743,4053,8.8,17.4,15.5,"75% or more P.O.C.","$70000 - $95000"
"06071002037","Census Tract 20.37, San Bernardino County, California",7949,104423,936,1515,132,993,0,4097,11.8,19.1,1.7,12.5,0,51.5,88.2,2202,1867,335,84.79,15.21,324,1543,143,192,467,1735,17.4,42.7,21.2,"75% or more P.O.C.","$95000 or more"
"06071002038","Census Tract 20.38, San Bernardino County, California",6890,110348,1155,1629,0,836,0,2899,16.8,23.6,0,12.1,0,42.1,83.2,1616,1375,241,85.09,14.91,398,977,174,67,572,1044,28.9,72.2,35.4,"75% or more P.O.C.","$95000 or more"
"06071002101","Census Tract 21.01, San Bernardino County, California",4960,55179,1116,320,120,108,18,2994,22.5,6.5,2.4,2.2,0.4,60.4,77.5,1405,762,643,54.23,45.77,149,613,226,417,375,1030,19.6,35.1,26.7,"75% or more P.O.C.","$51000 - $70000"
"06071002103","Census Tract 21.03, San Bernardino County, California",5334,47188,1456,643,0,509,59,2398,27.3,12.1,0,9.5,1.1,45,72.7,1904,436,1468,22.9,77.1,44,392,111,1357,155,1749,10.1,7.6,8.1,"50% - 75% P.O.C.","Less than $51000"
"06071002105","Census Tract 21.05, San Bernardino County, California",5920,74592,1217,479,8,755,0,3218,20.6,8.1,0.1,12.8,0,54.4,79.4,1956,1243,713,63.55,36.45,117,1126,185,528,302,1654,9.4,25.9,15.4,"75% or more P.O.C.","$70000 - $95000"
"06071002107","Census Tract 21.07, San Bernardino County, California",5577,52457,1616,665,28,243,0,2784,29,11.9,0.5,4.4,0,49.9,71,1927,667,1260,34.61,65.39,41,626,272,988,313,1614,6.1,21.6,16.2,"50% - 75% P.O.C.","$51000 - $70000"
"06071002109","Census Tract 21.09, San Bernardino County, California",6121,62500,1641,1084,0,1124,136,1852,26.8,17.7,0,18.4,2.2,30.3,73.2,2660,268,2392,10.08,89.92,26,242,150,2242,176,2484,9.7,6.3,6.6,"50% - 75% P.O.C.","$51000 - $70000"
"06071002110","Census Tract 21.10, San Bernardino County, California",7460,64511,2143,1456,56,938,25,2619,28.7,19.5,0.8,12.6,0.3,35.1,71.3,3264,267,2997,8.18,91.82,74,193,57,2940,131,3133,27.7,1.9,4,"50% - 75% P.O.C.","$51000 - $70000"
"06071002204","Census Tract 22.04, San Bernardino County, California",6624,64676,589,522,0,453,0,5007,8.9,7.9,0,6.8,0,75.6,91.1,1562,873,689,55.89,44.11,374,499,126,563,500,1062,42.8,18.3,32,"75% or more P.O.C.","$51000 - $70000"
"06071002206","Census Tract 22.06, San Bernardino County, California",7293,79375,1407,459,9,460,0,4721,19.3,6.3,0.1,6.3,0,64.7,80.7,2079,1600,479,76.96,23.04,454,1146,70,409,524,1555,28.4,14.6,25.2,"75% or more P.O.C.","$70000 - $95000"
"06071002207","Census Tract 22.07, San Bernardino County, California",5553,55852,943,1215,9,300,0,2980,17,21.9,0.2,5.4,0,53.7,83,911,197,714,21.62,78.38,29,168,81,633,110,801,14.7,11.3,12.1,"75% or more P.O.C.","$51000 - $70000"
"06071002301","Census Tract 23.01, San Bernardino County, California",11473,73401,783,547,23,956,3,8773,6.8,4.8,0.2,8.3,0,76.5,93.2,2905,2106,799,72.5,27.5,595,1511,253,546,848,2057,28.3,31.7,29.2,"75% or more P.O.C.","$70000 - $95000"
"06071002304","Census Tract 23.04, San Bernardino County, California",21798,101642,3829,2546,114,2870,0,11661,17.6,11.7,0.5,13.2,0,53.5,82.4,5471,4532,939,82.84,17.16,1479,3053,255,684,1734,3737,32.6,27.2,31.7,"75% or more P.O.C.","$95000 or more"
"06071002305","Census Tract 23.05, San Bernardino County, California",10909,77000,1476,1257,13,793,0,7208,13.5,11.5,0.1,7.3,0,66.1,86.5,2944,2427,517,82.44,17.56,554,1873,143,374,697,2247,22.8,27.7,23.7,"75% or more P.O.C.","$70000 - $95000"
"06071002306","Census Tract 23.06, San Bernardino County, California",4079,91813,379,429,1,231,0,2988,9.3,10.5,0,5.7,0,73.3,90.7,985,767,218,77.87,22.13,315,452,64,154,379,606,41.1,29.4,38.5,"75% or more P.O.C.","$70000 - $95000"
"06071002307","Census Tract 23.07, San Bernardino County, California",5149,78103,584,314,22,180,0,4014,11.3,6.1,0.4,3.5,0,78,88.7,1168,947,221,81.08,18.92,286,661,121,100,407,761,30.2,54.8,34.8,"75% or more P.O.C.","$70000 - $95000"
"06071002401","Census Tract 24.01, San Bernardino County, California",8682,49191,367,167,18,9,72,7914,4.2,1.9,0.2,0.1,0.8,91.2,95.8,2008,1172,836,58.37,41.63,389,783,296,540,685,1323,33.2,35.4,34.1,"75% or more P.O.C.","Less than $51000"
"06071002402","Census Tract 24.02, San Bernardino County, California",8364,53880,837,113,0,102,0,7298,10,1.4,0,1.2,0,87.3,90,2051,1164,887,56.75,43.25,431,733,269,618,700,1351,37,30.3,34.1,"75% or more P.O.C.","$51000 - $70000"
"06071002501","Census Tract 25.01, San Bernardino County, California",6840,53925,510,205,0,45,0,6080,7.5,3,0,0.7,0,88.9,92.5,1423,788,635,55.38,44.62,363,425,312,323,675,748,46.1,49.1,47.4,"75% or more P.O.C.","$51000 - $70000"
"06071002502","Census Tract 25.02, San Bernardino County, California",8979,71328,416,354,0,64,24,8050,4.6,3.9,0,0.7,0.3,89.7,95.4,1820,1476,344,81.1,18.9,622,854,227,117,849,971,42.1,66,46.6,"75% or more P.O.C.","$70000 - $95000"
"06071002601","Census Tract 26.01, San Bernardino County, California",9594,69428,1144,803,0,897,0,6392,11.9,8.4,0,9.3,0,66.6,88.1,2462,1774,688,72.06,27.94,428,1346,284,404,712,1750,24.1,41.3,28.9,"75% or more P.O.C.","$51000 - $70000"
"06071002602","Census Tract 26.02, San Bernardino County, California",7566,62743,708,568,16,283,0,5957,9.4,7.5,0.2,3.7,0,78.7,90.6,2051,1358,693,66.21,33.79,325,1033,237,456,562,1489,23.9,34.2,27.4,"75% or more P.O.C.","$51000 - $70000"
"06071002604","Census Tract 26.04, San Bernardino County, California",5592,80078,748,361,0,99,0,4093,13.4,6.5,0,1.8,0,73.2,86.6,1517,1075,442,70.86,29.14,170,905,96,346,266,1251,15.8,21.7,17.5,"75% or more P.O.C.","$70000 - $95000"
"06071002606","Census Tract 26.06, San Bernardino County, California",7857,84549,529,952,0,468,41,5681,6.7,12.1,0,6,0.5,72.3,93.3,2033,1332,701,65.52,34.48,442,890,183,518,625,1408,33.2,26.1,30.7,"75% or more P.O.C.","$70000 - $95000"
"06071002607","Census Tract 26.07, San Bernardino County, California",8987,96014,819,1221,24,492,0,5788,9.1,13.6,0.3,5.5,0,64.4,90.9,2122,1796,326,84.64,15.36,598,1198,175,151,773,1349,33.3,53.7,36.4,"75% or more P.O.C.","$95000 or more"
"06071002703","Census Tract 27.03, San Bernardino County, California",5670,90893,1192,788,0,134,0,3545,21,13.9,0,2.4,0,62.5,79,1586,1398,188,88.15,11.85,251,1147,81,107,332,1254,18,43.1,20.9,"75% or more P.O.C.","$70000 - $95000"
"06071002704","Census Tract 27.04, San Bernardino County, California",11527,104848,2668,1654,0,1496,0,5322,23.1,14.3,0,13,0,46.2,76.9,3140,2426,714,77.26,22.74,567,1859,245,469,812,2328,23.4,34.3,25.9,"75% or more P.O.C.","$95000 or more"
"06071002705","Census Tract 27.05, San Bernardino County, California",5273,79063,705,709,0,128,0,3622,13.4,13.4,0,2.4,0,68.7,86.6,1472,1301,171,88.38,11.62,359,942,15,156,374,1098,27.6,8.8,25.4,"75% or more P.O.C.","$70000 - $95000"
"06071002706","Census Tract 27.06, San Bernardino County, California",14133,109010,3389,2225,0,662,42,7517,24,15.7,0,4.7,0.3,53.2,76,3107,2857,250,91.95,8.05,603,2254,91,159,694,2413,21.1,36.4,22.3,"75% or more P.O.C.","$95000 or more"
"06071002801","Census Tract 28.01, San Bernardino County, California",5781,70353,414,327,0,210,0,4739,7.2,5.7,0,3.6,0,82,92.8,1347,634,713,47.07,52.93,259,375,195,518,454,893,40.9,27.3,33.7,"75% or more P.O.C.","$70000 - $95000"
"06071002803","Census Tract 28.03, San Bernardino County, California",4226,50972,354,254,0,55,0,3552,8.4,6,0,1.3,0,84.1,91.6,1032,354,678,34.3,65.7,100,254,207,471,307,725,28.2,30.5,29.7,"75% or more P.O.C.","Less than $51000"
"06071002804","Census Tract 28.04, San Bernardino County, California",5747,39447,240,425,0,30,0,5042,4.2,7.4,0,0.5,0,87.7,95.8,1491,196,1295,13.15,86.85,103,93,308,987,411,1080,52.6,23.8,27.6,"75% or more P.O.C.","Less than $51000"
"06071002901","Census Tract 29.01, San Bernardino County, California",4691,48238,403,118,0,101,0,4050,8.6,2.5,0,2.2,0,86.3,91.4,1211,519,692,42.86,57.14,224,295,218,474,442,769,43.2,31.5,36.5,"75% or more P.O.C.","Less than $51000"
"06071002902","Census Tract 29.02, San Bernardino County, California",6182,54103,638,525,0,111,0,4855,10.3,8.5,0,1.8,0,78.5,89.7,1752,756,996,43.15,56.85,240,516,290,706,530,1222,31.7,29.1,30.3,"75% or more P.O.C.","$51000 - $70000"
"06071003000","Census Tract 30, San Bernardino County, California",3254,29500,396,327,25,52,8,2446,12.2,10,0.8,1.6,0.2,75.2,87.8,1134,236,898,20.81,79.19,102,134,80,818,182,952,43.2,8.9,16,"75% or more P.O.C.","Less than $51000"
"06071003101","Census Tract 31.01, San Bernardino County, California",5287,64213,346,81,0,41,17,4745,6.5,1.5,0,0.8,0.3,89.7,93.5,1282,592,690,46.18,53.82,163,429,269,421,432,850,27.5,39,33.7,"75% or more P.O.C.","$51000 - $70000"
"06071003102","Census Tract 31.02, San Bernardino County, California",5919,40851,374,80,0,48,0,5417,6.3,1.4,0,0.8,0,91.5,93.7,1484,348,1136,23.45,76.55,71,277,382,754,453,1031,20.4,33.6,30.5,"75% or more P.O.C.","Less than $51000"
"06071003200","Census Tract 32, San Bernardino County, California",8222,67007,1394,359,80,14,118,6257,17,4.4,1,0.2,1.4,76.1,83,2199,1468,731,66.76,33.24,473,995,156,575,629,1570,32.2,21.3,28.6,"75% or more P.O.C.","$51000 - $70000"
"06071003301","Census Tract 33.01, San Bernardino County, California",5306,37188,448,242,0,122,0,4415,8.4,4.6,0,2.3,0,83.2,91.6,1608,520,1088,32.34,67.66,193,327,133,955,326,1282,37.1,12.2,20.3,"75% or more P.O.C.","Less than $51000"
"06071003302","Census Tract 33.02, San Bernardino County, California",6450,44400,1225,183,0,82,0,4863,19,2.8,0,1.3,0,75.4,81,1894,1038,856,54.8,45.2,342,696,155,701,497,1397,32.9,18.1,26.2,"75% or more P.O.C.","Less than $51000"
"06071003401","Census Tract 34.01, San Bernardino County, California",7654,57100,1205,484,0,87,35,5766,15.7,6.3,0,1.1,0.5,75.3,84.3,1894,1216,678,64.2,35.8,318,898,260,418,578,1316,26.2,38.3,30.5,"75% or more P.O.C.","$51000 - $70000"
"06071003403","Census Tract 34.03, San Bernardino County, California",3975,56417,749,20,25,8,0,3160,18.8,0.5,0.6,0.2,0,79.5,81.2,1077,692,385,64.25,35.75,183,509,118,267,301,776,26.4,30.6,27.9,"75% or more P.O.C.","$51000 - $70000"
"06071003404","Census Tract 34.04, San Bernardino County, California",5165,54871,346,481,7,96,0,4167,6.7,9.3,0.1,1.9,0,80.7,93.3,1335,615,720,46.07,53.93,267,348,128,592,395,940,43.4,17.8,29.6,"75% or more P.O.C.","$51000 - $70000"
"06071003405","Census Tract 34.05, San Bernardino County, California",5833,46996,422,668,0,146,0,4547,7.2,11.5,0,2.5,0,78,92.8,1584,416,1168,26.26,73.74,115,301,273,895,388,1196,27.6,23.4,24.5,"75% or more P.O.C.","Less than $51000"
"06071003503","Census Tract 35.03, San Bernardino County, California",5777,73967,543,647,0,314,0,4193,9.4,11.2,0,5.4,0,72.6,90.6,1313,1105,208,84.16,15.84,381,724,83,125,464,849,34.5,39.9,35.3,"75% or more P.O.C.","$70000 - $95000"
"06071003505","Census Tract 35.05, San Bernardino County, California",7473,53843,450,874,15,198,0,5803,6,11.7,0.2,2.6,0,77.7,94,1747,445,1302,25.47,74.53,224,221,488,814,712,1035,50.3,37.5,40.8,"75% or more P.O.C.","$51000 - $70000"
"06071003506","Census Tract 35.06, San Bernardino County, California",5535,72833,668,809,7,164,0,3873,12.1,14.6,0.1,3,0,70,87.9,1272,853,419,67.06,32.94,401,452,139,280,540,732,47,33.2,42.5,"75% or more P.O.C.","$70000 - $95000"
"06071003507","Census Tract 35.07, San Bernardino County, California",4367,76886,239,453,0,181,0,3460,5.5,10.4,0,4.1,0,79.2,94.5,1103,943,160,85.49,14.51,268,675,59,101,327,776,28.4,36.9,29.6,"75% or more P.O.C.","$70000 - $95000"
"06071003509","Census Tract 35.09, San Bernardino County, California",4343,41438,492,364,90,0,0,3397,11.3,8.4,2.1,0,0,78.2,88.7,1252,768,484,61.34,38.66,251,517,49,435,300,952,32.7,10.1,24,"75% or more P.O.C.","Less than $51000"
"06071003510","Census Tract 35.10, San Bernardino County, California",5368,45954,276,956,38,44,0,4020,5.1,17.8,0.7,0.8,0,74.9,94.9,1337,461,876,34.48,65.52,167,294,245,631,412,925,36.2,28,30.8,"75% or more P.O.C.","Less than $51000"
"06071003603","Census Tract 36.03, San Bernardino County, California",3938,71326,557,356,0,23,0,2944,14.1,9,0,0.6,0,74.8,85.9,925,703,222,76,24,242,461,59,163,301,624,34.4,26.6,32.5,"75% or more P.O.C.","$70000 - $95000"
"06071003605","Census Tract 36.05, San Bernardino County, California",4468,87600,766,364,23,65,0,3213,17.1,8.1,0.5,1.5,0,71.9,82.9,1020,836,184,81.96,18.04,362,474,43,141,405,615,43.3,23.4,39.7,"75% or more P.O.C.","$70000 - $95000"
"06071003606","Census Tract 36.06, San Bernardino County, California",4309,50239,559,0,0,120,0,3630,13,0,0,2.8,0,84.2,87,1315,917,398,69.73,30.27,132,785,140,258,272,1043,14.4,35.2,20.7,"75% or more P.O.C.","Less than $51000"
"06071003607","Census Tract 36.07, San Bernardino County, California",5532,55089,479,618,0,172,0,4173,8.7,11.2,0,3.1,0,75.4,91.3,1475,910,565,61.69,38.31,287,623,132,433,419,1056,31.5,23.4,28.4,"75% or more P.O.C.","$51000 - $70000"
"06071003609","Census Tract 36.09, San Bernardino County, California",5363,51988,273,194,0,119,0,4674,5.1,3.6,0,2.2,0,87.2,94.9,1341,746,595,55.63,44.37,210,536,226,369,436,905,28.2,38,32.5,"75% or more P.O.C.","$51000 - $70000"
"06071003611","Census Tract 36.11, San Bernardino County, California",4874,53565,713,420,0,250,0,3326,14.6,8.6,0,5.1,0,68.2,85.4,1422,768,654,54.01,45.99,165,603,89,565,254,1168,21.5,13.6,17.9,"75% or more P.O.C.","$51000 - $70000"
"06071003612","Census Tract 36.12, San Bernardino County, California",4676,57945,503,540,19,170,0,3263,10.8,11.5,0.4,3.6,0,69.8,89.2,1112,701,411,63.04,36.96,184,517,172,239,356,756,26.2,41.8,32,"75% or more P.O.C.","$51000 - $70000"
"06071003700","Census Tract 37, San Bernardino County, California",3782,30107,182,390,0,72,0,3044,4.8,10.3,0,1.9,0,80.5,95.2,1251,301,950,24.06,75.94,104,197,50,900,154,1097,34.6,5.3,12.3,"75% or more P.O.C.","Less than $51000"
"06071003801","Census Tract 38.01, San Bernardino County, California",5112,69394,375,1051,14,165,0,3506,7.3,20.6,0.3,3.2,0,68.6,92.7,1318,822,496,62.37,37.63,205,617,205,291,410,908,24.9,41.3,31.1,"75% or more P.O.C.","$51000 - $70000"
"06071003803","Census Tract 38.03, San Bernardino County, California",5531,58785,437,300,0,83,0,4592,7.9,5.4,0,1.5,0,83,92.1,1201,895,306,74.52,25.48,363,532,159,147,522,679,40.6,52,43.5,"75% or more P.O.C.","$51000 - $70000"
"06071003804","Census Tract 38.04, San Bernardino County, California",4951,57473,333,693,17,140,0,3751,6.7,14,0.3,2.8,0,75.8,93.3,1149,852,297,74.15,25.85,295,557,152,145,447,702,34.6,51.2,38.9,"75% or more P.O.C.","$51000 - $70000"
"06071003900","Census Tract 39, San Bernardino County, California",5857,57139,450,220,0,0,0,5165,7.7,3.8,0,0,0,88.2,92.3,1389,1090,299,78.47,21.53,316,774,172,127,488,901,29,57.5,35.1,"75% or more P.O.C.","$51000 - $70000"
"06071004001","Census Tract 40.01, San Bernardino County, California",4366,56576,548,185,6,14,2,3530,12.6,4.2,0.1,0.3,0,80.9,87.4,1025,719,306,70.15,29.85,189,530,126,180,315,710,26.3,41.2,30.7,"75% or more P.O.C.","$51000 - $70000"
"06071004003","Census Tract 40.03, San Bernardino County, California",5975,60737,563,3,7,36,0,5350,9.4,0.1,0.1,0.6,0,89.5,90.6,1457,970,487,66.58,33.42,315,655,166,321,481,976,32.5,34.1,33,"75% or more P.O.C.","$51000 - $70000"
"06071004004","Census Tract 40.04, San Bernardino County, California",5599,70964,1053,255,18,53,0,4198,18.8,4.6,0.3,0.9,0,75,81.2,1486,1142,344,76.85,23.15,248,894,224,120,472,1014,21.7,65.1,31.8,"75% or more P.O.C.","$70000 - $95000"
"06071004101","Census Tract 41.01, San Bernardino County, California",6404,59288,495,284,0,40,0,5558,7.7,4.4,0,0.6,0,86.8,92.3,1431,982,449,68.62,31.38,372,610,187,262,559,872,37.9,41.6,39.1,"75% or more P.O.C.","$51000 - $70000"
"06071004103","Census Tract 41.03, San Bernardino County, California",6290,51161,343,463,0,268,0,5216,5.5,7.4,0,4.3,0,82.9,94.5,1342,770,572,57.38,42.62,313,457,330,242,643,699,40.6,57.7,47.9,"75% or more P.O.C.","$51000 - $70000"
"06071004104","Census Tract 41.04, San Bernardino County, California",6360,41533,297,150,0,192,4,5603,4.7,2.4,0,3,0.1,88.1,95.3,1221,701,520,57.41,42.59,336,365,257,263,593,628,47.9,49.4,48.6,"75% or more P.O.C.","Less than $51000"
"06071004201","Census Tract 42.01, San Bernardino County, California",6943,50779,268,1744,0,431,0,4317,3.9,25.1,0,6.2,0,62.2,96.1,1701,1073,628,63.08,36.92,405,668,164,464,569,1132,37.7,26.1,33.5,"75% or more P.O.C.","Less than $51000"
"06071004202","Census Tract 42.02, San Bernardino County, California",5704,40455,150,930,11,173,81,4313,2.6,16.3,0.2,3,1.4,75.6,97.4,1432,773,659,53.98,46.02,177,596,235,424,412,1020,22.9,35.7,28.8,"75% or more P.O.C.","Less than $51000"
"06071004301","Census Tract 43.01, San Bernardino County, California",4449,59000,66,860,0,179,0,3168,1.5,19.3,0,4,0,71.2,98.5,1052,639,413,60.74,39.26,196,443,151,262,347,705,30.7,36.6,33,"75% or more P.O.C.","$51000 - $70000"
"06071004302","Census Tract 43.02, San Bernardino County, California",3655,31111,329,291,0,67,0,2916,9,8,0,1.8,0,79.8,91,982,465,517,47.35,52.65,109,356,109,408,218,764,23.4,21.1,22.2,"75% or more P.O.C.","Less than $51000"
"06071004401","Census Tract 44.01, San Bernardino County, California",4284,46470,459,111,0,57,24,3633,10.7,2.6,0,1.3,0.6,84.8,89.3,1127,953,174,84.56,15.44,318,635,31,143,349,778,33.4,17.8,31,"75% or more P.O.C.","Less than $51000"
"06071004403","Census Tract 44.03, San Bernardino County, California",5054,54650,281,321,0,152,0,4288,5.6,6.4,0,3,0,84.8,94.4,1297,934,363,72.01,27.99,255,679,125,238,380,917,27.3,34.4,29.3,"75% or more P.O.C.","$51000 - $70000"
"06071004404","Census Tract 44.04, San Bernardino County, California",4598,48571,310,544,0,63,0,3623,6.7,11.8,0,1.4,0,78.8,93.3,1370,857,513,62.55,37.45,136,721,107,406,243,1127,15.9,20.9,17.7,"75% or more P.O.C.","Less than $51000"
"06071004503","Census Tract 45.03, San Bernardino County, California",3718,103634,1567,190,0,233,0,1689,42.1,5.1,0,6.3,0,45.4,57.9,1009,926,83,91.77,8.23,231,695,0,83,231,778,24.9,0,22.9,"50% - 75% P.O.C.","$95000 or more"
"06071004504","Census Tract 45.04, San Bernardino County, California",8479,91387,1745,1367,0,470,0,4576,20.6,16.1,0,5.5,0,54,79.4,2505,1713,792,68.38,31.62,332,1381,177,615,509,1996,19.4,22.3,20.3,"75% or more P.O.C.","$70000 - $95000"
"06071004505","Census Tract 45.05, San Bernardino County, California",4989,55500,991,758,36,10,0,2832,19.9,15.2,0.7,0.2,0,56.8,80.1,1608,746,862,46.39,53.61,127,619,74,788,201,1407,17,8.6,12.5,"75% or more P.O.C.","$51000 - $70000"
"06071004507","Census Tract 45.07, San Bernardino County, California",5498,42917,884,654,0,49,199,3663,16.1,11.9,0,0.9,3.6,66.6,83.9,1599,626,973,39.15,60.85,198,428,156,817,354,1245,31.6,16,22.1,"75% or more P.O.C.","Less than $51000"
"06071004509","Census Tract 45.09, San Bernardino County, California",5251,83722,1231,647,18,214,43,2687,23.4,12.3,0.3,4.1,0.8,51.2,76.6,1379,880,499,63.81,36.19,231,649,173,326,404,975,26.2,34.7,29.3,"75% or more P.O.C.","$70000 - $95000"
"06071004510","Census Tract 45.10, San Bernardino County, California",5422,47370,959,513,7,659,9,2881,17.7,9.5,0.1,12.2,0.2,53.1,82.3,1156,679,477,58.74,41.26,185,494,17,460,202,954,27.2,3.6,17.5,"75% or more P.O.C.","Less than $51000"
"06071004601","Census Tract 46.01, San Bernardino County, California",7261,64792,1322,780,5,202,0,4610,18.2,10.7,0.1,2.8,0,63.5,81.8,2216,1238,978,55.87,44.13,351,887,76,902,427,1789,28.4,7.8,19.3,"75% or more P.O.C.","$51000 - $70000"
"06071004603","Census Tract 46.03, San Bernardino County, California",5526,38848,1741,616,0,138,0,2867,31.5,11.1,0,2.5,0,51.9,68.5,2159,805,1354,37.29,62.71,94,711,102,1252,196,1963,11.7,7.5,9.1,"50% - 75% P.O.C.","Less than $51000"
"06071004604","Census Tract 46.04, San Bernardino County, California",5621,49453,663,454,35,23,0,4255,11.8,8.1,0.6,0.4,0,75.7,88.2,1532,931,601,60.77,39.23,214,717,252,349,466,1066,23,41.9,30.4,"75% or more P.O.C.","Less than $51000"
"06071004700","Census Tract 47, San Bernardino County, California",5424,42708,287,290,6,9,0,4807,5.3,5.3,0.1,0.2,0,88.6,94.7,1388,796,592,57.35,42.65,234,562,234,358,468,920,29.4,39.5,33.7,"75% or more P.O.C.","Less than $51000"
"06071004800","Census Tract 48, San Bernardino County, California",3263,37048,104,200,0,19,0,2940,3.2,6.1,0,0.6,0,90.1,96.8,791,341,450,43.11,56.89,128,213,124,326,252,539,37.5,27.6,31.9,"75% or more P.O.C.","Less than $51000"
"06071004900","Census Tract 49, San Bernardino County, California",7113,31587,440,457,25,79,0,6112,6.2,6.4,0.4,1.1,0,85.9,93.8,1771,720,1051,40.65,59.35,198,522,413,638,611,1160,27.5,39.3,34.5,"75% or more P.O.C.","Less than $51000"
"06071005100","Census Tract 51, San Bernardino County, California",8442,51215,1595,1281,23,93,0,5268,18.9,15.2,0.3,1.1,0,62.4,81.1,2724,1430,1294,52.5,47.5,219,1211,261,1033,480,2244,15.3,20.2,17.6,"75% or more P.O.C.","$51000 - $70000"
"06071005200","Census Tract 52, San Bernardino County, California",4508,51804,801,367,0,127,24,2859,17.8,8.1,0,2.8,0.5,63.4,82.2,1383,807,576,58.35,41.65,159,648,48,528,207,1176,19.7,8.3,15,"75% or more P.O.C.","$51000 - $70000"
"06071005300","Census Tract 53, San Bernardino County, California",5363,43668,768,561,35,106,0,3868,14.3,10.5,0.7,2,0,72.1,85.7,1560,724,836,46.41,53.59,178,546,251,585,429,1131,24.6,30,27.5,"75% or more P.O.C.","Less than $51000"
"06071005400","Census Tract 54, San Bernardino County, California",6750,40421,807,817,28,300,0,4470,12,12.1,0.4,4.4,0,66.2,88,1954,641,1313,32.8,67.2,178,463,296,1017,474,1480,27.8,22.5,24.3,"75% or more P.O.C.","Less than $51000"
"06071005500","Census Tract 55, San Bernardino County, California",9180,32354,870,1175,11,104,0,6856,9.5,12.8,0.1,1.1,0,74.7,90.5,2422,327,2095,13.5,86.5,64,263,787,1308,851,1571,19.6,37.6,35.1,"75% or more P.O.C.","Less than $51000"
"06071005600","Census Tract 56, San Bernardino County, California",6727,30569,866,1010,0,74,0,4670,12.9,15,0,1.1,0,69.4,87.1,1824,411,1413,22.53,77.47,48,363,472,941,520,1304,11.7,33.4,28.5,"75% or more P.O.C.","Less than $51000"
"06071005701","Census Tract 57.01, San Bernardino County, California",1580,15928,150,260,0,187,0,983,9.5,16.5,0,11.8,0,62.2,90.5,802,132,670,16.46,83.54,46,86,0,670,46,756,34.8,0,5.7,"75% or more P.O.C.","Less than $51000"
"06071005800","Census Tract 58, San Bernardino County, California",4013,22091,351,680,9,301,1,2627,8.7,16.9,0.2,7.5,0,65.5,91.3,1327,112,1215,8.44,91.56,66,46,195,1020,261,1066,58.9,16,19.7,"75% or more P.O.C.","Less than $51000"
"06071006100","Census Tract 61, San Bernardino County, California",9735,55694,2074,1088,186,318,60,5871,21.3,11.2,1.9,3.3,0.6,60.3,78.7,2676,1727,949,64.54,35.46,247,1480,356,593,603,2073,14.3,37.5,22.5,"75% or more P.O.C.","$51000 - $70000"
"06071006201","Census Tract 62.01, San Bernardino County, California",4435,54423,787,116,2,32,0,3419,17.7,2.6,0,0.7,0,77.1,82.3,1092,760,332,69.6,30.4,311,449,163,169,474,618,40.9,49.1,43.4,"75% or more P.O.C.","$51000 - $70000"
"06071006203","Census Tract 62.03, San Bernardino County, California",4995,33843,489,1092,0,61,0,3220,9.8,21.9,0,1.2,0,64.5,90.2,1552,417,1135,26.87,73.13,64,353,207,928,271,1281,15.3,18.2,17.5,"75% or more P.O.C.","Less than $51000"
"06071006204","Census Tract 62.04, San Bernardino County, California",4277,35280,366,1433,0,104,0,2159,8.6,33.5,0,2.4,0,50.5,91.4,1355,188,1167,13.87,86.13,22,166,198,969,220,1135,11.7,17,16.2,"75% or more P.O.C.","Less than $51000"
"06071006301","Census Tract 63.01, San Bernardino County, California",5721,37321,1170,770,0,42,0,3717,20.5,13.5,0,0.7,0,65,79.5,1488,656,832,44.09,55.91,94,562,123,709,217,1271,14.3,14.8,14.6,"75% or more P.O.C.","Less than $51000"
"06071006302","Census Tract 63.02, San Bernardino County, California",10389,47094,1173,481,0,573,0,8142,11.3,4.6,0,5.5,0,78.4,88.7,2506,1159,1347,46.25,53.75,371,788,458,889,829,1677,32,34,33.1,"75% or more P.O.C.","Less than $51000"
"06071006401","Census Tract 64.01, San Bernardino County, California",2778,37368,97,388,9,29,0,2240,3.5,14,0.3,1,0,80.6,96.5,738,362,376,49.05,50.95,162,200,124,252,286,452,44.8,33,38.8,"75% or more P.O.C.","Less than $51000"
"06071006402","Census Tract 64.02, San Bernardino County, California",4813,48942,687,309,0,216,0,3410,14.3,6.4,0,4.5,0,70.8,85.7,1314,533,781,40.56,59.44,176,357,266,515,442,872,33,34.1,33.6,"75% or more P.O.C.","Less than $51000"
"06071006500","Census Tract 65, San Bernardino County, California",8416,28807,985,924,49,353,0,5900,11.7,11,0.6,4.2,0,70.1,88.3,1973,462,1511,23.42,76.58,99,363,523,988,622,1351,21.4,34.6,31.5,"75% or more P.O.C.","Less than $51000"
"06071006601","Census Tract 66.01, San Bernardino County, California",4477,52056,847,115,132,0,0,3347,18.9,2.6,2.9,0,0,74.8,81.1,1369,668,701,48.79,51.21,114,554,133,568,247,1122,17.1,19,18,"75% or more P.O.C.","$51000 - $70000"
"06071006603","Census Tract 66.03, San Bernardino County, California",6248,67083,1059,0,2,68,0,5118,16.9,0,0,1.1,0,81.9,83.1,1578,1163,415,73.7,26.3,258,905,207,208,465,1113,22.2,49.9,29.5,"75% or more P.O.C.","$51000 - $70000"
"06071006604","Census Tract 66.04, San Bernardino County, California",3383,49816,495,492,0,86,0,2243,14.6,14.5,0,2.5,0,66.3,85.4,1197,700,497,58.48,41.52,95,605,34,463,129,1068,13.6,6.8,10.8,"75% or more P.O.C.","Less than $51000"
"06071006700","Census Tract 67, San Bernardino County, California",4391,58571,528,93,0,9,0,3761,12,2.1,0,0.2,0,85.7,88,1314,812,502,61.8,38.2,167,645,80,422,247,1067,20.6,15.9,18.8,"75% or more P.O.C.","$51000 - $70000"
"06071007000","Census Tract 70, San Bernardino County, California",7368,43138,1082,290,0,323,0,5651,14.7,3.9,0,4.4,0,76.7,85.3,2243,874,1369,38.97,61.03,121,753,309,1060,430,1813,13.8,22.6,19.2,"75% or more P.O.C.","Less than $51000"
"06071007104","Census Tract 71.04, San Bernardino County, California",3913,74618,1513,201,0,349,33,1787,38.7,5.1,0,8.9,0.8,45.7,61.3,1443,1133,310,78.52,21.48,185,948,0,310,185,1258,16.3,0,12.8,"50% - 75% P.O.C.","$70000 - $95000"
"06071007105","Census Tract 71.05, San Bernardino County, California",3168,67364,1000,179,0,400,0,1537,31.6,5.7,0,12.6,0,48.5,68.4,1146,706,440,61.61,38.39,33,673,14,426,47,1099,4.7,3.2,4.1,"50% - 75% P.O.C.","$51000 - $70000"
"06071007106","Census Tract 71.06, San Bernardino County, California",3825,72964,1313,228,0,381,18,1800,34.3,6,0,10,0.5,47.1,65.7,1307,889,418,68.02,31.98,64,825,43,375,107,1200,7.2,10.3,8.2,"50% - 75% P.O.C.","$70000 - $95000"
"06071007107","Census Tract 71.07, San Bernardino County, California",3714,38801,720,622,0,108,14,2239,19.4,16.7,0,2.9,0.4,60.3,80.6,1227,356,871,29.01,70.99,78,278,51,820,129,1098,21.9,5.9,10.5,"75% or more P.O.C.","Less than $51000"
"06071007108","Census Tract 71.08, San Bernardino County, California",2191,44183,499,339,0,141,18,1121,22.8,15.5,0,6.4,0.8,51.2,77.2,1023,102,921,9.97,90.03,24,78,49,872,73,950,23.5,5.3,7.1,"75% or more P.O.C.","Less than $51000"
"06071007109","Census Tract 71.09, San Bernardino County, California",6611,56757,2836,487,0,759,0,2358,42.9,7.4,0,11.5,0,35.7,57.1,2426,712,1714,29.35,70.65,56,656,254,1460,310,2116,7.9,14.8,12.8,"50% - 75% P.O.C.","$51000 - $70000"
"06071007110","Census Tract 71.10, San Bernardino County, California",5084,83211,1216,439,22,1082,0,1947,23.9,8.6,0.4,21.3,0,38.3,76.1,1503,1173,330,78.04,21.96,203,970,29,301,232,1271,17.3,8.8,15.4,"75% or more P.O.C.","$70000 - $95000"
"06071007200","Census Tract 72, San Bernardino County, California",5964,50347,823,452,0,1297,0,3157,13.8,7.6,0,21.7,0,52.9,86.2,1556,701,855,45.05,54.95,168,533,228,627,396,1160,24,26.7,25.4,"75% or more P.O.C.","Less than $51000"
"06071007302","Census Tract 73.02, San Bernardino County, California",9458,79293,3369,769,15,3054,365,1634,35.6,8.1,0.2,32.3,3.9,17.3,64.4,3556,2360,1196,66.37,33.63,202,2158,31,1165,233,3323,8.6,2.6,6.6,"50% - 75% P.O.C.","$70000 - $95000"
"06071007303","Census Tract 73.03, San Bernardino County, California",5039,36896,1270,509,0,987,15,2122,25.2,10.1,0,19.6,0.3,42.1,74.8,1833,189,1644,10.31,89.69,0,189,155,1489,155,1678,0,9.4,8.5,"50% - 75% P.O.C.","Less than $51000"
"06071007305","Census Tract 73.05, San Bernardino County, California",4909,38018,1217,277,2,961,29,2180,24.8,5.6,0,19.6,0.6,44.4,75.2,1605,399,1206,24.86,75.14,65,334,155,1051,220,1385,16.3,12.9,13.7,"75% or more P.O.C.","Less than $51000"
"06071007306","Census Tract 73.06, San Bernardino County, California",6070,52702,1852,919,0,1232,0,1813,30.5,15.1,0,20.3,0,29.9,69.5,2255,717,1538,31.8,68.2,236,481,113,1425,349,1906,32.9,7.3,15.5,"50% - 75% P.O.C.","$51000 - $70000"
"06071007403","Census Tract 74.03, San Bernardino County, California",8102,54627,1518,1272,0,237,0,4904,18.7,15.7,0,2.9,0,60.5,81.3,2349,1335,1014,56.83,43.17,342,993,185,829,527,1822,25.6,18.2,22.4,"75% or more P.O.C.","$51000 - $70000"
"06071007404","Census Tract 74.04, San Bernardino County, California",4644,63529,1813,417,46,133,0,2189,39,9,1,2.9,0,47.1,61,1500,1172,328,78.13,21.87,237,935,72,256,309,1191,20.2,22,20.6,"50% - 75% P.O.C.","$51000 - $70000"
"06071007407","Census Tract 74.07, San Bernardino County, California",2939,45221,336,610,0,79,0,1882,11.4,20.8,0,2.7,0,64,88.6,835,221,614,26.47,73.53,54,167,140,474,194,641,24.4,22.8,23.2,"75% or more P.O.C.","Less than $51000"
"06071007408","Census Tract 74.08, San Bernardino County, California",4796,34597,771,521,0,148,638,2666,16.1,10.9,0,3.1,13.3,55.6,83.9,1355,460,895,33.95,66.05,122,338,134,761,256,1099,26.5,15,18.9,"75% or more P.O.C.","Less than $51000"
"06071007409","Census Tract 74.09, San Bernardino County, California",6979,59693,1058,712,21,346,0,4645,15.2,10.2,0.3,5,0,66.6,84.8,1767,1266,501,71.65,28.35,447,819,109,392,556,1211,35.3,21.8,31.5,"75% or more P.O.C.","$51000 - $70000"
"06071007410","Census Tract 74.10, San Bernardino County, California",5922,39293,1715,1365,32,357,142,2011,29,23,0.5,6,2.4,34,71,2038,682,1356,33.46,66.54,48,634,268,1088,316,1722,7,19.8,15.5,"50% - 75% P.O.C.","Less than $51000"
"06071007601","Census Tract 76.01, San Bernardino County, California",7655,35919,595,978,8,538,0,5159,7.8,12.8,0.1,7,0,67.4,92.2,2021,987,1034,48.84,51.16,244,743,351,683,595,1426,24.7,33.9,29.4,"75% or more P.O.C.","Less than $51000"
"06071007603","Census Tract 76.03, San Bernardino County, California",5166,43068,886,677,0,318,0,3236,17.2,13.1,0,6.2,0,62.6,82.8,1600,627,973,39.19,60.81,120,507,241,732,361,1239,19.1,24.8,22.6,"75% or more P.O.C.","Less than $51000"
"06071007604","Census Tract 76.04, San Bernardino County, California",4806,67704,1223,215,111,188,81,2686,25.4,4.5,2.3,3.9,1.7,55.9,74.6,1307,1080,227,82.63,17.37,176,904,150,77,326,981,16.3,66.1,24.9,"50% - 75% P.O.C.","$51000 - $70000"
"06071007800","Census Tract 78, San Bernardino County, California",5698,64766,2522,831,40,641,0,1439,44.3,14.6,0.7,11.2,0,25.3,55.7,2410,366,2044,15.19,84.81,0,366,163,1881,163,2247,0,8,6.8,"50% - 75% P.O.C.","$51000 - $70000"
"06071007901","Census Tract 79.01, San Bernardino County, California",7394,111802,3290,544,0,881,0,2459,44.5,7.4,0,11.9,0,33.3,55.5,2558,2402,156,93.9,6.1,390,2012,21,135,411,2147,16.2,13.5,16.1,"50% - 75% P.O.C.","$95000 or more"
"06071007903","Census Tract 79.03, San Bernardino County, California",4512,99923,2149,365,35,425,0,1412,47.6,8.1,0.8,9.4,0,31.3,52.4,1511,1238,273,81.93,18.07,110,1128,56,217,166,1345,8.9,20.5,11,"50% - 75% P.O.C.","$95000 or more"
"06071007904","Census Tract 79.04, San Bernardino County, California",6378,126042,3064,468,23,409,0,2176,48,7.3,0.4,6.4,0,34.1,52,1957,1764,193,90.14,9.86,304,1460,22,171,326,1631,17.2,11.4,16.7,"50% - 75% P.O.C.","$95000 or more"
"06071008001","Census Tract 80.01, San Bernardino County, California",7008,75820,2177,80,0,1186,0,3319,31.1,1.1,0,16.9,0,47.4,68.9,2124,1474,650,69.4,30.6,261,1213,94,556,355,1769,17.7,14.5,16.7,"50% - 75% P.O.C.","$70000 - $95000"
"06071008002","Census Tract 80.02, San Bernardino County, California",7585,38167,1387,698,19,301,31,5047,18.3,9.2,0.3,4,0.4,66.5,81.7,2242,901,1341,40.19,59.81,269,632,252,1089,521,1721,29.9,18.8,23.2,"75% or more P.O.C.","Less than $51000"
"06071008100","Census Tract 81, San Bernardino County, California",3048,47243,1095,153,0,252,0,1474,35.9,5,0,8.3,0,48.4,64.1,1329,206,1123,15.5,84.5,0,206,48,1075,48,1281,0,4.3,3.6,"50% - 75% P.O.C.","Less than $51000"
"06071008200","Census Tract 82, San Bernardino County, California",4865,75192,3691,201,0,155,0,780,75.9,4.1,0,3.2,0,16,24.1,2210,1089,1121,49.28,50.72,82,1007,40,1081,122,2088,7.5,3.6,5.5,"Less than 25% P.O.C.","$70000 - $95000"
"06071008301","Census Tract 83.01, San Bernardino County, California",6422,89954,3798,86,15,390,62,1733,59.1,1.3,0.2,6.1,1,27,40.9,2225,1353,872,60.81,39.19,63,1290,80,792,143,2082,4.7,9.2,6.4,"25% - 50% P.O.C.","$70000 - $95000"
"06071008302","Census Tract 83.02, San Bernardino County, California",3467,124342,2844,77,0,121,0,372,82,2.2,0,3.5,0,10.7,18,1240,1117,123,90.08,9.92,81,1036,10,113,91,1149,7.3,8.1,7.3,"Less than 25% P.O.C.","$95000 or more"
"06071008401","Census Tract 84.01, San Bernardino County, California",10335,68500,4879,408,22,889,47,3708,47.2,3.9,0.2,8.6,0.5,35.9,52.8,3110,1879,1231,60.42,39.58,251,1628,41,1190,292,2818,13.4,3.3,9.4,"50% - 75% P.O.C.","$51000 - $70000"
"06071008402","Census Tract 84.02, San Bernardino County, California",6968,83373,4018,180,7,408,7,2093,57.7,2.6,0.1,5.9,0.1,30,42.3,2285,2005,280,87.75,12.25,162,1843,28,252,190,2095,8.1,10,8.3,"25% - 50% P.O.C.","$70000 - $95000"
"06071008403","Census Tract 84.03, San Bernardino County, California",6201,97163,3713,731,0,437,0,1088,59.9,11.8,0,7,0,17.5,40.1,2103,1743,360,82.88,17.12,200,1543,26,334,226,1877,11.5,7.2,10.7,"25% - 50% P.O.C.","$95000 or more"
"06071008404","Census Tract 84.04, San Bernardino County, California",3010,37500,788,425,13,154,0,1572,26.2,14.1,0.4,5.1,0,52.2,73.8,1126,136,990,12.08,87.92,3,133,72,918,75,1051,2.2,7.3,6.7,"50% - 75% P.O.C.","Less than $51000"
"06071008500","Census Tract 85, San Bernardino County, California",8540,121875,6061,82,0,915,0,1169,71,1,0,10.7,0,13.7,29,2987,2826,161,94.61,5.39,175,2651,61,100,236,2751,6.2,37.9,7.9,"25% - 50% P.O.C.","$95000 or more"
"06071008601","Census Tract 86.01, San Bernardino County, California",6112,74848,2572,238,0,453,0,2466,42.1,3.9,0,7.4,0,40.3,57.9,2084,1201,883,57.63,42.37,161,1040,32,851,193,1891,13.4,3.6,9.3,"50% - 75% P.O.C.","$70000 - $95000"
"06071008602","Census Tract 86.02, San Bernardino County, California",4182,60272,2075,113,0,302,0,1529,49.6,2.7,0,7.2,0,36.6,50.4,1463,1000,463,68.35,31.65,141,859,42,421,183,1280,14.1,9.1,12.5,"50% - 75% P.O.C.","$51000 - $70000"
"06071008703","Census Tract 87.03, San Bernardino County, California",7573,120027,5500,136,0,274,23,1408,72.6,1.8,0,3.6,0.3,18.6,27.4,2553,2331,222,91.3,8.7,374,1957,16,206,390,2163,16,7.2,15.3,"25% - 50% P.O.C.","$95000 or more"
"06071008704","Census Tract 87.04, San Bernardino County, California",8118,69559,4839,34,42,371,0,2757,59.6,0.4,0.5,4.6,0,34,40.4,2654,2166,488,81.61,18.39,384,1782,108,380,492,2162,17.7,22.1,18.5,"25% - 50% P.O.C.","$51000 - $70000"
"06071008705","Census Tract 87.05, San Bernardino County, California",4795,51233,2750,1,144,53,12,1726,57.4,0,3,1.1,0.3,36,42.6,1679,872,807,51.94,48.06,108,764,87,720,195,1484,12.4,10.8,11.6,"25% - 50% P.O.C.","$51000 - $70000"
"06071008706","Census Tract 87.06, San Bernardino County, California",14184,95735,8354,222,0,663,0,4609,58.9,1.6,0,4.7,0,32.5,41.1,4483,3555,928,79.3,20.7,600,2955,215,713,815,3668,16.9,23.2,18.2,"25% - 50% P.O.C.","$95000 or more"
"06071008708","Census Tract 87.08, San Bernardino County, California",4304,88365,2862,15,0,165,0,1220,66.5,0.3,0,3.8,0,28.3,33.5,1343,1089,254,81.09,18.91,112,977,30,224,142,1201,10.3,11.8,10.6,"25% - 50% P.O.C.","$70000 - $95000"
"06071008709","Census Tract 87.09, San Bernardino County, California",4035,49500,2281,163,0,107,0,1439,56.5,4,0,2.7,0,35.7,43.5,1600,1076,524,67.25,32.75,86,990,79,445,165,1435,8,15.1,10.3,"25% - 50% P.O.C.","Less than $51000"
"06071008710","Census Tract 87.10, San Bernardino County, California",4417,32438,1812,86,29,42,0,2349,41,1.9,0.7,1,0,53.2,59,1733,1005,728,57.99,42.01,45,960,159,569,204,1529,4.5,21.8,11.8,"50% - 75% P.O.C.","Less than $51000"
"06071008800","Census Tract 88, San Bernardino County, California",6286,62353,3334,122,0,38,38,2733,53,1.9,0,0.6,0.6,43.5,47,2178,1165,1013,53.49,46.51,122,1043,150,863,272,1906,10.5,14.8,12.5,"25% - 50% P.O.C.","$51000 - $70000"
"06071008901","Census Tract 89.01, San Bernardino County, California",1954,37917,1415,101,9,33,0,357,72.4,5.2,0.5,1.7,0,18.3,27.6,872,503,369,57.68,42.32,44,459,56,313,100,772,8.7,15.2,11.5,"25% - 50% P.O.C.","Less than $51000"
"06071009107","Census Tract 91.07, San Bernardino County, California",7661,52357,4561,0,0,345,84,2629,59.5,0,0,4.5,1.1,34.3,40.5,2666,1964,702,73.67,26.33,390,1574,59,643,449,2217,19.9,8.4,16.8,"25% - 50% P.O.C.","$51000 - $70000"
"06071009108","Census Tract 91.08, San Bernardino County, California",7605,57852,3406,117,0,66,154,3789,44.8,1.5,0,0.9,2,49.8,55.2,1952,1438,514,73.67,26.33,336,1102,237,277,573,1379,23.4,46.1,29.4,"50% - 75% P.O.C.","$51000 - $70000"
"06071009109","Census Tract 91.09, San Bernardino County, California",6639,62120,4228,77,11,259,79,1774,63.7,1.2,0.2,3.9,1.2,26.7,36.3,2087,1690,397,80.98,19.02,334,1356,83,314,417,1670,19.8,20.9,20,"25% - 50% P.O.C.","$51000 - $70000"
"06071009110","Census Tract 91.10, San Bernardino County, California",18069,71828,2964,3933,17,1120,0,9323,16.4,21.8,0.1,6.2,0,51.6,83.6,4747,3314,1433,69.81,30.19,756,2558,462,971,1218,3529,22.8,32.2,25.7,"75% or more P.O.C.","$70000 - $95000"
"06071009112","Census Tract 91.12, San Bernardino County, California",9555,63635,755,1352,8,200,0,6731,7.9,14.1,0.1,2.1,0,70.4,92.1,2214,1456,758,65.76,34.24,507,949,373,385,880,1334,34.8,49.2,39.7,"75% or more P.O.C.","$51000 - $70000"
"06071009114","Census Tract 91.14, San Bernardino County, California",10227,54573,1297,1772,0,167,0,6661,12.7,17.3,0,1.6,0,65.1,87.3,2480,1493,987,60.2,39.8,447,1046,433,554,880,1600,29.9,43.9,35.5,"75% or more P.O.C.","$51000 - $70000"
"06071009116","Census Tract 91.16, San Bernardino County, California",6700,27188,899,1678,0,167,0,3870,13.4,25,0,2.5,0,57.8,86.6,1863,543,1320,29.15,70.85,130,413,349,971,479,1384,23.9,26.4,25.7,"75% or more P.O.C.","Less than $51000"
"06071009117","Census Tract 91.17, San Bernardino County, California",8697,36818,1947,1267,0,38,49,5220,22.4,14.6,0,0.4,0.6,60,77.6,1704,1019,685,59.8,40.2,243,776,264,421,507,1197,23.8,38.5,29.8,"75% or more P.O.C.","Less than $51000"
"06071009118","Census Tract 91.18, San Bernardino County, California",21531,83573,5573,3243,1,830,0,11139,25.9,15.1,0,3.9,0,51.7,74.1,5705,3618,2087,63.42,36.58,995,2623,573,1514,1568,4137,27.5,27.5,27.5,"50% - 75% P.O.C.","$70000 - $95000"
"06071009119","Census Tract 91.19, San Bernardino County, California",6128,75804,3294,134,0,48,15,2475,53.8,2.2,0,0.8,0.2,40.4,46.2,1779,1565,214,87.97,12.03,259,1306,62,152,321,1458,16.5,29,18,"25% - 50% P.O.C.","$70000 - $95000"
"06071009201","Census Tract 92.01, San Bernardino County, California",3984,64841,2971,0,13,21,6,811,74.6,0,0.3,0.5,0.2,20.4,25.4,1538,1179,359,76.66,23.34,108,1071,65,294,173,1365,9.2,18.1,11.2,"25% - 50% P.O.C.","$51000 - $70000"
"06071009202","Census Tract 92.02, San Bernardino County, California",1858,46974,1232,6,9,290,0,312,66.3,0.3,0.5,15.6,0,16.8,33.7,838,679,159,81.03,18.97,0,679,12,147,12,826,0,7.5,1.4,"25% - 50% P.O.C.","Less than $51000"
"06071009300","Census Tract 93, San Bernardino County, California",1037,34766,431,37,3,2,0,557,41.6,3.6,0.3,0.2,0,53.7,58.4,412,231,181,56.07,43.93,27,204,17,164,44,368,11.7,9.4,10.7,"50% - 75% P.O.C.","Less than $51000"
"06071009400","Census Tract 94, San Bernardino County, California",3262,22031,816,810,37,34,11,1450,25,24.8,1.1,1,0.3,44.5,75,1347,312,1035,23.16,76.84,38,274,69,966,107,1240,12.2,6.7,7.9,"75% or more P.O.C.","Less than $51000"
"06071009500","Census Tract 95, San Bernardino County, California",7903,32596,1890,1716,61,0,0,3196,23.9,21.7,0.8,0,0,40.4,76.1,2784,1022,1762,36.71,63.29,149,873,281,1481,430,2354,14.6,15.9,15.4,"75% or more P.O.C.","Less than $51000"
"06071009707","Census Tract 97.07, San Bernardino County, California",6433,51957,4228,367,16,301,3,1502,65.7,5.7,0.2,4.7,0,23.3,34.3,2969,2231,738,75.14,24.86,126,2105,14,724,140,2829,5.6,1.9,4.7,"25% - 50% P.O.C.","$51000 - $70000"
"06071009708","Census Tract 97.08, San Bernardino County, California",5488,54231,4117,80,16,33,0,1172,75,1.5,0.3,0.6,0,21.4,25,1860,1484,376,79.78,20.22,199,1285,85,291,284,1576,13.4,22.6,15.3,"25% - 50% P.O.C.","$51000 - $70000"
"06071009709","Census Tract 97.09, San Bernardino County, California",6657,53611,3023,482,0,0,0,3046,45.4,7.2,0,0,0,45.8,54.6,2028,1103,925,54.39,45.61,120,983,238,687,358,1670,10.9,25.7,17.7,"50% - 75% P.O.C.","$51000 - $70000"
"06071009710","Census Tract 97.10, San Bernardino County, California",7740,40701,2716,1088,0,178,56,3326,35.1,14.1,0,2.3,0.7,43,64.9,2162,957,1205,44.26,55.74,198,759,247,958,445,1717,20.7,20.5,20.6,"50% - 75% P.O.C.","Less than $51000"
"06071009711","Census Tract 97.11, San Bernardino County, California",9766,92000,5026,951,0,513,9,2999,51.5,9.7,0,5.3,0.1,30.7,48.5,3068,2468,600,80.44,19.56,405,2063,149,451,554,2514,16.4,24.8,18.1,"25% - 50% P.O.C.","$70000 - $95000"
"06071009712","Census Tract 97.12, San Bernardino County, California",6196,36420,2801,343,41,42,0,2749,45.2,5.5,0.7,0.7,0,44.4,54.8,2072,1192,880,57.53,42.47,127,1065,190,690,317,1755,10.7,21.6,15.3,"50% - 75% P.O.C.","Less than $51000"
"06071009713","Census Tract 97.13, San Bernardino County, California",6537,52921,3100,440,0,130,0,2554,47.4,6.7,0,2,0,39.1,52.6,2180,1646,534,75.5,24.5,119,1527,96,438,215,1965,7.2,18,9.9,"50% - 75% P.O.C.","$51000 - $70000"
"06071009714","Census Tract 97.14, San Bernardino County, California",3920,50263,1650,312,0,110,0,1717,42.1,8,0,2.8,0,43.8,57.9,1190,838,352,70.42,29.58,199,639,56,296,255,935,23.7,15.9,21.4,"50% - 75% P.O.C.","Less than $51000"
"06071009715","Census Tract 97.15, San Bernardino County, California",8818,81657,4534,500,176,83,0,3391,51.4,5.7,2,0.9,0,38.5,48.6,2734,2194,540,80.25,19.75,376,1818,103,437,479,2255,17.1,19.1,17.5,"25% - 50% P.O.C.","$70000 - $95000"
"06071009716","Census Tract 97.16, San Bernardino County, California",7658,34679,2857,819,0,105,0,3627,37.3,10.7,0,1.4,0,47.4,62.7,2493,1044,1449,41.88,58.12,124,920,191,1258,315,2178,11.9,13.2,12.6,"50% - 75% P.O.C.","Less than $51000"
"06071009717","Census Tract 97.17, San Bernardino County, California",4216,80625,2293,236,0,88,10,1541,54.4,5.6,0,2.1,0.2,36.6,45.6,1340,1062,278,79.25,20.75,203,859,40,238,243,1097,19.1,14.4,18.1,"25% - 50% P.O.C.","$70000 - $95000"
"06071009800","Census Tract 98, San Bernardino County, California",4820,28969,763,574,16,47,0,3325,15.8,11.9,0.3,1,0,69,84.2,1453,446,1007,30.7,69.3,92,354,244,763,336,1117,20.6,24.2,23.1,"75% or more P.O.C.","Less than $51000"
"06071009904","Census Tract 99.04, San Bernardino County, California",13319,37726,2415,2159,0,189,0,8177,18.1,16.2,0,1.4,0,61.4,81.9,3777,1004,2773,26.58,73.42,215,789,849,1924,1064,2713,21.4,30.6,28.2,"75% or more P.O.C.","Less than $51000"
"06071009905","Census Tract 99.05, San Bernardino County, California",7795,47191,1409,1249,0,335,0,4449,18.1,16,0,4.3,0,57.1,81.9,2053,1226,827,59.72,40.28,248,978,287,540,535,1518,20.2,34.7,26.1,"75% or more P.O.C.","Less than $51000"
"06071009906","Census Tract 99.06, San Bernardino County, California",5087,59133,1218,809,0,326,0,2578,23.9,15.9,0,6.4,0,50.7,76.1,1384,868,516,62.72,37.28,149,719,123,393,272,1112,17.2,23.8,19.7,"75% or more P.O.C.","$51000 - $70000"
"06071009908","Census Tract 99.08, San Bernardino County, California",4509,54338,1398,526,0,92,8,2414,31,11.7,0,2,0.2,53.5,69,1277,734,543,57.48,42.52,142,592,185,358,327,950,19.3,34.1,25.6,"50% - 75% P.O.C.","$51000 - $70000"
"06071009910","Census Tract 99.10, San Bernardino County, California",5851,55385,1319,600,0,165,0,3602,22.5,10.3,0,2.8,0,61.6,77.5,1402,886,516,63.2,36.8,200,686,192,324,392,1010,22.6,37.2,28,"75% or more P.O.C.","$51000 - $70000"
"06071009911","Census Tract 99.11, San Bernardino County, California",7388,63750,1619,889,9,237,0,4161,21.9,12,0.1,3.2,0,56.3,78.1,1855,1230,625,66.31,33.69,407,823,289,336,696,1159,33.1,46.2,37.5,"75% or more P.O.C.","$51000 - $70000"
"06071009912","Census Tract 99.12, San Bernardino County, California",4745,25555,1359,962,0,156,20,2196,28.6,20.3,0,3.3,0.4,46.3,71.4,1599,605,994,37.84,62.16,81,524,180,814,261,1338,13.4,18.1,16.3,"50% - 75% P.O.C.","Less than $51000"
"06071009913","Census Tract 99.13, San Bernardino County, California",5926,38370,1525,820,2,22,0,3380,25.7,13.8,0,0.4,0,57,74.3,1658,749,909,45.17,54.83,142,607,212,697,354,1304,19,23.3,21.4,"50% - 75% P.O.C.","Less than $51000"
"06071010004","Census Tract 100.04, San Bernardino County, California",8600,84295,5837,445,188,211,31,1888,67.9,5.2,2.2,2.5,0.4,22,32.1,2941,2192,749,74.53,25.47,235,1957,144,605,379,2562,10.7,19.2,12.9,"25% - 50% P.O.C.","$70000 - $95000"
"06071010009","Census Tract 100.09, San Bernardino County, California",4025,56858,1397,251,0,39,0,2242,34.7,6.2,0,1,0,55.7,65.3,1179,813,366,68.96,31.04,205,608,30,336,235,944,25.2,8.2,19.9,"50% - 75% P.O.C.","$51000 - $70000"
"06071010010","Census Tract 100.10, San Bernardino County, California",6458,51500,1613,163,0,113,0,4536,25,2.5,0,1.7,0,70.2,75,1792,986,806,55.02,44.98,306,680,157,649,463,1329,31,19.5,25.8,"75% or more P.O.C.","$51000 - $70000"
"06071010011","Census Tract 100.11, San Bernardino County, California",5540,40820,1624,301,0,205,10,3287,29.3,5.4,0,3.7,0.2,59.3,70.7,1471,751,720,51.05,48.95,263,488,203,517,466,1005,35,28.2,31.7,"50% - 75% P.O.C.","Less than $51000"
"06071010012","Census Tract 100.12, San Bernardino County, California",4965,51533,1949,167,0,41,0,2719,39.3,3.4,0,0.8,0,54.8,60.7,1447,1046,401,72.29,27.71,207,839,90,311,297,1150,19.8,22.4,20.5,"50% - 75% P.O.C.","$51000 - $70000"
"06071010013","Census Tract 100.13, San Bernardino County, California",8283,61649,2751,221,35,152,0,5018,33.2,2.7,0.4,1.8,0,60.6,66.8,2317,1607,710,69.36,30.64,536,1071,53,657,589,1728,33.4,7.5,25.4,"50% - 75% P.O.C.","$51000 - $70000"
"06071010014","Census Tract 100.14, San Bernardino County, California",4933,36786,826,269,31,78,0,3716,16.7,5.5,0.6,1.6,0,75.3,83.3,1302,430,872,33.03,66.97,75,355,310,562,385,917,17.4,35.6,29.6,"75% or more P.O.C.","Less than $51000"
"06071010015","Census Tract 100.15, San Bernardino County, California",6315,56364,1736,53,0,17,18,4457,27.5,0.8,0,0.3,0.3,70.6,72.5,1620,1009,611,62.28,37.72,374,635,180,431,554,1066,37.1,29.5,34.2,"50% - 75% P.O.C.","$51000 - $70000"
"06071010016","Census Tract 100.16, San Bernardino County, California",6086,49461,1677,355,0,243,0,3750,27.6,5.8,0,4,0,61.6,72.4,1586,897,689,56.56,43.44,178,719,241,448,419,1167,19.8,35,26.4,"50% - 75% P.O.C.","Less than $51000"
"06071010017","Census Tract 100.17, San Bernardino County, California",16448,82790,5335,718,757,689,0,8565,32.4,4.4,4.6,4.2,0,52.1,67.6,4226,3221,1005,76.22,23.78,1061,2160,176,829,1237,2989,32.9,17.5,29.3,"50% - 75% P.O.C.","$70000 - $95000"
"06071010018","Census Tract 100.18, San Bernardino County, California",7323,64773,1955,453,38,522,0,4268,26.7,6.2,0.5,7.1,0,58.3,73.3,2042,1319,723,64.59,35.41,298,1021,228,495,526,1516,22.6,31.5,25.8,"50% - 75% P.O.C.","$51000 - $70000"
"06071010019","Census Tract 100.19, San Bernardino County, California",4911,52117,1612,71,0,60,0,3102,32.8,1.4,0,1.2,0,63.2,67.2,1471,885,586,60.16,39.84,87,798,184,402,271,1200,9.8,31.4,18.4,"50% - 75% P.O.C.","$51000 - $70000"
"06071010020","Census Tract 100.20, San Bernardino County, California",8328,32247,2068,850,0,43,0,5012,24.8,10.2,0,0.5,0,60.2,75.2,2803,891,1912,31.79,68.21,68,823,468,1444,536,2267,7.6,24.5,19.1,"75% or more P.O.C.","Less than $51000"
"06071010021","Census Tract 100.21, San Bernardino County, California",6713,70266,3135,124,6,137,30,3281,46.7,1.8,0.1,2,0.4,48.9,53.3,2080,1654,426,79.52,20.48,313,1341,184,242,497,1583,18.9,43.2,23.9,"50% - 75% P.O.C.","$70000 - $95000"
"06071010022","Census Tract 100.22, San Bernardino County, California",4692,48182,2085,50,62,52,0,2396,44.4,1.1,1.3,1.1,0,51.1,55.6,1406,931,475,66.22,33.78,173,758,153,322,326,1080,18.6,32.2,23.2,"50% - 75% P.O.C.","Less than $51000"
"06071010023","Census Tract 100.23, San Bernardino County, California",5962,62359,2473,90,14,135,19,3023,41.5,1.5,0.2,2.3,0.3,50.7,58.5,1797,1287,510,71.62,28.38,185,1102,157,353,342,1455,14.4,30.8,19,"50% - 75% P.O.C.","$51000 - $70000"
"06071010024","Census Tract 100.24, San Bernardino County, California",5354,61144,3074,158,0,53,0,1914,57.4,3,0,1,0,35.7,42.6,1678,1272,406,75.8,24.2,260,1012,151,255,411,1267,20.4,37.2,24.5,"25% - 50% P.O.C.","$51000 - $70000"
"06071010025","Census Tract 100.25, San Bernardino County, California",8440,45262,1806,887,37,368,0,5047,21.4,10.5,0.4,4.4,0,59.8,78.6,2455,1364,1091,55.56,44.44,306,1058,327,764,633,1822,22.4,30,25.8,"75% or more P.O.C.","Less than $51000"
"06071010026","Census Tract 100.26, San Bernardino County, California",11255,54880,3057,1804,0,444,72,5588,27.2,16,0,3.9,0.6,49.6,72.8,3256,1665,1591,51.14,48.86,426,1239,391,1200,817,2439,25.6,24.6,25.1,"50% - 75% P.O.C.","$51000 - $70000"
"06071010300","Census Tract 103, San Bernardino County, California",3547,52975,2159,115,67,228,0,947,60.9,3.2,1.9,6.4,0,26.7,39.1,1401,869,532,62.03,37.97,98,771,35,497,133,1268,11.3,6.6,9.5,"25% - 50% P.O.C.","$51000 - $70000"
"06071010402","Census Tract 104.02, San Bernardino County, California",9593,44383,5892,562,157,292,4,2276,61.4,5.9,1.6,3,0,23.7,38.6,1703,11,1692,0.65,99.35,0,11,365,1327,365,1338,0,21.6,21.4,"25% - 50% P.O.C.","Less than $51000"
"06071010409","Census Tract 104.09, San Bernardino County, California",3096,44881,1617,354,0,69,413,508,52.2,11.4,0,2.2,13.3,16.4,47.8,1242,812,430,65.38,34.62,8,804,47,383,55,1187,1,10.9,4.4,"25% - 50% P.O.C.","Less than $51000"
"06071010410","Census Tract 104.10, San Bernardino County, California",3126,36509,2129,104,30,46,0,705,68.1,3.3,1,1.5,0,22.6,31.9,1234,948,286,76.82,23.18,55,893,70,216,125,1109,5.8,24.5,10.1,"25% - 50% P.O.C.","Less than $51000"
"06071010411","Census Tract 104.11, San Bernardino County, California",6659,30594,4702,195,0,93,181,1230,70.6,2.9,0,1.4,2.7,18.5,29.4,2973,1639,1334,55.13,44.87,71,1568,35,1299,106,2867,4.3,2.6,3.6,"25% - 50% P.O.C.","Less than $51000"
"06071010412","Census Tract 104.12, San Bernardino County, California",7582,66580,5171,653,90,212,0,1157,68.2,8.6,1.2,2.8,0,15.3,31.8,2999,2238,761,74.62,25.38,105,2133,120,641,225,2774,4.7,15.8,7.5,"25% - 50% P.O.C.","$51000 - $70000"
"06071010413","Census Tract 104.13, San Bernardino County, California",7226,48518,4114,494,59,0,33,2383,56.9,6.8,0.8,0,0.5,33,43.1,2576,1753,823,68.05,31.95,225,1528,114,709,339,2237,12.8,13.9,13.2,"25% - 50% P.O.C.","Less than $51000"
"06071010415","Census Tract 104.15, San Bernardino County, California",5316,53483,3081,237,23,470,175,943,58,4.5,0.4,8.8,3.3,17.7,42,2043,981,1062,48.02,51.98,70,911,96,966,166,1877,7.1,9,8.1,"25% - 50% P.O.C.","$51000 - $70000"
"06071010416","Census Tract 104.16, San Bernardino County, California",3094,36500,2314,85,52,148,0,414,74.8,2.7,1.7,4.8,0,13.4,25.2,1306,982,324,75.19,24.81,94,888,38,286,132,1174,9.6,11.7,10.1,"25% - 50% P.O.C.","Less than $51000"
"06071010417","Census Tract 104.17, San Bernardino County, California",2931,53909,2390,11,0,19,0,437,81.5,0.4,0,0.6,0,14.9,18.5,1354,1027,327,75.85,24.15,77,950,0,327,77,1277,7.5,0,5.7,"Less than 25% P.O.C.","$51000 - $70000"
"06071010419","Census Tract 104.19, San Bernardino County, California",4903,44009,3588,22,11,16,0,1030,73.2,0.4,0.2,0.3,0,21,26.8,1913,1029,884,53.79,46.21,0,1029,180,704,180,1733,0,20.4,9.4,"25% - 50% P.O.C.","Less than $51000"
"06071010420","Census Tract 104.20, San Bernardino County, California",3961,24603,2952,47,10,86,44,699,74.5,1.2,0.3,2.2,1.1,17.6,25.5,1809,958,851,52.96,47.04,51,907,63,788,114,1695,5.3,7.4,6.3,"25% - 50% P.O.C.","Less than $51000"
"06071010421","Census Tract 104.21, San Bernardino County, California",6003,32917,2531,1115,0,73,57,1949,42.2,18.6,0,1.2,0.9,32.5,57.8,2574,451,2123,17.52,82.48,26,425,221,1902,247,2327,5.8,10.4,9.6,"50% - 75% P.O.C.","Less than $51000"
"06071010422","Census Tract 104.22, San Bernardino County, California",1859,46667,954,230,22,33,44,535,51.3,12.4,1.2,1.8,2.4,28.8,48.7,638,296,342,46.39,53.61,30,266,26,316,56,582,10.1,7.6,8.8,"25% - 50% P.O.C.","Less than $51000"
"06071010423","Census Tract 104.23, San Bernardino County, California",3461,32122,2540,78,69,38,0,616,73.4,2.3,2,1.1,0,17.8,26.6,1591,1297,294,81.52,18.48,3,1294,34,260,37,1554,0.2,11.6,2.3,"25% - 50% P.O.C.","Less than $51000"
"06071010424","Census Tract 104.24, San Bernardino County, California",2078,34139,1517,22,29,35,10,427,73,1.1,1.4,1.7,0.5,20.5,27,947,648,299,68.43,31.57,21,627,65,234,86,861,3.2,21.7,9.1,"25% - 50% P.O.C.","Less than $51000"
"06071010700","Census Tract 107, San Bernardino County, California",4011,34841,2750,134,186,21,0,807,68.6,3.3,4.6,0.5,0,20.1,31.4,1578,776,802,49.18,50.82,101,675,48,754,149,1429,13,6,9.4,"25% - 50% P.O.C.","Less than $51000"
"06071010802","Census Tract 108.02, San Bernardino County, California",3820,55684,2851,140,0,0,0,829,74.6,3.7,0,0,0,21.7,25.4,1597,1283,314,80.34,19.66,113,1170,41,273,154,1443,8.8,13.1,9.6,"25% - 50% P.O.C.","$51000 - $70000"
"06071010803","Census Tract 108.03, San Bernardino County, California",3171,66538,2277,27,70,25,0,742,71.8,0.9,2.2,0.8,0,23.4,28.2,1212,850,362,70.13,29.87,82,768,41,321,123,1089,9.6,11.3,10.1,"25% - 50% P.O.C.","$51000 - $70000"
"06071010804","Census Tract 108.04, San Bernardino County, California",2620,66127,1946,42,29,67,0,427,74.3,1.6,1.1,2.6,0,16.3,25.7,1006,657,349,65.31,34.69,0,657,23,326,23,983,0,6.6,2.3,"25% - 50% P.O.C.","$51000 - $70000"
"06071010901","Census Tract 109.01, San Bernardino County, California",4121,79053,3260,72,71,69,0,613,79.1,1.7,1.7,1.7,0,14.9,20.9,1681,1232,449,73.29,26.71,109,1123,20,429,129,1552,8.8,4.5,7.7,"Less than 25% P.O.C.","$70000 - $95000"
"06071010902","Census Tract 109.02, San Bernardino County, California",2097,73243,1416,7,0,59,16,485,67.5,0.3,0,2.8,0.8,23.1,32.5,810,700,110,86.42,13.58,61,639,19,91,80,730,8.7,17.3,9.9,"25% - 50% P.O.C.","$70000 - $95000"
"06071011001","Census Tract 110.01, San Bernardino County, California",1929,41838,1228,6,16,0,0,586,63.7,0.3,0.8,0,0,30.4,36.3,760,382,378,50.26,49.74,0,382,48,330,48,712,0,12.7,6.3,"25% - 50% P.O.C.","Less than $51000"
"06071011002","Census Tract 110.02, San Bernardino County, California",1423,68036,862,48,13,32,0,408,60.6,3.4,0.9,2.2,0,28.7,39.4,485,423,62,87.22,12.78,34,389,15,47,49,436,8,24.2,10.1,"25% - 50% P.O.C.","$51000 - $70000"
"06071011101","Census Tract 111.01, San Bernardino County, California",3232,61813,2373,48,36,238,0,385,73.4,1.5,1.1,7.4,0,11.9,26.6,1195,757,438,63.35,36.65,86,671,60,378,146,1049,11.4,13.7,12.2,"25% - 50% P.O.C.","$51000 - $70000"
"06071011102","Census Tract 111.02, San Bernardino County, California",1760,60662,1076,86,0,44,38,294,61.1,4.9,0,2.5,2.2,16.7,38.9,723,581,142,80.36,19.64,26,555,32,110,58,665,4.5,22.5,8,"25% - 50% P.O.C.","$51000 - $70000"
"06071011203","Census Tract 112.03, San Bernardino County, California",1404,50945,982,4,8,0,0,406,69.9,0.3,0.6,0,0,28.9,30.1,621,377,244,60.71,39.29,4,373,25,219,29,592,1.1,10.2,4.7,"25% - 50% P.O.C.","Less than $51000"
"06071011204","Census Tract 112.04, San Bernardino County, California",1685,75375,1180,0,37,5,8,444,70,0,2.2,0.3,0.5,26.4,30,685,423,262,61.75,38.25,0,423,62,200,62,623,0,23.7,9.1,"25% - 50% P.O.C.","$70000 - $95000"
"06071011205","Census Tract 112.05, San Bernardino County, California",1163,35556,732,7,9,58,0,357,62.9,0.6,0.8,5,0,30.7,37.1,496,229,267,46.17,53.83,19,210,9,258,28,468,8.3,3.4,5.6,"25% - 50% P.O.C.","Less than $51000"
"06071011206","Census Tract 112.06, San Bernardino County, California",951,34500,575,0,0,73,0,293,60.5,0,0,7.7,0,30.8,39.5,422,166,256,39.34,60.66,0,166,21,235,21,401,0,8.2,5,"25% - 50% P.O.C.","Less than $51000"
"06071011300","Census Tract 113, San Bernardino County, California",1398,72574,1131,1,0,0,0,235,80.9,0.1,0,0,0,16.8,19.1,661,553,108,83.66,16.34,17,536,26,82,43,618,3.1,24.1,6.5,"Less than 25% P.O.C.","$70000 - $95000"
"06071011401","Census Tract 114.01, San Bernardino County, California",4507,50043,2621,8,21,45,0,1628,58.2,0.2,0.5,1,0,36.1,41.8,1787,1110,677,62.12,37.88,74,1036,75,602,149,1638,6.7,11.1,8.3,"25% - 50% P.O.C.","Less than $51000"
"06071011403","Census Tract 114.03, San Bernardino County, California",3451,43183,2446,95,26,8,0,876,70.9,2.8,0.8,0.2,0,25.4,29.1,1459,960,499,65.8,34.2,27,933,49,450,76,1383,2.8,9.8,5.2,"25% - 50% P.O.C.","Less than $51000"
"06071011404","Census Tract 114.04, San Bernardino County, California",4585,58922,3527,58,7,22,0,894,76.9,1.3,0.2,0.5,0,19.5,23.1,1696,1061,635,62.56,37.44,55,1006,80,555,135,1561,5.2,12.6,8,"Less than 25% P.O.C.","$51000 - $70000"
"06071011500","Census Tract 115, San Bernardino County, California",2125,67708,1714,10,6,10,24,316,80.7,0.5,0.3,0.5,1.1,14.9,19.3,802,572,230,71.32,28.68,36,536,15,215,51,751,6.3,6.5,6.4,"Less than 25% P.O.C.","$51000 - $70000"
"06071011600","Census Tract 116, San Bernardino County, California",8488,68644,5218,478,0,230,0,2247,61.5,5.6,0,2.7,0,26.5,38.5,3185,2244,941,70.46,29.54,142,2102,147,794,289,2896,6.3,15.6,9.1,"25% - 50% P.O.C.","$51000 - $70000"
"06071011700","Census Tract 117, San Bernardino County, California",1660,36360,681,7,15,18,0,817,41,0.4,0.9,1.1,0,49.2,59,512,278,234,54.3,45.7,40,238,42,192,82,430,14.4,17.9,16,"50% - 75% P.O.C.","Less than $51000"
"06071011800","Census Tract 118, San Bernardino County, California",7733,49985,3442,512,2,106,0,3494,44.5,6.6,0,1.4,0,45.2,55.5,2419,1288,1131,53.25,46.75,206,1082,285,846,491,1928,16,25.2,20.3,"50% - 75% P.O.C.","Less than $51000"
"06071011900","Census Tract 119, San Bernardino County, California",2645,51814,1138,138,64,26,0,1191,43,5.2,2.4,1,0,45,57,896,630,266,70.31,29.69,68,562,124,142,192,704,10.8,46.6,21.4,"50% - 75% P.O.C.","$51000 - $70000"
"06071012001","Census Tract 120.01, San Bernardino County, California",5815,56806,1367,824,38,388,316,2674,23.5,14.2,0.7,6.7,5.4,46,76.5,1887,1083,804,57.39,42.61,60,1023,151,653,211,1676,5.5,18.8,11.2,"75% or more P.O.C.","$51000 - $70000"
"06071012002","Census Tract 120.02, San Bernardino County, California",5653,49053,1586,626,165,71,0,3047,28.1,11.1,2.9,1.3,0,53.9,71.9,1891,1037,854,54.84,45.16,255,782,98,756,353,1538,24.6,11.5,18.7,"50% - 75% P.O.C.","Less than $51000"
"06071012101","Census Tract 121.01, San Bernardino County, California",5860,64250,3181,621,0,124,0,1309,54.3,10.6,0,2.1,0,22.3,45.7,1973,1161,812,58.84,41.16,167,994,132,680,299,1674,14.4,16.3,15.2,"25% - 50% P.O.C.","$51000 - $70000"
"06071012103","Census Tract 121.03, San Bernardino County, California",3562,33583,2452,103,91,101,0,743,68.8,2.9,2.6,2.8,0,20.9,31.2,1376,953,423,69.26,30.74,91,862,59,364,150,1226,9.5,13.9,10.9,"25% - 50% P.O.C.","Less than $51000"
"06071012104","Census Tract 121.04, San Bernardino County, California",5280,62609,3290,353,23,0,9,1551,62.3,6.7,0.4,0,0.2,29.4,37.7,1858,1209,649,65.07,34.93,149,1060,29,620,178,1680,12.3,4.5,9.6,"25% - 50% P.O.C.","$51000 - $70000"
"06071012200","Census Tract 122, San Bernardino County, California",18685,94915,4777,2431,116,3331,76,6812,25.6,13,0.6,17.8,0.4,36.5,74.4,1562,1058,504,67.73,32.27,126,932,240,264,366,1196,11.9,47.6,23.4,"50% - 75% P.O.C.","$70000 - $95000"
"06071012300","Census Tract 123, San Bernardino County, California",4966,NA,1562,1530,46,134,40,1409,31.5,30.8,0.9,2.7,0.8,28.4,68.5,0,0,0,NA,NA,0,0,0,0,0,0,NA,NA,NA,"50% - 75% P.O.C.","N/A"
"06071012400","Census Tract 124, San Bernardino County, California",3386,51250,374,72,0,46,0,2837,11,2.1,0,1.4,0,83.8,89,902,560,342,62.08,37.92,143,417,71,271,214,688,25.5,20.8,23.7,"75% or more P.O.C.","$51000 - $70000"
"06071012500","Census Tract 125, San Bernardino County, California",4972,39045,313,26,0,7,0,4626,6.3,0.5,0,0.1,0,93,93.7,1310,741,569,56.56,43.44,192,549,154,415,346,964,25.9,27.1,26.4,"75% or more P.O.C.","Less than $51000"
"06071012700","Census Tract 127, San Bernardino County, California",3920,84821,990,216,0,261,0,2375,25.3,5.5,0,6.7,0,60.6,74.7,1365,1096,269,80.29,19.71,104,992,67,202,171,1194,9.5,24.9,12.5,"50% - 75% P.O.C.","$70000 - $95000"
"06071025000","Census Tract 250, San Bernardino County, California",9872,54787,4725,1682,24,760,0,1831,47.9,17,0.2,7.7,0,18.5,52.1,2708,4,2704,0.15,99.85,0,4,330,2374,330,2378,0,12.2,12.2,"50% - 75% P.O.C.","$51000 - $70000"
"06071025100","Census Tract 251, San Bernardino County, California",1343,31845,661,14,400,8,0,218,49.2,1,29.8,0.6,0,16.2,50.8,616,374,242,60.71,39.29,25,349,13,229,38,578,6.7,5.4,6.2,"50% - 75% P.O.C.","Less than $51000"
"06071940100","Census Tract 9401, San Bernardino County, California",1312,33276,1043,7,40,5,0,193,79.5,0.5,3,0.4,0,14.7,20.5,610,491,119,80.49,19.51,17,474,18,101,35,575,3.5,15.1,5.7,"Less than 25% P.O.C.","Less than $51000"
"06071980100","Census Tract 9801, San Bernardino County, California",0,NA,0,0,0,0,0,0,NA,NA,NA,NA,NA,NA,NA,0,0,0,NA,NA,0,0,0,0,0,0,NA,NA,NA,"N/A","N/A"
"06071980200","Census Tract 9802, San Bernardino County, California",3817,NA,599,1029,120,68,55,1832,15.7,27,3.1,1.8,1.4,48,84.3,0,0,0,NA,NA,0,0,0,0,0,0,NA,NA,NA,"75% or more P.O.C.","N/A"
"06111000100","Census Tract 1, Ventura County, California",620,59028,548,0,0,11,0,30,88.4,0,0,1.8,0,4.8,11.6,280,217,63,77.5,22.5,3,214,0,63,3,277,1.4,0,1.1,"Less than 25% P.O.C.","$51000 - $70000"
"06111000200","Census Tract 2, Ventura County, California",2387,50000,223,23,24,4,0,2072,9.3,1,1,0.2,0,86.8,90.7,696,370,326,53.16,46.84,105,265,50,276,155,541,28.4,15.3,22.3,"75% or more P.O.C.","Less than $51000"
"06111000302","Census Tract 3.02, Ventura County, California",8257,76067,1941,0,84,101,0,5956,23.5,0,1,1.2,0,72.1,76.5,2419,1393,1026,57.59,42.41,397,996,303,723,700,1719,28.5,29.5,28.9,"75% or more P.O.C.","$70000 - $95000"
"06111000303","Census Tract 3.03, Ventura County, California",5076,86500,1273,43,0,25,5,3693,25.1,0.8,0,0.5,0.1,72.8,74.9,1400,1016,384,72.57,27.43,237,779,77,307,314,1086,23.3,20.1,22.4,"50% - 75% P.O.C.","$70000 - $95000"
"06111000304","Census Tract 3.04, Ventura County, California",4279,75200,1016,0,0,37,0,3200,23.7,0,0,0.9,0,74.8,76.3,1250,808,442,64.64,35.36,165,643,94,348,259,991,20.4,21.3,20.7,"75% or more P.O.C.","$70000 - $95000"
"06111000400","Census Tract 4, Ventura County, California",6021,62297,1264,17,5,70,0,4620,21,0.3,0.1,1.2,0,76.7,79,1640,932,708,56.83,43.17,85,847,177,531,262,1378,9.1,25,16,"75% or more P.O.C.","$51000 - $70000"
"06111000500","Census Tract 5, Ventura County, California",1697,53558,666,0,0,24,0,1004,39.2,0,0,1.4,0,59.2,60.8,581,315,266,54.22,45.78,4,311,75,191,79,502,1.3,28.2,13.6,"50% - 75% P.O.C.","$51000 - $70000"
"06111000600","Census Tract 6, Ventura County, California",5969,40540,392,53,0,33,0,5454,6.6,0.9,0,0.6,0,91.4,93.4,1758,512,1246,29.12,70.88,160,352,145,1101,305,1453,31.2,11.6,17.3,"75% or more P.O.C.","Less than $51000"
"06111000701","Census Tract 7.01, Ventura County, California",7508,61875,521,1,21,168,0,6610,6.9,0,0.3,2.2,0,88,93.1,1821,884,937,48.54,51.46,238,646,270,667,508,1313,26.9,28.8,27.9,"75% or more P.O.C.","$51000 - $70000"
"06111000702","Census Tract 7.02, Ventura County, California",3240,71579,461,5,0,19,0,2678,14.2,0.2,0,0.6,0,82.7,85.8,886,701,185,79.12,20.88,147,554,74,111,221,665,21,40,24.9,"75% or more P.O.C.","$70000 - $95000"
"06111000800","Census Tract 8, Ventura County, California",8465,78434,2419,14,15,115,0,5760,28.6,0.2,0.2,1.4,0,68,71.4,2633,1645,988,62.48,37.52,204,1441,166,822,370,2263,12.4,16.8,14.1,"50% - 75% P.O.C.","$70000 - $95000"
"06111000901","Census Tract 9.01, Ventura County, California",2503,66667,2135,7,0,29,0,316,85.3,0.3,0,1.2,0,12.6,14.7,1148,717,431,62.46,37.54,19,698,45,386,64,1084,2.6,10.4,5.6,"Less than 25% P.O.C.","$51000 - $70000"
"06111000902","Census Tract 9.02, Ventura County, California",2026,99375,1663,7,3,34,0,306,82.1,0.3,0.1,1.7,0,15.1,17.9,841,526,315,62.54,37.46,60,466,0,315,60,781,11.4,0,7.1,"Less than 25% P.O.C.","$95000 or more"
"06111000903","Census Tract 9.03, Ventura County, California",5854,76916,4339,9,0,258,23,1097,74.1,0.2,0,4.4,0.4,18.7,25.9,2146,1176,970,54.8,45.2,76,1100,54,916,130,2016,6.5,5.6,6.1,"25% - 50% P.O.C.","$70000 - $95000"
"06111001001","Census Tract 10.01, Ventura County, California",2560,78056,1795,4,9,82,0,486,70.1,0.2,0.4,3.2,0,19,29.9,996,617,379,61.95,38.05,72,545,30,349,102,894,11.7,7.9,10.2,"25% - 50% P.O.C.","$70000 - $95000"
"06111001002","Census Tract 10.02, Ventura County, California",6357,78277,4240,18,0,77,0,1713,66.7,0.3,0,1.2,0,26.9,33.3,2413,1710,703,70.87,29.13,41,1669,130,573,171,2242,2.4,18.5,7.1,"25% - 50% P.O.C.","$70000 - $95000"
"06111001101","Census Tract 11.01, Ventura County, California",4957,85703,3129,0,91,51,0,1545,63.1,0,1.8,1,0,31.2,36.9,1789,1439,350,80.44,19.56,233,1206,13,337,246,1543,16.2,3.7,13.8,"25% - 50% P.O.C.","$70000 - $95000"
"06111001102","Census Tract 11.02, Ventura County, California",3660,92796,2852,2,0,31,0,706,77.9,0.1,0,0.8,0,19.3,22.1,1287,990,297,76.92,23.08,71,919,68,229,139,1148,7.2,22.9,10.8,"Less than 25% P.O.C.","$70000 - $95000"
"06111001201","Census Tract 12.01, Ventura County, California",5147,69960,2221,422,0,125,0,2281,43.2,8.2,0,2.4,0,44.3,56.8,1938,947,991,48.86,51.14,116,831,14,977,130,1808,12.2,1.4,6.7,"50% - 75% P.O.C.","$51000 - $70000"
"06111001202","Census Tract 12.02, Ventura County, California",7385,122545,4766,128,1,513,0,1818,64.5,1.7,0,6.9,0,24.6,35.5,2426,2071,355,85.37,14.63,216,1855,61,294,277,2149,10.4,17.2,11.4,"25% - 50% P.O.C.","$95000 or more"
"06111001204","Census Tract 12.04, Ventura County, California",3036,78818,1229,31,14,12,0,1665,40.5,1,0.5,0.4,0,54.8,59.5,843,616,227,73.07,26.93,132,484,76,151,208,635,21.4,33.5,24.7,"50% - 75% P.O.C.","$70000 - $95000"
"06111001206","Census Tract 12.06, Ventura County, California",778,69408,419,0,0,30,0,296,53.9,0,0,3.9,0,38,46.1,345,182,163,52.75,47.25,0,182,0,163,0,345,0,0,0,"25% - 50% P.O.C.","$51000 - $70000"
"06111001301","Census Tract 13.01, Ventura County, California",7944,100344,3874,102,0,403,0,3450,48.8,1.3,0,5.1,0,43.4,51.2,2681,1620,1061,60.43,39.57,162,1458,207,854,369,2312,10,19.5,13.8,"50% - 75% P.O.C.","$95000 or more"
"06111001302","Census Tract 13.02, Ventura County, California",2358,45909,743,18,0,162,0,1413,31.5,0.8,0,6.9,0,59.9,68.5,782,589,193,75.32,24.68,85,504,64,129,149,633,14.4,33.2,19.1,"50% - 75% P.O.C.","Less than $51000"
"06111001401","Census Tract 14.01, Ventura County, California",4103,97679,2431,0,0,301,0,1210,59.2,0,0,7.3,0,29.5,40.8,1416,1079,337,76.2,23.8,88,991,12,325,100,1316,8.2,3.6,7.1,"25% - 50% P.O.C.","$95000 or more"
"06111001402","Census Tract 14.02, Ventura County, California",5418,95938,3503,13,0,124,0,1667,64.7,0.2,0,2.3,0,30.8,35.3,2128,1296,832,60.9,39.1,127,1169,75,757,202,1926,9.8,9,9.5,"25% - 50% P.O.C.","$95000 or more"
"06111001502","Census Tract 15.02, Ventura County, California",9534,62298,4148,89,31,385,0,4620,43.5,0.9,0.3,4,0,48.5,56.5,3781,1782,1999,47.13,52.87,154,1628,215,1784,369,3412,8.6,10.8,9.8,"50% - 75% P.O.C.","$51000 - $70000"
"06111001503","Census Tract 15.03, Ventura County, California",5106,53990,2541,336,7,233,0,1840,49.8,6.6,0.1,4.6,0,36,50.2,1848,747,1101,40.42,59.58,31,716,51,1050,82,1766,4.1,4.6,4.4,"50% - 75% P.O.C.","$51000 - $70000"
"06111001506","Census Tract 15.06, Ventura County, California",5151,87778,2613,266,46,191,0,1731,50.7,5.2,0.9,3.7,0,33.6,49.3,1714,1337,377,78,22,72,1265,74,303,146,1568,5.4,19.6,8.5,"25% - 50% P.O.C.","$70000 - $95000"
"06111001507","Census Tract 15.07, Ventura County, California",4063,72039,1921,93,0,219,0,1651,47.3,2.3,0,5.4,0,40.6,52.7,1393,767,626,55.06,44.94,88,679,65,561,153,1240,11.5,10.4,11,"50% - 75% P.O.C.","$70000 - $95000"
"06111001601","Census Tract 16.01, Ventura County, California",1260,61667,693,33,0,47,0,479,55,2.6,0,3.7,0,38,45,494,102,392,20.65,79.35,12,90,24,368,36,458,11.8,6.1,7.3,"25% - 50% P.O.C.","$51000 - $70000"
"06111001602","Census Tract 16.02, Ventura County, California",2503,90156,1829,5,0,17,8,565,73.1,0.2,0,0.7,0.3,22.6,26.9,943,701,242,74.34,25.66,41,660,36,206,77,866,5.8,14.9,8.2,"25% - 50% P.O.C.","$70000 - $95000"
"06111001700","Census Tract 17, Ventura County, California",3373,122000,2440,3,0,114,0,723,72.3,0.1,0,3.4,0,21.4,27.7,1206,1094,112,90.71,9.29,31,1063,30,82,61,1145,2.8,26.8,5.1,"25% - 50% P.O.C.","$95000 or more"
"06111001800","Census Tract 18, Ventura County, California",4624,122344,3591,31,41,132,0,673,77.7,0.7,0.9,2.9,0,14.6,22.3,1601,1350,251,84.32,15.68,145,1205,12,239,157,1444,10.7,4.8,9.8,"Less than 25% P.O.C.","$95000 or more"
"06111001900","Census Tract 19, Ventura County, California",4193,84844,2905,53,0,104,0,1030,69.3,1.3,0,2.5,0,24.6,30.7,1617,888,729,54.92,45.08,67,821,55,674,122,1495,7.5,7.5,7.5,"25% - 50% P.O.C.","$70000 - $95000"
"06111002000","Census Tract 20, Ventura County, California",2622,100758,2071,36,0,125,0,286,79,1.4,0,4.8,0,10.9,21,1076,674,402,62.64,37.36,28,646,22,380,50,1026,4.2,5.5,4.6,"Less than 25% P.O.C.","$95000 or more"
"06111002102","Census Tract 21.02, Ventura County, California",1645,51250,1299,0,22,52,0,197,79,0,1.3,3.2,0,12,21,1031,226,805,21.92,78.08,0,226,14,791,14,1017,0,1.7,1.4,"Less than 25% P.O.C.","$51000 - $70000"
"06111002200","Census Tract 22, Ventura County, California",6350,55000,1888,33,35,57,0,4323,29.7,0.5,0.6,0.9,0,68.1,70.3,2158,833,1325,38.6,61.4,95,738,186,1139,281,1877,11.4,14,13,"50% - 75% P.O.C.","$51000 - $70000"
"06111002300","Census Tract 23, Ventura County, California",6534,51989,1481,27,17,29,0,4908,22.7,0.4,0.3,0.4,0,75.1,77.3,2074,808,1266,38.96,61.04,14,794,187,1079,201,1873,1.7,14.8,9.7,"75% or more P.O.C.","$51000 - $70000"
"06111002400","Census Tract 24, Ventura County, California",2587,38621,1550,60,50,59,0,815,59.9,2.3,1.9,2.3,0,31.5,40.1,1334,96,1238,7.2,92.8,9,87,28,1210,37,1297,9.4,2.3,2.8,"25% - 50% P.O.C.","Less than $51000"
"06111002500","Census Tract 25, Ventura County, California",5374,86375,4014,44,97,142,0,955,74.7,0.8,1.8,2.6,0,17.8,25.3,2265,981,1284,43.31,56.69,27,954,91,1193,118,2147,2.8,7.1,5.2,"25% - 50% P.O.C.","$70000 - $95000"
"06111002600","Census Tract 26, Ventura County, California",3010,84155,2135,20,38,12,48,699,70.9,0.7,1.3,0.4,1.6,23.2,29.1,1353,593,760,43.83,56.17,39,554,17,743,56,1297,6.6,2.2,4.1,"25% - 50% P.O.C.","$70000 - $95000"
"06111002700","Census Tract 27, Ventura County, California",4398,78115,2714,0,17,172,0,1319,61.7,0,0.4,3.9,0,30,38.3,1826,721,1105,39.49,60.51,50,671,53,1052,103,1723,6.9,4.8,5.6,"25% - 50% P.O.C.","$70000 - $95000"
"06111002800","Census Tract 28, Ventura County, California",6693,76250,4222,56,13,230,0,2033,63.1,0.8,0.2,3.4,0,30.4,36.9,2508,1175,1333,46.85,53.15,98,1077,47,1286,145,2363,8.3,3.5,5.8,"25% - 50% P.O.C.","$70000 - $95000"
"06111002901","Census Tract 29.01, Ventura County, California",5665,94063,1538,196,0,679,9,2918,27.1,3.5,0,12,0.2,51.5,72.9,1706,1250,456,73.27,26.73,165,1085,95,361,260,1446,13.2,20.8,15.2,"50% - 75% P.O.C.","$70000 - $95000"
"06111002905","Census Tract 29.05, Ventura County, California",5433,98750,1110,450,0,587,0,3094,20.4,8.3,0,10.8,0,56.9,79.6,1572,1106,466,70.36,29.64,227,879,109,357,336,1236,20.5,23.4,21.4,"75% or more P.O.C.","$95000 or more"
"06111003010","Census Tract 30.10, Ventura County, California",3226,70486,445,82,1,255,4,2421,13.8,2.5,0,7.9,0.1,75,86.2,970,518,452,53.4,46.6,71,447,79,373,150,820,13.7,17.5,15.5,"75% or more P.O.C.","$70000 - $95000"
"06111003011","Census Tract 30.11, Ventura County, California",5539,55217,612,65,0,260,9,4535,11,1.2,0,4.7,0.2,81.9,89,1546,636,910,41.14,58.86,149,487,204,706,353,1193,23.4,22.4,22.8,"75% or more P.O.C.","$51000 - $70000"
"06111003012","Census Tract 30.12, Ventura County, California",675,28631,13,0,0,0,0,662,1.9,0,0,0,0,98.1,98.1,154,0,154,0,100,0,0,84,70,84,70,NA,54.5,54.5,"75% or more P.O.C.","Less than $51000"
"06111003013","Census Tract 30.13, Ventura County, California",5509,87606,1188,230,0,310,10,3575,21.6,4.2,0,5.6,0.2,64.9,78.4,1536,768,768,50,50,157,611,145,623,302,1234,20.4,18.9,19.7,"75% or more P.O.C.","$70000 - $95000"
"06111003100","Census Tract 31, Ventura County, California",14299,111919,2093,319,94,2278,92,9240,14.6,2.2,0.7,15.9,0.6,64.6,85.4,3326,2825,501,84.94,15.06,776,2049,205,296,981,2345,27.5,40.9,29.5,"75% or more P.O.C.","$95000 or more"
"06111003201","Census Tract 32.01, Ventura County, California",4230,54265,32,7,22,15,0,4127,0.8,0.2,0.5,0.4,0,97.6,99.2,700,190,510,27.14,72.86,81,109,318,192,399,301,42.6,62.4,57,"75% or more P.O.C.","$51000 - $70000"
"06111003300","Census Tract 33, Ventura County, California",8956,69703,1523,88,19,121,0,7014,17,1,0.2,1.4,0,78.3,83,2237,915,1322,40.9,59.1,98,817,397,925,495,1742,10.7,30,22.1,"75% or more P.O.C.","$51000 - $70000"
"06111003605","Census Tract 36.05, Ventura County, California",9631,86659,2765,445,0,891,31,4978,28.7,4.6,0,9.3,0.3,51.7,71.3,2829,1589,1240,56.17,43.83,264,1325,220,1020,484,2345,16.6,17.7,17.1,"50% - 75% P.O.C.","$70000 - $95000"
"06111003608","Census Tract 36.08, Ventura County, California",4024,79358,771,68,10,270,28,2658,19.2,1.7,0.2,6.7,0.7,66.1,80.8,1005,619,386,61.59,38.41,182,437,112,274,294,711,29.4,29,29.3,"75% or more P.O.C.","$70000 - $95000"
"06111003609","Census Tract 36.09, Ventura County, California",5863,102526,5112,0,0,116,0,516,87.2,0,0,2,0,8.8,12.8,2965,1889,1076,63.71,36.29,0,1889,17,1059,17,2948,0,1.6,0.6,"Less than 25% P.O.C.","$95000 or more"
"06111003612","Census Tract 36.12, Ventura County, California",4962,89787,3701,75,83,64,0,922,74.6,1.5,1.7,1.3,0,18.6,25.4,1981,754,1227,38.06,61.94,134,620,61,1166,195,1786,17.8,5,9.8,"25% - 50% P.O.C.","$70000 - $95000"
"06111003700","Census Tract 37, Ventura County, California",6687,79667,228,410,0,86,0,5963,3.4,6.1,0,1.3,0,89.2,96.6,1226,729,497,59.46,40.54,290,439,252,245,542,684,39.8,50.7,44.2,"75% or more P.O.C.","$70000 - $95000"
"06111003801","Census Tract 38.01, Ventura County, California",5033,50694,107,35,0,206,0,4685,2.1,0.7,0,4.1,0,93.1,97.9,1133,488,645,43.07,56.93,157,331,271,374,428,705,32.2,42,37.8,"75% or more P.O.C.","Less than $51000"
"06111003802","Census Tract 38.02, Ventura County, California",2849,67798,106,107,0,45,0,2591,3.7,3.8,0,1.6,0,90.9,96.3,549,252,297,45.9,54.1,119,133,95,202,214,335,47.2,32,39,"75% or more P.O.C.","$51000 - $70000"
"06111003900","Census Tract 39, Ventura County, California",6984,58396,241,216,0,387,0,6112,3.5,3.1,0,5.5,0,87.5,96.5,1482,896,586,60.46,39.54,240,656,241,345,481,1001,26.8,41.1,32.5,"75% or more P.O.C.","$51000 - $70000"
"06111004000","Census Tract 40, Ventura County, California",7179,60041,365,108,0,298,0,6363,5.1,1.5,0,4.2,0,88.6,94.9,1415,964,451,68.13,31.87,302,662,285,166,587,828,31.3,63.2,41.5,"75% or more P.O.C.","$51000 - $70000"
"06111004101","Census Tract 41.01, Ventura County, California",6947,75021,543,216,10,186,0,5906,7.8,3.1,0.1,2.7,0,85,92.2,1333,832,501,62.42,37.58,379,453,221,280,600,733,45.6,44.1,45,"75% or more P.O.C.","$70000 - $95000"
"06111004200","Census Tract 42, Ventura County, California",5797,83333,1018,96,0,220,0,4362,17.6,1.7,0,3.8,0,75.2,82.4,1238,981,257,79.24,20.76,411,570,45,212,456,782,41.9,17.5,36.8,"75% or more P.O.C.","$70000 - $95000"
"06111004304","Census Tract 43.04, Ventura County, California",5978,64439,1754,433,16,190,66,3384,29.3,7.2,0.3,3.2,1.1,56.6,70.7,2303,1192,1111,51.76,48.24,62,1130,14,1097,76,2227,5.2,1.3,3.3,"50% - 75% P.O.C.","$51000 - $70000"
"06111004305","Census Tract 43.05, Ventura County, California",2295,52727,1171,415,11,114,14,460,51,18.1,0.5,5,0.6,20,49,400,0,400,0,100,0,0,73,327,73,327,NA,18.2,18.2,"25% - 50% P.O.C.","$51000 - $70000"
"06111004400","Census Tract 44, Ventura County, California",8086,59167,2237,151,0,278,33,5233,27.7,1.9,0,3.4,0.4,64.7,72.3,2686,1075,1611,40.02,59.98,96,979,391,1220,487,2199,8.9,24.3,18.1,"50% - 75% P.O.C.","$51000 - $70000"
"06111004503","Census Tract 45.03, Ventura County, California",5112,52143,558,146,0,615,0,3703,10.9,2.9,0,12,0,72.4,89.1,1116,517,599,46.33,53.67,234,283,209,390,443,673,45.3,34.9,39.7,"75% or more P.O.C.","$51000 - $70000"
"06111004504","Census Tract 45.04, Ventura County, California",5777,73061,207,119,12,539,0,4867,3.6,2.1,0.2,9.3,0,84.2,96.4,1126,492,634,43.69,56.31,155,337,290,344,445,681,31.5,45.7,39.5,"75% or more P.O.C.","$70000 - $95000"
"06111004505","Census Tract 45.05, Ventura County, California",2208,64226,144,32,0,13,11,2002,6.5,1.4,0,0.6,0.5,90.7,93.5,473,237,236,50.11,49.89,76,161,73,163,149,324,32.1,30.9,31.5,"75% or more P.O.C.","$51000 - $70000"
"06111004506","Census Tract 45.06, Ventura County, California",7788,36791,263,150,19,127,0,7183,3.4,1.9,0.2,1.6,0,92.2,96.6,1439,204,1235,14.18,85.82,61,143,689,546,750,689,29.9,55.8,52.1,"75% or more P.O.C.","Less than $51000"
"06111004600","Census Tract 46, Ventura County, California",2035,48155,1295,134,28,117,19,282,63.6,6.6,1.4,5.7,0.9,13.9,36.4,467,0,467,0,100,0,0,96,371,96,371,NA,20.6,20.6,"25% - 50% P.O.C.","Less than $51000"
"06111004704","Census Tract 47.04, Ventura County, California",1372,59000,232,48,0,30,10,981,16.9,3.5,0,2.2,0.7,71.5,83.1,398,278,120,69.85,30.15,36,242,33,87,69,329,12.9,27.5,17.3,"75% or more P.O.C.","$51000 - $70000"
"06111004710","Census Tract 47.10, Ventura County, California",5707,69205,539,187,0,453,178,4219,9.4,3.3,0,7.9,3.1,73.9,90.6,1348,894,454,66.32,33.68,222,672,206,248,428,920,24.8,45.4,31.8,"75% or more P.O.C.","$51000 - $70000"
"06111004711","Census Tract 47.11, Ventura County, California",3552,59286,172,20,0,1148,96,2077,4.8,0.6,0,32.3,2.7,58.5,95.2,778,432,346,55.53,44.47,119,313,141,205,260,518,27.5,40.8,33.4,"75% or more P.O.C.","$51000 - $70000"
"06111004715","Census Tract 47.15, Ventura County, California",5417,70521,491,144,8,489,0,4186,9.1,2.7,0.1,9,0,77.3,90.9,1180,697,483,59.07,40.93,180,517,238,245,418,762,25.8,49.3,35.4,"75% or more P.O.C.","$70000 - $95000"
"06111004716","Census Tract 47.16, Ventura County, California",5066,80417,255,34,0,478,6,4276,5,0.7,0,9.4,0.1,84.4,95,924,722,202,78.14,21.86,330,392,105,97,435,489,45.7,52,47.1,"75% or more P.O.C.","$70000 - $95000"
"06111004717","Census Tract 47.17, Ventura County, California",3951,74118,142,105,0,163,0,3475,3.6,2.7,0,4.1,0,88,96.4,684,468,216,68.42,31.58,227,241,129,87,356,328,48.5,59.7,52,"75% or more P.O.C.","$70000 - $95000"
"06111004901","Census Tract 49.01, Ventura County, California",7229,95731,1128,385,0,1214,19,4190,15.6,5.3,0,16.8,0.3,58,84.4,1960,936,1024,47.76,52.24,246,690,223,801,469,1491,26.3,21.8,23.9,"75% or more P.O.C.","$95000 or more"
"06111004902","Census Tract 49.02, Ventura County, California",5072,57469,94,0,0,12,0,4966,1.9,0,0,0.2,0,97.9,98.1,1043,479,564,45.93,54.07,207,272,225,339,432,611,43.2,39.9,41.4,"75% or more P.O.C.","$51000 - $70000"
"06111005002","Census Tract 50.02, Ventura County, California",3339,46579,187,21,0,0,0,3130,5.6,0.6,0,0,0,93.7,94.4,676,221,455,32.69,67.31,77,144,152,303,229,447,34.8,33.4,33.9,"75% or more P.O.C.","Less than $51000"
"06111005003","Census Tract 50.03, Ventura County, California",7261,58603,975,143,0,88,22,5944,13.4,2,0,1.2,0.3,81.9,86.6,1774,902,872,50.85,49.15,172,730,313,559,485,1289,19.1,35.9,27.3,"75% or more P.O.C.","$51000 - $70000"
"06111005004","Census Tract 50.04, Ventura County, California",9833,99071,2716,285,36,1081,84,5135,27.6,2.9,0.4,11,0.9,52.2,72.4,3128,1331,1797,42.55,57.45,304,1027,160,1637,464,2664,22.8,8.9,14.8,"50% - 75% P.O.C.","$95000 or more"
"06111005100","Census Tract 51, Ventura County, California",4099,102868,1724,238,11,40,0,2021,42.1,5.8,0.3,1,0,49.3,57.9,1059,667,392,62.98,37.02,71,596,121,271,192,867,10.6,30.9,18.1,"50% - 75% P.O.C.","$95000 or more"
"06111005202","Census Tract 52.02, Ventura County, California",2570,98565,1666,59,21,110,0,706,64.8,2.3,0.8,4.3,0,27.5,35.2,1063,771,292,72.53,27.47,39,732,21,271,60,1003,5.1,7.2,5.6,"25% - 50% P.O.C.","$95000 or more"
"06111005203","Census Tract 52.03, Ventura County, California",5762,108083,3555,58,0,211,71,1388,61.7,1,0,3.7,1.2,24.1,38.3,1918,1410,508,73.51,26.49,131,1279,67,441,198,1720,9.3,13.2,10.3,"25% - 50% P.O.C.","$95000 or more"
"06111005204","Census Tract 52.04, Ventura County, California",3449,131250,2425,18,0,291,0,582,70.3,0.5,0,8.4,0,16.9,29.7,1236,1170,66,94.66,5.34,82,1088,26,40,108,1128,7,39.4,8.7,"25% - 50% P.O.C.","$95000 or more"
"06111005205","Census Tract 52.05, Ventura County, California",6072,131165,3926,117,0,988,0,936,64.7,1.9,0,16.3,0,15.4,35.3,2465,1751,714,71.03,28.97,123,1628,26,688,149,2316,7,3.6,6,"25% - 50% P.O.C.","$95000 or more"
"06111005303","Census Tract 53.03, Ventura County, California",9578,106164,5512,0,55,1149,0,2453,57.5,0,0.6,12,0,25.6,42.5,3300,2352,948,71.27,28.73,262,2090,197,751,459,2841,11.1,20.8,13.9,"25% - 50% P.O.C.","$95000 or more"
"06111005304","Census Tract 53.04, Ventura County, California",5623,64969,4061,52,0,398,0,1040,72.2,0.9,0,7.1,0,18.5,27.8,2947,1977,970,67.09,32.91,59,1918,0,970,59,2888,3,0,2,"25% - 50% P.O.C.","$51000 - $70000"
"06111005305","Census Tract 53.05, Ventura County, California",5437,176635,3618,129,84,686,0,636,66.5,2.4,1.5,12.6,0,11.7,33.5,1789,1679,110,93.85,6.15,250,1429,11,99,261,1528,14.9,10,14.6,"25% - 50% P.O.C.","$95000 or more"
"06111005306","Census Tract 53.06, Ventura County, California",4843,129318,3448,30,0,427,0,808,71.2,0.6,0,8.8,0,16.7,28.8,1670,1393,277,83.41,16.59,150,1243,64,213,214,1456,10.8,23.1,12.8,"25% - 50% P.O.C.","$95000 or more"
"06111005401","Census Tract 54.01, Ventura County, California",4312,109700,2376,10,1,355,27,1506,55.1,0.2,0,8.2,0.6,34.9,44.9,1334,1067,267,79.99,20.01,139,928,84,183,223,1111,13,31.5,16.7,"25% - 50% P.O.C.","$95000 or more"
"06111005403","Census Tract 54.03, Ventura County, California",2582,52688,867,31,0,121,0,1502,33.6,1.2,0,4.7,0,58.2,66.4,915,390,525,42.62,57.38,99,291,46,479,145,770,25.4,8.8,15.8,"50% - 75% P.O.C.","$51000 - $70000"
"06111005404","Census Tract 54.04, Ventura County, California",3924,99091,2162,16,0,230,0,1413,55.1,0.4,0,5.9,0,36,44.9,1170,944,226,80.68,19.32,129,815,77,149,206,964,13.7,34.1,17.6,"25% - 50% P.O.C.","$95000 or more"
"06111005502","Census Tract 55.02, Ventura County, California",5227,71997,2078,102,50,720,0,2015,39.8,2,1,13.8,0,38.5,60.2,2079,450,1629,21.65,78.35,25,425,155,1474,180,1899,5.6,9.5,8.7,"50% - 75% P.O.C.","$70000 - $95000"
"06111005503","Census Tract 55.03, Ventura County, California",4364,78138,2004,460,27,445,0,1032,45.9,10.5,0.6,10.2,0,23.6,54.1,1382,628,754,45.44,54.56,65,563,149,605,214,1168,10.4,19.8,15.5,"50% - 75% P.O.C.","$70000 - $95000"
"06111005504","Census Tract 55.04, Ventura County, California",4255,105452,2548,32,13,346,0,1156,59.9,0.8,0.3,8.1,0,27.2,40.1,1491,1066,425,71.5,28.5,95,971,64,361,159,1332,8.9,15.1,10.7,"25% - 50% P.O.C.","$95000 or more"
"06111005600","Census Tract 56, Ventura County, California",10497,84832,5833,121,0,1118,0,3215,55.6,1.2,0,10.7,0,30.6,44.4,4059,2466,1593,60.75,39.25,108,2358,89,1504,197,3862,4.4,5.6,4.9,"25% - 50% P.O.C.","$70000 - $95000"
"06111005700","Census Tract 57, Ventura County, California",3702,99375,1726,125,33,265,0,1350,46.6,3.4,0.9,7.2,0,36.5,53.4,654,197,457,30.12,69.88,8,189,27,430,35,619,4.1,5.9,5.4,"50% - 75% P.O.C.","$95000 or more"
"06111005801","Census Tract 58.01, Ventura County, California",5257,157667,4026,18,0,692,0,458,76.6,0.3,0,13.2,0,8.7,23.4,1712,1437,275,83.94,16.06,79,1358,35,240,114,1598,5.5,12.7,6.7,"Less than 25% P.O.C.","$95000 or more"
"06111005802","Census Tract 58.02, Ventura County, California",9547,144375,6911,64,0,1474,0,854,72.4,0.7,0,15.4,0,8.9,27.6,2996,2640,356,88.12,11.88,288,2352,42,314,330,2666,10.9,11.8,11,"25% - 50% P.O.C.","$95000 or more"
"06111005901","Census Tract 59.01, Ventura County, California",6623,131289,5064,0,0,565,0,831,76.5,0,0,8.5,0,12.5,23.5,2181,1801,380,82.58,17.42,167,1634,35,345,202,1979,9.3,9.2,9.3,"Less than 25% P.O.C.","$95000 or more"
"06111005906","Census Tract 59.06, Ventura County, California",6463,115431,4676,120,39,568,0,893,72.4,1.9,0.6,8.8,0,13.8,27.6,2570,1526,1044,59.38,40.62,204,1322,25,1019,229,2341,13.4,2.4,8.9,"25% - 50% P.O.C.","$95000 or more"
"06111005907","Census Tract 59.07, Ventura County, California",3467,86332,2876,99,0,64,0,387,83,2.9,0,1.8,0,11.2,17,1761,1277,484,72.52,27.48,42,1235,9,475,51,1710,3.3,1.9,2.9,"Less than 25% P.O.C.","$70000 - $95000"
"06111005908","Census Tract 59.08, Ventura County, California",2892,108813,2019,101,0,354,10,296,69.8,3.5,0,12.2,0.3,10.2,30.2,993,723,270,72.81,27.19,65,658,14,256,79,914,9,5.2,8,"25% - 50% P.O.C.","$95000 or more"
"06111005909","Census Tract 59.09, Ventura County, California",3335,81927,2489,48,0,293,0,448,74.6,1.4,0,8.8,0,13.4,25.4,1373,1105,268,80.48,19.52,44,1061,26,242,70,1303,4,9.7,5.1,"25% - 50% P.O.C.","$70000 - $95000"
"06111005910","Census Tract 59.10, Ventura County, California",1796,154286,1459,47,0,79,0,161,81.2,2.6,0,4.4,0,9,18.8,616,553,63,89.77,10.23,44,509,6,57,50,566,8,9.5,8.1,"Less than 25% P.O.C.","$95000 or more"
"06111005911","Census Tract 59.11, Ventura County, California",3643,106250,2503,120,0,222,0,591,68.7,3.3,0,6.1,0,16.2,31.3,1542,1017,525,65.95,34.05,31,986,8,517,39,1503,3,1.5,2.5,"25% - 50% P.O.C.","$95000 or more"
"06111006000","Census Tract 60, Ventura County, California",4947,109833,3356,0,0,268,0,1085,67.8,0,0,5.4,0,21.9,32.2,1542,1291,251,83.72,16.28,111,1180,10,241,121,1421,8.6,4,7.8,"25% - 50% P.O.C.","$95000 or more"
"06111006100","Census Tract 61, Ventura County, California",8324,102717,3181,164,0,1682,0,3268,38.2,2,0,20.2,0,39.3,61.8,2738,1243,1495,45.4,54.6,148,1095,179,1316,327,2411,11.9,12,11.9,"50% - 75% P.O.C.","$95000 or more"
"06111006200","Census Tract 62, Ventura County, California",3032,144946,2259,0,25,454,0,282,74.5,0,0.8,15,0,9.3,25.5,1061,932,129,87.84,12.16,102,830,18,111,120,941,10.9,14,11.3,"25% - 50% P.O.C.","$95000 or more"
"06111006301","Census Tract 63.01, Ventura County, California",6502,111500,4863,30,0,338,0,1179,74.8,0.5,0,5.2,0,18.1,25.2,2594,1707,887,65.81,34.19,101,1606,12,875,113,2481,5.9,1.4,4.4,"25% - 50% P.O.C.","$95000 or more"
"06111006302","Census Tract 63.02, Ventura County, California",3618,123625,2471,44,4,348,3,604,68.3,1.2,0.1,9.6,0.1,16.7,31.7,787,554,233,70.39,29.61,11,543,0,233,11,776,2,0,1.4,"25% - 50% P.O.C.","$95000 or more"
"06111006400","Census Tract 64, Ventura County, California",6859,118750,4357,95,0,422,38,1657,63.5,1.4,0,6.2,0.6,24.2,36.5,2423,2134,289,88.07,11.93,136,1998,82,207,218,2205,6.4,28.4,9,"25% - 50% P.O.C.","$95000 or more"
"06111006500","Census Tract 65, Ventura County, California",3563,77054,2209,0,80,171,31,972,62,0,2.2,4.8,0.9,27.3,38,1045,778,267,74.45,25.55,123,655,64,203,187,858,15.8,24,17.9,"25% - 50% P.O.C.","$70000 - $95000"
"06111006600","Census Tract 66, Ventura County, California",4129,110000,2977,38,0,216,0,820,72.1,0.9,0,5.2,0,19.9,27.9,1378,1170,208,84.91,15.09,74,1096,17,191,91,1287,6.3,8.2,6.6,"25% - 50% P.O.C.","$95000 or more"
"06111006700","Census Tract 67, Ventura County, California",3431,129063,2454,29,12,275,0,578,71.5,0.8,0.3,8,0,16.8,28.5,1140,796,344,69.82,30.18,82,714,61,283,143,997,10.3,17.7,12.5,"25% - 50% P.O.C.","$95000 or more"
"06111006800","Census Tract 68, Ventura County, California",3705,95179,2483,42,18,87,10,919,67,1.1,0.5,2.3,0.3,24.8,33,1228,862,366,70.2,29.8,125,737,61,305,186,1042,14.5,16.7,15.1,"25% - 50% P.O.C.","$95000 or more"
"06111006900","Census Tract 69, Ventura County, California",4048,62076,2412,44,0,288,0,1142,59.6,1.1,0,7.1,0,28.2,40.4,1728,675,1053,39.06,60.94,49,626,154,899,203,1525,7.3,14.6,11.7,"25% - 50% P.O.C.","$51000 - $70000"
"06111007000","Census Tract 70, Ventura County, California",4277,77292,1522,119,0,589,0,1909,35.6,2.8,0,13.8,0,44.6,64.4,1584,364,1220,22.98,77.02,48,316,89,1131,137,1447,13.2,7.3,8.6,"50% - 75% P.O.C.","$70000 - $95000"
"06111007100","Census Tract 71, Ventura County, California",6846,60104,2955,38,85,328,0,3287,43.2,0.6,1.2,4.8,0,48,56.8,2739,855,1884,31.22,68.78,37,818,233,1651,270,2469,4.3,12.4,9.9,"50% - 75% P.O.C.","$51000 - $70000"
"06111007201","Census Tract 72.01, Ventura County, California",3606,162159,2707,168,10,181,0,443,75.1,4.7,0.3,5,0,12.3,24.9,1218,1109,109,91.05,8.95,104,1005,4,105,108,1110,9.4,3.7,8.9,"Less than 25% P.O.C.","$95000 or more"
"06111007202","Census Tract 72.02, Ventura County, California",4446,150844,3202,51,11,360,0,547,72,1.1,0.2,8.1,0,12.3,28,1657,1446,211,87.27,12.73,117,1329,0,211,117,1540,8.1,0,7.1,"25% - 50% P.O.C.","$95000 or more"
"06111007300","Census Tract 73, Ventura County, California",1997,204773,1561,4,8,158,0,182,78.2,0.2,0.4,7.9,0,9.1,21.8,746,600,146,80.43,19.57,57,543,0,146,57,689,9.5,0,7.6,"Less than 25% P.O.C.","$95000 or more"
"06111007402","Census Tract 74.02, Ventura County, California",5981,138201,5031,72,0,374,0,494,84.1,1.2,0,6.3,0,8.3,15.9,2531,2239,292,88.46,11.54,176,2063,0,292,176,2355,7.9,0,7,"Less than 25% P.O.C.","$95000 or more"
"06111007403","Census Tract 74.03, Ventura County, California",5965,129861,3363,67,0,1529,0,607,56.4,1.1,0,25.6,0,10.2,43.6,2186,1495,691,68.39,31.61,53,1442,135,556,188,1998,3.5,19.5,8.6,"25% - 50% P.O.C.","$95000 or more"
"06111007405","Census Tract 74.05, Ventura County, California",6026,122167,4245,105,0,779,0,613,70.4,1.7,0,12.9,0,10.2,29.6,2384,1687,697,70.76,29.24,114,1573,14,683,128,2256,6.8,2,5.4,"25% - 50% P.O.C.","$95000 or more"
"06111007406","Census Tract 74.06, Ventura County, California",2390,157393,1679,19,0,469,17,120,70.3,0.8,0,19.6,0.7,5,29.7,865,615,250,71.1,28.9,69,546,14,236,83,782,11.2,5.6,9.6,"25% - 50% P.O.C.","$95000 or more"
"06111007505","Census Tract 75.05, Ventura County, California",3170,79069,1930,74,0,255,0,792,60.9,2.3,0,8,0,25,39.1,1125,978,147,86.93,13.07,130,848,30,117,160,965,13.3,20.4,14.2,"25% - 50% P.O.C.","$70000 - $95000"
"06111007506","Census Tract 75.06, Ventura County, California",7186,128147,5181,19,0,558,0,1317,72.1,0.3,0,7.8,0,18.3,27.9,2431,2138,293,87.95,12.05,214,1924,18,275,232,2199,10,6.1,9.5,"25% - 50% P.O.C.","$95000 or more"
"06111007507","Census Tract 75.07, Ventura County, California",6469,164097,4688,37,0,952,17,587,72.5,0.6,0,14.7,0.3,9.1,27.5,2363,2199,164,93.06,6.94,192,2007,41,123,233,2130,8.7,25,9.9,"25% - 50% P.O.C.","$95000 or more"
"06111007508","Census Tract 75.08, Ventura County, California",3609,95025,2613,112,0,182,7,647,72.4,3.1,0,5,0.2,17.9,27.6,1429,992,437,69.42,30.58,40,952,84,353,124,1305,4,19.2,8.7,"25% - 50% P.O.C.","$95000 or more"
"06111007509","Census Tract 75.09, Ventura County, California",4500,129132,3226,23,0,645,0,338,71.7,0.5,0,14.3,0,7.5,28.3,1477,933,544,63.17,36.83,120,813,28,516,148,1329,12.9,5.1,10,"25% - 50% P.O.C.","$95000 or more"
"06111007510","Census Tract 75.10, Ventura County, California",6421,178388,4258,0,0,1160,0,764,66.3,0,0,18.1,0,11.9,33.7,2075,1958,117,94.36,5.64,141,1817,0,117,141,1934,7.2,0,6.8,"25% - 50% P.O.C.","$95000 or more"
"06111007511","Census Tract 75.11, Ventura County, California",2217,158500,1557,59,0,205,0,315,70.2,2.7,0,9.2,0,14.2,29.8,798,693,105,86.84,13.16,52,641,18,87,70,728,7.5,17.1,8.8,"25% - 50% P.O.C.","$95000 or more"
"06111007512","Census Tract 75.12, Ventura County, California",5579,100278,3518,55,0,757,0,1012,63.1,1,0,13.6,0,18.1,36.9,1820,1422,398,78.13,21.87,208,1214,74,324,282,1538,14.6,18.6,15.5,"25% - 50% P.O.C.","$95000 or more"
"06111007513","Census Tract 75.13, Ventura County, California",1767,133654,1390,13,0,87,0,207,78.7,0.7,0,4.9,0,11.7,21.3,528,511,17,96.78,3.22,85,426,0,17,85,443,16.6,0,16.1,"Less than 25% P.O.C.","$95000 or more"
"06111007514","Census Tract 75.14, Ventura County, California",6317,92099,4391,125,0,649,0,998,69.5,2,0,10.3,0,15.8,30.5,2741,1400,1341,51.08,48.92,102,1298,23,1318,125,2616,7.3,1.7,4.6,"25% - 50% P.O.C.","$70000 - $95000"
"06111007606","Census Tract 76.06, Ventura County, California",1859,158000,1219,74,6,274,0,234,65.6,4,0.3,14.7,0,12.6,34.4,580,524,56,90.34,9.66,62,462,13,43,75,505,11.8,23.2,12.9,"25% - 50% P.O.C.","$95000 or more"
"06111007607","Census Tract 76.07, Ventura County, California",6243,143017,4458,165,0,548,0,836,71.4,2.6,0,8.8,0,13.4,28.6,2074,1727,347,83.27,16.73,149,1578,63,284,212,1862,8.6,18.2,10.2,"25% - 50% P.O.C.","$95000 or more"
"06111007609","Census Tract 76.09, Ventura County, California",2530,130625,1820,59,30,154,6,413,71.9,2.3,1.2,6.1,0.2,16.3,28.1,837,751,86,89.73,10.27,64,687,20,66,84,753,8.5,23.3,10,"25% - 50% P.O.C.","$95000 or more"
"06111007610","Census Tract 76.10, Ventura County, California",5339,122841,3531,180,0,336,10,1062,66.1,3.4,0,6.3,0.2,19.9,33.9,1809,1562,247,86.35,13.65,132,1430,22,225,154,1655,8.5,8.9,8.5,"25% - 50% P.O.C.","$95000 or more"
"06111007611","Census Tract 76.11, Ventura County, California",3923,73750,439,7,0,192,0,3253,11.2,0.2,0,4.9,0,82.9,88.8,948,447,501,47.15,52.85,153,294,81,420,234,714,34.2,16.2,24.7,"75% or more P.O.C.","$70000 - $95000"
"06111007612","Census Tract 76.12, Ventura County, California",5071,74500,2376,22,41,401,0,2022,46.9,0.4,0.8,7.9,0,39.9,53.1,1798,773,1025,42.99,57.01,142,631,101,924,243,1555,18.4,9.9,13.5,"50% - 75% P.O.C.","$70000 - $95000"
"06111007613","Census Tract 76.13, Ventura County, California",4894,166094,3114,32,12,436,0,1122,63.6,0.7,0.2,8.9,0,22.9,36.4,1447,1320,127,91.22,8.78,200,1120,30,97,230,1217,15.2,23.6,15.9,"25% - 50% P.O.C.","$95000 or more"
"06111007614","Census Tract 76.14, Ventura County, California",8375,100507,3989,16,0,858,201,2768,47.6,0.2,0,10.2,2.4,33.1,52.4,2525,2065,460,81.78,18.22,219,1846,68,392,287,2238,10.6,14.8,11.4,"50% - 75% P.O.C.","$95000 or more"
"06111007700","Census Tract 77, Ventura County, California",5813,77813,3304,58,0,384,0,1952,56.8,1,0,6.6,0,33.6,43.2,2020,1369,651,67.77,32.23,125,1244,75,576,200,1820,9.1,11.5,9.9,"25% - 50% P.O.C.","$70000 - $95000"
"06111007800","Census Tract 78, Ventura County, California",4072,59250,1415,149,0,732,0,1729,34.7,3.7,0,18,0,42.5,65.3,1427,522,905,36.58,63.42,82,440,113,792,195,1232,15.7,12.5,13.7,"50% - 75% P.O.C.","$51000 - $70000"
"06111007901","Census Tract 79.01, Ventura County, California",5361,91333,2335,234,0,398,0,2237,43.6,4.4,0,7.4,0,41.7,56.4,1688,1042,646,61.73,38.27,123,919,124,522,247,1441,11.8,19.2,14.6,"50% - 75% P.O.C.","$70000 - $95000"
"06111007903","Census Tract 79.03, Ventura County, California",5042,133607,2723,142,0,883,0,995,54,2.8,0,17.5,0,19.7,46,1525,1371,154,89.9,10.1,220,1151,29,125,249,1276,16,18.8,16.3,"25% - 50% P.O.C.","$95000 or more"
"06111007904","Census Tract 79.04, Ventura County, California",5668,1e+05,3069,13,0,410,12,1950,54.1,0.2,0,7.2,0.2,34.4,45.9,1704,1246,458,73.12,26.88,154,1092,68,390,222,1482,12.4,14.8,13,"25% - 50% P.O.C.","$95000 or more"
"06111008001","Census Tract 80.01, Ventura County, California",3871,99837,1887,43,0,196,0,1605,48.7,1.1,0,5.1,0,41.5,51.3,951,693,258,72.87,27.13,166,527,84,174,250,701,24,32.6,26.3,"50% - 75% P.O.C.","$95000 or more"
"06111008002","Census Tract 80.02, Ventura County, California",5020,83675,2625,3,0,183,0,2159,52.3,0.1,0,3.6,0,43,47.7,1553,872,681,56.15,43.85,157,715,100,581,257,1296,18,14.7,16.5,"25% - 50% P.O.C.","$70000 - $95000"
"06111008004","Census Tract 80.04, Ventura County, California",5292,96094,2472,18,12,456,17,2160,46.7,0.3,0.2,8.6,0.3,40.8,53.3,1490,1243,247,83.42,16.58,265,978,34,213,299,1191,21.3,13.8,20.1,"50% - 75% P.O.C.","$95000 or more"
"06111008005","Census Tract 80.05, Ventura County, California",2706,86797,1243,77,16,120,0,1182,45.9,2.8,0.6,4.4,0,43.7,54.1,776,689,87,88.79,11.21,108,581,38,49,146,630,15.7,43.7,18.8,"50% - 75% P.O.C.","$70000 - $95000"
"06111008101","Census Tract 81.01, Ventura County, California",3233,91607,2203,1,0,276,0,718,68.1,0,0,8.5,0,22.2,31.9,1100,885,215,80.45,19.55,56,829,22,193,78,1022,6.3,10.2,7.1,"25% - 50% P.O.C.","$70000 - $95000"
"06111008201","Census Tract 82.01, Ventura County, California",4843,87039,3000,37,0,798,0,870,61.9,0.8,0,16.5,0,18,38.1,1551,981,570,63.25,36.75,208,773,19,551,227,1324,21.2,3.3,14.6,"25% - 50% P.O.C.","$70000 - $95000"
"06111008202","Census Tract 82.02, Ventura County, California",4576,94375,2299,262,0,439,26,1466,50.2,5.7,0,9.6,0.6,32,49.8,1472,1184,288,80.43,19.57,114,1070,71,217,185,1287,9.6,24.7,12.6,"25% - 50% P.O.C.","$70000 - $95000"
"06111008302","Census Tract 83.02, Ventura County, California",5736,83914,3461,23,0,363,9,1658,60.3,0.4,0,6.3,0.2,28.9,39.7,2005,1377,628,68.68,31.32,68,1309,62,566,130,1875,4.9,9.9,6.5,"25% - 50% P.O.C.","$70000 - $95000"
"06111008303","Census Tract 83.03, Ventura County, California",3895,79704,2323,44,52,283,0,1126,59.6,1.1,1.3,7.3,0,28.9,40.4,1357,719,638,52.98,47.02,62,657,68,570,130,1227,8.6,10.7,9.6,"25% - 50% P.O.C.","$70000 - $95000"
"06111008304","Census Tract 83.04, Ventura County, California",5853,96617,3762,96,0,593,32,1206,64.3,1.6,0,10.1,0.5,20.6,35.7,2093,1617,476,77.26,22.74,57,1560,147,329,204,1889,3.5,30.9,9.7,"25% - 50% P.O.C.","$95000 or more"
"06111008305","Census Tract 83.05, Ventura County, California",3786,160156,2226,0,15,844,0,581,58.8,0,0.4,22.3,0,15.3,41.2,1191,1141,50,95.8,4.2,128,1013,0,50,128,1063,11.2,0,10.7,"25% - 50% P.O.C.","$95000 or more"
"06111008306","Census Tract 83.06, Ventura County, California",3970,88563,1757,63,52,444,41,1357,44.3,1.6,1.3,11.2,1,34.2,55.7,1529,665,864,43.49,56.51,22,643,27,837,49,1480,3.3,3.1,3.2,"50% - 75% P.O.C.","$70000 - $95000"
"06111008401","Census Tract 84.01, Ventura County, California",5271,91958,3269,12,0,474,0,1393,62,0.2,0,9,0,26.4,38,1809,1171,638,64.73,35.27,192,979,10,628,202,1607,16.4,1.6,11.2,"25% - 50% P.O.C.","$70000 - $95000"
"06111008402","Census Tract 84.02, Ventura County, California",5574,123344,3807,0,0,579,0,1114,68.3,0,0,10.4,0,20,31.7,1569,1366,203,87.06,12.94,215,1151,92,111,307,1262,15.7,45.3,19.6,"25% - 50% P.O.C.","$95000 or more"
"06111008500","Census Tract 85, Ventura County, California",8106,97129,5869,0,97,767,0,1175,72.4,0,1.2,9.5,0,14.5,27.6,2993,2202,791,73.57,26.43,199,2003,49,742,248,2745,9,6.2,8.3,"25% - 50% P.O.C.","$95000 or more"
"06111008600","Census Tract 86, Ventura County, California",7920,51809,598,100,11,594,0,6403,7.6,1.3,0.1,7.5,0,80.8,92.4,2128,530,1598,24.91,75.09,62,468,542,1056,604,1524,11.7,33.9,28.4,"75% or more P.O.C.","$51000 - $70000"
"06111008700","Census Tract 87, Ventura County, California",6029,48458,1073,65,27,202,0,4642,17.8,1.1,0.4,3.4,0,77,82.2,1851,598,1253,32.31,67.69,126,472,244,1009,370,1481,21.1,19.5,20,"75% or more P.O.C.","Less than $51000"
"06111008800","Census Tract 88, Ventura County, California",5582,82917,913,37,9,404,0,4049,16.4,0.7,0.2,7.2,0,72.5,83.6,1343,953,390,70.96,29.04,229,724,89,301,318,1025,24,22.8,23.7,"75% or more P.O.C.","$70000 - $95000"
"06111008900","Census Tract 89, Ventura County, California",3385,79205,372,20,0,80,0,2896,11,0.6,0,2.4,0,85.6,89,680,456,224,67.06,32.94,151,305,117,107,268,412,33.1,52.2,39.4,"75% or more P.O.C.","$70000 - $95000"
"06111009100","Census Tract 91, Ventura County, California",4870,38444,68,82,0,50,11,4617,1.4,1.7,0,1,0.2,94.8,98.6,1010,359,651,35.54,64.46,106,253,240,411,346,664,29.5,36.9,34.3,"75% or more P.O.C.","Less than $51000"
"06111980000","Census Tract 9800, Ventura County, California",118,NA,19,35,0,0,0,60,16.1,29.7,0,0,0,50.8,83.9,0,0,0,NA,NA,0,0,0,0,0,0,NA,NA,NA,"75% or more P.O.C.","N/A"
"06111990100","Census Tract 9901, Ventura County, California",0,NA,0,0,0,0,0,0,NA,NA,NA,NA,NA,NA,NA,0,0,0,NA,NA,0,0,0,0,0,0,NA,NA,NA,"N/A","N/A"
