"GEOID","NAME","total_pop","median_hh_income","white","black","ai_an","asian","hi_pi","hisp_lat","pct_white","pct_black","pct_ai_an","pct_asian","pct_hi_pi","pct_hisp_lat","pct_poc","total_hh","total_hh_owner","total_hh_renter","pct_owners","pct_renters","total_owner_more_than_4","total_owner_less_than_4","total_renter_more_than_4","total_renter_less_than_4","total_hh_more_than_4","total_hh_less_than_4","pct_owner_more_than_4","pct_renter_more_than_4","pct_total_hh_more_than_4","poc_bin","income_bin"
"06019000100","Census Tract 1, Fresno County, California",3676,16621,737,421,49,177,11,2207,20,11.5,1.3,4.8,0.3,60,80,683,19,664,2.78,97.22,0,19,0,664,0,683,0,0,0,"75% or more P.O.C.","Less than $38000"
"06019000200","Census Tract 2, Fresno County, California",2689,25595,165,319,3,217,0,1981,6.1,11.9,0.1,8.1,0,73.7,93.9,760,181,579,23.82,76.18,60,121,140,439,200,560,33.1,24.2,26.3,"75% or more P.O.C.","Less than $38000"
"06019000300","Census Tract 3, Fresno County, California",4225,35254,222,950,11,104,19,2801,5.3,22.5,0.3,2.5,0.4,66.3,94.7,1118,406,712,36.31,63.69,102,304,239,473,341,777,25.1,33.6,30.5,"75% or more P.O.C.","Less than $38000"
"06019000400","Census Tract 4, Fresno County, California",5498,29219,436,160,12,600,0,4284,7.9,2.9,0.2,10.9,0,77.9,92.1,1245,609,636,48.92,51.08,229,380,305,331,534,711,37.6,48,42.9,"75% or more P.O.C.","Less than $38000"
"06019000501","Census Tract 5.01, Fresno County, California",2532,23717,207,177,0,64,35,2049,8.2,7,0,2.5,1.4,80.9,91.8,775,92,683,11.87,88.13,24,68,126,557,150,625,26.1,18.4,19.4,"75% or more P.O.C.","Less than $38000"
"06019000502","Census Tract 5.02, Fresno County, California",3594,37283,509,60,21,321,0,2624,14.2,1.7,0.6,8.9,0,73,85.8,1008,220,788,21.83,78.17,29,191,195,593,224,784,13.2,24.7,22.2,"75% or more P.O.C.","Less than $38000"
"06019000600","Census Tract 6, Fresno County, California",4750,22514,911,637,0,130,0,3035,19.2,13.4,0,2.7,0,63.9,80.8,1950,199,1751,10.21,89.79,76,123,83,1668,159,1791,38.2,4.7,8.2,"75% or more P.O.C.","Less than $38000"
"06019000700","Census Tract 7, Fresno County, California",3664,21151,95,707,10,311,0,2448,2.6,19.3,0.3,8.5,0,66.8,97.4,1123,481,642,42.83,57.17,105,376,117,525,222,901,21.8,18.2,19.8,"75% or more P.O.C.","Less than $38000"
"06019000800","Census Tract 8, Fresno County, California",1292,25083,205,112,7,62,0,903,15.9,8.7,0.5,4.8,0,69.9,84.1,419,72,347,17.18,82.82,39,33,57,290,96,323,54.2,16.4,22.9,"75% or more P.O.C.","Less than $38000"
"06019000901","Census Tract 9.01, Fresno County, California",2759,31823,19,423,0,581,0,1727,0.7,15.3,0,21.1,0,62.6,99.3,713,238,475,33.38,66.62,83,155,131,344,214,499,34.9,27.6,30,"75% or more P.O.C.","Less than $38000"
"06019000902","Census Tract 9.02, Fresno County, California",5191,20117,93,606,0,564,0,3800,1.8,11.7,0,10.9,0,73.2,98.2,1393,382,1011,27.42,72.58,130,252,361,650,491,902,34,35.7,35.2,"75% or more P.O.C.","Less than $38000"
"06019001000","Census Tract 10, Fresno County, California",4255,28971,74,929,13,596,0,2585,1.7,21.8,0.3,14,0,60.8,98.3,1020,349,671,34.22,65.78,111,238,280,391,391,629,31.8,41.7,38.3,"75% or more P.O.C.","Less than $38000"
"06019001100","Census Tract 11, Fresno County, California",2780,33650,70,550,2,27,0,2058,2.5,19.8,0.1,1,0,74,97.5,701,239,462,34.09,65.91,80,159,151,311,231,470,33.5,32.7,33,"75% or more P.O.C.","Less than $38000"
"06019001201","Census Tract 12.01, Fresno County, California",5935,40755,316,234,97,466,0,4812,5.3,3.9,1.6,7.9,0,81.1,94.7,1446,603,843,41.7,58.3,173,430,284,559,457,989,28.7,33.7,31.6,"75% or more P.O.C.","$38000 - $50000"
"06019001202","Census Tract 12.02, Fresno County, California",4561,39223,66,233,0,587,30,3645,1.4,5.1,0,12.9,0.7,79.9,98.6,1142,434,708,38,62,110,324,276,432,386,756,25.3,39,33.8,"75% or more P.O.C.","$38000 - $50000"
"06019001301","Census Tract 13.01, Fresno County, California",5342,28375,174,10,14,315,0,4803,3.3,0.2,0.3,5.9,0,89.9,96.7,1473,591,882,40.12,59.88,140,451,327,555,467,1006,23.7,37.1,31.7,"75% or more P.O.C.","Less than $38000"
"06019001303","Census Tract 13.03, Fresno County, California",2420,33590,28,244,17,400,0,1644,1.2,10.1,0.7,16.5,0,67.9,98.8,591,210,381,35.53,64.47,87,123,92,289,179,412,41.4,24.1,30.3,"75% or more P.O.C.","Less than $38000"
"06019001304","Census Tract 13.04, Fresno County, California",5383,26467,282,528,0,1124,0,3432,5.2,9.8,0,20.9,0,63.8,94.8,1433,318,1115,22.19,77.81,112,206,308,807,420,1013,35.2,27.6,29.3,"75% or more P.O.C.","Less than $38000"
"06019001407","Census Tract 14.07, Fresno County, California",4798,27258,465,556,24,840,0,2838,9.7,11.6,0.5,17.5,0,59.1,90.3,1606,241,1365,15.01,84.99,41,200,123,1242,164,1442,17,9,10.2,"75% or more P.O.C.","Less than $38000"
"06019001408","Census Tract 14.08, Fresno County, California",2677,17417,1006,75,7,268,5,1171,37.6,2.8,0.3,10,0.2,43.7,62.4,1219,224,995,18.38,81.62,51,173,36,959,87,1132,22.8,3.6,7.1,"50% - 75% P.O.C.","Less than $38000"
"06019001409","Census Tract 14.09, Fresno County, California",2174,95766,856,97,0,464,0,612,39.4,4.5,0,21.3,0,28.2,60.6,683,497,186,72.77,27.23,64,433,54,132,118,565,12.9,29,17.3,"50% - 75% P.O.C.","$68000 or more"
"06019001410","Census Tract 14.10, Fresno County, California",12169,67790,1043,585,45,3517,0,6590,8.6,4.8,0.4,28.9,0,54.2,91.4,2785,2008,777,72.1,27.9,776,1232,235,542,1011,1774,38.6,30.2,36.3,"75% or more P.O.C.","$50000 - $68000"
"06019001411","Census Tract 14.11, Fresno County, California",6926,47993,1246,358,98,1933,19,3167,18,5.2,1.4,27.9,0.3,45.7,82,2141,1026,1115,47.92,52.08,326,700,155,960,481,1660,31.8,13.9,22.5,"75% or more P.O.C.","$38000 - $50000"
"06019001412","Census Tract 14.12, Fresno County, California",2979,79750,726,32,4,902,0,1240,24.4,1.1,0.1,30.3,0,41.6,75.6,694,566,128,81.56,18.44,173,393,71,57,244,450,30.6,55.5,35.2,"75% or more P.O.C.","$68000 or more"
"06019001413","Census Tract 14.13, Fresno County, California",6823,93967,1570,166,0,1730,12,3197,23,2.4,0,25.4,0.2,46.9,77,1841,1510,331,82.02,17.98,409,1101,97,234,506,1335,27.1,29.3,27.5,"75% or more P.O.C.","$68000 or more"
"06019001414","Census Tract 14.14, Fresno County, California",8555,98477,1770,427,0,2675,24,3534,20.7,5,0,31.3,0.3,41.3,79.3,2425,2011,414,82.93,17.07,531,1480,50,364,581,1844,26.4,12.1,24,"75% or more P.O.C.","$68000 or more"
"06019001500","Census Tract 15, Fresno County, California",2407,42240,464,30,0,93,0,1811,19.3,1.2,0,3.9,0,75.2,80.7,619,342,277,55.25,44.75,85,257,105,172,190,429,24.9,37.9,30.7,"75% or more P.O.C.","$38000 - $50000"
"06019001600","Census Tract 16, Fresno County, California",5177,47406,1342,11,0,389,1,3242,25.9,0.2,0,7.5,0,62.6,74.1,1788,963,825,53.86,46.14,89,874,59,766,148,1640,9.2,7.2,8.3,"50% - 75% P.O.C.","$38000 - $50000"
"06019001700","Census Tract 17, Fresno County, California",6945,61400,1192,32,96,1159,0,4299,17.2,0.5,1.4,16.7,0,61.9,82.8,1836,952,884,51.85,48.15,224,728,248,636,472,1364,23.5,28.1,25.7,"75% or more P.O.C.","$50000 - $68000"
"06019001800","Census Tract 18, Fresno County, California",4837,58088,1285,17,0,241,0,3210,26.6,0.4,0,5,0,66.4,73.4,1318,768,550,58.27,41.73,134,634,231,319,365,953,17.4,42,27.7,"50% - 75% P.O.C.","$50000 - $68000"
"06019001900","Census Tract 19, Fresno County, California",2868,51131,458,310,20,255,0,1801,16,10.8,0.7,8.9,0,62.8,84,841,478,363,56.84,43.16,97,381,115,248,212,629,20.3,31.7,25.2,"75% or more P.O.C.","$50000 - $68000"
"06019002000","Census Tract 20, Fresno County, California",6284,27031,860,646,48,471,0,4178,13.7,10.3,0.8,7.5,0,66.5,86.3,1757,641,1116,36.48,63.52,155,486,274,842,429,1328,24.2,24.6,24.4,"75% or more P.O.C.","Less than $38000"
"06019002100","Census Tract 21, Fresno County, California",6200,38323,1436,584,0,19,0,4098,23.2,9.4,0,0.3,0,66.1,76.8,2062,1009,1053,48.93,51.07,144,865,270,783,414,1648,14.3,25.6,20.1,"75% or more P.O.C.","$38000 - $50000"
"06019002200","Census Tract 22, Fresno County, California",3617,39796,1242,174,32,68,74,1937,34.3,4.8,0.9,1.9,2,53.6,65.7,1598,469,1129,29.35,70.65,33,436,116,1013,149,1449,7,10.3,9.3,"50% - 75% P.O.C.","$38000 - $50000"
"06019002300","Census Tract 23, Fresno County, California",3559,28125,1117,105,34,16,0,2256,31.4,3,1,0.4,0,63.4,68.6,1284,438,846,34.11,65.89,53,385,58,788,111,1173,12.1,6.9,8.6,"50% - 75% P.O.C.","Less than $38000"
"06019002400","Census Tract 24, Fresno County, California",4401,27500,313,152,0,992,0,2934,7.1,3.5,0,22.5,0,66.7,92.9,1338,308,1030,23.02,76.98,76,232,193,837,269,1069,24.7,18.7,20.1,"75% or more P.O.C.","Less than $38000"
"06019002501","Census Tract 25.01, Fresno County, California",4720,32295,346,386,0,646,0,3247,7.3,8.2,0,13.7,0,68.8,92.7,1345,217,1128,16.13,83.87,77,140,247,881,324,1021,35.5,21.9,24.1,"75% or more P.O.C.","Less than $38000"
"06019002502","Census Tract 25.02, Fresno County, California",4577,20594,193,40,38,891,19,3367,4.2,0.9,0.8,19.5,0.4,73.6,95.8,1126,169,957,15.01,84.99,77,92,283,674,360,766,45.6,29.6,32,"75% or more P.O.C.","Less than $38000"
"06019002601","Census Tract 26.01, Fresno County, California",4971,31982,164,19,0,392,0,4357,3.3,0.4,0,7.9,0,87.6,96.7,1307,411,896,31.45,68.55,29,382,272,624,301,1006,7.1,30.4,23,"75% or more P.O.C.","Less than $38000"
"06019002602","Census Tract 26.02, Fresno County, California",3480,43450,464,262,0,130,0,2564,13.3,7.5,0,3.7,0,73.7,86.7,986,578,408,58.62,41.38,135,443,80,328,215,771,23.4,19.6,21.8,"75% or more P.O.C.","$38000 - $50000"
"06019002701","Census Tract 27.01, Fresno County, California",4209,29528,334,7,20,316,0,3523,7.9,0.2,0.5,7.5,0,83.7,92.1,1160,559,601,48.19,51.81,45,514,256,345,301,859,8.1,42.6,25.9,"75% or more P.O.C.","Less than $38000"
"06019002702","Census Tract 27.02, Fresno County, California",4891,24322,333,212,0,333,2,3881,6.8,4.3,0,6.8,0,79.3,93.2,1376,247,1129,17.95,82.05,26,221,353,776,379,997,10.5,31.3,27.5,"75% or more P.O.C.","Less than $38000"
"06019002800","Census Tract 28, Fresno County, California",4435,25114,140,166,44,813,0,3271,3.2,3.7,1,18.3,0,73.8,96.8,1282,371,911,28.94,71.06,103,268,251,660,354,928,27.8,27.6,27.6,"75% or more P.O.C.","Less than $38000"
"06019002903","Census Tract 29.03, Fresno County, California",3791,23596,630,313,0,788,0,1976,16.6,8.3,0,20.8,0,52.1,83.4,1170,296,874,25.3,74.7,62,234,208,666,270,900,20.9,23.8,23.1,"75% or more P.O.C.","Less than $38000"
"06019002904","Census Tract 29.04, Fresno County, California",3132,36884,393,261,15,725,0,1710,12.5,8.3,0.5,23.1,0,54.6,87.5,839,511,328,60.91,39.09,128,383,137,191,265,574,25,41.8,31.6,"75% or more P.O.C.","Less than $38000"
"06019002905","Census Tract 29.05, Fresno County, California",3046,38676,413,188,0,498,0,1894,13.6,6.2,0,16.3,0,62.2,86.4,916,262,654,28.6,71.4,39,223,119,535,158,758,14.9,18.2,17.2,"75% or more P.O.C.","$38000 - $50000"
"06019002906","Census Tract 29.06, Fresno County, California",5229,45279,524,383,45,1326,52,2881,10,7.3,0.9,25.4,1,55.1,90,1557,701,856,45.02,54.98,217,484,101,755,318,1239,31,11.8,20.4,"75% or more P.O.C.","$38000 - $50000"
"06019003001","Census Tract 30.01, Fresno County, California",3241,37635,265,402,38,1002,0,1451,8.2,12.4,1.2,30.9,0,44.8,91.8,884,404,480,45.7,54.3,114,290,90,390,204,680,28.2,18.8,23.1,"75% or more P.O.C.","Less than $38000"
"06019003003","Census Tract 30.03, Fresno County, California",4366,36036,620,357,8,1081,8,2250,14.2,8.2,0.2,24.8,0.2,51.5,85.8,1156,284,872,24.57,75.43,50,234,235,637,285,871,17.6,26.9,24.7,"75% or more P.O.C.","Less than $38000"
"06019003004","Census Tract 30.04, Fresno County, California",2412,52750,630,35,50,330,0,1320,26.1,1.5,2.1,13.7,0,54.7,73.9,722,521,201,72.16,27.84,81,440,34,167,115,607,15.5,16.9,15.9,"50% - 75% P.O.C.","$50000 - $68000"
"06019003102","Census Tract 31.02, Fresno County, California",7558,40838,2717,558,0,725,0,3182,35.9,7.4,0,9.6,0,42.1,64.1,2649,793,1856,29.94,70.06,210,583,127,1729,337,2312,26.5,6.8,12.7,"50% - 75% P.O.C.","$38000 - $50000"
"06019003103","Census Tract 31.03, Fresno County, California",5339,39474,1935,78,12,427,60,2735,36.2,1.5,0.2,8,1.1,51.2,63.8,2036,677,1359,33.25,66.75,7,670,171,1188,178,1858,1,12.6,8.7,"50% - 75% P.O.C.","$38000 - $50000"
"06019003104","Census Tract 31.04, Fresno County, California",4159,52347,1372,164,9,822,0,1561,33,3.9,0.2,19.8,0,37.5,67,1570,514,1056,32.74,67.26,60,454,69,987,129,1441,11.7,6.5,8.2,"50% - 75% P.O.C.","$50000 - $68000"
"06019003201","Census Tract 32.01, Fresno County, California",5151,51667,773,164,18,908,12,3148,15,3.2,0.3,17.6,0.2,61.1,85,1486,703,783,47.31,52.69,171,532,232,551,403,1083,24.3,29.6,27.1,"75% or more P.O.C.","$50000 - $68000"
"06019003202","Census Tract 32.02, Fresno County, California",5745,24981,1263,451,0,1071,0,2826,22,7.9,0,18.6,0,49.2,78,1654,557,1097,33.68,66.32,179,378,172,925,351,1303,32.1,15.7,21.2,"75% or more P.O.C.","Less than $38000"
"06019003301","Census Tract 33.01, Fresno County, California",3179,33555,712,280,42,144,0,1933,22.4,8.8,1.3,4.5,0,60.8,77.6,1057,538,519,50.9,49.1,88,450,29,490,117,940,16.4,5.6,11.1,"75% or more P.O.C.","Less than $38000"
"06019003302","Census Tract 33.02, Fresno County, California",4666,34805,838,422,9,200,0,3072,18,9,0.2,4.3,0,65.8,82,1500,552,948,36.8,63.2,75,477,238,710,313,1187,13.6,25.1,20.9,"75% or more P.O.C.","Less than $38000"
"06019003400","Census Tract 34, Fresno County, California",5456,30559,837,202,44,663,10,3503,15.3,3.7,0.8,12.2,0.2,64.2,84.7,1683,606,1077,36.01,63.99,83,523,258,819,341,1342,13.7,24,20.3,"75% or more P.O.C.","Less than $38000"
"06019003500","Census Tract 35, Fresno County, California",4901,43544,1526,212,142,153,0,2768,31.1,4.3,2.9,3.1,0,56.5,68.9,2093,1034,1059,49.4,50.6,54,980,25,1034,79,2014,5.2,2.4,3.8,"50% - 75% P.O.C.","$38000 - $50000"
"06019003600","Census Tract 36, Fresno County, California",4528,70880,2508,260,0,49,0,1675,55.4,5.7,0,1.1,0,37,44.6,1764,1060,704,60.09,39.91,74,986,91,613,165,1599,7,12.9,9.4,"25% - 50% P.O.C.","$68000 or more"
"06019003701","Census Tract 37.01, Fresno County, California",3462,41979,714,197,5,94,0,2380,20.6,5.7,0.1,2.7,0,68.7,79.4,1053,402,651,38.18,61.82,93,309,141,510,234,819,23.1,21.7,22.2,"75% or more P.O.C.","$38000 - $50000"
"06019003702","Census Tract 37.02, Fresno County, California",4581,42143,1050,363,16,576,0,2489,22.9,7.9,0.3,12.6,0,54.3,77.1,1520,688,832,45.26,54.74,73,615,117,715,190,1330,10.6,14.1,12.5,"75% or more P.O.C.","$38000 - $50000"
"06019003803","Census Tract 38.03, Fresno County, California",10542,67227,3072,320,0,2473,0,4441,29.1,3,0,23.5,0,42.1,70.9,2578,1925,653,74.67,25.33,712,1213,226,427,938,1640,37,34.6,36.4,"50% - 75% P.O.C.","$50000 - $68000"
"06019003804","Census Tract 38.04, Fresno County, California",6349,64898,1148,539,50,1107,0,3283,18.1,8.5,0.8,17.4,0,51.7,81.9,1642,1144,498,69.67,30.33,232,912,149,349,381,1261,20.3,29.9,23.2,"75% or more P.O.C.","$50000 - $68000"
"06019003805","Census Tract 38.05, Fresno County, California",7392,44167,834,569,194,1782,0,3726,11.3,7.7,2.6,24.1,0,50.4,88.7,2070,677,1393,32.71,67.29,146,531,335,1058,481,1589,21.6,24,23.2,"75% or more P.O.C.","$38000 - $50000"
"06019003807","Census Tract 38.07, Fresno County, California",3496,35476,576,179,0,409,0,2252,16.5,5.1,0,11.7,0,64.4,83.5,1090,430,660,39.45,60.55,161,269,109,551,270,820,37.4,16.5,24.8,"75% or more P.O.C.","Less than $38000"
"06019003808","Census Tract 38.08, Fresno County, California",5042,66298,822,455,39,760,0,2857,16.3,9,0.8,15.1,0,56.7,83.7,1463,1067,396,72.93,27.07,268,799,118,278,386,1077,25.1,29.8,26.4,"75% or more P.O.C.","$50000 - $68000"
"06019003809","Census Tract 38.09, Fresno County, California",5362,55587,951,439,0,1341,22,2299,17.7,8.2,0,25,0.4,42.9,82.3,1600,660,940,41.25,58.75,223,437,167,773,390,1210,33.8,17.8,24.4,"75% or more P.O.C.","$50000 - $68000"
"06019003810","Census Tract 38.10, Fresno County, California",5704,67719,1290,475,0,917,0,2917,22.6,8.3,0,16.1,0,51.1,77.4,1585,1151,434,72.62,27.38,175,976,221,213,396,1189,15.2,50.9,25,"75% or more P.O.C.","$50000 - $68000"
"06019003900","Census Tract 39, Fresno County, California",6477,61776,1573,55,0,1,43,4655,24.3,0.8,0,0,0.7,71.9,75.7,1673,782,891,46.74,53.26,116,666,430,461,546,1127,14.8,48.3,32.6,"75% or more P.O.C.","$50000 - $68000"
"06019004001","Census Tract 40.01, Fresno County, California",8458,64278,1716,59,0,447,0,6056,20.3,0.7,0,5.3,0,71.6,79.7,2186,1296,890,59.29,40.71,383,913,209,681,592,1594,29.6,23.5,27.1,"75% or more P.O.C.","$50000 - $68000"
"06019004002","Census Tract 40.02, Fresno County, California",7209,36554,601,0,12,173,0,6423,8.3,0,0.2,2.4,0,89.1,91.7,1927,913,1014,47.38,52.62,271,642,280,734,551,1376,29.7,27.6,28.6,"75% or more P.O.C.","Less than $38000"
"06019004100","Census Tract 41, Fresno County, California",3404,53750,700,73,14,330,0,2211,20.6,2.1,0.4,9.7,0,65,79.4,928,469,459,50.54,49.46,124,345,83,376,207,721,26.4,18.1,22.3,"75% or more P.O.C.","$50000 - $68000"
"06019004205","Census Tract 42.05, Fresno County, California",6153,48153,1091,1130,18,778,0,3047,17.7,18.4,0.3,12.6,0,49.5,82.3,2035,785,1250,38.57,61.43,83,702,285,965,368,1667,10.6,22.8,18.1,"75% or more P.O.C.","$38000 - $50000"
"06019004207","Census Tract 42.07, Fresno County, California",11921,76875,2072,784,0,2059,0,6677,17.4,6.6,0,17.3,0,56,82.6,3050,2370,680,77.7,22.3,534,1836,248,432,782,2268,22.5,36.5,25.6,"75% or more P.O.C.","$68000 or more"
"06019004208","Census Tract 42.08, Fresno County, California",7367,88304,3695,462,0,1206,0,1751,50.2,6.3,0,16.4,0,23.8,49.8,2446,2072,374,84.71,15.29,271,1801,52,322,323,2123,13.1,13.9,13.2,"25% - 50% P.O.C.","$68000 or more"
"06019004210","Census Tract 42.10, Fresno County, California",3702,52095,1288,454,9,292,0,1588,34.8,12.3,0.2,7.9,0,42.9,65.2,1480,444,1036,30,70,15,429,63,973,78,1402,3.4,6.1,5.3,"50% - 75% P.O.C.","$50000 - $68000"
"06019004211","Census Tract 42.11, Fresno County, California",6982,68880,2675,255,76,749,0,3123,38.3,3.7,1.1,10.7,0,44.7,61.7,2235,1617,618,72.35,27.65,117,1500,260,358,377,1858,7.2,42.1,16.9,"50% - 75% P.O.C.","$68000 or more"
"06019004212","Census Tract 42.12, Fresno County, California",12379,48297,3489,2082,0,1990,0,4490,28.2,16.8,0,16.1,0,36.3,71.8,4590,1320,3270,28.76,71.24,171,1149,239,3031,410,4180,13,7.3,8.9,"50% - 75% P.O.C.","$38000 - $50000"
"06019004213","Census Tract 42.13, Fresno County, California",3324,68909,1587,32,62,159,0,1390,47.7,1,1.9,4.8,0,41.8,52.3,1299,681,618,52.42,47.58,37,644,26,592,63,1236,5.4,4.2,4.8,"50% - 75% P.O.C.","$68000 or more"
"06019004214","Census Tract 42.14, Fresno County, California",4570,79620,2751,113,0,390,0,1277,60.2,2.5,0,8.5,0,27.9,39.8,1897,1364,533,71.9,28.1,47,1317,18,515,65,1832,3.4,3.4,3.4,"25% - 50% P.O.C.","$68000 or more"
"06019004215","Census Tract 42.15, Fresno County, California",4557,63934,1652,265,0,709,0,1639,36.3,5.8,0,15.6,0,36,63.7,1412,1103,309,78.12,21.88,92,1011,97,212,189,1223,8.3,31.4,13.4,"50% - 75% P.O.C.","$50000 - $68000"
"06019004216","Census Tract 42.16, Fresno County, California",3454,79255,1087,290,0,287,0,1645,31.5,8.4,0,8.3,0,47.6,68.5,1222,878,344,71.85,28.15,75,803,67,277,142,1080,8.5,19.5,11.6,"50% - 75% P.O.C.","$68000 or more"
"06019004301","Census Tract 43.01, Fresno County, California",4129,124632,2882,97,0,361,0,731,69.8,2.3,0,8.7,0,17.7,30.2,1769,1480,289,83.66,16.34,69,1411,0,289,69,1700,4.7,0,3.9,"25% - 50% P.O.C.","$68000 or more"
"06019004302","Census Tract 43.02, Fresno County, California",5243,89179,3349,56,0,760,0,965,63.9,1.1,0,14.5,0,18.4,36.1,2073,1845,228,89,11,129,1716,16,212,145,1928,7,7,7,"25% - 50% P.O.C.","$68000 or more"
"06019004303","Census Tract 43.03, Fresno County, California",4526,92860,3172,56,49,201,17,860,70.1,1.2,1.1,4.4,0.4,19,29.9,1869,1517,352,81.17,18.83,78,1439,26,326,104,1765,5.1,7.4,5.6,"25% - 50% P.O.C.","$68000 or more"
"06019004404","Census Tract 44.04, Fresno County, California",3152,36202,681,119,22,108,0,1990,21.6,3.8,0.7,3.4,0,63.1,78.4,1108,162,946,14.62,85.38,29,133,93,853,122,986,17.9,9.8,11,"75% or more P.O.C.","Less than $38000"
"06019004405","Census Tract 44.05, Fresno County, California",3663,124107,2287,108,0,321,0,829,62.4,2.9,0,8.8,0,22.6,37.6,1421,1159,262,81.56,18.44,74,1085,23,239,97,1324,6.4,8.8,6.8,"25% - 50% P.O.C.","$68000 or more"
"06019004406","Census Tract 44.06, Fresno County, California",5328,62897,2843,284,2,605,2,1498,53.4,5.3,0,11.4,0,28.1,46.6,2316,1147,1169,49.53,50.47,130,1017,0,1169,130,2186,11.3,0,5.6,"25% - 50% P.O.C.","$50000 - $68000"
"06019004408","Census Tract 44.08, Fresno County, California",3566,75000,1800,220,97,232,0,997,50.5,6.2,2.7,6.5,0,28,49.5,1662,473,1189,28.46,71.54,40,433,48,1141,88,1574,8.5,4,5.3,"25% - 50% P.O.C.","$68000 or more"
"06019004409","Census Tract 44.09, Fresno County, California",3232,61202,1564,106,67,163,0,1133,48.4,3.3,2.1,5,0,35.1,51.6,1293,711,582,54.99,45.01,45,666,65,517,110,1183,6.3,11.2,8.5,"50% - 75% P.O.C.","$50000 - $68000"
"06019004503","Census Tract 45.03, Fresno County, California",5176,60643,2807,234,15,518,0,1574,54.2,4.5,0.3,10,0,30.4,45.8,2160,1054,1106,48.8,51.2,31,1023,117,989,148,2012,2.9,10.6,6.9,"25% - 50% P.O.C.","$50000 - $68000"
"06019004504","Census Tract 45.04, Fresno County, California",5245,43839,2254,691,0,700,0,1572,43,13.2,0,13.3,0,30,57,2092,712,1380,34.03,65.97,93,619,87,1293,180,1912,13.1,6.3,8.6,"50% - 75% P.O.C.","$38000 - $50000"
"06019004505","Census Tract 45.05, Fresno County, California",5425,42946,1806,390,21,502,0,2602,33.3,7.2,0.4,9.3,0,48,66.7,2124,540,1584,25.42,74.58,30,510,72,1512,102,2022,5.6,4.5,4.8,"50% - 75% P.O.C.","$38000 - $50000"
"06019004506","Census Tract 45.06, Fresno County, California",3254,87692,2471,90,14,201,0,375,75.9,2.8,0.4,6.2,0,11.5,24.1,1476,1051,425,71.21,28.79,17,1034,9,416,26,1450,1.6,2.1,1.8,"Less than 25% P.O.C.","$68000 or more"
"06019004601","Census Tract 46.01, Fresno County, California",3136,68857,1548,39,35,80,0,1354,49.4,1.2,1.1,2.6,0,43.2,50.6,1150,881,269,76.61,23.39,99,782,60,209,159,991,11.2,22.3,13.8,"50% - 75% P.O.C.","$68000 or more"
"06019004602","Census Tract 46.02, Fresno County, California",2837,86979,1511,91,0,129,0,958,53.3,3.2,0,4.5,0,33.8,46.7,1092,940,152,86.08,13.92,73,867,0,152,73,1019,7.8,0,6.7,"25% - 50% P.O.C.","$68000 or more"
"06019004701","Census Tract 47.01, Fresno County, California",6923,37371,1610,1454,65,594,0,3079,23.3,21,0.9,8.6,0,44.5,76.7,2349,791,1558,33.67,66.33,88,703,323,1235,411,1938,11.1,20.7,17.5,"75% or more P.O.C.","Less than $38000"
"06019004703","Census Tract 47.03, Fresno County, California",4130,41827,961,687,0,115,0,2302,23.3,16.6,0,2.8,0,55.7,76.7,1226,649,577,52.94,47.06,139,510,151,426,290,936,21.4,26.2,23.7,"75% or more P.O.C.","$38000 - $50000"
"06019004704","Census Tract 47.04, Fresno County, California",5345,23175,672,690,83,300,15,3502,12.6,12.9,1.6,5.6,0.3,65.5,87.4,1647,529,1118,32.12,67.88,60,469,180,938,240,1407,11.3,16.1,14.6,"75% or more P.O.C.","Less than $38000"
"06019004801","Census Tract 48.01, Fresno County, California",4811,38114,1029,440,0,122,0,3025,21.4,9.1,0,2.5,0,62.9,78.6,1586,355,1231,22.38,77.62,54,301,198,1033,252,1334,15.2,16.1,15.9,"75% or more P.O.C.","$38000 - $50000"
"06019004802","Census Tract 48.02, Fresno County, California",4448,27358,936,538,35,77,0,2806,21,12.1,0.8,1.7,0,63.1,79,1501,492,1009,32.78,67.22,106,386,206,803,312,1189,21.5,20.4,20.8,"75% or more P.O.C.","Less than $38000"
"06019004901","Census Tract 49.01, Fresno County, California",4057,51250,1550,287,21,82,0,2028,38.2,7.1,0.5,2,0,50,61.8,1471,596,875,40.52,59.48,57,539,117,758,174,1297,9.6,13.4,11.8,"50% - 75% P.O.C.","$50000 - $68000"
"06019004902","Census Tract 49.02, Fresno County, California",2233,69563,790,213,6,70,26,1094,35.4,9.5,0.3,3.1,1.2,49,64.6,727,477,250,65.61,34.39,46,431,108,142,154,573,9.6,43.2,21.2,"50% - 75% P.O.C.","$68000 or more"
"06019005000","Census Tract 50, Fresno County, California",4548,60886,1781,266,0,150,0,2129,39.2,5.8,0,3.3,0,46.8,60.8,1522,762,760,50.07,49.93,113,649,93,667,206,1316,14.8,12.2,13.5,"50% - 75% P.O.C.","$50000 - $68000"
"06019005100","Census Tract 51, Fresno County, California",6799,27033,2096,532,34,261,0,3765,30.8,7.8,0.5,3.8,0,55.4,69.2,2104,771,1333,36.64,63.36,153,618,271,1062,424,1680,19.8,20.3,20.2,"50% - 75% P.O.C.","Less than $38000"
"06019005202","Census Tract 52.02, Fresno County, California",3050,21066,457,152,0,566,0,1868,15,5,0,18.6,0,61.2,85,1118,370,748,33.09,66.91,148,222,62,686,210,908,40,8.3,18.8,"75% or more P.O.C.","Less than $38000"
"06019005203","Census Tract 52.03, Fresno County, California",5107,37458,988,370,7,330,0,3302,19.3,7.2,0.1,6.5,0,64.7,80.7,1598,626,972,39.17,60.83,111,515,159,813,270,1328,17.7,16.4,16.9,"75% or more P.O.C.","Less than $38000"
"06019005204","Census Tract 52.04, Fresno County, California",4299,43068,1042,318,42,520,0,2348,24.2,7.4,1,12.1,0,54.6,75.8,1367,556,811,40.67,59.33,87,469,137,674,224,1143,15.6,16.9,16.4,"75% or more P.O.C.","$38000 - $50000"
"06019005301","Census Tract 53.01, Fresno County, California",6018,54552,1624,455,5,597,0,3204,27,7.6,0.1,9.9,0,53.2,73,1870,991,879,52.99,47.01,130,861,144,735,274,1596,13.1,16.4,14.7,"50% - 75% P.O.C.","$50000 - $68000"
"06019005302","Census Tract 53.02, Fresno County, California",5355,40871,1754,531,0,642,0,2121,32.8,9.9,0,12,0,39.6,67.2,1908,639,1269,33.49,66.51,88,551,192,1077,280,1628,13.8,15.1,14.7,"50% - 75% P.O.C.","$38000 - $50000"
"06019005304","Census Tract 53.04, Fresno County, California",5365,33361,1381,254,184,509,0,2741,25.7,4.7,3.4,9.5,0,51.1,74.3,2058,509,1549,24.73,75.27,94,415,178,1371,272,1786,18.5,11.5,13.2,"50% - 75% P.O.C.","Less than $38000"
"06019005305","Census Tract 53.05, Fresno County, California",3648,58726,1186,250,15,648,37,1501,32.5,6.9,0.4,17.8,1,41.1,67.5,1110,649,461,58.47,41.53,92,557,83,378,175,935,14.2,18,15.8,"50% - 75% P.O.C.","$50000 - $68000"
"06019005403","Census Tract 54.03, Fresno County, California",4872,23234,1594,408,0,661,0,1985,32.7,8.4,0,13.6,0,40.7,67.3,1407,208,1199,14.78,85.22,59,149,149,1050,208,1199,28.4,12.4,14.8,"50% - 75% P.O.C.","Less than $38000"
"06019005405","Census Tract 54.05, Fresno County, California",4693,75583,2332,51,0,474,0,1733,49.7,1.1,0,10.1,0,36.9,50.3,1492,1112,380,74.53,25.47,184,928,24,356,208,1284,16.5,6.3,13.9,"50% - 75% P.O.C.","$68000 or more"
"06019005406","Census Tract 54.06, Fresno County, California",4192,70307,2154,23,0,542,0,1459,51.4,0.5,0,12.9,0,34.8,48.6,1437,1132,305,78.78,21.22,108,1024,86,219,194,1243,9.5,28.2,13.5,"25% - 50% P.O.C.","$68000 or more"
"06019005407","Census Tract 54.07, Fresno County, California",3476,72109,1784,65,0,386,13,1140,51.3,1.9,0,11.1,0.4,32.8,48.7,1224,724,500,59.15,40.85,94,630,98,402,192,1032,13,19.6,15.7,"25% - 50% P.O.C.","$68000 or more"
"06019005408","Census Tract 54.08, Fresno County, California",2268,17132,990,138,22,264,37,736,43.7,6.1,1,11.6,1.6,32.5,56.3,344,7,337,2.03,97.97,0,7,50,287,50,294,0,14.8,14.5,"50% - 75% P.O.C.","Less than $38000"
"06019005409","Census Tract 54.09, Fresno County, California",3328,35556,1364,295,23,366,0,1167,41,8.9,0.7,11,0,35.1,59,1406,344,1062,24.47,75.53,42,302,8,1054,50,1356,12.2,0.8,3.6,"50% - 75% P.O.C.","Less than $38000"
"06019005410","Census Tract 54.10, Fresno County, California",3536,55125,1319,95,33,432,0,1476,37.3,2.7,0.9,12.2,0,41.7,62.7,1154,451,703,39.08,60.92,113,338,47,656,160,994,25.1,6.7,13.9,"50% - 75% P.O.C.","$50000 - $68000"
"06019005503","Census Tract 55.03, Fresno County, California",5706,107483,3560,103,0,1023,0,905,62.4,1.8,0,17.9,0,15.9,37.6,2315,1650,665,71.27,28.73,122,1528,73,592,195,2120,7.4,11,8.4,"25% - 50% P.O.C.","$68000 or more"
"06019005504","Census Tract 55.04, Fresno County, California",3384,104107,1780,99,0,758,0,628,52.6,2.9,0,22.4,0,18.6,47.4,1075,840,235,78.14,21.86,113,727,57,178,170,905,13.5,24.3,15.8,"25% - 50% P.O.C.","$68000 or more"
"06019005505","Census Tract 55.05, Fresno County, California",7095,108971,3763,60,81,1323,22,1476,53,0.8,1.1,18.6,0.3,20.8,47,2112,1664,448,78.79,21.21,273,1391,120,328,393,1719,16.4,26.8,18.6,"25% - 50% P.O.C.","$68000 or more"
"06019005507","Census Tract 55.07, Fresno County, California",5503,94669,2980,115,1,710,0,1630,54.2,2.1,0,12.9,0,29.6,45.8,2267,1504,763,66.34,33.66,59,1445,87,676,146,2121,3.9,11.4,6.4,"25% - 50% P.O.C.","$68000 or more"
"06019005508","Census Tract 55.08, Fresno County, California",5671,100316,2883,114,4,1186,16,1324,50.8,2,0.1,20.9,0.3,23.3,49.2,2036,1401,635,68.81,31.19,204,1197,48,587,252,1784,14.6,7.6,12.4,"25% - 50% P.O.C.","$68000 or more"
"06019005509","Census Tract 55.09, Fresno County, California",5128,84841,2885,222,65,555,17,1261,56.3,4.3,1.3,10.8,0.3,24.6,43.7,1755,928,827,52.88,47.12,67,861,106,721,173,1582,7.2,12.8,9.9,"25% - 50% P.O.C.","$68000 or more"
"06019005510","Census Tract 55.10, Fresno County, California",4983,73750,2623,215,0,685,0,1251,52.6,4.3,0,13.7,0,25.1,47.4,2259,892,1367,39.49,60.51,11,881,107,1260,118,2141,1.2,7.8,5.2,"25% - 50% P.O.C.","$68000 or more"
"06019005512","Census Tract 55.12, Fresno County, California",5376,92411,3187,18,0,598,0,1373,59.3,0.3,0,11.1,0,25.5,40.7,1717,1150,567,66.98,33.02,180,970,89,478,269,1448,15.7,15.7,15.7,"25% - 50% P.O.C.","$68000 or more"
"06019005513","Census Tract 55.13, Fresno County, California",2995,117938,1992,47,25,325,0,539,66.5,1.6,0.8,10.9,0,18,33.5,953,761,192,79.85,20.15,79,682,51,141,130,823,10.4,26.6,13.6,"25% - 50% P.O.C.","$68000 or more"
"06019005514","Census Tract 55.14, Fresno County, California",4041,102161,2583,332,0,386,0,635,63.9,8.2,0,9.6,0,15.7,36.1,1330,877,453,65.94,34.06,127,750,62,391,189,1141,14.5,13.7,14.2,"25% - 50% P.O.C.","$68000 or more"
"06019005515","Census Tract 55.15, Fresno County, California",1820,90982,1172,39,39,154,0,394,64.4,2.1,2.1,8.5,0,21.6,35.6,635,523,112,82.36,17.64,64,459,16,96,80,555,12.2,14.3,12.6,"25% - 50% P.O.C.","$68000 or more"
"06019005516","Census Tract 55.16, Fresno County, California",6180,90806,3463,318,0,459,0,1753,56,5.1,0,7.4,0,28.4,44,2727,1155,1572,42.35,57.65,90,1065,87,1485,177,2550,7.8,5.5,6.5,"25% - 50% P.O.C.","$68000 or more"
"06019005517","Census Tract 55.17, Fresno County, California",7978,106726,4804,0,0,1354,42,1160,60.2,0,0,17,0.5,14.5,39.8,2629,2000,629,76.07,23.93,250,1750,42,587,292,2337,12.5,6.7,11.1,"25% - 50% P.O.C.","$68000 or more"
"06019005518","Census Tract 55.18, Fresno County, California",5790,119113,3720,100,13,513,0,1354,64.2,1.7,0.2,8.9,0,23.4,35.8,1860,1494,366,80.32,19.68,216,1278,74,292,290,1570,14.5,20.2,15.6,"25% - 50% P.O.C.","$68000 or more"
"06019005520","Census Tract 55.20, Fresno County, California",2997,143875,1845,84,5,467,0,465,61.6,2.8,0.2,15.6,0,15.5,38.4,871,811,60,93.11,6.89,159,652,17,43,176,695,19.6,28.3,20.2,"25% - 50% P.O.C.","$68000 or more"
"06019005522","Census Tract 55.22, Fresno County, California",4860,130455,3057,0,0,661,0,914,62.9,0,0,13.6,0,18.8,37.1,1464,1167,297,79.71,20.29,227,940,55,242,282,1182,19.5,18.5,19.3,"25% - 50% P.O.C.","$68000 or more"
"06019005524","Census Tract 55.24, Fresno County, California",4660,143006,2980,79,0,625,0,790,63.9,1.7,0,13.4,0,17,36.1,1579,1279,300,81,19,153,1126,93,207,246,1333,12,31,15.6,"25% - 50% P.O.C.","$68000 or more"
"06019005525","Census Tract 55.25, Fresno County, California",1041,114167,678,33,0,134,0,137,65.1,3.2,0,12.9,0,13.2,34.9,394,347,47,88.07,11.93,40,307,0,47,40,354,11.5,0,10.2,"25% - 50% P.O.C.","$68000 or more"
"06019005602","Census Tract 56.02, Fresno County, California",4991,41055,2694,105,73,338,0,1679,54,2.1,1.5,6.8,0,33.6,46,2248,604,1644,26.87,73.13,29,575,117,1527,146,2102,4.8,7.1,6.5,"25% - 50% P.O.C.","$38000 - $50000"
"06019005605","Census Tract 56.05, Fresno County, California",1745,95046,1271,9,0,55,0,389,72.8,0.5,0,3.2,0,22.3,27.2,533,462,71,86.68,13.32,81,381,18,53,99,434,17.5,25.4,18.6,"25% - 50% P.O.C.","$68000 or more"
"06019005606","Census Tract 56.06, Fresno County, California",4010,83188,1999,208,41,254,0,1236,49.9,5.2,1,6.3,0,30.8,50.1,1341,896,445,66.82,33.18,36,860,73,372,109,1232,4,16.4,8.1,"50% - 75% P.O.C.","$68000 or more"
"06019005607","Census Tract 56.07, Fresno County, California",4688,39271,2175,274,0,249,209,1687,46.4,5.8,0,5.3,4.5,36,53.6,1956,323,1633,16.51,83.49,0,323,94,1539,94,1862,0,5.8,4.8,"50% - 75% P.O.C.","$38000 - $50000"
"06019005608","Census Tract 56.08, Fresno County, California",3137,44567,1815,99,0,68,0,1015,57.9,3.2,0,2.2,0,32.4,42.1,1325,747,578,56.38,43.62,23,724,114,464,137,1188,3.1,19.7,10.3,"25% - 50% P.O.C.","$38000 - $50000"
"06019005701","Census Tract 57.01, Fresno County, California",3582,43254,1650,40,7,381,0,1443,46.1,1.1,0.2,10.6,0,40.3,53.9,1329,645,684,48.53,51.47,76,569,81,603,157,1172,11.8,11.8,11.8,"50% - 75% P.O.C.","$38000 - $50000"
"06019005702","Census Tract 57.02, Fresno County, California",5254,85000,3405,59,0,366,0,1287,64.8,1.1,0,7,0,24.5,35.2,1818,1342,476,73.82,26.18,69,1273,144,332,213,1605,5.1,30.3,11.7,"25% - 50% P.O.C.","$68000 or more"
"06019005703","Census Tract 57.03, Fresno County, California",5199,95605,3252,202,106,310,0,1191,62.6,3.9,2,6,0,22.9,37.4,1742,1512,230,86.8,13.2,155,1357,57,173,212,1530,10.3,24.8,12.2,"25% - 50% P.O.C.","$68000 or more"
"06019005704","Census Tract 57.04, Fresno County, California",5186,53300,2468,49,0,305,0,2156,47.6,0.9,0,5.9,0,41.6,52.4,1720,927,793,53.9,46.1,105,822,86,707,191,1529,11.3,10.8,11.1,"50% - 75% P.O.C.","$50000 - $68000"
"06019005801","Census Tract 58.01, Fresno County, California",4699,59315,2272,69,28,428,0,1809,48.4,1.5,0.6,9.1,0,38.5,51.6,1790,1016,774,56.76,43.24,46,970,91,683,137,1653,4.5,11.8,7.7,"50% - 75% P.O.C.","$50000 - $68000"
"06019005802","Census Tract 58.02, Fresno County, California",4800,123550,2244,330,0,775,0,1326,46.8,6.9,0,16.1,0,27.6,53.2,1489,1339,150,89.93,10.07,216,1123,7,143,223,1266,16.1,4.7,15,"50% - 75% P.O.C.","$68000 or more"
"06019005804","Census Tract 58.04, Fresno County, California",6940,70866,2263,103,0,986,46,3391,32.6,1.5,0,14.2,0.7,48.9,67.4,2097,1447,650,69,31,258,1189,69,581,327,1770,17.8,10.6,15.6,"50% - 75% P.O.C.","$68000 or more"
"06019005805","Census Tract 58.05, Fresno County, California",6416,87475,2628,170,35,1388,0,2037,41,2.6,0.5,21.6,0,31.7,59,1806,1628,178,90.14,9.86,339,1289,0,178,339,1467,20.8,0,18.8,"50% - 75% P.O.C.","$68000 or more"
"06019005904","Census Tract 59.04, Fresno County, California",6398,94392,2540,131,0,1536,0,2054,39.7,2,0,24,0,32.1,60.3,1871,1592,279,85.09,14.91,358,1234,95,184,453,1418,22.5,34.1,24.2,"50% - 75% P.O.C.","$68000 or more"
"06019005905","Census Tract 59.05, Fresno County, California",7435,120774,4636,36,75,1122,0,1408,62.4,0.5,1,15.1,0,18.9,37.6,2521,2300,221,91.23,8.77,220,2080,31,190,251,2270,9.6,14,10,"25% - 50% P.O.C.","$68000 or more"
"06019005906","Census Tract 59.06, Fresno County, California",2427,87226,1248,0,7,390,0,754,51.4,0,0.3,16.1,0,31.1,48.6,745,524,221,70.34,29.66,55,469,59,162,114,631,10.5,26.7,15.3,"25% - 50% P.O.C.","$68000 or more"
"06019005907","Census Tract 59.07, Fresno County, California",3485,94479,2000,54,0,468,44,729,57.4,1.5,0,13.4,1.3,20.9,42.6,1023,746,277,72.92,27.08,119,627,59,218,178,845,16,21.3,17.4,"25% - 50% P.O.C.","$68000 or more"
"06019005909","Census Tract 59.09, Fresno County, California",8035,119719,3470,77,0,1450,0,2588,43.2,1,0,18,0,32.2,56.8,2245,1951,294,86.9,13.1,500,1451,38,256,538,1707,25.6,12.9,24,"50% - 75% P.O.C.","$68000 or more"
"06019005911","Census Tract 59.11, Fresno County, California",6018,95764,2705,128,0,1051,0,1910,44.9,2.1,0,17.5,0,31.7,55.1,1891,1615,276,85.4,14.6,259,1356,19,257,278,1613,16,6.9,14.7,"50% - 75% P.O.C.","$68000 or more"
"06019005912","Census Tract 59.12, Fresno County, California",5865,102704,3669,0,41,594,0,1436,62.6,0,0.7,10.1,0,24.5,37.4,2008,1836,172,91.43,8.57,184,1652,0,172,184,1824,10,0,9.2,"25% - 50% P.O.C.","$68000 or more"
"06019006000","Census Tract 60, Fresno County, California",9788,60979,1785,8,0,177,0,7508,18.2,0.1,0,1.8,0,76.7,81.8,3033,1864,1169,61.46,38.54,355,1509,365,804,720,2313,19,31.2,23.7,"75% or more P.O.C.","$50000 - $68000"
"06019006100","Census Tract 61, Fresno County, California",8126,44815,1179,0,86,522,0,6289,14.5,0,1.1,6.4,0,77.4,85.5,2210,1226,984,55.48,44.52,341,885,281,703,622,1588,27.8,28.6,28.1,"75% or more P.O.C.","$38000 - $50000"
"06019006201","Census Tract 62.01, Fresno County, California",2357,27222,116,9,8,19,0,2196,4.9,0.4,0.3,0.8,0,93.2,95.1,678,281,397,41.45,58.55,45,236,110,287,155,523,16,27.7,22.9,"75% or more P.O.C.","Less than $38000"
"06019006202","Census Tract 62.02, Fresno County, California",6202,50301,304,0,0,14,0,5833,4.9,0,0,0.2,0,94.1,95.1,1681,828,853,49.26,50.74,237,591,245,608,482,1199,28.6,28.7,28.7,"75% or more P.O.C.","$50000 - $68000"
"06019006300","Census Tract 63, Fresno County, California",7507,78295,3354,33,1,478,0,3290,44.7,0.4,0,6.4,0,43.8,55.3,2391,1905,486,79.67,20.33,398,1507,88,398,486,1905,20.9,18.1,20.3,"50% - 75% P.O.C.","$68000 or more"
"06019006402","Census Tract 64.02, Fresno County, California",2779,73239,1981,30,335,17,5,225,71.3,1.1,12.1,0.6,0.2,8.1,28.7,1067,887,180,83.13,16.87,103,784,43,137,146,921,11.6,23.9,13.7,"25% - 50% P.O.C.","$68000 or more"
"06019006403","Census Tract 64.03, Fresno County, California",6101,64156,4044,33,51,149,0,1801,66.3,0.5,0.8,2.4,0,29.5,33.7,2074,1816,258,87.56,12.44,197,1619,67,191,264,1810,10.8,26,12.7,"25% - 50% P.O.C.","$50000 - $68000"
"06019006404","Census Tract 64.04, Fresno County, California",4731,85250,3615,58,164,93,24,542,76.4,1.2,3.5,2,0.5,11.5,23.6,1750,1492,258,85.26,14.74,155,1337,24,234,179,1571,10.4,9.3,10.2,"Less than 25% P.O.C.","$68000 or more"
"06019006405","Census Tract 64.05, Fresno County, California",5217,73333,3738,24,77,344,0,836,71.7,0.5,1.5,6.6,0,16,28.3,1994,1684,310,84.45,15.55,132,1552,29,281,161,1833,7.8,9.4,8.1,"25% - 50% P.O.C.","$68000 or more"
"06019006501","Census Tract 65.01, Fresno County, California",6871,29084,300,120,17,18,0,6416,4.4,1.7,0.2,0.3,0,93.4,95.6,1702,654,1048,38.43,61.57,246,408,290,758,536,1166,37.6,27.7,31.5,"75% or more P.O.C.","Less than $38000"
"06019006502","Census Tract 65.02, Fresno County, California",4810,25247,259,0,0,0,29,4522,5.4,0,0,0,0.6,94,94.6,1299,461,838,35.49,64.51,94,367,342,496,436,863,20.4,40.8,33.6,"75% or more P.O.C.","Less than $38000"
"06019006602","Census Tract 66.02, Fresno County, California",6083,41806,480,0,3,83,26,5432,7.9,0,0,1.4,0.4,89.3,92.1,1582,777,805,49.12,50.88,178,599,215,590,393,1189,22.9,26.7,24.8,"75% or more P.O.C.","$38000 - $50000"
"06019006603","Census Tract 66.03, Fresno County, California",2312,44375,663,90,4,65,6,1427,28.7,3.9,0.2,2.8,0.3,61.7,71.3,644,331,313,51.4,48.6,91,240,5,308,96,548,27.5,1.6,14.9,"50% - 75% P.O.C.","$38000 - $50000"
"06019006604","Census Tract 66.04, Fresno County, California",7768,44444,484,0,9,150,0,6866,6.2,0,0.1,1.9,0,88.4,93.8,1852,986,866,53.24,46.76,361,625,363,503,724,1128,36.6,41.9,39.1,"75% or more P.O.C.","$38000 - $50000"
"06019006700","Census Tract 67, Fresno County, California",6345,45195,1426,174,0,411,0,4060,22.5,2.7,0,6.5,0,64,77.5,2161,1684,477,77.93,22.07,255,1429,120,357,375,1786,15.1,25.2,17.4,"75% or more P.O.C.","$38000 - $50000"
"06019006802","Census Tract 68.02, Fresno County, California",3339,40000,473,25,0,30,0,2742,14.2,0.7,0,0.9,0,82.1,85.8,1030,459,571,44.56,55.44,163,296,100,471,263,767,35.5,17.5,25.5,"75% or more P.O.C.","$38000 - $50000"
"06019006900","Census Tract 69, Fresno County, California",3293,40573,403,0,0,108,0,2708,12.2,0,0,3.3,0,82.2,87.8,888,538,350,60.59,39.41,165,373,69,281,234,654,30.7,19.7,26.4,"75% or more P.O.C.","$38000 - $50000"
"06019007002","Census Tract 70.02, Fresno County, California",4943,37760,419,4,2,24,0,4386,8.5,0.1,0,0.5,0,88.7,91.5,1466,619,847,42.22,57.78,125,494,222,625,347,1119,20.2,26.2,23.7,"75% or more P.O.C.","Less than $38000"
"06019007003","Census Tract 70.03, Fresno County, California",8061,56033,1014,0,11,381,0,6558,12.6,0,0.1,4.7,0,81.4,87.4,2228,1558,670,69.93,30.07,415,1143,292,378,707,1521,26.6,43.6,31.7,"75% or more P.O.C.","$50000 - $68000"
"06019007004","Census Tract 70.04, Fresno County, California",5813,58341,1195,29,19,343,0,4102,20.6,0.5,0.3,5.9,0,70.6,79.4,1823,1263,560,69.28,30.72,211,1052,86,474,297,1526,16.7,15.4,16.3,"75% or more P.O.C.","$50000 - $68000"
"06019007100","Census Tract 71, Fresno County, California",7637,33916,574,62,0,89,0,6881,7.5,0.8,0,1.2,0,90.1,92.5,2050,1018,1032,49.66,50.34,286,732,380,652,666,1384,28.1,36.8,32.5,"75% or more P.O.C.","Less than $38000"
"06019007201","Census Tract 72.01, Fresno County, California",8196,68553,4303,18,3,258,0,3237,52.5,0.2,0,3.1,0,39.5,47.5,2822,1891,931,67.01,32.99,316,1575,126,805,442,2380,16.7,13.5,15.7,"25% - 50% P.O.C.","$68000 or more"
"06019007202","Census Tract 72.02, Fresno County, California",5144,62808,1613,20,42,188,0,3049,31.4,0.4,0.8,3.7,0,59.3,68.6,1667,1114,553,66.83,33.17,269,845,109,444,378,1289,24.1,19.7,22.7,"50% - 75% P.O.C.","$50000 - $68000"
"06019007300","Census Tract 73, Fresno County, California",4325,57656,1306,172,0,445,0,2367,30.2,4,0,10.3,0,54.7,69.8,1246,632,614,50.72,49.28,149,483,188,426,337,909,23.6,30.6,27,"50% - 75% P.O.C.","$50000 - $68000"
"06019007400","Census Tract 74, Fresno County, California",3407,37917,950,0,0,0,0,2423,27.9,0,0,0,0,71.1,72.1,1009,471,538,46.68,53.32,74,397,178,360,252,757,15.7,33.1,25,"50% - 75% P.O.C.","Less than $38000"
"06019007500","Census Tract 75, Fresno County, California",5068,45587,1289,8,0,306,0,3320,25.4,0.2,0,6,0,65.5,74.6,1497,859,638,57.38,42.62,214,645,134,504,348,1149,24.9,21,23.2,"50% - 75% P.O.C.","$38000 - $50000"
"06019007600","Census Tract 76, Fresno County, California",4273,50335,1050,72,10,100,0,3005,24.6,1.7,0.2,2.3,0,70.3,75.4,1303,605,698,46.43,53.57,45,560,189,509,234,1069,7.4,27.1,18,"75% or more P.O.C.","$50000 - $68000"
"06019007700","Census Tract 77, Fresno County, California",5221,50434,1438,16,0,2,0,3682,27.5,0.3,0,0,0,70.5,72.5,1495,840,655,56.19,43.81,135,705,202,453,337,1158,16.1,30.8,22.5,"50% - 75% P.O.C.","$50000 - $68000"
"06019007801","Census Tract 78.01, Fresno County, California",2731,44042,34,21,0,1,0,2675,1.2,0.8,0,0,0,97.9,98.8,655,261,394,39.85,60.15,109,152,159,235,268,387,41.8,40.4,40.9,"75% or more P.O.C.","$38000 - $50000"
"06019007802","Census Tract 78.02, Fresno County, California",5354,22391,338,17,174,17,0,4808,6.3,0.3,3.2,0.3,0,89.8,93.7,1296,221,1075,17.05,82.95,83,138,358,717,441,855,37.6,33.3,34,"75% or more P.O.C.","Less than $38000"
"06019007901","Census Tract 79.01, Fresno County, California",3251,NA,670,66,42,112,28,2174,20.6,2,1.3,3.4,0.9,66.9,79.4,0,0,0,NA,NA,0,0,0,0,0,0,NA,NA,NA,"75% or more P.O.C.","N/A"
"06019007902","Census Tract 79.02, Fresno County, California",2952,52173,453,117,74,22,2,2226,15.3,4,2.5,0.7,0.1,75.4,84.7,871,493,378,56.6,43.4,132,361,89,289,221,650,26.8,23.5,25.4,"75% or more P.O.C.","$50000 - $68000"
"06019008000","Census Tract 80, Fresno County, California",5360,72719,2399,87,7,89,0,2748,44.8,1.6,0.1,1.7,0,51.3,55.2,1688,931,757,55.15,44.85,183,748,118,639,301,1387,19.7,15.6,17.8,"50% - 75% P.O.C.","$68000 or more"
"06019008100","Census Tract 81, Fresno County, California",6532,51815,1907,253,276,169,86,3710,29.2,3.9,4.2,2.6,1.3,56.8,70.8,2065,1047,1018,50.7,49.3,181,866,191,827,372,1693,17.3,18.8,18,"50% - 75% P.O.C.","$50000 - $68000"
"06019008200","Census Tract 82, Fresno County, California",6768,36968,358,48,0,0,0,6362,5.3,0.7,0,0,0,94,94.7,1781,711,1070,39.92,60.08,266,445,352,718,618,1163,37.4,32.9,34.7,"75% or more P.O.C.","Less than $38000"
"06019008301","Census Tract 83.01, Fresno County, California",6009,27375,331,0,0,0,0,5658,5.5,0,0,0,0,94.2,94.5,1495,613,882,41,59,166,447,260,622,426,1069,27.1,29.5,28.5,"75% or more P.O.C.","Less than $38000"
"06019008302","Census Tract 83.02, Fresno County, California",7406,36717,123,312,0,55,0,6906,1.7,4.2,0,0.7,0,93.2,98.3,1571,565,1006,35.96,64.04,257,308,342,664,599,972,45.5,34,38.1,"75% or more P.O.C.","Less than $38000"
"06019008401","Census Tract 84.01, Fresno County, California",8857,36685,816,0,0,3,0,8038,9.2,0,0,0,0,90.8,90.8,2321,916,1405,39.47,60.53,379,537,305,1100,684,1637,41.4,21.7,29.5,"75% or more P.O.C.","Less than $38000"
"06019008402","Census Tract 84.02, Fresno County, California",980,50556,214,0,0,0,0,766,21.8,0,0,0,0,78.2,78.2,300,107,193,35.67,64.33,8,99,42,151,50,250,7.5,21.8,16.7,"75% or more P.O.C.","$50000 - $68000"
"06019008501","Census Tract 85.01, Fresno County, California",4420,35852,58,0,0,15,0,4347,1.3,0,0,0.3,0,98.3,98.7,1186,397,789,33.47,66.53,77,320,253,536,330,856,19.4,32.1,27.8,"75% or more P.O.C.","Less than $38000"
"06019008502","Census Tract 85.02, Fresno County, California",9242,36395,102,0,0,24,0,9116,1.1,0,0,0.3,0,98.6,98.9,2201,915,1286,41.57,58.43,300,615,468,818,768,1433,32.8,36.4,34.9,"75% or more P.O.C.","Less than $38000"
"06031000100","Census Tract 1, Kings County, California",3053,97736,1708,5,3,167,7,1106,55.9,0.2,0.1,5.5,0.2,36.2,44.1,949,565,384,59.54,40.46,149,416,65,319,214,735,26.4,16.9,22.6,"25% - 50% P.O.C.","$68000 or more"
"06031000200","Census Tract 2, Kings County, California",2287,51875,1249,59,4,15,6,954,54.6,2.6,0.2,0.7,0.3,41.7,45.4,764,398,366,52.09,47.91,32,366,80,286,112,652,8,21.9,14.7,"25% - 50% P.O.C.","$50000 - $68000"
"06031000300","Census Tract 3, Kings County, California",6858,52450,3428,1089,34,296,39,1601,50,15.9,0.5,4.3,0.6,23.3,50,1603,0,1603,0,100,0,0,181,1422,181,1422,NA,11.3,11.3,"50% - 75% P.O.C.","$50000 - $68000"
"06031000402","Census Tract 4.02, Kings County, California",5976,80580,2798,231,0,464,0,2310,46.8,3.9,0,7.8,0,38.7,53.2,1962,1268,694,64.63,35.37,226,1042,136,558,362,1600,17.8,19.6,18.5,"50% - 75% P.O.C.","$68000 or more"
"06031000403","Census Tract 4.03, Kings County, California",5007,64348,2044,490,9,285,0,1884,40.8,9.8,0.2,5.7,0,37.6,59.2,1766,1020,746,57.76,42.24,140,880,81,665,221,1545,13.7,10.9,12.5,"50% - 75% P.O.C.","$50000 - $68000"
"06031000404","Census Tract 4.04, Kings County, California",10622,67819,4921,317,0,870,9,4046,46.3,3,0,8.2,0.1,38.1,53.7,3441,1975,1466,57.4,42.6,296,1679,148,1318,444,2997,15,10.1,12.9,"50% - 75% P.O.C.","$50000 - $68000"
"06031000405","Census Tract 4.05, Kings County, California",6796,44796,2131,288,50,427,11,3732,31.4,4.2,0.7,6.3,0.2,54.9,68.6,2308,790,1518,34.23,65.77,184,606,219,1299,403,1905,23.3,14.4,17.5,"50% - 75% P.O.C.","$38000 - $50000"
"06031000500","Census Tract 5, Kings County, California",5358,52304,1335,311,23,188,0,3367,24.9,5.8,0.4,3.5,0,62.8,75.1,1566,980,586,62.58,37.42,163,817,215,371,378,1188,16.6,36.7,24.1,"75% or more P.O.C.","$50000 - $68000"
"06031000601","Census Tract 6.01, Kings County, California",9844,98075,4642,429,0,802,0,3562,47.2,4.4,0,8.1,0,36.2,52.8,3346,2531,815,75.64,24.36,317,2214,117,698,434,2912,12.5,14.4,13,"50% - 75% P.O.C.","$68000 or more"
"06031000602","Census Tract 6.02, Kings County, California",5962,82306,3470,362,0,291,0,1580,58.2,6.1,0,4.9,0,26.5,41.8,2367,1527,840,64.51,35.49,51,1476,43,797,94,2273,3.3,5.1,4,"25% - 50% P.O.C.","$68000 or more"
"06031000701","Census Tract 7.01, Kings County, California",5656,79471,2983,120,35,150,0,2099,52.7,2.1,0.6,2.7,0,37.1,47.3,2112,1529,583,72.4,27.6,124,1405,30,553,154,1958,8.1,5.1,7.3,"25% - 50% P.O.C.","$68000 or more"
"06031000702","Census Tract 7.02, Kings County, California",4342,62941,1626,528,0,119,0,1854,37.4,12.2,0,2.7,0,42.7,62.6,1618,1037,581,64.09,35.91,66,971,64,517,130,1488,6.4,11,8,"50% - 75% P.O.C.","$50000 - $68000"
"06031000800","Census Tract 8, Kings County, California",5055,46250,1796,216,61,96,0,2760,35.5,4.3,1.2,1.9,0,54.6,64.5,1513,823,690,54.4,45.6,162,661,136,554,298,1215,19.7,19.7,19.7,"50% - 75% P.O.C.","$38000 - $50000"
"06031000900","Census Tract 9, Kings County, California",7956,43968,2485,489,109,46,0,4717,31.2,6.1,1.4,0.6,0,59.3,68.8,2774,928,1846,33.45,66.55,112,816,338,1508,450,2324,12.1,18.3,16.2,"50% - 75% P.O.C.","$38000 - $50000"
"06031001001","Census Tract 10.01, Kings County, California",4519,73079,2541,185,0,328,0,1252,56.2,4.1,0,7.3,0,27.7,43.8,1753,1055,698,60.18,39.82,137,918,42,656,179,1574,13,6,10.2,"25% - 50% P.O.C.","$68000 or more"
"06031001002","Census Tract 10.02, Kings County, California",5094,46725,736,177,0,166,0,3889,14.4,3.5,0,3.3,0,76.3,85.6,1323,406,917,30.69,69.31,190,216,268,649,458,865,46.8,29.2,34.6,"75% or more P.O.C.","$38000 - $50000"
"06031001003","Census Tract 10.03, Kings County, California",6811,54821,1053,178,166,506,6,4799,15.5,2.6,2.4,7.4,0.1,70.5,84.5,1743,1145,598,65.69,34.31,383,762,168,430,551,1192,33.4,28.1,31.6,"75% or more P.O.C.","$50000 - $68000"
"06031001100","Census Tract 11, Kings County, California",6631,32652,650,260,11,113,131,5343,9.8,3.9,0.2,1.7,2,80.6,90.2,1803,649,1154,36,64,143,506,309,845,452,1351,22,26.8,25.1,"75% or more P.O.C.","Less than $38000"
"06031001200","Census Tract 12, Kings County, California",2445,55670,1191,10,17,19,1,1177,48.7,0.4,0.7,0.8,0,48.1,51.3,803,388,415,48.32,51.68,56,332,152,263,208,595,14.4,36.6,25.9,"50% - 75% P.O.C.","$50000 - $68000"
"06031001300","Census Tract 13, Kings County, California",4811,32134,558,205,0,0,0,3891,11.6,4.3,0,0,0,80.9,88.4,1348,418,930,31.01,68.99,58,360,327,603,385,963,13.9,35.2,28.6,"75% or more P.O.C.","Less than $38000"
"06031001401","Census Tract 14.01, Kings County, California",2646,37479,216,52,0,0,0,2378,8.2,2,0,0,0,89.9,91.8,821,497,324,60.54,39.46,129,368,62,262,191,630,26,19.1,23.3,"75% or more P.O.C.","Less than $38000"
"06031001402","Census Tract 14.02, Kings County, California",2168,35433,378,14,14,0,0,1753,17.4,0.6,0.6,0,0,80.9,82.6,669,289,380,43.2,56.8,44,245,91,289,135,534,15.2,23.9,20.2,"75% or more P.O.C.","Less than $38000"
"06031001500","Census Tract 15, Kings County, California",4671,43804,726,185,0,16,0,3744,15.5,4,0,0.3,0,80.2,84.5,1534,779,755,50.78,49.22,155,624,123,632,278,1256,19.9,16.3,18.1,"75% or more P.O.C.","$38000 - $50000"
"06031001601","Census Tract 16.01, Kings County, California",4101,52181,683,80,549,34,0,2664,16.7,2,13.4,0.8,0,65,83.3,1051,510,541,48.53,51.47,136,374,259,282,395,656,26.7,47.9,37.6,"75% or more P.O.C.","$50000 - $68000"
"06031001602","Census Tract 16.02, Kings County, California",9035,NA,1915,2081,143,145,20,4518,21.2,23,1.6,1.6,0.2,50,78.8,0,0,0,NA,NA,0,0,0,0,0,0,NA,NA,NA,"75% or more P.O.C.","N/A"
"06031001701","Census Tract 17.01, Kings County, California",10015,40523,609,23,0,0,0,9383,6.1,0.2,0,0,0,93.7,93.9,2515,1226,1289,48.75,51.25,359,867,623,666,982,1533,29.3,48.3,39,"75% or more P.O.C.","$38000 - $50000"
"06031981800","Census Tract 9818, Kings County, California",2972,NA,665,395,54,22,11,1753,22.4,13.3,1.8,0.7,0.4,59,77.6,0,0,0,NA,NA,0,0,0,0,0,0,NA,NA,NA,"75% or more P.O.C.","N/A"
"06039000102","Census Tract 1.02, Madera County, California",4060,65938,3039,0,224,57,0,580,74.9,0,5.5,1.4,0,14.3,25.1,1795,1483,312,82.62,17.38,53,1430,47,265,100,1695,3.6,15.1,5.6,"25% - 50% P.O.C.","$50000 - $68000"
"06039000103","Census Tract 1.03, Madera County, California",5197,50366,4649,0,43,0,0,463,89.5,0,0.8,0,0,8.9,10.5,2087,1384,703,66.32,33.68,80,1304,26,677,106,1981,5.8,3.7,5.1,"Less than 25% P.O.C.","$50000 - $68000"
"06039000104","Census Tract 1.04, Madera County, California",4503,61445,3318,0,14,253,0,839,73.7,0,0.3,5.6,0,18.6,26.3,1684,1358,326,80.64,19.36,82,1276,138,188,220,1464,6,42.3,13.1,"25% - 50% P.O.C.","$50000 - $68000"
"06039000106","Census Tract 1.06, Madera County, California",5692,74107,4548,20,145,95,0,615,79.9,0.4,2.5,1.7,0,10.8,20.1,2073,1752,321,84.52,15.48,123,1629,32,289,155,1918,7,10,7.5,"Less than 25% P.O.C.","$68000 or more"
"06039000108","Census Tract 1.08, Madera County, California",6669,67358,5144,112,109,0,0,1109,77.1,1.7,1.6,0,0,16.6,22.9,2814,2432,382,86.43,13.57,204,2228,5,377,209,2605,8.4,1.3,7.4,"Less than 25% P.O.C.","$50000 - $68000"
"06039000109","Census Tract 1.09, Madera County, California",2161,55694,1363,6,25,44,9,461,63.1,0.3,1.2,2,0.4,21.3,36.9,846,681,165,80.5,19.5,42,639,49,116,91,755,6.2,29.7,10.8,"25% - 50% P.O.C.","$50000 - $68000"
"06039000201","Census Tract 2.01, Madera County, California",8718,73311,2711,1403,189,262,18,3818,31.1,16.1,2.2,3,0.2,43.8,68.9,432,229,203,53.01,46.99,61,168,42,161,103,329,26.6,20.7,23.8,"50% - 75% P.O.C.","$68000 or more"
"06039000202","Census Tract 2.02, Madera County, California",5738,73060,2710,9,63,421,38,2440,47.2,0.2,1.1,7.3,0.7,42.5,52.8,1801,1126,675,62.52,37.48,192,934,133,542,325,1476,17.1,19.7,18,"50% - 75% P.O.C.","$68000 or more"
"06039000300","Census Tract 3, Madera County, California",7844,44179,3173,101,159,34,0,4236,40.5,1.3,2,0.4,0,54,59.5,2369,1006,1363,42.47,57.53,191,815,364,999,555,1814,19,26.7,23.4,"50% - 75% P.O.C.","$38000 - $50000"
"06039000400","Census Tract 4, Madera County, California",1279,59236,331,9,27,5,0,890,25.9,0.7,2.1,0.4,0,69.6,74.1,351,151,200,43.02,56.98,12,139,72,128,84,267,7.9,36,23.9,"50% - 75% P.O.C.","$50000 - $68000"
"06039000502","Census Tract 5.02, Madera County, California",12934,51829,1221,823,23,57,0,10683,9.4,6.4,0.2,0.4,0,82.6,90.6,3156,1580,1576,50.06,49.94,570,1010,566,1010,1136,2020,36.1,35.9,36,"75% or more P.O.C.","$50000 - $68000"
"06039000503","Census Tract 5.03, Madera County, California",9292,59471,2689,228,0,825,0,5538,28.9,2.5,0,8.9,0,59.6,71.1,2965,1884,1081,63.54,36.46,147,1737,195,886,342,2623,7.8,18,11.5,"50% - 75% P.O.C.","$50000 - $68000"
"06039000506","Census Tract 5.06, Madera County, California",6471,76583,1382,167,0,22,0,4724,21.4,2.6,0,0.3,0,73,78.6,1590,1393,197,87.61,12.39,370,1023,110,87,480,1110,26.6,55.8,30.2,"75% or more P.O.C.","$68000 or more"
"06039000507","Census Tract 5.07, Madera County, California",10535,71283,2509,143,21,81,0,7738,23.8,1.4,0.2,0.8,0,73.5,76.2,2649,2126,523,80.26,19.74,596,1530,257,266,853,1796,28,49.1,32.2,"75% or more P.O.C.","$68000 or more"
"06039000508","Census Tract 5.08, Madera County, California",7591,71078,2507,188,7,93,0,4709,33,2.5,0.1,1.2,0,62,67,1909,1505,404,78.84,21.16,385,1120,166,238,551,1358,25.6,41.1,28.9,"50% - 75% P.O.C.","$68000 or more"
"06039000509","Census Tract 5.09, Madera County, California",6374,79476,3531,55,279,303,0,2034,55.4,0.9,4.4,4.8,0,31.9,44.6,2067,1842,225,89.11,10.89,299,1543,101,124,400,1667,16.2,44.9,19.4,"25% - 50% P.O.C.","$68000 or more"
"06039000602","Census Tract 6.02, Madera County, California",4296,31966,329,17,44,0,0,3895,7.7,0.4,1,0,0,90.7,92.3,1284,550,734,42.83,57.17,31,519,239,495,270,1014,5.6,32.6,21,"75% or more P.O.C.","Less than $38000"
"06039000603","Census Tract 6.03, Madera County, California",5963,39455,594,134,18,0,71,5046,10,2.2,0.3,0,1.2,84.6,90,1469,540,929,36.76,63.24,134,406,337,592,471,998,24.8,36.3,32.1,"75% or more P.O.C.","$38000 - $50000"
"06039000604","Census Tract 6.04, Madera County, California",5485,34239,438,128,0,0,0,4769,8,2.3,0,0,0,86.9,92,1362,430,932,31.57,68.43,138,292,351,581,489,873,32.1,37.7,35.9,"75% or more P.O.C.","Less than $38000"
"06039000700","Census Tract 7, Madera County, California",11600,67093,3266,184,113,301,0,7443,28.2,1.6,1,2.6,0,64.2,71.8,4028,2599,1429,64.52,35.48,308,2291,201,1228,509,3519,11.9,14.1,12.6,"50% - 75% P.O.C.","$50000 - $68000"
"06039000800","Census Tract 8, Madera County, California",6793,32587,994,131,0,0,0,5594,14.6,1.9,0,0,0,82.3,85.4,1974,434,1540,21.99,78.01,46,388,399,1141,445,1529,10.6,25.9,22.5,"75% or more P.O.C.","Less than $38000"
"06039000900","Census Tract 9, Madera County, California",11006,36495,337,844,0,92,0,9683,3.1,7.7,0,0.8,0,88,96.9,2524,994,1530,39.38,60.62,482,512,609,921,1091,1433,48.5,39.8,43.2,"75% or more P.O.C.","Less than $38000"
"06039001000","Census Tract 10, Madera County, California",5232,74167,2270,68,43,75,5,2491,43.4,1.3,0.8,1.4,0.1,47.6,56.6,1652,1293,359,78.27,21.73,183,1110,153,206,336,1316,14.2,42.6,20.3,"50% - 75% P.O.C.","$68000 or more"
"06043000101","Census Tract 1.01, Mariposa County, California",3883,34363,2984,196,63,109,0,415,76.8,5,1.6,2.8,0,10.7,23.2,1818,1102,716,60.62,39.38,29,1073,68,648,97,1721,2.6,9.5,5.3,"Less than 25% P.O.C.","Less than $38000"
"06043000102","Census Tract 1.02, Mariposa County, California",2576,49628,2327,0,52,11,0,174,90.3,0,2,0.4,0,6.8,9.7,1203,900,303,74.81,25.19,63,837,23,280,86,1117,7,7.6,7.1,"Less than 25% P.O.C.","$38000 - $50000"
"06043000200","Census Tract 2, Mariposa County, California",2857,39719,2108,16,31,12,39,530,73.8,0.6,1.1,0.4,1.4,18.6,26.2,1432,1105,327,77.16,22.84,40,1065,20,307,60,1372,3.6,6.1,4.2,"25% - 50% P.O.C.","$38000 - $50000"
"06043000301","Census Tract 3.01, Mariposa County, California",3771,65965,3143,0,15,17,14,326,83.3,0,0.4,0.5,0.4,8.6,16.7,1590,1118,472,70.31,29.69,92,1026,79,393,171,1419,8.2,16.7,10.8,"Less than 25% P.O.C.","$50000 - $68000"
"06043000302","Census Tract 3.02, Mariposa County, California",2631,64432,2178,0,164,12,0,147,82.8,0,6.2,0.5,0,5.6,17.2,1171,931,240,79.5,20.5,69,862,37,203,106,1065,7.4,15.4,9.1,"Less than 25% P.O.C.","$50000 - $68000"
"06043000400","Census Tract 4, Mariposa County, California",1702,47829,1195,41,0,49,0,371,70.2,2.4,0,2.9,0,21.8,29.8,429,74,355,17.25,82.75,0,74,22,333,22,407,0,6.2,5.1,"25% - 50% P.O.C.","$38000 - $50000"
"06047000201","Census Tract 2.01, Merced County, California",3918,61379,1505,10,159,116,0,2104,38.4,0.3,4.1,3,0,53.7,61.6,1174,654,520,55.71,44.29,127,527,161,359,288,886,19.4,31,24.5,"50% - 75% P.O.C.","$50000 - $68000"
"06047000202","Census Tract 2.02, Merced County, California",1889,45846,616,4,0,49,0,1220,32.6,0.2,0,2.6,0,64.6,67.4,555,210,345,37.84,62.16,52,158,111,234,163,392,24.8,32.2,29.4,"50% - 75% P.O.C.","$38000 - $50000"
"06047000203","Census Tract 2.03, Merced County, California",10533,62980,1553,0,0,507,0,8323,14.7,0,0,4.8,0,79,85.3,2502,1747,755,69.82,30.18,692,1055,238,517,930,1572,39.6,31.5,37.2,"75% or more P.O.C.","$50000 - $68000"
"06047000301","Census Tract 3.01, Merced County, California",5499,53833,415,0,0,1044,0,3983,7.5,0,0,19,0,72.4,92.5,1376,709,667,51.53,48.47,337,372,188,479,525,851,47.5,28.2,38.2,"75% or more P.O.C.","$50000 - $68000"
"06047000303","Census Tract 3.03, Merced County, California",2540,65167,1257,34,7,71,0,1164,49.5,1.3,0.3,2.8,0,45.8,50.5,768,352,416,45.83,54.17,87,265,126,290,213,555,24.7,30.3,27.7,"50% - 75% P.O.C.","$50000 - $68000"
"06047000304","Census Tract 3.04, Merced County, California",10132,55500,810,17,0,1989,0,7224,8,0.2,0,19.6,0,71.3,92,2638,1331,1307,50.45,49.55,504,827,408,899,912,1726,37.9,31.2,34.6,"75% or more P.O.C.","$50000 - $68000"
"06047000401","Census Tract 4.01, Merced County, California",1526,40714,760,31,27,5,0,703,49.8,2,1.8,0.3,0,46.1,50.2,540,269,271,49.81,50.19,15,254,74,197,89,451,5.6,27.3,16.5,"50% - 75% P.O.C.","$38000 - $50000"
"06047000402","Census Tract 4.02, Merced County, California",9060,62500,5838,0,35,16,0,2842,64.4,0,0.4,0.2,0,31.4,35.6,3138,1786,1352,56.92,43.08,159,1627,316,1036,475,2663,8.9,23.4,15.1,"25% - 50% P.O.C.","$50000 - $68000"
"06047000503","Census Tract 5.03, Merced County, California",3231,49219,1203,492,0,113,0,1356,37.2,15.2,0,3.5,0,42,62.8,657,342,315,52.05,47.95,32,310,66,249,98,559,9.4,21,14.9,"50% - 75% P.O.C.","$38000 - $50000"
"06047000504","Census Tract 5.04, Merced County, California",6569,46896,1280,16,0,102,0,5155,19.5,0.2,0,1.6,0,78.5,80.5,1911,943,968,49.35,50.65,231,712,278,690,509,1402,24.5,28.7,26.6,"75% or more P.O.C.","$38000 - $50000"
"06047000505","Census Tract 5.05, Merced County, California",6663,47380,1569,41,0,434,162,4351,23.5,0.6,0,6.5,2.4,65.3,76.5,1810,1285,525,70.99,29.01,288,997,229,296,517,1293,22.4,43.6,28.6,"75% or more P.O.C.","$38000 - $50000"
"06047000601","Census Tract 6.01, Merced County, California",4719,43446,1653,135,37,86,0,2622,35,2.9,0.8,1.8,0,55.6,65,1699,747,952,43.97,56.03,74,673,132,820,206,1493,9.9,13.9,12.1,"50% - 75% P.O.C.","$38000 - $50000"
"06047000602","Census Tract 6.02, Merced County, California",4192,56310,1427,53,0,62,32,2593,34,1.3,0,1.5,0.8,61.9,66,1162,603,559,51.89,48.11,107,496,248,311,355,807,17.7,44.4,30.6,"50% - 75% P.O.C.","$50000 - $68000"
"06047000603","Census Tract 6.03, Merced County, California",5882,62900,1848,296,13,238,0,3357,31.4,5,0.2,4,0,57.1,68.6,1886,1130,756,59.92,40.08,233,897,220,536,453,1433,20.6,29.1,24,"50% - 75% P.O.C.","$50000 - $68000"
"06047000701","Census Tract 7.01, Merced County, California",3226,40854,828,269,26,34,11,1951,25.7,8.3,0.8,1.1,0.3,60.5,74.3,997,378,619,37.91,62.09,73,305,101,518,174,823,19.3,16.3,17.5,"50% - 75% P.O.C.","$38000 - $50000"
"06047000702","Census Tract 7.02, Merced County, California",5681,97311,2985,166,64,664,0,1691,52.5,2.9,1.1,11.7,0,29.8,47.5,1927,1654,273,85.83,14.17,173,1481,28,245,201,1726,10.5,10.3,10.4,"25% - 50% P.O.C.","$68000 or more"
"06047000801","Census Tract 8.01, Merced County, California",5539,55472,1878,261,16,325,0,2919,33.9,4.7,0.3,5.9,0,52.7,66.1,1700,652,1048,38.35,61.65,144,508,157,891,301,1399,22.1,15,17.7,"50% - 75% P.O.C.","$50000 - $68000"
"06047000802","Census Tract 8.02, Merced County, California",4109,61140,1575,91,15,294,0,2081,38.3,2.2,0.4,7.2,0,50.6,61.7,1411,994,417,70.45,29.55,124,870,106,311,230,1181,12.5,25.4,16.3,"50% - 75% P.O.C.","$50000 - $68000"
"06047000901","Census Tract 9.01, Merced County, California",4028,59968,1331,80,0,40,0,2468,33,2,0,1,0,61.3,67,1023,464,559,45.36,54.64,62,402,119,440,181,842,13.4,21.3,17.7,"50% - 75% P.O.C.","$50000 - $68000"
"06047000902","Census Tract 9.02, Merced County, California",9505,62926,3480,76,29,1573,0,4123,36.6,0.8,0.3,16.5,0,43.4,63.4,2579,1595,984,61.85,38.15,454,1141,316,668,770,1809,28.5,32.1,29.9,"50% - 75% P.O.C.","$50000 - $68000"
"06047001002","Census Tract 10.02, Merced County, California",15901,69814,4703,803,0,3051,0,6971,29.6,5,0,19.2,0,43.8,70.4,4329,1885,2444,43.54,56.46,441,1444,751,1693,1192,3137,23.4,30.7,27.5,"50% - 75% P.O.C.","$68000 or more"
"06047001003","Census Tract 10.03, Merced County, California",4281,35396,976,362,19,329,0,2298,22.8,8.5,0.4,7.7,0,53.7,77.2,1432,294,1138,20.53,79.47,75,219,119,1019,194,1238,25.5,10.5,13.5,"75% or more P.O.C.","Less than $38000"
"06047001004","Census Tract 10.04, Merced County, California",3650,36122,1004,325,3,356,0,1798,27.5,8.9,0.1,9.8,0,49.3,72.5,1717,253,1464,14.74,85.26,4,249,51,1413,55,1662,1.6,3.5,3.2,"50% - 75% P.O.C.","Less than $38000"
"06047001005","Census Tract 10.05, Merced County, California",2461,36892,471,319,6,116,4,1483,19.1,13,0.2,4.7,0.2,60.3,80.9,934,389,545,41.65,58.35,14,375,59,486,73,861,3.6,10.8,7.8,"75% or more P.O.C.","Less than $38000"
"06047001101","Census Tract 11.01, Merced County, California",5681,76266,2480,232,37,548,54,2150,43.7,4.1,0.7,9.6,1,37.8,56.3,2070,1362,708,65.8,34.2,97,1265,138,570,235,1835,7.1,19.5,11.4,"50% - 75% P.O.C.","$68000 or more"
"06047001200","Census Tract 12, Merced County, California",5636,63299,2105,151,12,360,0,2576,37.3,2.7,0.2,6.4,0,45.7,62.7,1809,1190,619,65.78,34.22,130,1060,199,420,329,1480,10.9,32.1,18.2,"50% - 75% P.O.C.","$50000 - $68000"
"06047001301","Census Tract 13.01, Merced County, California",2662,30714,955,100,0,70,0,1514,35.9,3.8,0,2.6,0,56.9,64.1,1158,356,802,30.74,69.26,0,356,57,745,57,1101,0,7.1,4.9,"50% - 75% P.O.C.","Less than $38000"
"06047001302","Census Tract 13.02, Merced County, California",2873,23283,763,99,6,32,0,1868,26.6,3.4,0.2,1.1,0,65,73.4,1134,144,990,12.7,87.3,0,144,80,910,80,1054,0,8.1,7.1,"50% - 75% P.O.C.","Less than $38000"
"06047001401","Census Tract 14.01, Merced County, California",4194,42193,1352,99,9,141,0,2485,32.2,2.4,0.2,3.4,0,59.3,67.8,1406,465,941,33.07,66.93,57,408,170,771,227,1179,12.3,18.1,16.1,"50% - 75% P.O.C.","$38000 - $50000"
"06047001402","Census Tract 14.02, Merced County, California",4423,45184,1696,242,0,281,0,2094,38.3,5.5,0,6.4,0,47.3,61.7,1537,780,757,50.75,49.25,93,687,149,608,242,1295,11.9,19.7,15.7,"50% - 75% P.O.C.","$38000 - $50000"
"06047001501","Census Tract 15.01, Merced County, California",2425,66492,418,24,0,413,0,1548,17.2,1,0,17,0,63.8,82.8,705,560,145,79.43,20.57,123,437,42,103,165,540,22,29,23.4,"75% or more P.O.C.","$50000 - $68000"
"06047001502","Census Tract 15.02, Merced County, California",2329,31771,173,11,0,112,0,2033,7.4,0.5,0,4.8,0,87.3,92.6,695,199,496,28.63,71.37,57,142,102,394,159,536,28.6,20.6,22.9,"75% or more P.O.C.","Less than $38000"
"06047001503","Census Tract 15.03, Merced County, California",4585,27125,316,290,25,502,0,3411,6.9,6.3,0.5,10.9,0,74.4,93.1,1169,299,870,25.58,74.42,40,259,294,576,334,835,13.4,33.8,28.6,"75% or more P.O.C.","Less than $38000"
"06047001601","Census Tract 16.01, Merced County, California",4238,26325,437,220,1,94,0,3432,10.3,5.2,0,2.2,0,81,89.7,1066,106,960,9.94,90.06,54,52,313,647,367,699,50.9,32.6,34.4,"75% or more P.O.C.","Less than $38000"
"06047001602","Census Tract 16.02, Merced County, California",7877,42868,786,427,0,1498,0,5058,10,5.4,0,19,0,64.2,90,1694,621,1073,36.66,63.34,251,370,508,565,759,935,40.4,47.3,44.8,"75% or more P.O.C.","$38000 - $50000"
"06047001700","Census Tract 17, Merced County, California",6684,42083,1456,324,0,769,0,3997,21.8,4.8,0,11.5,0,59.8,78.2,1947,1004,943,51.57,48.43,163,841,269,674,432,1515,16.2,28.5,22.2,"75% or more P.O.C.","$38000 - $50000"
"06047001801","Census Tract 18.01, Merced County, California",5719,102946,2169,126,23,844,0,2393,37.9,2.2,0.4,14.8,0,41.8,62.1,1113,805,308,72.33,27.67,61,744,113,195,174,939,7.6,36.7,15.6,"50% - 75% P.O.C.","$68000 or more"
"06047001901","Census Tract 19.01, Merced County, California",5517,40987,579,0,55,15,18,4842,10.5,0,1,0.3,0.3,87.8,89.5,1609,919,690,57.12,42.88,173,746,247,443,420,1189,18.8,35.8,26.1,"75% or more P.O.C.","$38000 - $50000"
"06047001902","Census Tract 19.02, Merced County, California",2345,48806,562,36,0,34,0,1694,24,1.5,0,1.4,0,72.2,76,762,504,258,66.14,33.86,58,446,75,183,133,629,11.5,29.1,17.5,"75% or more P.O.C.","$38000 - $50000"
"06047002000","Census Tract 20, Merced County, California",8712,60521,3204,14,37,20,0,5420,36.8,0.2,0.4,0.2,0,62.2,63.2,2823,1675,1148,59.33,40.67,179,1496,354,794,533,2290,10.7,30.8,18.9,"50% - 75% P.O.C.","$50000 - $68000"
"06047002100","Census Tract 21, Merced County, California",4246,55719,1040,20,84,119,20,2893,24.5,0.5,2,2.8,0.5,68.1,75.5,1165,706,459,60.6,39.4,108,598,159,300,267,898,15.3,34.6,22.9,"75% or more P.O.C.","$50000 - $68000"
"06047002201","Census Tract 22.01, Merced County, California",6249,36645,1256,32,0,72,2,4826,20.1,0.5,0,1.2,0,77.2,79.9,1993,743,1250,37.28,62.72,145,598,224,1026,369,1624,19.5,17.9,18.5,"75% or more P.O.C.","Less than $38000"
"06047002202","Census Tract 22.02, Merced County, California",10170,50801,1473,269,45,77,0,8086,14.5,2.6,0.4,0.8,0,79.5,85.5,2599,1369,1230,52.67,47.33,331,1038,561,669,892,1707,24.2,45.6,34.3,"75% or more P.O.C.","$50000 - $68000"
"06047002301","Census Tract 23.01, Merced County, California",6759,91576,2668,267,0,302,0,3509,39.5,4,0,4.5,0,51.9,60.5,2210,1686,524,76.29,23.71,290,1396,156,368,446,1764,17.2,29.8,20.2,"50% - 75% P.O.C.","$68000 or more"
"06047002302","Census Tract 23.02, Merced County, California",15950,66269,2658,361,120,601,304,11516,16.7,2.3,0.8,3.8,1.9,72.2,83.3,4076,2369,1707,58.12,41.88,794,1575,581,1126,1375,2701,33.5,34,33.7,"75% or more P.O.C.","$50000 - $68000"
"06047002401","Census Tract 24.01, Merced County, California",1406,34300,493,67,4,49,0,779,35.1,4.8,0.3,3.5,0,55.4,64.9,556,263,293,47.3,52.7,5,258,46,247,51,505,1.9,15.7,9.2,"50% - 75% P.O.C.","Less than $38000"
"06047002402","Census Tract 24.02, Merced County, California",7637,45781,1363,244,0,31,0,5656,17.8,3.2,0,0.4,0,74.1,82.2,2259,1370,889,60.65,39.35,285,1085,222,667,507,1752,20.8,25,22.4,"75% or more P.O.C.","$38000 - $50000"
"06047002500","Census Tract 25, Merced County, California",2389,67727,1101,23,17,292,0,945,46.1,1,0.7,12.2,0,39.6,53.9,786,430,356,54.71,45.29,59,371,100,256,159,627,13.7,28.1,20.2,"50% - 75% P.O.C.","$50000 - $68000"
"06047002600","Census Tract 26, Merced County, California",5942,84931,2569,253,0,760,0,2309,43.2,4.3,0,12.8,0,38.9,56.8,1802,1204,598,66.81,33.19,209,995,227,371,436,1366,17.4,38,24.2,"50% - 75% P.O.C.","$68000 or more"
"06107000100","Census Tract 1, Tulare County, California",4845,74836,3462,76,27,157,0,1058,71.5,1.6,0.6,3.2,0,21.8,28.5,1889,1648,241,87.24,12.76,97,1551,16,225,113,1776,5.9,6.6,6,"25% - 50% P.O.C.","$68000 or more"
"06107000201","Census Tract 2.01, Tulare County, California",9384,37088,270,0,248,660,0,8077,2.9,0,2.6,7,0,86.1,97.1,2391,1273,1118,53.24,46.76,456,817,362,756,818,1573,35.8,32.4,34.2,"75% or more P.O.C.","Less than $38000"
"06107000202","Census Tract 2.02, Tulare County, California",2369,31004,274,0,4,95,0,1996,11.6,0,0.2,4,0,84.3,88.4,657,252,405,38.36,61.64,19,233,177,228,196,461,7.5,43.7,29.8,"75% or more P.O.C.","Less than $38000"
"06107000301","Census Tract 3.01, Tulare County, California",7486,53036,2716,39,32,32,0,4526,36.3,0.5,0.4,0.4,0,60.5,63.7,2127,1162,965,54.63,45.37,246,916,340,625,586,1541,21.2,35.2,27.6,"50% - 75% P.O.C.","$50000 - $68000"
"06107000302","Census Tract 3.02, Tulare County, California",3205,37500,450,11,0,18,0,2698,14,0.3,0,0.6,0,84.2,86,832,338,494,40.62,59.38,83,255,177,317,260,572,24.6,35.8,31.2,"75% or more P.O.C.","Less than $38000"
"06107000401","Census Tract 4.01, Tulare County, California",6242,54744,730,0,24,369,0,5076,11.7,0,0.4,5.9,0,81.3,88.3,1641,1144,497,69.71,30.29,293,851,226,271,519,1122,25.6,45.5,31.6,"75% or more P.O.C.","$50000 - $68000"
"06107000402","Census Tract 4.02, Tulare County, California",7415,56261,1376,31,11,37,0,5960,18.6,0.4,0.1,0.5,0,80.4,81.4,2033,1039,994,51.11,48.89,219,820,339,655,558,1475,21.1,34.1,27.4,"75% or more P.O.C.","$50000 - $68000"
"06107000501","Census Tract 5.01, Tulare County, California",7097,32998,274,29,7,53,0,6626,3.9,0.4,0.1,0.7,0,93.4,96.1,1851,666,1185,35.98,64.02,222,444,376,809,598,1253,33.3,31.7,32.3,"75% or more P.O.C.","Less than $38000"
"06107000502","Census Tract 5.02, Tulare County, California",4107,57589,383,19,0,33,3,3616,9.3,0.5,0,0.8,0.1,88,90.7,945,594,351,62.86,37.14,181,413,130,221,311,634,30.5,37,32.9,"75% or more P.O.C.","$50000 - $68000"
"06107000600","Census Tract 6, Tulare County, California",6998,42900,444,47,0,65,53,6279,6.3,0.7,0,0.9,0.8,89.7,93.7,1686,732,954,43.42,56.58,203,529,397,557,600,1086,27.7,41.6,35.6,"75% or more P.O.C.","$38000 - $50000"
"06107000701","Census Tract 7.01, Tulare County, California",2425,40933,718,1,5,17,0,1684,29.6,0,0.2,0.7,0,69.4,70.4,848,503,345,59.32,40.68,69,434,64,281,133,715,13.7,18.6,15.7,"50% - 75% P.O.C.","$38000 - $50000"
"06107000702","Census Tract 7.02, Tulare County, California",6028,39688,243,0,0,186,30,5501,4,0,0,3.1,0.5,91.3,96,1616,752,864,46.53,53.47,216,536,192,672,408,1208,28.7,22.2,25.2,"75% or more P.O.C.","$38000 - $50000"
"06107000800","Census Tract 8, Tulare County, California",7837,43599,2064,0,15,0,0,5548,26.3,0,0.2,0,0,70.8,73.7,2227,1204,1023,54.06,45.94,251,953,429,594,680,1547,20.8,41.9,30.5,"50% - 75% P.O.C.","$38000 - $50000"
"06107000900","Census Tract 9, Tulare County, California",9746,41335,2092,92,218,251,100,6822,21.5,0.9,2.2,2.6,1,70,78.5,2441,1472,969,60.3,39.7,242,1230,274,695,516,1925,16.4,28.3,21.1,"75% or more P.O.C.","$38000 - $50000"
"06107001003","Census Tract 10.03, Tulare County, California",25636,83097,9930,13,0,2061,28,13052,38.7,0.1,0,8,0.1,50.9,61.3,7399,5499,1900,74.32,25.68,949,4550,447,1453,1396,6003,17.3,23.5,18.9,"50% - 75% P.O.C.","$68000 or more"
"06107001004","Census Tract 10.04, Tulare County, California",7791,43364,534,47,22,1028,0,6036,6.9,0.6,0.3,13.2,0,77.5,93.1,1931,1059,872,54.84,45.16,323,736,212,660,535,1396,30.5,24.3,27.7,"75% or more P.O.C.","$38000 - $50000"
"06107001005","Census Tract 10.05, Tulare County, California",2785,90114,1886,0,0,117,0,710,67.7,0,0,4.2,0,25.5,32.3,1047,789,258,75.36,24.64,84,705,10,248,94,953,10.6,3.9,9,"25% - 50% P.O.C.","$68000 or more"
"06107001006","Census Tract 10.06, Tulare County, California",5144,69926,3341,7,0,132,0,1490,64.9,0.1,0,2.6,0,29,35.1,2170,1339,831,61.71,38.29,46,1293,25,806,71,2099,3.4,3,3.3,"25% - 50% P.O.C.","$68000 or more"
"06107001100","Census Tract 11, Tulare County, California",6950,29310,806,138,51,516,8,5413,11.6,2,0.7,7.4,0.1,77.9,88.4,1930,364,1566,18.86,81.14,103,261,388,1178,491,1439,28.3,24.8,25.4,"75% or more P.O.C.","Less than $38000"
"06107001200","Census Tract 12, Tulare County, California",1245,26591,589,29,3,34,21,431,47.3,2.3,0.2,2.7,1.7,34.6,52.7,530,77,453,14.53,85.47,13,64,40,413,53,477,16.9,8.8,10,"50% - 75% P.O.C.","Less than $38000"
"06107001301","Census Tract 13.01, Tulare County, California",8734,57241,3273,34,11,362,18,4749,37.5,0.4,0.1,4.1,0.2,54.4,62.5,2665,2119,546,79.51,20.49,373,1746,138,408,511,2154,17.6,25.3,19.2,"50% - 75% P.O.C.","$50000 - $68000"
"06107001302","Census Tract 13.02, Tulare County, California",9219,60185,2563,206,34,504,0,5832,27.8,2.2,0.4,5.5,0,63.3,72.2,2632,1339,1293,50.87,49.13,320,1019,364,929,684,1948,23.9,28.2,26,"50% - 75% P.O.C.","$50000 - $68000"
"06107001400","Census Tract 14, Tulare County, California",4826,72411,1997,16,0,25,0,2751,41.4,0.3,0,0.5,0,57,58.6,1763,1342,421,76.12,23.88,102,1240,3,418,105,1658,7.6,0.7,6,"50% - 75% P.O.C.","$68000 or more"
"06107001501","Census Tract 15.01, Tulare County, California",5421,46890,3149,34,30,296,0,1821,58.1,0.6,0.6,5.5,0,33.6,41.9,1888,1235,653,65.41,34.59,133,1102,89,564,222,1666,10.8,13.6,11.8,"25% - 50% P.O.C.","$38000 - $50000"
"06107001502","Census Tract 15.02, Tulare County, California",5745,42760,2263,54,53,81,0,3239,39.4,0.9,0.9,1.4,0,56.4,60.6,1848,1256,592,67.97,32.03,183,1073,192,400,375,1473,14.6,32.4,20.3,"50% - 75% P.O.C.","$38000 - $50000"
"06107001601","Census Tract 16.01, Tulare County, California",5422,32096,647,31,0,21,3,4643,11.9,0.6,0,0.4,0.1,85.6,88.1,1387,745,642,53.71,46.29,251,494,184,458,435,952,33.7,28.7,31.4,"75% or more P.O.C.","Less than $38000"
"06107001602","Census Tract 16.02, Tulare County, California",6023,43281,1202,35,0,36,0,4739,20,0.6,0,0.6,0,78.7,80,1657,1001,656,60.41,39.59,416,585,108,548,524,1133,41.6,16.5,31.6,"75% or more P.O.C.","$38000 - $50000"
"06107001701","Census Tract 17.01, Tulare County, California",6626,48945,2112,81,10,170,0,4139,31.9,1.2,0.2,2.6,0,62.5,68.1,2331,1024,1307,43.93,56.07,262,762,157,1150,419,1912,25.6,12,18,"50% - 75% P.O.C.","$38000 - $50000"
"06107001703","Census Tract 17.03, Tulare County, California",6458,71950,3282,60,0,118,0,2617,50.8,0.9,0,1.8,0,40.5,49.2,2463,1938,525,78.68,21.32,146,1792,12,513,158,2305,7.5,2.3,6.4,"25% - 50% P.O.C.","$68000 or more"
"06107001704","Census Tract 17.04, Tulare County, California",7474,72817,3553,62,72,443,0,3147,47.5,0.8,1,5.9,0,42.1,52.5,2619,1408,1211,53.76,46.24,100,1308,132,1079,232,2387,7.1,10.9,8.9,"50% - 75% P.O.C.","$68000 or more"
"06107001800","Census Tract 18, Tulare County, California",4608,49917,1881,441,6,178,0,1896,40.8,9.6,0.1,3.9,0,41.1,59.2,1679,833,846,49.61,50.39,48,785,118,728,166,1513,5.8,13.9,9.9,"50% - 75% P.O.C.","$38000 - $50000"
"06107001901","Census Tract 19.01, Tulare County, California",3761,62888,1612,0,0,74,0,2066,42.9,0,0,2,0,54.9,57.1,1237,721,516,58.29,41.71,33,688,139,377,172,1065,4.6,26.9,13.9,"50% - 75% P.O.C.","$50000 - $68000"
"06107001902","Census Tract 19.02, Tulare County, California",4337,69508,2489,14,0,129,0,1656,57.4,0.3,0,3,0,38.2,42.6,1387,1034,353,74.55,25.45,144,890,54,299,198,1189,13.9,15.3,14.3,"25% - 50% P.O.C.","$68000 or more"
"06107002002","Census Tract 20.02, Tulare County, California",4370,53656,1907,0,0,215,0,2228,43.6,0,0,4.9,0,51,56.4,1553,792,761,51,49,80,712,135,626,215,1338,10.1,17.7,13.8,"50% - 75% P.O.C.","$50000 - $68000"
"06107002003","Census Tract 20.03, Tulare County, California",6426,70313,2370,799,0,24,0,3222,36.9,12.4,0,0.4,0,50.1,63.1,2007,1237,770,61.63,38.37,205,1032,47,723,252,1755,16.6,6.1,12.6,"50% - 75% P.O.C.","$68000 or more"
"06107002004","Census Tract 20.04, Tulare County, California",4972,63750,2261,34,87,127,0,2430,45.5,0.7,1.7,2.6,0,48.9,54.5,1745,1039,706,59.54,40.46,189,850,125,581,314,1431,18.2,17.7,18,"50% - 75% P.O.C.","$50000 - $68000"
"06107002006","Census Tract 20.06, Tulare County, California",4364,106842,2767,11,0,200,0,1349,63.4,0.3,0,4.6,0,30.9,36.6,1534,1024,510,66.75,33.25,119,905,25,485,144,1390,11.6,4.9,9.4,"25% - 50% P.O.C.","$68000 or more"
"06107002007","Census Tract 20.07, Tulare County, California",8642,66089,3806,295,188,284,9,3868,44,3.4,2.2,3.3,0.1,44.8,56,2883,2066,817,71.66,28.34,267,1799,176,641,443,2440,12.9,21.5,15.4,"50% - 75% P.O.C.","$50000 - $68000"
"06107002008","Census Tract 20.08, Tulare County, California",2562,33365,1053,127,21,130,0,1064,41.1,5,0.8,5.1,0,41.5,58.9,1161,194,967,16.71,83.29,0,194,57,910,57,1104,0,5.9,4.9,"50% - 75% P.O.C.","Less than $38000"
"06107002009","Census Tract 20.09, Tulare County, California",3795,50875,1888,34,43,88,0,1718,49.7,0.9,1.1,2.3,0,45.3,50.3,1546,873,673,56.47,43.53,60,813,38,635,98,1448,6.9,5.6,6.3,"50% - 75% P.O.C.","$50000 - $68000"
"06107002100","Census Tract 21, Tulare County, California",2536,57019,865,15,2,60,0,1560,34.1,0.6,0.1,2.4,0,61.5,65.9,719,361,358,50.21,49.79,101,260,82,276,183,536,28,22.9,25.5,"50% - 75% P.O.C.","$50000 - $68000"
"06107002202","Census Tract 22.02, Tulare County, California",5765,30886,603,612,15,102,0,4416,10.5,10.6,0.3,1.8,0,76.6,89.5,1669,468,1201,28.04,71.96,113,355,232,969,345,1324,24.1,19.3,20.7,"75% or more P.O.C.","Less than $38000"
"06107002203","Census Tract 22.03, Tulare County, California",4663,61890,1026,40,0,198,0,3383,22,0.9,0,4.2,0,72.5,78,1207,873,334,72.33,27.67,123,750,170,164,293,914,14.1,50.9,24.3,"75% or more P.O.C.","$50000 - $68000"
"06107002204","Census Tract 22.04, Tulare County, California",6280,47273,1015,282,32,31,4,4731,16.2,4.5,0.5,0.5,0.1,75.3,83.8,1660,897,763,54.04,45.96,290,607,192,571,482,1178,32.3,25.2,29,"75% or more P.O.C.","$38000 - $50000"
"06107002302","Census Tract 23.02, Tulare County, California",4611,54886,1913,273,14,68,0,2214,41.5,5.9,0.3,1.5,0,48,58.5,1516,880,636,58.05,41.95,126,754,94,542,220,1296,14.3,14.8,14.5,"50% - 75% P.O.C.","$50000 - $68000"
"06107002303","Census Tract 23.03, Tulare County, California",6636,72006,3587,196,81,63,30,2353,54.1,3,1.2,0.9,0.5,35.5,45.9,2223,1490,733,67.03,32.97,191,1299,74,659,265,1958,12.8,10.1,11.9,"25% - 50% P.O.C.","$68000 or more"
"06107002304","Census Tract 23.04, Tulare County, California",1885,41140,808,39,31,16,42,878,42.9,2.1,1.6,0.8,2.2,46.6,57.1,735,287,448,39.05,60.95,51,236,6,442,57,678,17.8,1.3,7.8,"50% - 75% P.O.C.","$38000 - $50000"
"06107002400","Census Tract 24, Tulare County, California",14401,84571,5592,226,69,415,0,7990,38.8,1.6,0.5,2.9,0,55.5,61.2,4081,3017,1064,73.93,26.07,622,2395,315,749,937,3144,20.6,29.6,23,"50% - 75% P.O.C.","$68000 or more"
"06107002500","Census Tract 25, Tulare County, California",4035,54054,1300,0,0,55,25,2655,32.2,0,0,1.4,0.6,65.8,67.8,1211,823,388,67.96,32.04,236,587,53,335,289,922,28.7,13.7,23.9,"50% - 75% P.O.C.","$50000 - $68000"
"06107002601","Census Tract 26.01, Tulare County, California",4635,27442,261,66,9,10,0,4280,5.6,1.4,0.2,0.2,0,92.3,94.4,1362,705,657,51.76,48.24,201,504,137,520,338,1024,28.5,20.9,24.8,"75% or more P.O.C.","Less than $38000"
"06107002602","Census Tract 26.02, Tulare County, California",5749,39764,689,0,0,95,0,4965,12,0,0,1.7,0,86.4,88,1631,967,664,59.29,40.71,222,745,231,433,453,1178,23,34.8,27.8,"75% or more P.O.C.","$38000 - $50000"
"06107002700","Census Tract 27, Tulare County, California",5237,44020,3359,79,618,78,6,928,64.1,1.5,11.8,1.5,0.1,17.7,35.9,2418,1643,775,67.95,32.05,53,1590,69,706,122,2296,3.2,8.9,5,"25% - 50% P.O.C.","$38000 - $50000"
"06107002800","Census Tract 28, Tulare County, California",3599,24161,697,0,0,25,0,2809,19.4,0,0,0.7,0,78,80.6,1123,361,762,32.15,67.85,60,301,202,560,262,861,16.6,26.5,23.3,"75% or more P.O.C.","Less than $38000"
"06107002901","Census Tract 29.01, Tulare County, California",4202,46761,399,144,0,0,0,3659,9.5,3.4,0,0,0,87.1,90.5,1039,427,612,41.1,58.9,193,234,268,344,461,578,45.2,43.8,44.4,"75% or more P.O.C.","$38000 - $50000"
"06107002903","Census Tract 29.03, Tulare County, California",4717,58618,1961,6,130,0,0,2532,41.6,0.1,2.8,0,0,53.7,58.4,1560,1061,499,68.01,31.99,148,913,205,294,353,1207,13.9,41.1,22.6,"50% - 75% P.O.C.","$50000 - $68000"
"06107002904","Census Tract 29.04, Tulare County, California",5175,45841,1732,31,42,0,20,3268,33.5,0.6,0.8,0,0.4,63.1,66.5,1573,772,801,49.08,50.92,174,598,125,676,299,1274,22.5,15.6,19,"50% - 75% P.O.C.","$38000 - $50000"
"06107003001","Census Tract 30.01, Tulare County, California",4702,30768,611,46,0,27,0,3923,13,1,0,0.6,0,83.4,87,1205,430,775,35.68,64.32,149,281,232,543,381,824,34.7,29.9,31.6,"75% or more P.O.C.","Less than $38000"
"06107003002","Census Tract 30.02, Tulare County, California",3525,43155,501,169,0,67,12,2750,14.2,4.8,0,1.9,0.3,78,85.8,943,410,533,43.48,56.52,129,281,158,375,287,656,31.5,29.6,30.4,"75% or more P.O.C.","$38000 - $50000"
"06107003100","Census Tract 31, Tulare County, California",3515,40571,768,54,18,0,0,2651,21.8,1.5,0.5,0,0,75.4,78.2,973,340,633,34.94,65.06,76,264,200,433,276,697,22.4,31.6,28.4,"75% or more P.O.C.","$38000 - $50000"
"06107003200","Census Tract 32, Tulare County, California",7396,34964,904,0,20,7,0,6465,12.2,0,0.3,0.1,0,87.4,87.8,1858,770,1088,41.44,58.56,299,471,370,718,669,1189,38.8,34,36,"75% or more P.O.C.","Less than $38000"
"06107003300","Census Tract 33, Tulare County, California",8019,38580,2432,7,0,24,0,5511,30.3,0.1,0,0.3,0,68.7,69.7,2226,1354,872,60.83,39.17,238,1116,292,580,530,1696,17.6,33.5,23.8,"50% - 75% P.O.C.","$38000 - $50000"
"06107003400","Census Tract 34, Tulare County, California",6781,42500,2395,18,11,578,2,3634,35.3,0.3,0.2,8.5,0,53.6,64.7,2212,1510,702,68.26,31.74,269,1241,126,576,395,1817,17.8,17.9,17.9,"50% - 75% P.O.C.","$38000 - $50000"
"06107003501","Census Tract 35.01, Tulare County, California",2879,47222,1482,0,16,292,0,958,51.5,0,0.6,10.1,0,33.3,48.5,974,608,366,62.42,37.58,92,516,59,307,151,823,15.1,16.1,15.5,"25% - 50% P.O.C.","$38000 - $50000"
"06107003502","Census Tract 35.02, Tulare County, California",12394,74554,3480,78,147,432,0,7376,28.1,0.6,1.2,3.5,0,59.5,71.9,3201,2286,915,71.42,28.58,524,1762,329,586,853,2348,22.9,36,26.6,"50% - 75% P.O.C.","$68000 or more"
"06107003601","Census Tract 36.01, Tulare County, California",7569,48682,1731,105,29,717,0,4792,22.9,1.4,0.4,9.5,0,63.3,77.1,2161,1293,868,59.83,40.17,410,883,258,610,668,1493,31.7,29.7,30.9,"75% or more P.O.C.","$38000 - $50000"
"06107003602","Census Tract 36.02, Tulare County, California",7130,46563,2125,5,20,516,0,4438,29.8,0.1,0.3,7.2,0,62.2,70.2,2129,1089,1040,51.15,48.85,263,826,130,910,393,1736,24.2,12.5,18.5,"50% - 75% P.O.C.","$38000 - $50000"
"06107003700","Census Tract 37, Tulare County, California",6449,42690,1975,0,0,377,0,3958,30.6,0,0,5.8,0,61.4,69.4,1966,868,1098,44.15,55.85,112,756,291,807,403,1563,12.9,26.5,20.5,"50% - 75% P.O.C.","$38000 - $50000"
"06107003801","Census Tract 38.01, Tulare County, California",3021,37063,920,8,13,83,37,1852,30.5,0.3,0.4,2.7,1.2,61.3,69.5,1045,321,724,30.72,69.28,19,302,112,612,131,914,5.9,15.5,12.5,"50% - 75% P.O.C.","Less than $38000"
"06107003802","Census Tract 38.02, Tulare County, California",4604,19940,778,16,44,64,140,3450,16.9,0.3,1,1.4,3,74.9,83.1,1456,355,1101,24.38,75.62,139,216,130,971,269,1187,39.2,11.8,18.5,"75% or more P.O.C.","Less than $38000"
"06107003901","Census Tract 39.01, Tulare County, California",6648,35213,1198,1,0,0,0,5449,18,0,0,0,0,82,82,1826,1110,716,60.79,39.21,230,880,231,485,461,1365,20.7,32.3,25.2,"75% or more P.O.C.","Less than $38000"
"06107003902","Census Tract 39.02, Tulare County, California",5549,43000,1704,0,0,164,19,3592,30.7,0,0,3,0.3,64.7,69.3,1646,1001,645,60.81,39.19,232,769,98,547,330,1316,23.2,15.2,20,"50% - 75% P.O.C.","$38000 - $50000"
"06107004000","Census Tract 40, Tulare County, California",582,NA,361,53,6,8,7,135,62,9.1,1,1.4,1.2,23.2,38,0,0,0,NA,NA,0,0,0,0,0,0,NA,NA,NA,"25% - 50% P.O.C.","N/A"
"06107004101","Census Tract 41.01, Tulare County, California",9417,36360,1311,1,1,383,0,7589,13.9,0,0,4.1,0,80.6,86.1,2522,914,1608,36.24,63.76,200,714,282,1326,482,2040,21.9,17.5,19.1,"75% or more P.O.C.","Less than $38000"
"06107004102","Census Tract 41.02, Tulare County, California",1999,40357,514,0,83,29,0,1348,25.7,0,4.2,1.5,0,67.4,74.3,600,364,236,60.67,39.33,85,279,78,158,163,437,23.4,33.1,27.2,"50% - 75% P.O.C.","$38000 - $50000"
"06107004200","Census Tract 42, Tulare County, California",5934,33504,490,244,0,27,0,5161,8.3,4.1,0,0.5,0,87,91.7,1739,693,1046,39.85,60.15,145,548,293,753,438,1301,20.9,28,25.2,"75% or more P.O.C.","Less than $38000"
"06107004300","Census Tract 43, Tulare County, California",7437,32021,413,19,79,106,3,6804,5.6,0.3,1.1,1.4,0,91.5,94.4,1919,842,1077,43.88,56.12,309,533,287,790,596,1323,36.7,26.6,31.1,"75% or more P.O.C.","Less than $38000"
"06107004400","Census Tract 44, Tulare County, California",7541,30504,0,0,0,466,0,7075,0,0,0,6.2,0,93.8,100,1889,926,963,49.02,50.98,413,513,352,611,765,1124,44.6,36.6,40.5,"75% or more P.O.C.","Less than $38000"
"06107004500","Census Tract 45, Tulare County, California",6161,33164,1159,5,32,0,4,4940,18.8,0.1,0.5,0,0.1,80.2,81.2,1845,1224,621,66.34,33.66,270,954,160,461,430,1415,22.1,25.8,23.3,"75% or more P.O.C.","Less than $38000"
