"GEOID","NAME","total_pop","median_hh_income","white","black","ai_an","asian","hi_pi","hisp_lat","pct_white","pct_black","pct_ai_an","pct_asian","pct_hi_pi","pct_hisp_lat","pct_poc","total_hh","total_hh_owner","total_hh_renter","pct_owners","pct_renters","total_owner_more_than_4","total_owner_less_than_4","total_renter_more_than_4","total_renter_less_than_4","total_hh_more_than_4","total_hh_less_than_4","pct_owner_more_than_4","pct_renter_more_than_4","pct_total_hh_more_than_4","poc_bin","income_bin"
"06001400100","Census Tract 4001, Alameda County, California",3120,219861,2317,107,0,391,0,118,74.3,3.4,0,12.5,0,3.8,25.7,1293,1150,143,88.94,11.06,15,1135,19,124,34,1259,1.3,13.3,2.6,"25% - 50% P.O.C.","$141000 or more"
"06001400200","Census Tract 4002, Alameda County, California",2007,188958,1475,52,4,171,0,174,73.5,2.6,0.2,8.5,0,8.7,26.5,847,525,322,61.98,38.02,19,506,3,319,22,825,3.6,0.9,2.6,"25% - 50% P.O.C.","$141000 or more"
"06001400300","Census Tract 4003, Alameda County, California",5051,114598,3434,459,0,590,23,351,68,9.1,0,11.7,0.5,6.9,32,2441,1014,1427,41.54,58.46,22,992,41,1386,63,2378,2.2,2.9,2.6,"25% - 50% P.O.C.","$108000 - $141000"
"06001400400","Census Tract 4004, Alameda County, California",4007,130658,2554,266,35,420,0,485,63.7,6.6,0.9,10.5,0,12.1,36.3,1802,738,1064,40.95,59.05,9,729,0,1064,9,1793,1.2,0,0.5,"25% - 50% P.O.C.","$108000 - $141000"
"06001400500","Census Tract 4005, Alameda County, California",4124,115263,1874,882,0,446,22,390,45.4,21.4,0,10.8,0.5,9.5,54.6,1606,638,968,39.73,60.27,45,593,59,909,104,1502,7.1,6.1,6.5,"50% - 75% P.O.C.","$108000 - $141000"
"06001400600","Census Tract 4006, Alameda County, California",1745,135398,860,358,3,169,15,131,49.3,20.5,0.2,9.7,0.9,7.5,50.7,673,285,388,42.35,57.65,5,280,23,365,28,645,1.8,5.9,4.2,"50% - 75% P.O.C.","$108000 - $141000"
"06001400700","Census Tract 4007, Alameda County, California",5128,82639,1963,1448,0,329,0,994,38.3,28.2,0,6.4,0,19.4,61.7,1951,728,1223,37.31,62.69,42,686,112,1111,154,1797,5.8,9.2,7.9,"50% - 75% P.O.C.","$80000 - $108000"
"06001400800","Census Tract 4008, Alameda County, California",4069,77045,1772,947,8,618,0,432,43.5,23.3,0.2,15.2,0,10.6,56.5,1652,668,984,40.44,59.56,0,668,95,889,95,1557,0,9.7,5.8,"50% - 75% P.O.C.","Less than $80000"
"06001400900","Census Tract 4009, Alameda County, California",2471,62833,1029,711,61,101,0,391,41.6,28.8,2.5,4.1,0,15.8,58.4,1078,385,693,35.71,64.29,13,372,26,667,39,1039,3.4,3.8,3.6,"50% - 75% P.O.C.","Less than $80000"
"06001401000","Census Tract 4010, Alameda County, California",6133,82895,2051,1862,0,412,95,1148,33.4,30.4,0,6.7,1.5,18.7,66.6,2470,855,1615,34.62,65.38,21,834,69,1546,90,2380,2.5,4.3,3.6,"50% - 75% P.O.C.","$80000 - $108000"
"06001401100","Census Tract 4011, Alameda County, California",4287,81960,2246,332,0,849,12,461,52.4,7.7,0,19.8,0.3,10.8,47.6,2071,419,1652,20.23,79.77,30,389,42,1610,72,1999,7.2,2.5,3.5,"25% - 50% P.O.C.","$80000 - $108000"
"06001401200","Census Tract 4012, Alameda County, California",2619,99342,1598,295,2,301,0,319,61,11.3,0.1,11.5,0,12.2,39,1230,475,755,38.62,61.38,12,463,0,755,12,1218,2.5,0,1,"25% - 50% P.O.C.","$80000 - $108000"
"06001401300","Census Tract 4013, Alameda County, California",3921,58170,1506,1118,24,657,0,397,38.4,28.5,0.6,16.8,0,10.1,61.6,1827,294,1533,16.09,83.91,0,294,18,1515,18,1809,0,1.2,1,"50% - 75% P.O.C.","Less than $80000"
"06001401400","Census Tract 4014, Alameda County, California",4732,48224,1218,1511,73,570,15,897,25.7,31.9,1.5,12,0.3,19,74.3,1598,302,1296,18.9,81.1,46,256,151,1145,197,1401,15.2,11.7,12.3,"50% - 75% P.O.C.","Less than $80000"
"06001401500","Census Tract 4015, Alameda County, California",2839,63548,1048,1060,0,129,24,401,36.9,37.3,0,4.5,0.8,14.1,63.1,1142,408,734,35.73,64.27,21,387,70,664,91,1051,5.1,9.5,8,"50% - 75% P.O.C.","Less than $80000"
"06001401600","Census Tract 4016, Alameda County, California",2289,57604,656,822,0,239,21,459,28.7,35.9,0,10.4,0.9,20.1,71.3,896,172,724,19.2,80.8,15,157,18,706,33,863,8.7,2.5,3.7,"50% - 75% P.O.C.","Less than $80000"
"06001401700","Census Tract 4017, Alameda County, California",3018,117305,1173,514,0,360,7,804,38.9,17,0,11.9,0.2,26.6,61.1,1295,686,609,52.97,47.03,32,654,20,589,52,1243,4.7,3.3,4,"50% - 75% P.O.C.","$108000 - $141000"
"06001401800","Census Tract 4018, Alameda County, California",1801,65655,603,688,4,99,0,365,33.5,38.2,0.2,5.5,0,20.3,66.5,677,170,507,25.11,74.89,10,160,11,496,21,656,5.9,2.2,3.1,"50% - 75% P.O.C.","Less than $80000"
"06001402200","Census Tract 4022, Alameda County, California",2477,68606,740,787,31,405,0,402,29.9,31.8,1.3,16.4,0,16.2,70.1,871,297,574,34.1,65.9,7,290,87,487,94,777,2.4,15.2,10.8,"50% - 75% P.O.C.","Less than $80000"
"06001402400","Census Tract 4024, Alameda County, California",2866,39913,691,1387,0,362,10,262,24.1,48.4,0,12.6,0.3,9.1,75.9,1221,287,934,23.51,76.49,55,232,40,894,95,1126,19.2,4.3,7.8,"75% or more P.O.C.","Less than $80000"
"06001402500","Census Tract 4025, Alameda County, California",1781,30000,194,1040,0,237,0,263,10.9,58.4,0,13.3,0,14.8,89.1,734,78,656,10.63,89.37,13,65,64,592,77,657,16.7,9.8,10.5,"75% or more P.O.C.","Less than $80000"
"06001402600","Census Tract 4026, Alameda County, California",1243,25885,179,322,6,481,0,205,14.4,25.9,0.5,38.7,0,16.5,85.6,631,67,564,10.62,89.38,6,61,21,543,27,604,9,3.7,4.3,"75% or more P.O.C.","Less than $80000"
"06001402700","Census Tract 4027, Alameda County, California",1890,76417,439,799,12,205,0,389,23.2,42.3,0.6,10.8,0,20.6,76.8,693,213,480,30.74,69.26,28,185,36,444,64,629,13.1,7.5,9.2,"75% or more P.O.C.","Less than $80000"
"06001402800","Census Tract 4028, Alameda County, California",4480,45339,1263,1706,26,832,0,281,28.2,38.1,0.6,18.6,0,6.3,71.8,2389,192,2197,8.04,91.96,0,192,28,2169,28,2361,0,1.3,1.2,"50% - 75% P.O.C.","Less than $80000"
"06001402900","Census Tract 4029, Alameda County, California",1406,31326,303,241,3,528,0,248,21.6,17.1,0.2,37.6,0,17.6,78.4,949,0,949,0,100,0,0,0,949,0,949,NA,0,0,"75% or more P.O.C.","Less than $80000"
"06001403000","Census Tract 4030, Alameda County, California",2905,26353,189,127,10,2366,72,66,6.5,4.4,0.3,81.4,2.5,2.3,93.5,1469,495,974,33.7,66.3,8,487,3,971,11,1458,1.6,0.3,0.7,"75% or more P.O.C.","Less than $80000"
"06001403100","Census Tract 4031, Alameda County, California",2101,94688,585,371,6,795,12,274,27.8,17.7,0.3,37.8,0.6,13,72.2,898,252,646,28.06,71.94,0,252,8,638,8,890,0,1.2,0.9,"50% - 75% P.O.C.","$80000 - $108000"
"06001403300","Census Tract 4033, Alameda County, California",4178,70795,1093,312,100,2182,0,252,26.2,7.5,2.4,52.2,0,6,73.8,2143,703,1440,32.8,67.2,0,703,74,1366,74,2069,0,5.1,3.5,"50% - 75% P.O.C.","Less than $80000"
"06001403400","Census Tract 4034, Alameda County, California",4340,69132,1716,831,19,1128,35,355,39.5,19.1,0.4,26,0.8,8.2,60.5,2838,275,2563,9.69,90.31,0,275,0,2563,0,2838,0,0,0,"50% - 75% P.O.C.","Less than $80000"
"06001403501","Census Tract 4035.01, Alameda County, California",4492,52952,1683,1073,24,835,39,551,37.5,23.9,0.5,18.6,0.9,12.3,62.5,2655,279,2376,10.51,89.49,0,279,3,2373,3,2652,0,0.1,0.1,"50% - 75% P.O.C.","Less than $80000"
"06001403502","Census Tract 4035.02, Alameda County, California",2044,71406,859,520,0,227,0,244,42,25.4,0,11.1,0,11.9,58,1158,239,919,20.64,79.36,11,228,11,908,22,1136,4.6,1.2,1.9,"50% - 75% P.O.C.","Less than $80000"
"06001403600","Census Tract 4036, Alameda County, California",5570,77813,1634,2297,13,522,0,775,29.3,41.2,0.2,9.4,0,13.9,70.7,2643,301,2342,11.39,88.61,0,301,66,2276,66,2577,0,2.8,2.5,"50% - 75% P.O.C.","Less than $80000"
"06001403701","Census Tract 4037.01, Alameda County, California",2968,76762,1277,794,0,374,0,362,43,26.8,0,12.6,0,12.2,57,1738,218,1520,12.54,87.46,9,209,2,1518,11,1727,4.1,0.1,0.6,"50% - 75% P.O.C.","Less than $80000"
"06001403702","Census Tract 4037.02, Alameda County, California",1930,95729,1002,290,0,341,0,189,51.9,15,0,17.7,0,9.8,48.1,1102,218,884,19.78,80.22,0,218,7,877,7,1095,0,0.8,0.6,"25% - 50% P.O.C.","$80000 - $108000"
"06001403800","Census Tract 4038, Alameda County, California",3351,101053,2270,435,0,392,4,120,67.7,13,0,11.7,0.1,3.6,32.3,1814,605,1209,33.35,66.65,15,590,23,1186,38,1776,2.5,1.9,2.1,"25% - 50% P.O.C.","$80000 - $108000"
"06001403900","Census Tract 4039, Alameda County, California",4051,98455,2321,549,9,655,0,301,57.3,13.6,0.2,16.2,0,7.4,42.7,2059,789,1270,38.32,61.68,55,734,0,1270,55,2004,7,0,2.7,"25% - 50% P.O.C.","$80000 - $108000"
"06001404000","Census Tract 4040, Alameda County, California",2895,82717,1598,210,29,295,71,475,55.2,7.3,1,10.2,2.5,16.4,44.8,1638,468,1170,28.57,71.43,22,446,0,1170,22,1616,4.7,0,1.3,"25% - 50% P.O.C.","$80000 - $108000"
"06001404101","Census Tract 4041.01, Alameda County, California",3017,97976,1876,237,11,380,0,212,62.2,7.9,0.4,12.6,0,7,37.8,1660,588,1072,35.42,64.58,0,588,14,1058,14,1646,0,1.3,0.8,"25% - 50% P.O.C.","$80000 - $108000"
"06001404102","Census Tract 4041.02, Alameda County, California",2653,76801,1764,125,36,319,20,262,66.5,4.7,1.4,12,0.8,9.9,33.5,1657,249,1408,15.03,84.97,0,249,0,1408,0,1657,0,0,0,"25% - 50% P.O.C.","Less than $80000"
"06001404200","Census Tract 4042, Alameda County, California",3877,201744,2394,245,8,736,33,217,61.7,6.3,0.2,19,0.9,5.6,38.3,1286,1030,256,80.09,19.91,89,941,42,214,131,1155,8.6,16.4,10.2,"25% - 50% P.O.C.","$141000 or more"
"06001404300","Census Tract 4043, Alameda County, California",3443,210882,2248,57,0,467,0,413,65.3,1.7,0,13.6,0,12,34.7,1284,1133,151,88.24,11.76,55,1078,0,151,55,1229,4.9,0,4.3,"25% - 50% P.O.C.","$141000 or more"
"06001404400","Census Tract 4044, Alameda County, California",5628,167891,3771,131,18,729,0,299,67,2.3,0.3,13,0,5.3,33,2315,2024,291,87.43,12.57,77,1947,38,253,115,2200,3.8,13.1,5,"25% - 50% P.O.C.","$141000 or more"
"06001404501","Census Tract 4045.01, Alameda County, California",1809,204338,1201,122,0,209,9,121,66.4,6.7,0,11.6,0.5,6.7,33.6,659,605,54,91.81,8.19,66,539,0,54,66,593,10.9,0,10,"25% - 50% P.O.C.","$141000 or more"
"06001404502","Census Tract 4045.02, Alameda County, California",5891,181023,4448,67,0,600,0,449,75.5,1.1,0,10.2,0,7.6,24.5,2483,2119,364,85.34,14.66,40,2079,0,364,40,2443,1.9,0,1.6,"Less than 25% P.O.C.","$141000 or more"
"06001404600","Census Tract 4046, Alameda County, California",4625,165139,3223,178,8,604,106,223,69.7,3.8,0.2,13.1,2.3,4.8,30.3,1783,1661,122,93.16,6.84,105,1556,17,105,122,1661,6.3,13.9,6.8,"25% - 50% P.O.C.","$141000 or more"
"06001404700","Census Tract 4047, Alameda County, California",2137,179250,1487,128,0,240,9,202,69.6,6,0,11.2,0.4,9.5,30.4,805,699,106,86.83,13.17,42,657,28,78,70,735,6,26.4,8.7,"25% - 50% P.O.C.","$141000 or more"
"06001404800","Census Tract 4048, Alameda County, California",2647,97396,1307,423,11,293,0,382,49.4,16,0.4,11.1,0,14.4,50.6,1159,539,620,46.51,53.49,52,487,15,605,67,1092,9.6,2.4,5.8,"50% - 75% P.O.C.","$80000 - $108000"
"06001404900","Census Tract 4049, Alameda County, California",4197,121731,2354,403,28,645,31,497,56.1,9.6,0.7,15.4,0.7,11.8,43.9,1860,1120,740,60.22,39.78,63,1057,3,737,66,1794,5.6,0.4,3.5,"25% - 50% P.O.C.","$108000 - $141000"
"06001405000","Census Tract 4050, Alameda County, California",3394,155556,2090,398,0,373,0,251,61.6,11.7,0,11,0,7.4,38.4,1446,1057,389,73.1,26.9,43,1014,0,389,43,1403,4.1,0,3,"25% - 50% P.O.C.","$141000 or more"
"06001405100","Census Tract 4051, Alameda County, California",4285,204412,2786,581,0,435,0,147,65,13.6,0,10.2,0,3.4,35,1608,1479,129,91.98,8.02,81,1398,10,119,91,1517,5.5,7.8,5.7,"25% - 50% P.O.C.","$141000 or more"
"06001405200","Census Tract 4052, Alameda County, California",5183,90532,1983,466,15,1635,25,821,38.3,9,0.3,31.5,0.5,15.8,61.7,2414,730,1684,30.24,69.76,63,667,0,1684,63,2351,8.6,0,2.6,"50% - 75% P.O.C.","$80000 - $108000"
"06001405301","Census Tract 4053.01, Alameda County, California",2954,84917,1555,339,0,304,13,540,52.6,11.5,0,10.3,0.4,18.3,47.4,1572,171,1401,10.88,89.12,17,154,37,1364,54,1518,9.9,2.6,3.4,"25% - 50% P.O.C.","$80000 - $108000"
"06001405302","Census Tract 4053.02, Alameda County, California",2373,47444,730,304,8,1004,0,192,30.8,12.8,0.3,42.3,0,8.1,69.2,1377,85,1292,6.17,93.83,17,68,0,1292,17,1360,20,0,1.2,"50% - 75% P.O.C.","Less than $80000"
"06001405401","Census Tract 4054.01, Alameda County, California",3648,51018,749,592,0,1277,0,824,20.5,16.2,0,35,0,22.6,79.5,1657,219,1438,13.22,86.78,19,200,34,1404,53,1604,8.7,2.4,3.2,"75% or more P.O.C.","Less than $80000"
"06001405402","Census Tract 4054.02, Alameda County, California",3357,54093,579,866,8,938,102,707,17.2,25.8,0.2,27.9,3,21.1,82.8,1180,117,1063,9.92,90.08,22,95,120,943,142,1038,18.8,11.3,12,"75% or more P.O.C.","Less than $80000"
"06001405500","Census Tract 4055, Alameda County, California",3880,62778,831,870,27,1619,31,360,21.4,22.4,0.7,41.7,0.8,9.3,78.6,1572,407,1165,25.89,74.11,44,363,56,1109,100,1472,10.8,4.8,6.4,"75% or more P.O.C.","Less than $80000"
"06001405600","Census Tract 4056, Alameda County, California",3269,59875,866,588,73,727,0,792,26.5,18,2.2,22.2,0,24.2,73.5,1386,435,951,31.39,68.61,65,370,37,914,102,1284,14.9,3.9,7.4,"50% - 75% P.O.C.","Less than $80000"
"06001405700","Census Tract 4057, Alameda County, California",3531,61444,508,747,17,1625,0,482,14.4,21.2,0.5,46,0,13.7,85.6,1368,400,968,29.24,70.76,86,314,75,893,161,1207,21.5,7.7,11.8,"75% or more P.O.C.","Less than $80000"
"06001405800","Census Tract 4058, Alameda County, California",4370,48846,656,944,57,1871,25,745,15,21.6,1.3,42.8,0.6,17,85,1338,461,877,34.45,65.55,100,361,150,727,250,1088,21.7,17.1,18.7,"75% or more P.O.C.","Less than $80000"
"06001405901","Census Tract 4059.01, Alameda County, California",4426,42028,163,628,47,1618,37,1828,3.7,14.2,1.1,36.6,0.8,41.3,96.3,1100,328,772,29.82,70.18,106,222,214,558,320,780,32.3,27.7,29.1,"75% or more P.O.C.","Less than $80000"
"06001405902","Census Tract 4059.02, Alameda County, California",2942,44922,258,352,14,1453,0,739,8.8,12,0.5,49.4,0,25.1,91.2,925,295,630,31.89,68.11,74,221,89,541,163,762,25.1,14.1,17.6,"75% or more P.O.C.","Less than $80000"
"06001406000","Census Tract 4060, Alameda County, California",3796,46394,702,525,0,1590,3,896,18.5,13.8,0,41.9,0.1,23.6,81.5,1551,236,1315,15.22,84.78,29,207,86,1229,115,1436,12.3,6.5,7.4,"75% or more P.O.C.","Less than $80000"
"06001406100","Census Tract 4061, Alameda County, California",4733,50307,703,422,0,824,28,2709,14.9,8.9,0,17.4,0.6,57.2,85.1,1475,519,956,35.19,64.81,104,415,190,766,294,1181,20,19.9,19.9,"75% or more P.O.C.","Less than $80000"
"06001406201","Census Tract 4062.01, Alameda County, California",4995,41438,264,1056,8,1424,18,2071,5.3,21.1,0.2,28.5,0.4,41.5,94.7,1485,283,1202,19.06,80.94,80,203,248,954,328,1157,28.3,20.6,22.1,"75% or more P.O.C.","Less than $80000"
"06001406202","Census Tract 4062.02, Alameda County, California",4817,46233,458,684,101,603,0,2885,9.5,14.2,2.1,12.5,0,59.9,90.5,1337,180,1157,13.46,86.54,33,147,246,911,279,1058,18.3,21.3,20.9,"75% or more P.O.C.","Less than $80000"
"06001406300","Census Tract 4063, Alameda County, California",4383,49323,553,1161,19,1061,0,1480,12.6,26.5,0.4,24.2,0,33.8,87.4,1255,529,726,42.15,57.85,111,418,178,548,289,966,21,24.5,23,"75% or more P.O.C.","Less than $80000"
"06001406400","Census Tract 4064, Alameda County, California",2545,77115,801,526,5,483,16,546,31.5,20.7,0.2,19,0.6,21.5,68.5,748,353,395,47.19,52.81,78,275,57,338,135,613,22.1,14.4,18,"50% - 75% P.O.C.","Less than $80000"
"06001406500","Census Tract 4065, Alameda County, California",6586,43226,770,1085,0,923,185,3324,11.7,16.5,0,14,2.8,50.5,88.3,1948,623,1325,31.98,68.02,153,470,359,966,512,1436,24.6,27.1,26.3,"75% or more P.O.C.","Less than $80000"
"06001406601","Census Tract 4066.01, Alameda County, California",4955,50380,738,992,8,1089,0,1764,14.9,20,0.2,22,0,35.6,85.1,1746,491,1255,28.12,71.88,67,424,166,1089,233,1513,13.6,13.2,13.3,"75% or more P.O.C.","Less than $80000"
"06001406602","Census Tract 4066.02, Alameda County, California",2698,51490,340,443,42,973,5,763,12.6,16.4,1.6,36.1,0.2,28.3,87.4,941,295,646,31.35,68.65,59,236,86,560,145,796,20,13.3,15.4,"75% or more P.O.C.","Less than $80000"
"06001406700","Census Tract 4067, Alameda County, California",5159,97875,2328,748,34,1059,0,713,45.1,14.5,0.7,20.5,0,13.8,54.9,2178,1438,740,66.02,33.98,94,1344,28,712,122,2056,6.5,3.8,5.6,"50% - 75% P.O.C.","$80000 - $108000"
"06001406800","Census Tract 4068, Alameda County, California",3611,103833,1196,403,16,761,0,914,33.1,11.2,0.4,21.1,0,25.3,66.9,1360,943,417,69.34,30.66,62,881,51,366,113,1247,6.6,12.2,8.3,"50% - 75% P.O.C.","$80000 - $108000"
"06001406900","Census Tract 4069, Alameda County, California",3608,89852,1697,670,15,593,12,368,47,18.6,0.4,16.4,0.3,10.2,53,1551,903,648,58.22,41.78,7,896,24,624,31,1520,0.8,3.7,2,"50% - 75% P.O.C.","$80000 - $108000"
"06001407000","Census Tract 4070, Alameda County, California",5869,63465,770,1234,68,1453,0,1758,13.1,21,1.2,24.8,0,30,86.9,1991,906,1085,45.5,54.5,96,810,111,974,207,1784,10.6,10.2,10.4,"75% or more P.O.C.","Less than $80000"
"06001407101","Census Tract 4071.01, Alameda County, California",3821,47917,188,534,8,956,0,2072,4.9,14,0.2,25,0,54.2,95.1,1056,356,700,33.71,66.29,77,279,169,531,246,810,21.6,24.1,23.3,"75% or more P.O.C.","Less than $80000"
"06001407102","Census Tract 4071.02, Alameda County, California",4387,53714,435,1143,17,611,0,1954,9.9,26.1,0.4,13.9,0,44.5,90.1,1355,640,715,47.23,52.77,91,549,198,517,289,1066,14.2,27.7,21.3,"75% or more P.O.C.","Less than $80000"
"06001407200","Census Tract 4072, Alameda County, California",6985,47458,667,590,15,968,3,4539,9.5,8.4,0.2,13.9,0,65,90.5,1927,469,1458,24.34,75.66,141,328,336,1122,477,1450,30.1,23,24.8,"75% or more P.O.C.","Less than $80000"
"06001407300","Census Tract 4073, Alameda County, California",2420,60167,286,266,3,236,12,1542,11.8,11,0.1,9.8,0.5,63.7,88.2,730,163,567,22.33,77.67,45,118,121,446,166,564,27.6,21.3,22.7,"75% or more P.O.C.","Less than $80000"
"06001407400","Census Tract 4074, Alameda County, California",4531,57471,80,823,0,329,9,3177,1.8,18.2,0,7.3,0.2,70.1,98.2,1127,386,741,34.25,65.75,103,283,192,549,295,832,26.7,25.9,26.2,"75% or more P.O.C.","Less than $80000"
"06001407500","Census Tract 4075, Alameda County, California",4299,31860,179,1247,4,278,5,2366,4.2,29,0.1,6.5,0.1,55,95.8,1358,336,1022,24.74,75.26,94,242,230,792,324,1034,28,22.5,23.9,"75% or more P.O.C.","Less than $80000"
"06001407600","Census Tract 4076, Alameda County, California",6327,79428,1060,2472,0,526,0,2025,16.8,39.1,0,8.3,0,32,83.2,2123,1139,984,53.65,46.35,301,838,51,933,352,1771,26.4,5.2,16.6,"75% or more P.O.C.","Less than $80000"
"06001407700","Census Tract 4077, Alameda County, California",4122,78350,1237,1770,0,206,17,668,30,42.9,0,5,0.4,16.2,70,1651,1239,412,75.05,24.95,43,1196,0,412,43,1608,3.5,0,2.6,"50% - 75% P.O.C.","Less than $80000"
"06001407800","Census Tract 4078, Alameda County, California",2728,93478,850,645,0,550,3,541,31.2,23.6,0,20.2,0.1,19.8,68.8,748,536,212,71.66,28.34,36,500,10,202,46,702,6.7,4.7,6.1,"50% - 75% P.O.C.","$80000 - $108000"
"06001407900","Census Tract 4079, Alameda County, California",2873,125119,1428,530,0,447,2,241,49.7,18.4,0,15.6,0.1,8.4,50.3,1126,881,245,78.24,21.76,28,853,0,245,28,1098,3.2,0,2.5,"50% - 75% P.O.C.","$108000 - $141000"
"06001408000","Census Tract 4080, Alameda County, California",2700,181776,1476,250,12,499,2,337,54.7,9.3,0.4,18.5,0.1,12.5,45.3,1037,940,97,90.65,9.35,24,916,0,97,24,1013,2.6,0,2.3,"25% - 50% P.O.C.","$141000 or more"
"06001408100","Census Tract 4081, Alameda County, California",6320,131127,2531,1506,0,1287,0,636,40,23.8,0,20.4,0,10.1,60,2717,2285,432,84.1,15.9,129,2156,0,432,129,2588,5.6,0,4.7,"50% - 75% P.O.C.","$108000 - $141000"
"06001408200","Census Tract 4082, Alameda County, California",4570,58487,834,2350,35,238,30,713,18.2,51.4,0.8,5.2,0.7,15.6,81.8,1961,801,1160,40.85,59.15,49,752,11,1149,60,1901,6.1,0.9,3.1,"75% or more P.O.C.","Less than $80000"
"06001408300","Census Tract 4083, Alameda County, California",5047,81949,1136,1877,6,589,61,1107,22.5,37.2,0.1,11.7,1.2,21.9,77.5,1828,1260,568,68.93,31.07,78,1182,150,418,228,1600,6.2,26.4,12.5,"75% or more P.O.C.","$80000 - $108000"
"06001408400","Census Tract 4084, Alameda County, California",3201,44728,238,1610,0,52,8,1210,7.4,50.3,0,1.6,0.2,37.8,92.6,1157,398,759,34.4,65.6,20,378,131,628,151,1006,5,17.3,13.1,"75% or more P.O.C.","Less than $80000"
"06001408500","Census Tract 4085, Alameda County, California",5977,56947,144,2201,1,132,113,3204,2.4,36.8,0,2.2,1.9,53.6,97.6,1611,523,1088,32.46,67.54,91,432,337,751,428,1183,17.4,31,26.6,"75% or more P.O.C.","Less than $80000"
"06001408600","Census Tract 4086, Alameda County, California",7096,47350,235,2497,19,302,0,3715,3.3,35.2,0.3,4.3,0,52.4,96.7,1811,798,1013,44.06,55.94,253,545,209,804,462,1349,31.7,20.6,25.5,"75% or more P.O.C.","Less than $80000"
"06001408700","Census Tract 4087, Alameda County, California",7909,59514,663,3312,0,181,0,3565,8.4,41.9,0,2.3,0,45.1,91.6,2455,1092,1363,44.48,55.52,154,938,239,1124,393,2062,14.1,17.5,16,"75% or more P.O.C.","Less than $80000"
"06001408800","Census Tract 4088, Alameda County, California",7149,23819,387,2718,0,308,361,3334,5.4,38,0,4.3,5,46.6,94.6,2225,523,1702,23.51,76.49,150,373,305,1397,455,1770,28.7,17.9,20.4,"75% or more P.O.C.","Less than $80000"
"06001408900","Census Tract 4089, Alameda County, California",3546,44451,175,759,0,162,35,2338,4.9,21.4,0,4.6,1,65.9,95.1,1016,282,734,27.76,72.24,93,189,152,582,245,771,33,20.7,24.1,"75% or more P.O.C.","Less than $80000"
"06001409000","Census Tract 4090, Alameda County, California",4687,47426,94,1638,0,221,6,2509,2,34.9,0,4.7,0.1,53.5,98,1135,491,644,43.26,56.74,121,370,203,441,324,811,24.6,31.5,28.5,"75% or more P.O.C.","Less than $80000"
"06001409100","Census Tract 4091, Alameda County, California",2490,61315,49,694,18,109,0,1475,2,27.9,0.7,4.4,0,59.2,98,675,434,241,64.3,35.7,114,320,65,176,179,496,26.3,27,26.5,"75% or more P.O.C.","Less than $80000"
"06001409200","Census Tract 4092, Alameda County, California",3672,55160,93,1137,0,240,0,2094,2.5,31,0,6.5,0,57,97.5,982,444,538,45.21,54.79,101,343,180,358,281,701,22.7,33.5,28.6,"75% or more P.O.C.","Less than $80000"
"06001409300","Census Tract 4093, Alameda County, California",5303,44671,254,1305,0,148,27,3456,4.8,24.6,0,2.8,0.5,65.2,95.2,1627,667,960,41,59,104,563,266,694,370,1257,15.6,27.7,22.7,"75% or more P.O.C.","Less than $80000"
"06001409400","Census Tract 4094, Alameda County, California",4780,41567,216,728,0,443,15,3327,4.5,15.2,0,9.3,0.3,69.6,95.5,1268,439,829,34.62,65.38,116,323,254,575,370,898,26.4,30.6,29.2,"75% or more P.O.C.","Less than $80000"
"06001409500","Census Tract 4095, Alameda County, California",4128,43750,173,1032,5,69,83,2678,4.2,25,0.1,1.7,2,64.9,95.8,1131,300,831,26.53,73.47,88,212,217,614,305,826,29.3,26.1,27,"75% or more P.O.C.","Less than $80000"
"06001409600","Census Tract 4096, Alameda County, California",4978,51958,159,1623,11,233,36,2838,3.2,32.6,0.2,4.7,0.7,57,96.8,1484,399,1085,26.89,73.11,32,367,362,723,394,1090,8,33.4,26.5,"75% or more P.O.C.","Less than $80000"
"06001409700","Census Tract 4097, Alameda County, California",4991,47746,177,1598,0,94,17,2880,3.5,32,0,1.9,0.3,57.7,96.5,1577,527,1050,33.42,66.58,95,432,218,832,313,1264,18,20.8,19.8,"75% or more P.O.C.","Less than $80000"
"06001409800","Census Tract 4098, Alameda County, California",3516,86711,717,1944,10,150,0,440,20.4,55.3,0.3,4.3,0,12.5,79.6,1294,620,674,47.91,52.09,68,552,72,602,140,1154,11,10.7,10.8,"75% or more P.O.C.","$80000 - $108000"
"06001409900","Census Tract 4099, Alameda County, California",3642,114861,1046,1715,0,265,0,295,28.7,47.1,0,7.3,0,8.1,71.3,1423,1229,194,86.37,13.63,50,1179,11,183,61,1362,4.1,5.7,4.3,"50% - 75% P.O.C.","$108000 - $141000"
"06001410000","Census Tract 4100, Alameda County, California",3242,115268,935,1301,8,158,29,300,28.8,40.1,0.2,4.9,0.9,9.3,71.2,1227,1079,148,87.94,12.06,61,1018,0,148,61,1166,5.7,0,5,"50% - 75% P.O.C.","$108000 - $141000"
"06001410100","Census Tract 4101, Alameda County, California",2667,67159,330,1479,0,129,14,468,12.4,55.5,0,4.8,0.5,17.5,87.6,1100,644,456,58.55,41.45,28,616,6,450,34,1066,4.3,1.3,3.1,"75% or more P.O.C.","Less than $80000"
"06001410200","Census Tract 4102, Alameda County, California",3630,59282,53,2000,31,104,86,1279,1.5,55.1,0.9,2.9,2.4,35.2,98.5,1127,672,455,59.63,40.37,94,578,0,455,94,1033,14,0,8.3,"75% or more P.O.C.","Less than $80000"
"06001410300","Census Tract 4103, Alameda County, California",3857,50139,83,959,18,121,51,2527,2.2,24.9,0.5,3.1,1.3,65.5,97.8,1023,427,596,41.74,58.26,106,321,119,477,225,798,24.8,20,22,"75% or more P.O.C.","Less than $80000"
"06001410400","Census Tract 4104, Alameda County, California",4477,73996,286,1505,12,452,0,2136,6.4,33.6,0.3,10.1,0,47.7,93.6,1351,775,576,57.36,42.64,128,647,90,486,218,1133,16.5,15.6,16.1,"75% or more P.O.C.","Less than $80000"
"06001410500","Census Tract 4105, Alameda County, California",2705,31151,403,1652,7,294,24,266,14.9,61.1,0.3,10.9,0.9,9.8,85.1,925,124,801,13.41,86.59,19,105,91,710,110,815,15.3,11.4,11.9,"75% or more P.O.C.","Less than $80000"
"06001420100","Census Tract 4201, Alameda County, California",2440,139196,1506,11,10,512,0,192,61.7,0.5,0.4,21,0,7.9,38.3,891,637,254,71.49,28.51,11,626,29,225,40,851,1.7,11.4,4.5,"25% - 50% P.O.C.","$108000 - $141000"
"06001420200","Census Tract 4202, Alameda County, California",3332,97195,1183,186,18,1279,0,402,35.5,5.6,0.5,38.4,0,12.1,64.5,1256,492,764,39.17,60.83,72,420,38,726,110,1146,14.6,5,8.8,"50% - 75% P.O.C.","$80000 - $108000"
"06001420300","Census Tract 4203, Alameda County, California",4977,87521,1482,196,60,1987,52,781,29.8,3.9,1.2,39.9,1,15.7,70.2,1947,911,1036,46.79,53.21,76,835,99,937,175,1772,8.3,9.6,9,"50% - 75% P.O.C.","$80000 - $108000"
"06001420400","Census Tract 4204, Alameda County, California",3062,44844,971,37,11,935,13,912,31.7,1.2,0.4,30.5,0.4,29.8,68.3,1129,0,1129,0,100,0,0,54,1075,54,1075,NA,4.8,4.8,"50% - 75% P.O.C.","Less than $80000"
"06001420500","Census Tract 4205, Alameda County, California",2557,102361,1308,138,27,540,0,286,51.2,5.4,1.1,21.1,0,11.2,48.8,974,458,516,47.02,52.98,19,439,24,492,43,931,4.1,4.7,4.4,"25% - 50% P.O.C.","$80000 - $108000"
"06001420600","Census Tract 4206, Alameda County, California",3436,161250,2283,12,0,502,19,400,66.4,0.3,0,14.6,0.6,11.6,33.6,1247,998,249,80.03,19.97,63,935,29,220,92,1155,6.3,11.6,7.4,"25% - 50% P.O.C.","$141000 or more"
"06001421100","Census Tract 4211, Alameda County, California",2084,179625,1633,36,0,223,7,123,78.4,1.7,0,10.7,0.3,5.9,21.6,837,767,70,91.64,8.36,24,743,0,70,24,813,3.1,0,2.9,"Less than 25% P.O.C.","$141000 or more"
"06001421200","Census Tract 4212, Alameda County, California",3594,166071,2619,48,4,364,0,148,72.9,1.3,0.1,10.1,0,4.1,27.1,1466,1328,138,90.59,9.41,23,1305,0,138,23,1443,1.7,0,1.6,"25% - 50% P.O.C.","$141000 or more"
"06001421300","Census Tract 4213, Alameda County, California",3873,159391,3046,58,0,340,8,142,78.6,1.5,0,8.8,0.2,3.7,21.4,1578,1282,296,81.24,18.76,27,1255,16,280,43,1535,2.1,5.4,2.7,"Less than 25% P.O.C.","$141000 or more"
"06001421400","Census Tract 4214, Alameda County, California",1634,140583,1199,30,7,202,4,105,73.4,1.8,0.4,12.4,0.2,6.4,26.6,625,536,89,85.76,14.24,44,492,10,79,54,571,8.2,11.2,8.6,"25% - 50% P.O.C.","$108000 - $141000"
"06001421500","Census Tract 4215, Alameda County, California",3694,171296,2873,95,0,434,11,175,77.8,2.6,0,11.7,0.3,4.7,22.2,1576,1282,294,81.35,18.65,37,1245,23,271,60,1516,2.9,7.8,3.8,"Less than 25% P.O.C.","$141000 or more"
"06001421600","Census Tract 4216, Alameda County, California",3617,153750,2658,112,0,466,20,144,73.5,3.1,0,12.9,0.6,4,26.5,1537,1202,335,78.2,21.8,38,1164,1,334,39,1498,3.2,0.3,2.5,"25% - 50% P.O.C.","$141000 or more"
"06001421700","Census Tract 4217, Alameda County, California",3492,92500,2383,23,5,631,0,323,68.2,0.7,0.1,18.1,0,9.2,31.8,1574,664,910,42.19,57.81,26,638,40,870,66,1508,3.9,4.4,4.2,"25% - 50% P.O.C.","$80000 - $108000"
"06001421800","Census Tract 4218, Alameda County, California",2144,140688,1603,31,1,300,0,65,74.8,1.4,0,14,0,3,25.2,859,574,285,66.82,33.18,15,559,18,267,33,826,2.6,6.3,3.8,"25% - 50% P.O.C.","$108000 - $141000"
"06001421900","Census Tract 4219, Alameda County, California",4171,114052,2345,223,0,741,7,445,56.2,5.3,0,17.8,0.2,10.7,43.8,1732,980,752,56.58,43.42,67,913,34,718,101,1631,6.8,4.5,5.8,"25% - 50% P.O.C.","$108000 - $141000"
"06001422000","Census Tract 4220, Alameda County, California",2156,104826,1387,234,0,176,0,148,64.3,10.9,0,8.2,0,6.9,35.7,928,239,689,25.75,74.25,0,239,33,656,33,895,0,4.8,3.6,"25% - 50% P.O.C.","$80000 - $108000"
"06001422100","Census Tract 4221, Alameda County, California",3073,81236,1445,394,25,375,0,642,47,12.8,0.8,12.2,0,20.9,53,1212,538,674,44.39,55.61,78,460,24,650,102,1110,14.5,3.6,8.4,"50% - 75% P.O.C.","$80000 - $108000"
"06001422200","Census Tract 4222, Alameda County, California",3237,93105,1714,171,0,511,0,529,53,5.3,0,15.8,0,16.3,47,1554,761,793,48.97,51.03,25,736,12,781,37,1517,3.3,1.5,2.4,"25% - 50% P.O.C.","$80000 - $108000"
"06001422300","Census Tract 4223, Alameda County, California",3643,79555,2192,105,6,778,0,321,60.2,2.9,0.2,21.4,0,8.8,39.8,1680,633,1047,37.68,62.32,66,567,0,1047,66,1614,10.4,0,3.9,"25% - 50% P.O.C.","Less than $80000"
"06001422400","Census Tract 4224, Alameda County, California",4487,61622,1886,56,0,1691,0,616,42,1.2,0,37.7,0,13.7,58,2067,271,1796,13.11,86.89,8,263,50,1746,58,2009,3,2.8,2.8,"50% - 75% P.O.C.","Less than $80000"
"06001422500","Census Tract 4225, Alameda County, California",4400,62240,2083,126,10,1483,11,435,47.3,2.9,0.2,33.7,0.2,9.9,52.7,1439,358,1081,24.88,75.12,5,353,14,1067,19,1420,1.4,1.3,1.3,"50% - 75% P.O.C.","Less than $80000"
"06001422600","Census Tract 4226, Alameda County, California",1043,222500,403,32,0,459,0,129,38.6,3.1,0,44,0,12.4,61.4,26,26,0,100,0,0,26,0,0,0,26,0,NA,0,"50% - 75% P.O.C.","$141000 or more"
"06001422700","Census Tract 4227, Alameda County, California",5266,41080,2391,126,47,1536,10,872,45.4,2.4,0.9,29.2,0.2,16.6,54.6,1053,180,873,17.09,82.91,14,166,51,822,65,988,7.8,5.8,6.2,"50% - 75% P.O.C.","Less than $80000"
"06001422800","Census Tract 4228, Alameda County, California",9064,19777,2580,382,13,4062,76,1463,28.5,4.2,0.1,44.8,0.8,16.1,71.5,1293,29,1264,2.24,97.76,0,29,45,1219,45,1248,0,3.6,3.5,"50% - 75% P.O.C.","Less than $80000"
"06001422900","Census Tract 4229, Alameda County, California",5761,30978,1957,691,0,2421,156,303,34,12,0,42,2.7,5.3,66,2128,57,2071,2.68,97.32,11,46,148,1923,159,1969,19.3,7.1,7.5,"50% - 75% P.O.C.","Less than $80000"
"06001423000","Census Tract 4230, Alameda County, California",4962,76115,2649,241,5,1234,0,597,53.4,4.9,0.1,24.9,0,12,46.6,2087,851,1236,40.78,59.22,24,827,0,1236,24,2063,2.8,0,1.1,"25% - 50% P.O.C.","Less than $80000"
"06001423100","Census Tract 4231, Alameda County, California",4413,73571,2189,733,0,624,43,570,49.6,16.6,0,14.1,1,12.9,50.4,1976,665,1311,33.65,66.35,17,648,8,1303,25,1951,2.6,0.6,1.3,"50% - 75% P.O.C.","Less than $80000"
"06001423200","Census Tract 4232, Alameda County, California",2982,58667,912,669,0,217,103,811,30.6,22.4,0,7.3,3.5,27.2,69.4,1142,285,857,24.96,75.04,43,242,27,830,70,1072,15.1,3.2,6.1,"50% - 75% P.O.C.","Less than $80000"
"06001423300","Census Tract 4233, Alameda County, California",3504,97625,1556,893,3,333,0,440,44.4,25.5,0.1,9.5,0,12.6,55.6,1587,936,651,58.98,41.02,7,929,9,642,16,1571,0.7,1.4,1,"50% - 75% P.O.C.","$80000 - $108000"
"06001423400","Census Tract 4234, Alameda County, California",5163,85769,2548,709,0,629,0,764,49.4,13.7,0,12.2,0,14.8,50.6,2002,753,1249,37.61,62.39,83,670,13,1236,96,1906,11,1,4.8,"50% - 75% P.O.C.","$80000 - $108000"
"06001423500","Census Tract 4235, Alameda County, California",3426,59643,1628,692,0,459,11,487,47.5,20.2,0,13.4,0.3,14.2,52.5,1486,508,978,34.19,65.81,8,500,68,910,76,1410,1.6,7,5.1,"50% - 75% P.O.C.","Less than $80000"
"06001423601","Census Tract 4236.01, Alameda County, California",2671,112826,1879,138,17,246,0,233,70.3,5.2,0.6,9.2,0,8.7,29.7,1214,520,694,42.83,57.17,10,510,10,684,20,1194,1.9,1.4,1.6,"25% - 50% P.O.C.","$108000 - $141000"
"06001423602","Census Tract 4236.02, Alameda County, California",6528,43561,3087,84,99,2305,31,571,47.3,1.3,1.5,35.3,0.5,8.7,52.7,2193,269,1924,12.27,87.73,0,269,175,1749,175,2018,0,9.1,8,"50% - 75% P.O.C.","Less than $80000"
"06001423700","Census Tract 4237, Alameda County, California",4148,102546,2547,95,6,824,22,438,61.4,2.3,0.1,19.9,0.5,10.6,38.6,1305,534,771,40.92,59.08,22,512,18,753,40,1265,4.1,2.3,3.1,"25% - 50% P.O.C.","$80000 - $108000"
"06001423800","Census Tract 4238, Alameda County, California",2986,182432,2372,71,0,211,0,190,79.4,2.4,0,7.1,0,6.4,20.6,1306,982,324,75.19,24.81,51,931,0,324,51,1255,5.2,0,3.9,"Less than 25% P.O.C.","$141000 or more"
"06001423901","Census Tract 4239.01, Alameda County, California",2054,90469,1289,219,7,187,0,286,62.8,10.7,0.3,9.1,0,13.9,37.2,818,287,531,35.09,64.91,43,244,13,518,56,762,15,2.4,6.8,"25% - 50% P.O.C.","$80000 - $108000"
"06001423902","Census Tract 4239.02, Alameda County, California",1605,130500,1135,47,0,248,0,96,70.7,2.9,0,15.5,0,6,29.3,712,270,442,37.92,62.08,6,264,0,442,6,706,2.2,0,0.8,"25% - 50% P.O.C.","$108000 - $141000"
"06001424001","Census Tract 4240.01, Alameda County, California",4027,80238,1886,892,13,336,12,656,46.8,22.2,0.3,8.3,0.3,16.3,53.2,1426,446,980,31.28,68.72,51,395,28,952,79,1347,11.4,2.9,5.5,"50% - 75% P.O.C.","$80000 - $108000"
"06001424002","Census Tract 4240.02, Alameda County, California",2583,74914,707,868,14,267,0,586,27.4,33.6,0.5,10.3,0,22.7,72.6,934,465,469,49.79,50.21,57,408,9,460,66,868,12.3,1.9,7.1,"50% - 75% P.O.C.","Less than $80000"
"06001425101","Census Tract 4251.01, Alameda County, California",1659,82313,969,58,5,419,8,97,58.4,3.5,0.3,25.3,0.5,5.8,41.6,1159,608,551,52.46,47.54,0,608,11,540,11,1148,0,2,0.9,"25% - 50% P.O.C.","$80000 - $108000"
"06001425102","Census Tract 4251.02, Alameda County, California",3906,111056,1329,325,8,1594,38,351,34,8.3,0.2,40.8,1,9,66,2022,517,1505,25.57,74.43,0,517,52,1453,52,1970,0,3.5,2.6,"50% - 75% P.O.C.","$108000 - $141000"
"06001425103","Census Tract 4251.03, Alameda County, California",2795,122044,1219,428,2,736,0,209,43.6,15.3,0.1,26.3,0,7.5,56.4,1429,495,934,34.64,65.36,4,491,31,903,35,1394,0.8,3.3,2.4,"50% - 75% P.O.C.","$108000 - $141000"
"06001425104","Census Tract 4251.04, Alameda County, California",3539,72315,1277,941,0,639,14,482,36.1,26.6,0,18.1,0.4,13.6,63.9,1958,626,1332,31.97,68.03,16,610,0,1332,16,1942,2.6,0,0.8,"50% - 75% P.O.C.","Less than $80000"
"06001426100","Census Tract 4261, Alameda County, California",6521,250001,4783,45,0,1298,0,134,73.3,0.7,0,19.9,0,2.1,26.7,2178,1953,225,89.67,10.33,205,1748,0,225,205,1973,10.5,0,9.4,"25% - 50% P.O.C.","$141000 or more"
"06001426200","Census Tract 4262, Alameda County, California",4796,192037,3242,110,4,722,7,336,67.6,2.3,0.1,15.1,0.1,7,32.4,1660,1420,240,85.54,14.46,147,1273,19,221,166,1494,10.4,7.9,10,"25% - 50% P.O.C.","$141000 or more"
"06001427100","Census Tract 4271, Alameda County, California",3975,140648,2550,55,19,567,8,640,64.2,1.4,0.5,14.3,0.2,16.1,35.8,1420,1043,377,73.45,26.55,87,956,0,377,87,1333,8.3,0,6.1,"25% - 50% P.O.C.","$108000 - $141000"
"06001427200","Census Tract 4272, Alameda County, California",4180,77375,1674,122,12,1482,19,702,40,2.9,0.3,35.5,0.5,16.8,60,1597,637,960,39.89,60.11,83,554,34,926,117,1480,13,3.5,7.3,"50% - 75% P.O.C.","Less than $80000"
"06001427300","Census Tract 4273, Alameda County, California",5346,94939,1996,386,22,2008,39,581,37.3,7.2,0.4,37.6,0.7,10.9,62.7,2058,1165,893,56.61,43.39,130,1035,65,828,195,1863,11.2,7.3,9.5,"50% - 75% P.O.C.","$80000 - $108000"
"06001427600","Census Tract 4276, Alameda County, California",5200,70650,1483,975,4,1790,55,534,28.5,18.8,0.1,34.4,1.1,10.3,71.5,1773,318,1455,17.94,82.06,8,310,185,1270,193,1580,2.5,12.7,10.9,"50% - 75% P.O.C.","Less than $80000"
"06001427700","Census Tract 4277, Alameda County, California",5201,101678,2520,491,2,930,0,921,48.5,9.4,0,17.9,0,17.7,51.5,2234,800,1434,35.81,64.19,105,695,40,1394,145,2089,13.1,2.8,6.5,"50% - 75% P.O.C.","$80000 - $108000"
"06001427800","Census Tract 4278, Alameda County, California",4954,106477,2669,236,6,1075,0,489,53.9,4.8,0.1,21.7,0,9.9,46.1,2072,798,1274,38.51,61.49,39,759,53,1221,92,1980,4.9,4.2,4.4,"25% - 50% P.O.C.","$80000 - $108000"
"06001427900","Census Tract 4279, Alameda County, California",5052,100815,2432,232,34,1432,0,720,48.1,4.6,0.7,28.3,0,14.3,51.9,2072,677,1395,32.67,67.33,2,675,98,1297,100,1972,0.3,7,4.8,"50% - 75% P.O.C.","$80000 - $108000"
"06001428000","Census Tract 4280, Alameda County, California",2877,68750,1044,153,3,781,0,673,36.3,5.3,0.1,27.1,0,23.4,63.7,1362,192,1170,14.1,85.9,43,149,86,1084,129,1233,22.4,7.4,9.5,"50% - 75% P.O.C.","Less than $80000"
"06001428100","Census Tract 4281, Alameda County, California",4839,115208,2553,315,0,1052,30,560,52.8,6.5,0,21.7,0.6,11.6,47.2,1983,1043,940,52.6,47.4,72,971,46,894,118,1865,6.9,4.9,6,"25% - 50% P.O.C.","$108000 - $141000"
"06001428200","Census Tract 4282, Alameda County, California",6606,107664,3421,414,0,1395,30,847,51.8,6.3,0,21.1,0.5,12.8,48.2,2661,1485,1176,55.81,44.19,112,1373,75,1101,187,2474,7.5,6.4,7,"25% - 50% P.O.C.","$80000 - $108000"
"06001428301","Census Tract 4283.01, Alameda County, California",7277,140405,2304,338,22,3167,60,771,31.7,4.6,0.3,43.5,0.8,10.6,68.3,2492,2000,492,80.26,19.74,242,1758,37,455,279,2213,12.1,7.5,11.2,"50% - 75% P.O.C.","$108000 - $141000"
"06001428302","Census Tract 4283.02, Alameda County, California",7424,181000,3095,194,0,3185,0,479,41.7,2.6,0,42.9,0,6.5,58.3,2474,2091,383,84.52,15.48,148,1943,69,314,217,2257,7.1,18,8.8,"50% - 75% P.O.C.","$141000 or more"
"06001428400","Census Tract 4284, Alameda County, California",4568,80839,1814,491,21,1130,28,802,39.7,10.7,0.5,24.7,0.6,17.6,60.3,1873,468,1405,24.99,75.01,20,448,53,1352,73,1800,4.3,3.8,3.9,"50% - 75% P.O.C.","$80000 - $108000"
"06001428500","Census Tract 4285, Alameda County, California",3097,95217,1274,246,31,854,0,397,41.1,7.9,1,27.6,0,12.8,58.9,1386,492,894,35.5,64.5,9,483,41,853,50,1336,1.8,4.6,3.6,"50% - 75% P.O.C.","$80000 - $108000"
"06001428600","Census Tract 4286, Alameda County, California",3454,107396,1484,254,9,1182,0,208,43,7.4,0.3,34.2,0,6,57,1581,816,765,51.61,48.39,59,757,21,744,80,1501,7.2,2.7,5.1,"50% - 75% P.O.C.","$80000 - $108000"
"06001428700","Census Tract 4287, Alameda County, California",4472,70893,1226,752,19,1461,0,727,27.4,16.8,0.4,32.7,0,16.3,72.6,1380,563,817,40.8,59.2,122,441,48,769,170,1210,21.7,5.9,12.3,"50% - 75% P.O.C.","Less than $80000"
"06001430101","Census Tract 4301.01, Alameda County, California",6842,164297,1981,441,10,3401,81,641,29,6.4,0.1,49.7,1.2,9.4,71,2179,1972,207,90.5,9.5,201,1771,80,127,281,1898,10.2,38.6,12.9,"50% - 75% P.O.C.","$141000 or more"
"06001430102","Census Tract 4301.02, Alameda County, California",2424,141563,1402,41,0,469,17,298,57.8,1.7,0,19.3,0.7,12.3,42.2,900,780,120,86.67,13.33,46,734,4,116,50,850,5.9,3.3,5.6,"25% - 50% P.O.C.","$141000 or more"
"06001430200","Census Tract 4302, Alameda County, California",6878,131071,3884,324,61,1640,1,651,56.5,4.7,0.9,23.8,0,9.5,43.5,2400,2212,188,92.17,7.83,168,2044,0,188,168,2232,7.6,0,7,"25% - 50% P.O.C.","$108000 - $141000"
"06001430300","Census Tract 4303, Alameda County, California",3826,135476,2137,43,0,976,5,502,55.9,1.1,0,25.5,0.1,13.1,44.1,1334,1177,157,88.23,11.77,153,1024,16,141,169,1165,13,10.2,12.7,"25% - 50% P.O.C.","$108000 - $141000"
"06001430400","Census Tract 4304, Alameda County, California",2107,165526,1243,32,0,465,9,247,59,1.5,0,22.1,0.4,11.7,41,716,673,43,93.99,6.01,70,603,17,26,87,629,10.4,39.5,12.2,"25% - 50% P.O.C.","$141000 or more"
"06001430500","Census Tract 4305, Alameda County, California",5987,80652,1756,1488,46,1308,4,1151,29.3,24.9,0.8,21.8,0.1,19.2,70.7,2086,1327,759,63.61,36.39,145,1182,42,717,187,1899,10.9,5.5,9,"50% - 75% P.O.C.","$80000 - $108000"
"06001430600","Census Tract 4306, Alameda County, California",6486,114940,2993,486,32,1787,36,829,46.1,7.5,0.5,27.6,0.6,12.8,53.9,2166,1847,319,85.27,14.73,200,1647,54,265,254,1912,10.8,16.9,11.7,"50% - 75% P.O.C.","$108000 - $141000"
"06001430700","Census Tract 4307, Alameda County, California",4170,99145,2091,203,18,880,0,659,50.1,4.9,0.4,21.1,0,15.8,49.9,1395,1094,301,78.42,21.58,79,1015,15,286,94,1301,7.2,5,6.7,"25% - 50% P.O.C.","$80000 - $108000"
"06001430800","Census Tract 4308, Alameda County, California",5282,79284,3015,81,47,1475,60,396,57.1,1.5,0.9,27.9,1.1,7.5,42.9,2109,1503,606,71.27,28.73,46,1457,43,563,89,2020,3.1,7.1,4.2,"25% - 50% P.O.C.","Less than $80000"
"06001430900","Census Tract 4309, Alameda County, California",5309,77958,2236,514,45,1010,6,1115,42.1,9.7,0.8,19,0.1,21,57.9,1864,397,1467,21.3,78.7,41,356,192,1275,233,1631,10.3,13.1,12.5,"50% - 75% P.O.C.","Less than $80000"
"06001431000","Census Tract 4310, Alameda County, California",2777,71098,1014,158,20,854,0,540,36.5,5.7,0.7,30.8,0,19.4,63.5,1087,459,628,42.23,57.77,30,429,29,599,59,1028,6.5,4.6,5.4,"50% - 75% P.O.C.","Less than $80000"
"06001431100","Census Tract 4311, Alameda County, California",3561,76845,1136,607,5,433,33,1081,31.9,17,0.1,12.2,0.9,30.4,68.1,1377,415,962,30.14,69.86,28,387,69,893,97,1280,6.7,7.2,7,"50% - 75% P.O.C.","Less than $80000"
"06001431200","Census Tract 4312, Alameda County, California",5574,97833,2586,593,0,777,0,1300,46.4,10.6,0,13.9,0,23.3,53.6,2496,1239,1257,49.64,50.36,0,1239,68,1189,68,2428,0,5.4,2.7,"50% - 75% P.O.C.","$80000 - $108000"
"06001432100","Census Tract 4321, Alameda County, California",3574,129148,1613,413,0,666,63,636,45.1,11.6,0,18.6,1.8,17.8,54.9,1458,1095,363,75.1,24.9,87,1008,21,342,108,1350,7.9,5.8,7.4,"50% - 75% P.O.C.","$108000 - $141000"
"06001432200","Census Tract 4322, Alameda County, California",4078,80882,1410,901,15,484,41,988,34.6,22.1,0.4,11.9,1,24.2,65.4,1680,769,911,45.77,54.23,49,720,85,826,134,1546,6.4,9.3,8,"50% - 75% P.O.C.","$80000 - $108000"
"06001432300","Census Tract 4323, Alameda County, California",4744,96696,905,542,16,1306,120,1568,19.1,11.4,0.3,27.5,2.5,33.1,80.9,1655,1011,644,61.09,38.91,64,947,63,581,127,1528,6.3,9.8,7.7,"75% or more P.O.C.","$80000 - $108000"
"06001432400","Census Tract 4324, Alameda County, California",7003,71250,1190,465,0,2088,126,2950,17,6.6,0,29.8,1.8,42.1,83,1832,826,1006,45.09,54.91,255,571,218,788,473,1359,30.9,21.7,25.8,"75% or more P.O.C.","Less than $80000"
"06001432501","Census Tract 4325.01, Alameda County, California",4854,64702,824,354,6,2023,30,1445,17,7.3,0.1,41.7,0.6,29.8,83,1422,714,708,50.21,49.79,163,551,184,524,347,1075,22.8,26,24.4,"75% or more P.O.C.","Less than $80000"
"06001432502","Census Tract 4325.02, Alameda County, California",5178,75938,715,686,3,2111,0,1538,13.8,13.2,0.1,40.8,0,29.7,86.2,1536,843,693,54.88,45.12,143,700,205,488,348,1188,17,29.6,22.7,"75% or more P.O.C.","Less than $80000"
"06001432600","Census Tract 4326, Alameda County, California",7043,59591,1791,1030,49,1758,48,2137,25.4,14.6,0.7,25,0.7,30.3,74.6,3036,1079,1957,35.54,64.46,79,1000,93,1864,172,2864,7.3,4.8,5.7,"50% - 75% P.O.C.","Less than $80000"
"06001432700","Census Tract 4327, Alameda County, California",2816,88934,1239,168,12,464,21,727,44,6,0.4,16.5,0.7,25.8,56,1035,746,289,72.08,27.92,45,701,11,278,56,979,6,3.8,5.4,"50% - 75% P.O.C.","$80000 - $108000"
"06001432800","Census Tract 4328, Alameda County, California",3979,124318,1168,412,6,1335,7,850,29.4,10.4,0.2,33.6,0.2,21.4,70.6,1442,1241,201,86.06,13.94,147,1094,8,193,155,1287,11.8,4,10.7,"50% - 75% P.O.C.","$108000 - $141000"
"06001433000","Census Tract 4330, Alameda County, California",3654,94514,1097,215,3,1463,7,753,30,5.9,0.1,40,0.2,20.6,70,1371,1032,339,75.27,24.73,57,975,100,239,157,1214,5.5,29.5,11.5,"50% - 75% P.O.C.","$80000 - $108000"
"06001433102","Census Tract 4331.02, Alameda County, California",4485,81744,501,387,5,1854,0,1622,11.2,8.6,0.1,41.3,0,36.2,88.8,1384,790,594,57.08,42.92,151,639,62,532,213,1171,19.1,10.4,15.4,"75% or more P.O.C.","$80000 - $108000"
"06001433103","Census Tract 4331.03, Alameda County, California",3523,59453,483,584,20,868,0,1513,13.7,16.6,0.6,24.6,0,42.9,86.3,1410,336,1074,23.83,76.17,46,290,154,920,200,1210,13.7,14.3,14.2,"75% or more P.O.C.","Less than $80000"
"06001433104","Census Tract 4331.04, Alameda County, California",3724,53708,1061,811,24,451,0,1112,28.5,21.8,0.6,12.1,0,29.9,71.5,1849,462,1387,24.99,75.01,22,440,47,1340,69,1780,4.8,3.4,3.7,"50% - 75% P.O.C.","Less than $80000"
"06001433200","Census Tract 4332, Alameda County, California",7991,58521,1396,968,38,2912,25,2290,17.5,12.1,0.5,36.4,0.3,28.7,82.5,2772,1169,1603,42.17,57.83,173,996,183,1420,356,2416,14.8,11.4,12.8,"75% or more P.O.C.","Less than $80000"
"06001433300","Census Tract 4333, Alameda County, California",7761,94653,2069,21,0,3492,157,1820,26.7,0.3,0,45,2,23.5,73.3,2218,1795,423,80.93,19.07,339,1456,60,363,399,1819,18.9,14.2,18,"50% - 75% P.O.C.","$80000 - $108000"
"06001433400","Census Tract 4334, Alameda County, California",5934,93269,978,551,78,3341,140,536,16.5,9.3,1.3,56.3,2.4,9,83.5,2200,1660,540,75.45,24.55,173,1487,25,515,198,2002,10.4,4.6,9,"75% or more P.O.C.","$80000 - $108000"
"06001433500","Census Tract 4335, Alameda County, California",4830,95875,1278,204,0,2250,3,1095,26.5,4.2,0,46.6,0.1,22.7,73.5,1402,1183,219,84.38,15.62,188,995,21,198,209,1193,15.9,9.6,14.9,"50% - 75% P.O.C.","$80000 - $108000"
"06001433600","Census Tract 4336, Alameda County, California",6094,56750,1409,531,122,2489,118,1078,23.1,8.7,2,40.8,1.9,17.7,76.9,2132,1184,948,55.53,44.47,241,943,94,854,335,1797,20.4,9.9,15.7,"75% or more P.O.C.","Less than $80000"
"06001433700","Census Tract 4337, Alameda County, California",3503,82782,457,186,26,655,0,2014,13,5.3,0.7,18.7,0,57.5,87,1019,399,620,39.16,60.84,106,293,128,492,234,785,26.6,20.6,23,"75% or more P.O.C.","$80000 - $108000"
"06001433800","Census Tract 4338, Alameda County, California",8179,75344,767,635,19,3035,10,3665,9.4,7.8,0.2,37.1,0.1,44.8,90.6,2573,1298,1275,50.45,49.55,354,944,57,1218,411,2162,27.3,4.5,16,"75% or more P.O.C.","Less than $80000"
"06001433900","Census Tract 4339, Alameda County, California",7685,61381,824,1715,7,1223,103,3122,10.7,22.3,0.1,15.9,1.3,40.6,89.3,2373,419,1954,17.66,82.34,109,310,388,1566,497,1876,26,19.9,20.9,"75% or more P.O.C.","Less than $80000"
"06001434000","Census Tract 4340, Alameda County, California",5334,48611,729,870,20,1003,0,2487,13.7,16.3,0.4,18.8,0,46.6,86.3,1822,667,1155,36.61,63.39,79,588,164,991,243,1579,11.8,14.2,13.3,"75% or more P.O.C.","Less than $80000"
"06001435102","Census Tract 4351.02, Alameda County, California",6189,124094,1704,864,33,1444,0,1822,27.5,14,0.5,23.3,0,29.4,72.5,1574,1126,448,71.54,28.46,103,1023,43,405,146,1428,9.1,9.6,9.3,"50% - 75% P.O.C.","$108000 - $141000"
"06001435103","Census Tract 4351.03, Alameda County, California",7420,184071,2178,553,0,3294,0,802,29.4,7.5,0,44.4,0,10.8,70.6,2346,2151,195,91.69,8.31,302,1849,16,179,318,2028,14,8.2,13.6,"50% - 75% P.O.C.","$141000 or more"
"06001435104","Census Tract 4351.04, Alameda County, California",6117,84290,877,673,22,1607,108,2359,14.3,11,0.4,26.3,1.8,38.6,85.7,2202,511,1691,23.21,76.79,101,410,183,1508,284,1918,19.8,10.8,12.9,"75% or more P.O.C.","$80000 - $108000"
"06001435200","Census Tract 4352, Alameda County, California",4659,113659,1044,921,11,1101,7,1276,22.4,19.8,0.2,23.6,0.2,27.4,77.6,1505,1252,253,83.19,16.81,140,1112,50,203,190,1315,11.2,19.8,12.6,"75% or more P.O.C.","$108000 - $141000"
"06001435300","Census Tract 4353, Alameda County, California",4739,73269,1186,1096,7,747,261,1285,25,23.1,0.1,15.8,5.5,27.1,75,1640,626,1014,38.17,61.83,82,544,58,956,140,1500,13.1,5.7,8.5,"75% or more P.O.C.","Less than $80000"
"06001435400","Census Tract 4354, Alameda County, California",4538,69375,991,1227,18,886,35,1078,21.8,27,0.4,19.5,0.8,23.8,78.2,1781,575,1206,32.29,67.71,60,515,71,1135,131,1650,10.4,5.9,7.4,"75% or more P.O.C.","Less than $80000"
"06001435500","Census Tract 4355, Alameda County, California",3983,61179,1159,456,20,447,134,1650,29.1,11.4,0.5,11.2,3.4,41.4,70.9,1530,439,1091,28.69,71.31,58,381,157,934,215,1315,13.2,14.4,14.1,"50% - 75% P.O.C.","Less than $80000"
"06001435601","Census Tract 4356.01, Alameda County, California",5662,72222,629,719,4,732,146,3242,11.1,12.7,0.1,12.9,2.6,57.3,88.9,1600,397,1203,24.81,75.19,53,344,370,833,423,1177,13.4,30.8,26.4,"75% or more P.O.C.","Less than $80000"
"06001435602","Census Tract 4356.02, Alameda County, California",5453,79290,1302,362,6,568,43,3102,23.9,6.6,0.1,10.4,0.8,56.9,76.1,1673,425,1248,25.4,74.6,78,347,178,1070,256,1417,18.4,14.3,15.3,"75% or more P.O.C.","Less than $80000"
"06001435700","Census Tract 4357, Alameda County, California",5231,92163,1116,594,5,731,158,2483,21.3,11.4,0.1,14,3,47.5,78.7,1459,925,534,63.4,36.6,180,745,141,393,321,1138,19.5,26.4,22,"75% or more P.O.C.","$80000 - $108000"
"06001435800","Census Tract 4358, Alameda County, California",5543,98902,1253,68,0,1547,0,2390,22.6,1.2,0,27.9,0,43.1,77.4,1652,1241,411,75.12,24.88,137,1104,144,267,281,1371,11,35,17,"75% or more P.O.C.","$80000 - $108000"
"06001435900","Census Tract 4359, Alameda County, California",5371,96682,1537,185,0,1665,57,1770,28.6,3.4,0,31,1.1,33,71.4,1633,1362,271,83.4,16.6,252,1110,8,263,260,1373,18.5,3,15.9,"50% - 75% P.O.C.","$80000 - $108000"
"06001436000","Census Tract 4360, Alameda County, California",5063,97031,1506,43,32,1237,3,2148,29.7,0.8,0.6,24.4,0.1,42.4,70.3,1506,1205,301,80.01,19.99,230,975,31,270,261,1245,19.1,10.3,17.3,"50% - 75% P.O.C.","$80000 - $108000"
"06001436100","Census Tract 4361, Alameda County, California",5977,97222,1228,210,29,1453,291,2482,20.5,3.5,0.5,24.3,4.9,41.5,79.5,1756,1020,736,58.09,41.91,261,759,79,657,340,1416,25.6,10.7,19.4,"75% or more P.O.C.","$80000 - $108000"
"06001436200","Census Tract 4362, Alameda County, California",4266,52660,453,702,0,478,38,2455,10.6,16.5,0,11.2,0.9,57.5,89.4,1268,192,1076,15.14,84.86,95,97,183,893,278,990,49.5,17,21.9,"75% or more P.O.C.","Less than $80000"
"06001436300","Census Tract 4363, Alameda County, California",9444,90100,1240,917,23,2513,34,4549,13.1,9.7,0.2,26.6,0.4,48.2,86.9,2978,1355,1623,45.5,54.5,108,1247,292,1331,400,2578,8,18,13.4,"75% or more P.O.C.","$80000 - $108000"
"06001436401","Census Tract 4364.01, Alameda County, California",7173,91375,2500,1035,9,1594,56,1478,34.9,14.4,0.1,22.2,0.8,20.6,65.1,2848,1759,1089,61.76,38.24,81,1678,100,989,181,2667,4.6,9.2,6.4,"50% - 75% P.O.C.","$80000 - $108000"
"06001436402","Census Tract 4364.02, Alameda County, California",2704,142857,1137,294,0,565,0,510,42,10.9,0,20.9,0,18.9,58,1058,953,105,90.08,9.92,58,895,0,105,58,1000,6.1,0,5.5,"50% - 75% P.O.C.","$141000 or more"
"06001436500","Census Tract 4365, Alameda County, California",5375,73243,799,515,4,1150,200,2395,14.9,9.6,0.1,21.4,3.7,44.6,85.1,1722,479,1243,27.82,72.18,156,323,103,1140,259,1463,32.6,8.3,15,"75% or more P.O.C.","Less than $80000"
"06001436601","Census Tract 4366.01, Alameda County, California",6938,90769,887,467,0,1050,0,3849,12.8,6.7,0,15.1,0,55.5,87.2,1862,760,1102,40.82,59.18,222,538,337,765,559,1303,29.2,30.6,30,"75% or more P.O.C.","$80000 - $108000"
"06001436602","Census Tract 4366.02, Alameda County, California",5113,66184,534,702,0,1066,172,2478,10.4,13.7,0,20.8,3.4,48.5,89.6,1680,297,1383,17.68,82.32,100,197,204,1179,304,1376,33.7,14.8,18.1,"75% or more P.O.C.","Less than $80000"
"06001436700","Census Tract 4367, Alameda County, California",3265,82895,657,194,0,696,14,1582,20.1,5.9,0,21.3,0.4,48.5,79.9,1088,594,494,54.6,45.4,146,448,28,466,174,914,24.6,5.7,16,"75% or more P.O.C.","$80000 - $108000"
"06001436800","Census Tract 4368, Alameda County, California",4382,98409,528,590,38,960,139,2013,12,13.5,0.9,21.9,3.2,45.9,88,1342,705,637,52.53,47.47,133,572,62,575,195,1147,18.9,9.7,14.5,"75% or more P.O.C.","$80000 - $108000"
"06001436900","Census Tract 4369, Alameda County, California",6745,72614,823,488,5,1276,189,3770,12.2,7.2,0.1,18.9,2.8,55.9,87.8,1885,843,1042,44.72,55.28,222,621,300,742,522,1363,26.3,28.8,27.7,"75% or more P.O.C.","Less than $80000"
"06001437000","Census Tract 4370, Alameda County, California",3493,92546,630,198,10,824,152,1538,18,5.7,0.3,23.6,4.4,44,82,1213,991,222,81.7,18.3,125,866,30,192,155,1058,12.6,13.5,12.8,"75% or more P.O.C.","$80000 - $108000"
"06001437101","Census Tract 4371.01, Alameda County, California",7867,118939,1185,579,71,3383,416,1847,15.1,7.4,0.9,43,5.3,23.5,84.9,2036,1663,373,81.68,18.32,391,1272,164,209,555,1481,23.5,44,27.3,"75% or more P.O.C.","$108000 - $141000"
"06001437102","Census Tract 4371.02, Alameda County, California",4521,69615,530,357,7,1887,6,1329,11.7,7.9,0.2,41.7,0.1,29.4,88.3,1406,617,789,43.88,56.12,190,427,102,687,292,1114,30.8,12.9,20.8,"75% or more P.O.C.","Less than $80000"
"06001437200","Census Tract 4372, Alameda County, California",7489,91618,1355,414,67,2918,192,2095,18.1,5.5,0.9,39,2.6,28,81.9,2344,1632,712,69.62,30.38,211,1421,166,546,377,1967,12.9,23.3,16.1,"75% or more P.O.C.","$80000 - $108000"
"06001437300","Census Tract 4373, Alameda County, California",3277,76161,453,403,1,929,61,1249,13.8,12.3,0,28.3,1.9,38.1,86.2,959,513,446,53.49,46.51,112,401,77,369,189,770,21.8,17.3,19.7,"75% or more P.O.C.","Less than $80000"
"06001437400","Census Tract 4374, Alameda County, California",3485,86210,487,137,14,854,44,1897,14,3.9,0.4,24.5,1.3,54.4,86,954,756,198,79.25,20.75,149,607,68,130,217,737,19.7,34.3,22.7,"75% or more P.O.C.","$80000 - $108000"
"06001437500","Census Tract 4375, Alameda County, California",4531,66983,620,130,0,742,9,2993,13.7,2.9,0,16.4,0.2,66.1,86.3,1192,319,873,26.76,73.24,41,278,311,562,352,840,12.9,35.6,29.5,"75% or more P.O.C.","Less than $80000"
"06001437600","Census Tract 4376, Alameda County, California",3536,85543,464,214,0,1131,82,1512,13.1,6.1,0,32,2.3,42.8,86.9,920,546,374,59.35,40.65,120,426,51,323,171,749,22,13.6,18.6,"75% or more P.O.C.","$80000 - $108000"
"06001437701","Census Tract 4377.01, Alameda County, California",3773,64559,350,486,52,492,79,2231,9.3,12.9,1.4,13,2.1,59.1,90.7,1026,193,833,18.81,81.19,39,154,188,645,227,799,20.2,22.6,22.1,"75% or more P.O.C.","Less than $80000"
"06001437702","Census Tract 4377.02, Alameda County, California",4295,65188,201,281,8,372,67,3257,4.7,6.5,0.2,8.7,1.6,75.8,95.3,1112,55,1057,4.95,95.05,5,50,390,667,395,717,9.1,36.9,35.5,"75% or more P.O.C.","Less than $80000"
"06001437800","Census Tract 4378, Alameda County, California",4997,111382,972,145,48,1545,143,1953,19.5,2.9,1,30.9,2.9,39.1,80.5,1360,912,448,67.06,32.94,228,684,99,349,327,1033,25,22.1,24,"75% or more P.O.C.","$108000 - $141000"
"06001437900","Census Tract 4379, Alameda County, California",2321,77750,278,122,13,354,103,1378,12,5.3,0.6,15.3,4.4,59.4,88,663,264,399,39.82,60.18,82,182,48,351,130,533,31.1,12,19.6,"75% or more P.O.C.","Less than $80000"
"06001438000","Census Tract 4380, Alameda County, California",3952,97399,1076,316,0,1299,25,1066,27.2,8,0,32.9,0.6,27,72.8,1145,680,465,59.39,40.61,131,549,152,313,283,862,19.3,32.7,24.7,"50% - 75% P.O.C.","$80000 - $108000"
"06001438100","Census Tract 4381, Alameda County, California",8307,105382,1327,599,67,2454,71,3387,16,7.2,0.8,29.5,0.9,40.8,84,2145,1475,670,68.76,31.24,392,1083,274,396,666,1479,26.6,40.9,31,"75% or more P.O.C.","$80000 - $108000"
"06001438201","Census Tract 4382.01, Alameda County, California",5144,72917,403,330,0,832,120,3194,7.8,6.4,0,16.2,2.3,62.1,92.2,1193,936,257,78.46,21.54,349,587,70,187,419,774,37.3,27.2,35.1,"75% or more P.O.C.","Less than $80000"
"06001438203","Census Tract 4382.03, Alameda County, California",3888,71716,613,212,0,2001,121,827,15.8,5.5,0,51.5,3.1,21.3,84.2,1159,916,243,79.03,20.97,177,739,60,183,237,922,19.3,24.7,20.4,"75% or more P.O.C.","Less than $80000"
"06001438204","Census Tract 4382.04, Alameda County, California",5838,76042,754,361,38,2250,137,1915,12.9,6.2,0.7,38.5,2.3,32.8,87.1,1847,1423,424,77.04,22.96,233,1190,112,312,345,1502,16.4,26.4,18.7,"75% or more P.O.C.","Less than $80000"
"06001438300","Census Tract 4383, Alameda County, California",3767,90179,207,331,0,1613,305,1223,5.5,8.8,0,42.8,8.1,32.5,94.5,873,603,270,69.07,30.93,120,483,134,136,254,619,19.9,49.6,29.1,"75% or more P.O.C.","$80000 - $108000"
"06001438400","Census Tract 4384, Alameda County, California",2757,85729,477,252,0,1034,57,866,17.3,9.1,0,37.5,2.1,31.4,82.7,733,619,114,84.45,15.55,176,443,35,79,211,522,28.4,30.7,28.8,"75% or more P.O.C.","$80000 - $108000"
"06001440100","Census Tract 4401, Alameda County, California",2799,84271,1117,82,7,950,28,579,39.9,2.9,0.3,33.9,1,20.7,60.1,1140,495,645,43.42,56.58,78,417,22,623,100,1040,15.8,3.4,8.8,"50% - 75% P.O.C.","$80000 - $108000"
"06001440200","Census Tract 4402, Alameda County, California",6125,82675,216,410,9,1166,0,4268,3.5,6.7,0.1,19,0,69.7,96.5,1520,735,785,48.36,51.64,147,588,240,545,387,1133,20,30.6,25.5,"75% or more P.O.C.","$80000 - $108000"
"06001440301","Census Tract 4403.01, Alameda County, California",7596,100776,1616,418,12,2642,278,2305,21.3,5.5,0.2,34.8,3.7,30.3,78.7,2244,1500,744,66.84,33.16,213,1287,289,455,502,1742,14.2,38.8,22.4,"75% or more P.O.C.","$80000 - $108000"
"06001440304","Census Tract 4403.04, Alameda County, California",5035,95515,308,464,0,3246,200,654,6.1,9.2,0,64.5,4,13,93.9,1307,892,415,68.25,31.75,189,703,132,283,321,986,21.2,31.8,24.6,"75% or more P.O.C.","$80000 - $108000"
"06001440305","Census Tract 4403.05, Alameda County, California",4190,127578,789,99,23,2259,146,693,18.8,2.4,0.5,53.9,3.5,16.5,81.2,1061,909,152,85.67,14.33,199,710,55,97,254,807,21.9,36.2,23.9,"75% or more P.O.C.","$108000 - $141000"
"06001440306","Census Tract 4403.06, Alameda County, California",4322,104211,537,177,0,2982,43,334,12.4,4.1,0,69,1,7.7,87.6,1026,677,349,65.98,34.02,167,510,190,159,357,669,24.7,54.4,34.8,"75% or more P.O.C.","$80000 - $108000"
"06001440307","Census Tract 4403.07, Alameda County, California",4748,77979,905,224,10,2525,28,896,19.1,4.7,0.2,53.2,0.6,18.9,80.9,1690,1168,522,69.11,30.89,50,1118,55,467,105,1585,4.3,10.5,6.2,"75% or more P.O.C.","Less than $80000"
"06001440308","Census Tract 4403.08, Alameda County, California",6171,115000,949,199,3,3031,9,1654,15.4,3.2,0,49.1,0.1,26.8,84.6,2006,1014,992,50.55,49.45,114,900,57,935,171,1835,11.2,5.7,8.5,"75% or more P.O.C.","$108000 - $141000"
"06001440331","Census Tract 4403.31, Alameda County, California",3276,118750,378,55,5,1737,98,820,11.5,1.7,0.2,53,3,25,88.5,899,468,431,52.06,47.94,84,384,72,359,156,743,17.9,16.7,17.4,"75% or more P.O.C.","$108000 - $141000"
"06001440332","Census Tract 4403.32, Alameda County, California",3505,174079,309,64,17,2633,16,287,8.8,1.8,0.5,75.1,0.5,8.2,91.2,918,814,104,88.67,11.33,152,662,37,67,189,729,18.7,35.6,20.6,"75% or more P.O.C.","$141000 or more"
"06001440333","Census Tract 4403.33, Alameda County, California",2982,127250,472,66,3,2128,5,133,15.8,2.2,0.1,71.4,0.2,4.5,84.2,843,712,131,84.46,15.54,144,568,51,80,195,648,20.2,38.9,23.1,"75% or more P.O.C.","$108000 - $141000"
"06001440334","Census Tract 4403.34, Alameda County, California",4414,121480,640,422,7,2505,27,617,14.5,9.6,0.2,56.8,0.6,14,85.5,1114,886,228,79.53,20.47,218,668,73,155,291,823,24.6,32,26.1,"75% or more P.O.C.","$108000 - $141000"
"06001440335","Census Tract 4403.35, Alameda County, California",7051,169313,1342,243,28,4506,86,124,19,3.4,0.4,63.9,1.2,1.8,81,2365,1339,1026,56.62,43.38,229,1110,84,942,313,2052,17.1,8.2,13.2,"75% or more P.O.C.","$141000 or more"
"06001440336","Census Tract 4403.36, Alameda County, California",4437,102128,803,387,28,2246,7,816,18.1,8.7,0.6,50.6,0.2,18.4,81.9,1434,821,613,57.25,42.75,137,684,49,564,186,1248,16.7,8,13,"75% or more P.O.C.","$80000 - $108000"
"06001441100","Census Tract 4411, Alameda County, California",4625,96920,2065,43,24,1255,8,926,44.6,0.9,0.5,27.1,0.2,20,55.4,1675,1266,409,75.58,24.42,213,1053,12,397,225,1450,16.8,2.9,13.4,"50% - 75% P.O.C.","$80000 - $108000"
"06001441200","Census Tract 4412, Alameda County, California",7277,106923,2568,340,22,2540,0,1352,35.3,4.7,0.3,34.9,0,18.6,64.7,2518,1379,1139,54.77,45.23,94,1285,64,1075,158,2360,6.8,5.6,6.3,"50% - 75% P.O.C.","$80000 - $108000"
"06001441301","Census Tract 4413.01, Alameda County, California",3301,136563,604,215,27,2126,12,197,18.3,6.5,0.8,64.4,0.4,6,81.7,1158,556,602,48.01,51.99,43,513,13,589,56,1102,7.7,2.2,4.8,"75% or more P.O.C.","$108000 - $141000"
"06001441302","Census Tract 4413.02, Alameda County, California",5937,143897,1588,160,12,3104,52,780,26.7,2.7,0.2,52.3,0.9,13.1,73.3,1894,1232,662,65.05,34.95,134,1098,108,554,242,1652,10.9,16.3,12.8,"50% - 75% P.O.C.","$141000 or more"
"06001441401","Census Tract 4414.01, Alameda County, California",8082,134101,1662,93,25,4911,157,805,20.6,1.2,0.3,60.8,1.9,10,79.4,2385,1351,1034,56.65,43.35,186,1165,122,912,308,2077,13.8,11.8,12.9,"75% or more P.O.C.","$108000 - $141000"
"06001441402","Census Tract 4414.02, Alameda County, California",5407,151550,910,130,15,3648,0,499,16.8,2.4,0.3,67.5,0,9.2,83.2,1727,1222,505,70.76,29.24,156,1066,33,472,189,1538,12.8,6.5,10.9,"75% or more P.O.C.","$141000 or more"
"06001441501","Census Tract 4415.01, Alameda County, California",6546,163583,830,156,19,4528,149,530,12.7,2.4,0.3,69.2,2.3,8.1,87.3,1825,1701,124,93.21,6.79,296,1405,59,65,355,1470,17.4,47.6,19.5,"75% or more P.O.C.","$141000 or more"
"06001441503","Census Tract 4415.03, Alameda County, California",8013,174891,703,158,69,6617,30,278,8.8,2,0.9,82.6,0.4,3.5,91.2,2394,1843,551,76.98,23.02,275,1568,25,526,300,2094,14.9,4.5,12.5,"75% or more P.O.C.","$141000 or more"
"06001441521","Census Tract 4415.21, Alameda County, California",6175,163679,1000,98,0,4324,73,442,16.2,1.6,0,70,1.2,7.2,83.8,1821,1371,450,75.29,24.71,140,1231,109,341,249,1572,10.2,24.2,13.7,"75% or more P.O.C.","$141000 or more"
"06001441522","Census Tract 4415.22, Alameda County, California",5233,129909,697,349,13,3394,27,641,13.3,6.7,0.2,64.9,0.5,12.2,86.7,1491,1265,226,84.84,15.16,170,1095,29,197,199,1292,13.4,12.8,13.3,"75% or more P.O.C.","$108000 - $141000"
"06001441523","Census Tract 4415.23, Alameda County, California",4418,138125,518,104,0,3327,95,284,11.7,2.4,0,75.3,2.2,6.4,88.3,1445,612,833,42.35,57.65,17,595,99,734,116,1329,2.8,11.9,8,"75% or more P.O.C.","$108000 - $141000"
"06001441524","Census Tract 4415.24, Alameda County, California",4215,160281,333,96,0,3605,0,107,7.9,2.3,0,85.5,0,2.5,92.1,1333,815,518,61.14,38.86,49,766,56,462,105,1228,6,10.8,7.9,"75% or more P.O.C.","$141000 or more"
"06001441601","Census Tract 4416.01, Alameda County, California",4982,130625,1372,450,16,1953,208,838,27.5,9,0.3,39.2,4.2,16.8,72.5,1468,1210,258,82.43,17.57,112,1098,56,202,168,1300,9.3,21.7,11.4,"50% - 75% P.O.C.","$108000 - $141000"
"06001441602","Census Tract 4416.02, Alameda County, California",8113,105766,1767,144,0,4237,410,1437,21.8,1.8,0,52.2,5.1,17.7,78.2,2412,1292,1120,53.57,46.43,138,1154,286,834,424,1988,10.7,25.5,17.6,"75% or more P.O.C.","$80000 - $108000"
"06001441700","Census Tract 4417, Alameda County, California",8527,112617,2148,353,26,3982,0,1731,25.2,4.1,0.3,46.7,0,20.3,74.8,2955,1490,1465,50.42,49.58,267,1223,168,1297,435,2520,17.9,11.5,14.7,"50% - 75% P.O.C.","$108000 - $141000"
"06001441800","Census Tract 4418, Alameda County, California",7543,125521,2600,141,18,3765,0,881,34.5,1.9,0.2,49.9,0,11.7,65.5,2380,1337,1043,56.18,43.82,183,1154,173,870,356,2024,13.7,16.6,15,"50% - 75% P.O.C.","$108000 - $141000"
"06001441921","Census Tract 4419.21, Alameda County, California",3909,150694,639,262,74,1623,0,1006,16.3,6.7,1.9,41.5,0,25.7,83.7,1263,461,802,36.5,63.5,89,372,44,758,133,1130,19.3,5.5,10.5,"75% or more P.O.C.","$141000 or more"
"06001441923","Census Tract 4419.23, Alameda County, California",6250,104526,924,179,31,4209,0,583,14.8,2.9,0.5,67.3,0,9.3,85.2,2292,133,2159,5.8,94.2,0,133,116,2043,116,2176,0,5.4,5.1,"75% or more P.O.C.","$80000 - $108000"
"06001441924","Census Tract 4419.24, Alameda County, California",7481,138851,1348,219,32,4648,0,884,18,2.9,0.4,62.1,0,11.8,82,2658,1621,1037,60.99,39.01,114,1507,56,981,170,2488,7,5.4,6.4,"75% or more P.O.C.","$108000 - $141000"
"06001441925","Census Tract 4419.25, Alameda County, California",7291,127409,1075,441,12,4984,0,549,14.7,6,0.2,68.4,0,7.5,85.3,3069,513,2556,16.72,83.28,0,513,63,2493,63,3006,0,2.5,2.1,"75% or more P.O.C.","$108000 - $141000"
"06001441926","Census Tract 4419.26, Alameda County, California",4595,99858,399,176,24,2254,23,1514,8.7,3.8,0.5,49.1,0.5,32.9,91.3,1511,336,1175,22.24,77.76,52,284,124,1051,176,1335,15.5,10.6,11.6,"75% or more P.O.C.","$80000 - $108000"
"06001441927","Census Tract 4419.27, Alameda County, California",4492,106707,613,146,19,2948,62,436,13.6,3.3,0.4,65.6,1.4,9.7,86.4,1788,451,1337,25.22,74.78,15,436,49,1288,64,1724,3.3,3.7,3.6,"75% or more P.O.C.","$80000 - $108000"
"06001442000","Census Tract 4420, Alameda County, California",3419,178466,521,3,18,2515,16,270,15.2,0.1,0.5,73.6,0.5,7.9,84.8,1021,935,86,91.58,8.42,101,834,17,69,118,903,10.8,19.8,11.6,"75% or more P.O.C.","$141000 or more"
"06001442100","Census Tract 4421, Alameda County, California",5462,192344,731,78,29,4399,30,54,13.4,1.4,0.5,80.5,0.5,1,86.6,1630,1448,182,88.83,11.17,192,1256,0,182,192,1438,13.3,0,11.8,"75% or more P.O.C.","$141000 or more"
"06001442200","Census Tract 4422, Alameda County, California",7473,181845,1438,106,25,5257,69,448,19.2,1.4,0.3,70.3,0.9,6,80.8,2267,1975,292,87.12,12.88,192,1783,34,258,226,2041,9.7,11.6,10,"75% or more P.O.C.","$141000 or more"
"06001442301","Census Tract 4423.01, Alameda County, California",5496,110761,969,214,38,3000,29,1010,17.6,3.9,0.7,54.6,0.5,18.4,82.4,1648,793,855,48.12,51.88,119,674,107,748,226,1422,15,12.5,13.7,"75% or more P.O.C.","$108000 - $141000"
"06001442302","Census Tract 4423.02, Alameda County, California",6366,75789,1096,319,23,3826,13,725,17.2,5,0.4,60.1,0.2,11.4,82.8,2368,669,1699,28.25,71.75,44,625,125,1574,169,2199,6.6,7.4,7.1,"75% or more P.O.C.","Less than $80000"
"06001442400","Census Tract 4424, Alameda County, California",6822,129583,1408,279,14,3340,0,1686,20.6,4.1,0.2,49,0,24.7,79.4,2018,1256,762,62.24,37.76,153,1103,214,548,367,1651,12.2,28.1,18.2,"75% or more P.O.C.","$108000 - $141000"
"06001442500","Census Tract 4425, Alameda County, California",7374,95729,1252,250,42,3521,130,1725,17,3.4,0.6,47.7,1.8,23.4,83,2297,1303,994,56.73,43.27,137,1166,114,880,251,2046,10.5,11.5,10.9,"75% or more P.O.C.","$80000 - $108000"
"06001442601","Census Tract 4426.01, Alameda County, California",4160,152778,1460,16,0,1671,19,857,35.1,0.4,0,40.2,0.5,20.6,64.9,1316,907,409,68.92,31.08,96,811,86,323,182,1134,10.6,21,13.8,"50% - 75% P.O.C.","$141000 or more"
"06001442602","Census Tract 4426.02, Alameda County, California",5059,111518,1705,183,4,1564,0,1411,33.7,3.6,0.1,30.9,0,27.9,66.3,1641,966,675,58.87,41.13,96,870,155,520,251,1390,9.9,23,15.3,"50% - 75% P.O.C.","$108000 - $141000"
"06001442700","Census Tract 4427, Alameda County, California",3048,146480,1124,154,11,1200,0,468,36.9,5.1,0.4,39.4,0,15.4,63.1,1052,758,294,72.05,27.95,65,693,34,260,99,953,8.6,11.6,9.4,"50% - 75% P.O.C.","$141000 or more"
"06001442800","Census Tract 4428, Alameda County, California",2952,122609,911,43,4,1373,0,493,30.9,1.5,0.1,46.5,0,16.7,69.1,940,798,142,84.89,15.11,131,667,38,104,169,771,16.4,26.8,18,"50% - 75% P.O.C.","$108000 - $141000"
"06001442900","Census Tract 4429, Alameda County, California",7761,135966,2056,295,106,3615,208,1322,26.5,3.8,1.4,46.6,2.7,17,73.5,2287,1676,611,73.28,26.72,328,1348,77,534,405,1882,19.6,12.6,17.7,"50% - 75% P.O.C.","$108000 - $141000"
"06001443001","Census Tract 4430.01, Alameda County, California",2891,116613,659,142,10,881,122,1024,22.8,4.9,0.3,30.5,4.2,35.4,77.2,836,590,246,70.57,29.43,23,567,70,176,93,743,3.9,28.5,11.1,"75% or more P.O.C.","$108000 - $141000"
"06001443002","Census Tract 4430.02, Alameda County, California",6930,107930,1198,207,12,4032,9,1212,17.3,3,0.2,58.2,0.1,17.5,82.7,2014,1360,654,67.53,32.47,206,1154,194,460,400,1614,15.1,29.7,19.9,"75% or more P.O.C.","$80000 - $108000"
"06001443102","Census Tract 4431.02, Alameda County, California",5065,191971,730,29,0,3871,25,283,14.4,0.6,0,76.4,0.5,5.6,85.6,1511,1363,148,90.21,9.79,134,1229,18,130,152,1359,9.8,12.2,10.1,"75% or more P.O.C.","$141000 or more"
"06001443103","Census Tract 4431.03, Alameda County, California",4107,198158,453,8,29,3357,0,137,11,0.2,0.7,81.7,0,3.3,89,1248,1094,154,87.66,12.34,65,1029,28,126,93,1155,5.9,18.2,7.5,"75% or more P.O.C.","$141000 or more"
"06001443104","Census Tract 4431.04, Alameda County, California",5620,163884,1010,19,0,4325,37,65,18,0.3,0,77,0.7,1.2,82,1789,1191,598,66.57,33.43,68,1123,21,577,89,1700,5.7,3.5,5,"75% or more P.O.C.","$141000 or more"
"06001443105","Census Tract 4431.05, Alameda County, California",4785,183008,667,74,0,3760,38,117,13.9,1.5,0,78.6,0.8,2.4,86.1,1539,1411,128,91.68,8.32,163,1248,7,121,170,1369,11.6,5.5,11,"75% or more P.O.C.","$141000 or more"
"06001443200","Census Tract 4432, Alameda County, California",4053,220568,730,0,14,3033,47,30,18,0,0.3,74.8,1.2,0.7,82,1225,1198,27,97.8,2.2,166,1032,0,27,166,1059,13.9,0,13.6,"75% or more P.O.C.","$141000 or more"
"06001443301","Census Tract 4433.01, Alameda County, California",4355,168750,1109,63,0,2596,12,382,25.5,1.4,0,59.6,0.3,8.8,74.5,1286,1087,199,84.53,15.47,123,964,28,171,151,1135,11.3,14.1,11.7,"50% - 75% P.O.C.","$141000 or more"
"06001443321","Census Tract 4433.21, Alameda County, California",3368,130875,170,128,0,2677,14,310,5,3.8,0,79.5,0.4,9.2,95,1125,471,654,41.87,58.13,37,434,10,644,47,1078,7.9,1.5,4.2,"75% or more P.O.C.","$108000 - $141000"
"06001443322","Census Tract 4433.22, Alameda County, California",3308,178200,634,54,22,2317,22,150,19.2,1.6,0.7,70,0.7,4.5,80.8,992,907,85,91.43,8.57,119,788,11,74,130,862,13.1,12.9,13.1,"75% or more P.O.C.","$141000 or more"
"06001444100","Census Tract 4441, Alameda County, California",7556,116812,3005,83,9,2059,23,2178,39.8,1.1,0.1,27.2,0.3,28.8,60.2,2573,2162,411,84.03,15.97,274,1888,43,368,317,2256,12.7,10.5,12.3,"50% - 75% P.O.C.","$108000 - $141000"
"06001444200","Census Tract 4442, Alameda County, California",7112,126028,1376,386,49,2494,74,2371,19.3,5.4,0.7,35.1,1,33.3,80.7,1887,1484,403,78.64,21.36,326,1158,149,254,475,1412,22,37,25.2,"75% or more P.O.C.","$108000 - $141000"
"06001444301","Census Tract 4443.01, Alameda County, California",3973,121156,1307,185,0,1066,0,1289,32.9,4.7,0,26.8,0,32.4,67.1,1189,862,327,72.5,27.5,101,761,144,183,245,944,11.7,44,20.6,"50% - 75% P.O.C.","$108000 - $141000"
"06001444302","Census Tract 4443.02, Alameda County, California",5185,105188,736,236,27,1898,90,2061,14.2,4.6,0.5,36.6,1.7,39.7,85.8,1500,762,738,50.8,49.2,146,616,220,518,366,1134,19.2,29.8,24.4,"75% or more P.O.C.","$80000 - $108000"
"06001444400","Census Tract 4444, Alameda County, California",5477,93094,784,270,24,1121,53,2925,14.3,4.9,0.4,20.5,1,53.4,85.7,1519,848,671,55.83,44.17,138,710,188,483,326,1193,16.3,28,21.5,"75% or more P.O.C.","$80000 - $108000"
"06001444500","Census Tract 4445, Alameda County, California",7518,109441,1387,307,11,1918,79,3577,18.4,4.1,0.1,25.5,1.1,47.6,81.6,2025,879,1146,43.41,56.59,276,603,257,889,533,1492,31.4,22.4,26.3,"75% or more P.O.C.","$108000 - $141000"
"06001444601","Census Tract 4446.01, Alameda County, California",5787,139119,1845,79,5,2184,32,1466,31.9,1.4,0.1,37.7,0.6,25.3,68.1,1779,1543,236,86.73,13.27,165,1378,83,153,248,1531,10.7,35.2,13.9,"50% - 75% P.O.C.","$108000 - $141000"
"06001444602","Census Tract 4446.02, Alameda County, California",4563,128229,728,272,5,2846,65,525,16,6,0.1,62.4,1.4,11.5,84,1575,1129,446,71.68,28.32,78,1051,33,413,111,1464,6.9,7.4,7,"75% or more P.O.C.","$108000 - $141000"
"06001450101","Census Tract 4501.01, Alameda County, California",5750,143611,1837,255,22,2715,10,464,31.9,4.4,0.4,47.2,0.2,8.1,68.1,2168,650,1518,29.98,70.02,49,601,122,1396,171,1997,7.5,8,7.9,"50% - 75% P.O.C.","$141000 or more"
"06001450102","Census Tract 4501.02, Alameda County, California",5664,162794,1402,360,73,2359,10,998,24.8,6.4,1.3,41.6,0.2,17.6,75.2,1334,831,503,62.29,37.71,104,727,81,422,185,1149,12.5,16.1,13.9,"75% or more P.O.C.","$141000 or more"
"06001450200","Census Tract 4502, Alameda County, California",5244,124338,2197,164,0,2014,24,544,41.9,3.1,0,38.4,0.5,10.4,58.1,2155,832,1323,38.61,61.39,0,832,76,1247,76,2079,0,5.7,3.5,"50% - 75% P.O.C.","$108000 - $141000"
"06001450300","Census Tract 4503, Alameda County, California",5212,115729,2603,163,6,1219,0,1076,49.9,3.1,0.1,23.4,0,20.6,50.1,1811,1146,665,63.28,36.72,84,1062,63,602,147,1664,7.3,9.5,8.1,"50% - 75% P.O.C.","$108000 - $141000"
"06001450400","Census Tract 4504, Alameda County, California",7286,117448,3522,243,0,1941,36,1013,48.3,3.3,0,26.6,0.5,13.9,51.7,2461,1684,777,68.43,31.57,192,1492,114,663,306,2155,11.4,14.7,12.4,"50% - 75% P.O.C.","$108000 - $141000"
"06001450501","Census Tract 4505.01, Alameda County, California",3156,138929,1879,0,20,807,0,281,59.5,0,0.6,25.6,0,8.9,40.5,1200,914,286,76.17,23.83,60,854,23,263,83,1117,6.6,8,6.9,"25% - 50% P.O.C.","$108000 - $141000"
"06001450502","Census Tract 4505.02, Alameda County, California",5490,176733,2527,81,52,2144,26,485,46,1.5,0.9,39.1,0.5,8.8,54,1823,1608,215,88.21,11.79,214,1394,18,197,232,1591,13.3,8.4,12.7,"50% - 75% P.O.C.","$141000 or more"
"06001450601","Census Tract 4506.01, Alameda County, California",3641,154828,1843,61,19,1314,0,223,50.6,1.7,0.5,36.1,0,6.1,49.4,1370,1176,194,85.84,14.16,89,1087,11,183,100,1270,7.6,5.7,7.3,"25% - 50% P.O.C.","$141000 or more"
"06001450602","Census Tract 4506.02, Alameda County, California",10265,160595,5229,274,10,3476,74,846,50.9,2.7,0.1,33.9,0.7,8.2,49.1,3538,2713,825,76.68,23.32,328,2385,38,787,366,3172,12.1,4.6,10.3,"25% - 50% P.O.C.","$141000 or more"
"06001450603","Census Tract 4506.03, Alameda County, California",5155,157388,2848,71,19,1513,0,607,55.2,1.4,0.4,29.4,0,11.8,44.8,1671,1317,354,78.82,21.18,82,1235,47,307,129,1542,6.2,13.3,7.7,"25% - 50% P.O.C.","$141000 or more"
"06001450604","Census Tract 4506.04, Alameda County, California",5505,162727,3204,29,0,1523,0,521,58.2,0.5,0,27.7,0,9.5,41.8,1848,1401,447,75.81,24.19,80,1321,17,430,97,1751,5.7,3.8,5.2,"25% - 50% P.O.C.","$141000 or more"
"06001450605","Census Tract 4506.05, Alameda County, California",3893,159412,2413,36,2,924,75,358,62,0.9,0.1,23.7,1.9,9.2,38,1508,1215,293,80.57,19.43,125,1090,0,293,125,1383,10.3,0,8.3,"25% - 50% P.O.C.","$141000 or more"
"06001450606","Census Tract 4506.06, Alameda County, California",6254,190521,3764,40,41,1760,0,385,60.2,0.6,0.7,28.1,0,6.2,39.8,2103,1763,340,83.83,16.17,131,1632,31,309,162,1941,7.4,9.1,7.7,"25% - 50% P.O.C.","$141000 or more"
"06001450607","Census Tract 4506.07, Alameda County, California",5717,104139,3059,127,0,1586,0,688,53.5,2.2,0,27.7,0,12,46.5,2445,920,1525,37.63,62.37,48,872,4,1521,52,2393,5.2,0.3,2.1,"25% - 50% P.O.C.","$80000 - $108000"
"06001450701","Census Tract 4507.01, Alameda County, California",8596,232250,4799,178,10,2769,0,531,55.8,2.1,0.1,32.2,0,6.2,44.2,2785,2485,300,89.23,10.77,369,2116,5,295,374,2411,14.8,1.7,13.4,"25% - 50% P.O.C.","$141000 or more"
"06001450741","Census Tract 4507.41, Alameda County, California",5852,133981,3111,159,27,1128,0,1157,53.2,2.7,0.5,19.3,0,19.8,46.8,2050,1169,881,57.02,42.98,104,1065,98,783,202,1848,8.9,11.1,9.9,"25% - 50% P.O.C.","$108000 - $141000"
"06001450742","Census Tract 4507.42, Alameda County, California",5436,160513,3163,32,0,1393,0,548,58.2,0.6,0,25.6,0,10.1,41.8,1974,1637,337,82.93,17.07,108,1529,9,328,117,1857,6.6,2.7,5.9,"25% - 50% P.O.C.","$141000 or more"
"06001450743","Census Tract 4507.43, Alameda County, California",6684,128737,1320,357,44,4066,127,387,19.7,5.3,0.7,60.8,1.9,5.8,80.3,2492,836,1656,33.55,66.45,27,809,112,1544,139,2353,3.2,6.8,5.6,"75% or more P.O.C.","$108000 - $141000"
"06001450744","Census Tract 4507.44, Alameda County, California",6273,158529,3523,69,42,1896,72,453,56.2,1.1,0.7,30.2,1.1,7.2,43.8,2156,1473,683,68.32,31.68,163,1310,53,630,216,1940,11.1,7.8,10,"25% - 50% P.O.C.","$141000 or more"
"06001450745","Census Tract 4507.45, Alameda County, California",6712,190195,1966,26,19,3899,37,666,29.3,0.4,0.3,58.1,0.6,9.9,70.7,2321,1735,586,74.75,25.25,182,1553,22,564,204,2117,10.5,3.8,8.8,"50% - 75% P.O.C.","$141000 or more"
"06001450746","Census Tract 4507.46, Alameda County, California",3525,114612,2030,11,0,942,0,422,57.6,0.3,0,26.7,0,12,42.4,1423,1042,381,73.23,26.77,53,989,12,369,65,1358,5.1,3.1,4.6,"25% - 50% P.O.C.","$108000 - $141000"
"06001450750","Census Tract 4507.50, Alameda County, California",5630,122309,1376,415,0,3069,17,526,24.4,7.4,0,54.5,0.3,9.3,75.6,2288,939,1349,41.04,58.96,5,934,48,1301,53,2235,0.5,3.6,2.3,"75% or more P.O.C.","$108000 - $141000"
"06001450751","Census Tract 4507.51, Alameda County, California",11119,239094,1334,139,5,9015,26,342,12,1.3,0,81.1,0.2,3.1,88,3135,2987,148,95.28,4.72,414,2573,49,99,463,2672,13.9,33.1,14.8,"75% or more P.O.C.","$141000 or more"
"06001450752","Census Tract 4507.52, Alameda County, California",7343,228980,1520,340,6,4553,69,543,20.7,4.6,0.1,62,0.9,7.4,79.3,2091,1770,321,84.65,15.35,314,1456,37,284,351,1740,17.7,11.5,16.8,"75% or more P.O.C.","$141000 or more"
"06001451101","Census Tract 4511.01, Alameda County, California",8692,170000,5355,147,1,1465,138,1262,61.6,1.7,0,16.9,1.6,14.5,38.4,2630,2189,441,83.23,16.77,333,1856,110,331,443,2187,15.2,24.9,16.8,"25% - 50% P.O.C.","$141000 or more"
"06001451102","Census Tract 4511.02, Alameda County, California",4003,181458,3090,13,25,290,0,376,77.2,0.3,0.6,7.2,0,9.4,22.8,1359,1332,27,98.01,1.99,136,1196,24,3,160,1199,10.2,88.9,11.8,"Less than 25% P.O.C.","$141000 or more"
"06001451201","Census Tract 4512.01, Alameda County, California",7695,95292,4432,97,29,1151,0,1559,57.6,1.3,0.4,15,0,20.3,42.4,2831,2045,786,72.24,27.76,171,1874,117,669,288,2543,8.4,14.9,10.2,"25% - 50% P.O.C.","$80000 - $108000"
"06001451202","Census Tract 4512.02, Alameda County, California",5188,143051,3166,41,15,808,20,762,61,0.8,0.3,15.6,0.4,14.7,39,1825,1577,248,86.41,13.59,161,1416,48,200,209,1616,10.2,19.4,11.5,"25% - 50% P.O.C.","$141000 or more"
"06001451300","Census Tract 4513, Alameda County, California",6903,119896,4377,95,0,622,0,1355,63.4,1.4,0,9,0,19.6,36.6,2369,1871,498,78.98,21.02,195,1676,134,364,329,2040,10.4,26.9,13.9,"25% - 50% P.O.C.","$108000 - $141000"
"06001451401","Census Tract 4514.01, Alameda County, California",6191,106542,3519,337,0,820,0,1261,56.8,5.4,0,13.2,0,20.4,43.2,2442,1509,933,61.79,38.21,85,1424,69,864,154,2288,5.6,7.4,6.3,"25% - 50% P.O.C.","$80000 - $108000"
"06001451403","Census Tract 4514.03, Alameda County, California",2308,122019,1302,36,0,206,0,642,56.4,1.6,0,8.9,0,27.8,43.6,783,613,170,78.29,21.71,93,520,12,158,105,678,15.2,7.1,13.4,"25% - 50% P.O.C.","$108000 - $141000"
"06001451404","Census Tract 4514.04, Alameda County, California",7094,79589,2786,320,3,438,0,3373,39.3,4.5,0,6.2,0,47.5,60.7,2222,1011,1211,45.5,54.5,95,916,224,987,319,1903,9.4,18.5,14.4,"50% - 75% P.O.C.","Less than $80000"
"06001451501","Census Tract 4515.01, Alameda County, California",4693,133304,3165,42,5,389,51,763,67.4,0.9,0.1,8.3,1.1,16.3,32.6,1733,1081,652,62.38,37.62,128,953,33,619,161,1572,11.8,5.1,9.3,"25% - 50% P.O.C.","$108000 - $141000"
"06001451503","Census Tract 4515.03, Alameda County, California",6182,145714,3897,113,5,839,29,949,63,1.8,0.1,13.6,0.5,15.4,37,2244,1749,495,77.94,22.06,208,1541,28,467,236,2008,11.9,5.7,10.5,"25% - 50% P.O.C.","$141000 or more"
"06001451504","Census Tract 4515.04, Alameda County, California",1709,124079,932,17,0,409,0,326,54.5,1,0,23.9,0,19.1,45.5,626,474,152,75.72,24.28,42,432,25,127,67,559,8.9,16.4,10.7,"25% - 50% P.O.C.","$108000 - $141000"
"06001451505","Census Tract 4515.05, Alameda County, California",3418,164965,2581,33,10,263,0,477,75.5,1,0.3,7.7,0,14,24.5,1193,1076,117,90.19,9.81,63,1013,15,102,78,1115,5.9,12.8,6.5,"Less than 25% P.O.C.","$141000 or more"
"06001451506","Census Tract 4515.06, Alameda County, California",3385,104565,1487,200,0,243,37,1358,43.9,5.9,0,7.2,1.1,40.1,56.1,1104,530,574,48.01,51.99,14,516,81,493,95,1009,2.6,14.1,8.6,"50% - 75% P.O.C.","$80000 - $108000"
"06001451601","Census Tract 4516.01, Alameda County, California",5362,172542,4196,9,0,469,24,572,78.3,0.2,0,8.7,0.4,10.7,21.7,1983,1500,483,75.64,24.36,81,1419,26,457,107,1876,5.4,5.4,5.4,"Less than 25% P.O.C.","$141000 or more"
"06001451602","Census Tract 4516.02, Alameda County, California",6809,96638,4724,126,10,447,19,1118,69.4,1.9,0.1,6.6,0.3,16.4,30.6,2759,1574,1185,57.05,42.95,104,1470,87,1098,191,2568,6.6,7.3,6.9,"25% - 50% P.O.C.","$80000 - $108000"
"06001451701","Census Tract 4517.01, Alameda County, California",3112,127750,2230,34,5,172,28,456,71.7,1.1,0.2,5.5,0.9,14.7,28.3,1109,853,256,76.92,23.08,70,783,49,207,119,990,8.2,19.1,10.7,"25% - 50% P.O.C.","$108000 - $141000"
"06001451703","Census Tract 4517.03, Alameda County, California",4080,155727,2406,0,13,692,0,790,59,0,0.3,17,0,19.4,41,1393,1228,165,88.16,11.84,104,1124,27,138,131,1262,8.5,16.4,9.4,"25% - 50% P.O.C.","$141000 or more"
"06001451704","Census Tract 4517.04, Alameda County, California",4519,128963,3265,17,10,375,60,596,72.3,0.4,0.2,8.3,1.3,13.2,27.7,1659,1248,411,75.23,24.77,145,1103,37,374,182,1477,11.6,9,11,"25% - 50% P.O.C.","$108000 - $141000"
"06001981900","Census Tract 9819, Alameda County, California",58,171563,50,0,0,0,0,8,86.2,0,0,0,0,13.8,13.8,27,0,27,0,100,0,0,0,27,0,27,NA,0,0,"Less than 25% P.O.C.","$141000 or more"
"06001982000","Census Tract 9820, Alameda County, California",63,128750,10,23,2,20,0,8,15.9,36.5,3.2,31.7,0,12.7,84.1,32,32,0,100,0,0,32,0,0,0,32,0,NA,0,"75% or more P.O.C.","$108000 - $141000"
"06001983200","Census Tract 9832, Alameda County, California",583,165909,308,53,9,138,3,47,52.8,9.1,1.5,23.7,0.5,8.1,47.2,340,289,51,85,15,0,289,0,51,0,340,0,0,0,"25% - 50% P.O.C.","$141000 or more"
"06001990000","Census Tract 9900, Alameda County, California",0,NA,0,0,0,0,0,0,NA,NA,NA,NA,NA,NA,NA,0,0,0,NA,NA,0,0,0,0,0,0,NA,NA,NA,"N/A","N/A"
"06013301000","Census Tract 3010, Contra Costa County, California",5150,76786,3205,462,0,145,0,1147,62.2,9,0,2.8,0,22.3,37.8,1864,1513,351,81.17,18.83,182,1331,36,315,218,1646,12,10.3,11.7,"25% - 50% P.O.C.","Less than $80000"
"06013302005","Census Tract 3020.05, Contra Costa County, California",7290,64127,2972,1073,35,266,149,2426,40.8,14.7,0.5,3.6,2,33.3,59.2,2318,1287,1031,55.52,44.48,93,1194,283,748,376,1942,7.2,27.4,16.2,"50% - 75% P.O.C.","Less than $80000"
"06013302006","Census Tract 3020.06, Contra Costa County, California",3775,105729,1783,231,0,283,0,1324,47.2,6.1,0,7.5,0,35.1,52.8,1231,991,240,80.5,19.5,149,842,47,193,196,1035,15,19.6,15.9,"50% - 75% P.O.C.","$80000 - $108000"
"06013302007","Census Tract 3020.07, Contra Costa County, California",6652,73717,2618,530,68,430,140,2577,39.4,8,1,6.5,2.1,38.7,60.6,1995,1408,587,70.58,29.42,216,1192,269,318,485,1510,15.3,45.8,24.3,"50% - 75% P.O.C.","Less than $80000"
"06013302008","Census Tract 3020.08, Contra Costa County, California",8781,115000,3044,946,73,565,88,3558,34.7,10.8,0.8,6.4,1,40.5,65.3,2262,1775,487,78.47,21.53,658,1117,68,419,726,1536,37.1,14,32.1,"50% - 75% P.O.C.","$108000 - $141000"
"06013302009","Census Tract 3020.09, Contra Costa County, California",7279,103854,1585,1507,0,1672,0,2172,21.8,20.7,0,23,0,29.8,78.2,2126,1411,715,66.37,33.63,267,1144,316,399,583,1543,18.9,44.2,27.4,"75% or more P.O.C.","$80000 - $108000"
"06013302010","Census Tract 3020.10, Contra Costa County, California",11767,132926,5441,491,8,940,15,3791,46.2,4.2,0.1,8,0.1,32.2,53.8,3170,2832,338,89.34,10.66,644,2188,115,223,759,2411,22.7,34,23.9,"50% - 75% P.O.C.","$108000 - $141000"
"06013303102","Census Tract 3031.02, Contra Costa County, California",9625,121113,4344,936,0,1358,0,2557,45.1,9.7,0,14.1,0,26.6,54.9,2847,2136,711,75.03,24.97,351,1785,103,608,454,2393,16.4,14.5,15.9,"50% - 75% P.O.C.","$108000 - $141000"
"06013303103","Census Tract 3031.03, Contra Costa County, California",12652,93697,5948,831,204,995,29,4239,47,6.6,1.6,7.9,0.2,33.5,53,3907,2668,1239,68.29,31.71,337,2331,288,951,625,3282,12.6,23.2,16,"50% - 75% P.O.C.","$80000 - $108000"
"06013303201","Census Tract 3032.01, Contra Costa County, California",12171,117114,4565,2096,18,1919,681,2189,37.5,17.2,0.1,15.8,5.6,18,62.5,3193,2196,997,68.78,31.22,431,1765,301,696,732,2461,19.6,30.2,22.9,"50% - 75% P.O.C.","$108000 - $141000"
"06013303202","Census Tract 3032.02, Contra Costa County, California",7439,124034,4140,595,0,498,0,1487,55.7,8,0,6.7,0,20,44.3,2431,1932,499,79.47,20.53,276,1656,126,373,402,2029,14.3,25.3,16.5,"25% - 50% P.O.C.","$108000 - $141000"
"06013303203","Census Tract 3032.03, Contra Costa County, California",10070,129255,4904,910,110,1260,0,2350,48.7,9,1.1,12.5,0,23.3,51.3,2985,2413,572,80.84,19.16,423,1990,41,531,464,2521,17.5,7.2,15.5,"50% - 75% P.O.C.","$108000 - $141000"
"06013303204","Census Tract 3032.04, Contra Costa County, California",4751,69004,2450,316,0,210,13,1584,51.6,6.7,0,4.4,0.3,33.3,48.4,1693,1221,472,72.12,27.88,144,1077,150,322,294,1399,11.8,31.8,17.4,"25% - 50% P.O.C.","Less than $80000"
"06013303205","Census Tract 3032.05, Contra Costa County, California",8931,96381,5739,286,0,585,179,1439,64.3,3.2,0,6.6,2,16.1,35.7,3460,2970,490,85.84,14.16,263,2707,75,415,338,3122,8.9,15.3,9.8,"25% - 50% P.O.C.","$80000 - $108000"
"06013304001","Census Tract 3040.01, Contra Costa County, California",5272,147292,3235,528,0,675,0,595,61.4,10,0,12.8,0,11.3,38.6,1912,1596,316,83.47,16.53,120,1476,105,211,225,1687,7.5,33.2,11.8,"25% - 50% P.O.C.","$141000 or more"
"06013304002","Census Tract 3040.02, Contra Costa County, California",1463,71042,888,43,21,21,0,479,60.7,2.9,1.4,1.4,0,32.7,39.3,475,367,108,77.26,22.74,52,315,21,87,73,402,14.2,19.4,15.4,"25% - 50% P.O.C.","Less than $80000"
"06013304003","Census Tract 3040.03, Contra Costa County, California",3793,136912,2809,95,6,234,0,630,74.1,2.5,0.2,6.2,0,16.6,25.9,1510,1317,193,87.22,12.78,54,1263,21,172,75,1435,4.1,10.9,5,"25% - 50% P.O.C.","$108000 - $141000"
"06013304004","Census Tract 3040.04, Contra Costa County, California",4114,121688,3287,20,0,211,0,464,79.9,0.5,0,5.1,0,11.3,20.1,1677,1310,367,78.12,21.88,20,1290,9,358,29,1648,1.5,2.5,1.7,"Less than 25% P.O.C.","$108000 - $141000"
"06013304005","Census Tract 3040.05, Contra Costa County, California",8766,129932,5243,687,0,536,0,1912,59.8,7.8,0,6.1,0,21.8,40.2,2422,2038,384,84.15,15.85,450,1588,100,284,550,1872,22.1,26,22.7,"25% - 50% P.O.C.","$108000 - $141000"
"06013305000","Census Tract 3050, Contra Costa County, California",6561,39987,1678,1235,62,612,0,2823,25.6,18.8,0.9,9.3,0,43,74.4,2219,543,1676,24.47,75.53,84,459,264,1412,348,1871,15.5,15.8,15.7,"50% - 75% P.O.C.","Less than $80000"
"06013306002","Census Tract 3060.02, Contra Costa County, California",3837,92283,1340,235,10,282,0,1970,34.9,6.1,0.3,7.3,0,51.3,65.1,1040,803,237,77.21,22.79,56,747,156,81,212,828,7,65.8,20.4,"50% - 75% P.O.C.","$80000 - $108000"
"06013306003","Census Tract 3060.03, Contra Costa County, California",5193,68194,1741,440,64,265,0,2426,33.5,8.5,1.2,5.1,0,46.7,66.5,1639,872,767,53.2,46.8,194,678,155,612,349,1290,22.2,20.2,21.3,"50% - 75% P.O.C.","Less than $80000"
"06013306004","Census Tract 3060.04, Contra Costa County, California",3616,64167,1532,1079,0,40,0,791,42.4,29.8,0,1.1,0,21.9,57.6,1272,592,680,46.54,53.46,58,534,111,569,169,1103,9.8,16.3,13.3,"50% - 75% P.O.C.","Less than $80000"
"06013307101","Census Tract 3071.01, Contra Costa County, California",4516,64253,2120,152,18,239,0,1799,46.9,3.4,0.4,5.3,0,39.8,53.1,1463,1022,441,69.86,30.14,157,865,94,347,251,1212,15.4,21.3,17.2,"50% - 75% P.O.C.","Less than $80000"
"06013307102","Census Tract 3071.02, Contra Costa County, California",5330,52238,1218,705,0,274,35,2785,22.9,13.2,0,5.1,0.7,52.3,77.1,1747,846,901,48.43,51.57,136,710,149,752,285,1462,16.1,16.5,16.3,"75% or more P.O.C.","Less than $80000"
"06013307201","Census Tract 3072.01, Contra Costa County, California",3803,54702,1069,188,0,235,0,1958,28.1,4.9,0,6.2,0,51.5,71.9,1067,489,578,45.83,54.17,60,429,180,398,240,827,12.3,31.1,22.5,"50% - 75% P.O.C.","Less than $80000"
"06013307202","Census Tract 3072.02, Contra Costa County, California",4299,35721,575,1660,9,95,55,1510,13.4,38.6,0.2,2.2,1.3,35.1,86.6,1542,216,1326,14.01,85.99,16,200,200,1126,216,1326,7.4,15.1,14,"75% or more P.O.C.","Less than $80000"
"06013307204","Census Tract 3072.04, Contra Costa County, California",4386,79609,1247,633,10,462,0,1932,28.4,14.4,0.2,10.5,0,44,71.6,1312,989,323,75.38,24.62,174,815,85,238,259,1053,17.6,26.3,19.7,"50% - 75% P.O.C.","Less than $80000"
"06013307205","Census Tract 3072.05, Contra Costa County, California",7557,54750,1809,2599,11,788,33,1884,23.9,34.4,0.1,10.4,0.4,24.9,76.1,2593,863,1730,33.28,66.72,127,736,221,1509,348,2245,14.7,12.8,13.4,"75% or more P.O.C.","Less than $80000"
"06013308001","Census Tract 3080.01, Contra Costa County, California",7653,73185,3067,1283,40,288,13,2567,40.1,16.8,0.5,3.8,0.2,33.5,59.9,2467,1648,819,66.8,33.2,196,1452,124,695,320,2147,11.9,15.1,13,"50% - 75% P.O.C.","Less than $80000"
"06013308002","Census Tract 3080.02, Contra Costa County, California",4472,92132,1411,761,0,1057,0,1118,31.6,17,0,23.6,0,25,68.4,1407,1150,257,81.73,18.27,94,1056,84,173,178,1229,8.2,32.7,12.7,"50% - 75% P.O.C.","$80000 - $108000"
"06013309000","Census Tract 3090, Contra Costa County, California",3546,61058,910,888,0,379,0,1177,25.7,25,0,10.7,0,33.2,74.3,1252,677,575,54.07,45.93,163,514,81,494,244,1008,24.1,14.1,19.5,"50% - 75% P.O.C.","Less than $80000"
"06013310000","Census Tract 3100, Contra Costa County, California",6257,60326,720,1093,0,304,22,3677,11.5,17.5,0,4.9,0.4,58.8,88.5,1714,735,979,42.88,57.12,188,547,314,665,502,1212,25.6,32.1,29.3,"75% or more P.O.C.","Less than $80000"
"06013311000","Census Tract 3110, Contra Costa County, California",5329,61378,702,847,37,703,0,2790,13.2,15.9,0.7,13.2,0,52.4,86.8,1511,824,687,54.53,45.47,175,649,111,576,286,1225,21.2,16.2,18.9,"75% or more P.O.C.","Less than $80000"
"06013312000","Census Tract 3120, Contra Costa County, California",2243,32474,186,754,10,166,0,1033,8.3,33.6,0.4,7.4,0,46.1,91.7,735,232,503,31.56,68.44,58,174,74,429,132,603,25,14.7,18,"75% or more P.O.C.","Less than $80000"
"06013313101","Census Tract 3131.01, Contra Costa County, California",7178,52992,1737,884,11,844,0,3226,24.2,12.3,0.2,11.8,0,44.9,75.8,2664,1124,1540,42.19,57.81,140,984,208,1332,348,2316,12.5,13.5,13.1,"75% or more P.O.C.","Less than $80000"
"06013313102","Census Tract 3131.02, Contra Costa County, California",4595,75603,694,1330,0,629,85,1658,15.1,28.9,0,13.7,1.8,36.1,84.9,1534,633,901,41.26,58.74,82,551,122,779,204,1330,13,13.5,13.3,"75% or more P.O.C.","Less than $80000"
"06013313103","Census Tract 3131.03, Contra Costa County, California",8866,96694,2773,1296,0,1475,84,2701,31.3,14.6,0,16.6,0.9,30.5,68.7,2650,1570,1080,59.25,40.75,348,1222,251,829,599,2051,22.2,23.2,22.6,"50% - 75% P.O.C.","$80000 - $108000"
"06013313203","Census Tract 3132.03, Contra Costa County, California",3456,91438,825,185,5,361,33,1676,23.9,5.4,0.1,10.4,1,48.5,76.1,953,739,214,77.54,22.46,153,586,85,129,238,715,20.7,39.7,25,"75% or more P.O.C.","$80000 - $108000"
"06013313204","Census Tract 3132.04, Contra Costa County, California",5538,78482,1438,757,1,624,0,2361,26,13.7,0,11.3,0,42.6,74,1755,889,866,50.66,49.34,116,773,182,684,298,1457,13,21,17,"50% - 75% P.O.C.","Less than $80000"
"06013313205","Census Tract 3132.05, Contra Costa County, California",1696,95795,331,220,0,309,0,723,19.5,13,0,18.2,0,42.6,80.5,500,366,134,73.2,26.8,49,317,41,93,90,410,13.4,30.6,18,"75% or more P.O.C.","$80000 - $108000"
"06013313206","Census Tract 3132.06, Contra Costa County, California",6377,63451,724,833,0,587,120,3934,11.4,13.1,0,9.2,1.9,61.7,88.6,1562,795,767,50.9,49.1,210,585,336,431,546,1016,26.4,43.8,35,"75% or more P.O.C.","Less than $80000"
"06013314102","Census Tract 3141.02, Contra Costa County, California",6561,64332,1129,655,20,842,51,3510,17.2,10,0.3,12.8,0.8,53.5,82.8,1875,1296,579,69.12,30.88,180,1116,224,355,404,1471,13.9,38.7,21.5,"75% or more P.O.C.","Less than $80000"
"06013314103","Census Tract 3141.03, Contra Costa County, California",5629,57394,598,908,6,527,0,3417,10.6,16.1,0.1,9.4,0,60.7,89.4,1545,584,961,37.8,62.2,121,463,285,676,406,1139,20.7,29.7,26.3,"75% or more P.O.C.","Less than $80000"
"06013314104","Census Tract 3141.04, Contra Costa County, California",9278,65269,911,1003,71,854,0,6062,9.8,10.8,0.8,9.2,0,65.3,90.2,2522,1287,1235,51.03,48.97,271,1016,254,981,525,1997,21.1,20.6,20.8,"75% or more P.O.C.","Less than $80000"
"06013314200","Census Tract 3142, Contra Costa County, California",7748,57500,836,49,9,427,110,6179,10.8,0.6,0.1,5.5,1.4,79.7,89.2,1824,1151,673,63.1,36.9,342,809,428,245,770,1054,29.7,63.6,42.2,"75% or more P.O.C.","Less than $80000"
"06013315000","Census Tract 3150, Contra Costa County, California",3862,79658,1463,509,122,575,79,988,37.9,13.2,3.2,14.9,2,25.6,62.1,1291,1015,276,78.62,21.38,73,942,77,199,150,1141,7.2,27.9,11.6,"50% - 75% P.O.C.","Less than $80000"
"06013316000","Census Tract 3160, Contra Costa County, California",1055,32604,545,182,0,9,0,256,51.7,17.3,0,0.9,0,24.3,48.3,472,79,393,16.74,83.26,0,79,15,378,15,457,0,3.8,3.2,"25% - 50% P.O.C.","Less than $80000"
"06013317000","Census Tract 3170, Contra Costa County, California",2040,59808,1625,50,6,73,0,143,79.7,2.5,0.3,3.6,0,7,20.3,1012,376,636,37.15,62.85,36,340,0,636,36,976,9.6,0,3.6,"Less than 25% P.O.C.","Less than $80000"
"06013318000","Census Tract 3180, Contra Costa County, California",3734,84022,2294,109,0,402,0,765,61.4,2.9,0,10.8,0,20.5,38.6,1572,729,843,46.37,53.63,28,701,8,835,36,1536,3.8,0.9,2.3,"25% - 50% P.O.C.","$80000 - $108000"
"06013319000","Census Tract 3190, Contra Costa County, California",8558,93942,5919,184,0,203,0,1957,69.2,2.2,0,2.4,0,22.9,30.8,3122,1815,1307,58.14,41.86,95,1720,121,1186,216,2906,5.2,9.3,6.9,"25% - 50% P.O.C.","$80000 - $108000"
"06013320001","Census Tract 3200.01, Contra Costa County, California",3671,98365,1677,9,0,305,101,1421,45.7,0.2,0,8.3,2.8,38.7,54.3,1183,859,324,72.61,27.39,52,807,124,200,176,1007,6.1,38.3,14.9,"50% - 75% P.O.C.","$80000 - $108000"
"06013320003","Census Tract 3200.03, Contra Costa County, California",2721,131125,2150,65,0,383,0,76,79,2.4,0,14.1,0,2.8,21,1016,868,148,85.43,14.57,56,812,57,91,113,903,6.5,38.5,11.1,"Less than 25% P.O.C.","$108000 - $141000"
"06013320004","Census Tract 3200.04, Contra Costa County, California",6587,113297,3824,296,0,829,0,1204,58.1,4.5,0,12.6,0,18.3,41.9,2554,1844,710,72.2,27.8,115,1729,74,636,189,2365,6.2,10.4,7.4,"25% - 50% P.O.C.","$108000 - $141000"
"06013321101","Census Tract 3211.01, Contra Costa County, California",6654,122554,4004,163,29,644,0,1344,60.2,2.4,0.4,9.7,0,20.2,39.8,2334,1717,617,73.56,26.44,136,1581,60,557,196,2138,7.9,9.7,8.4,"25% - 50% P.O.C.","$108000 - $141000"
"06013321102","Census Tract 3211.02, Contra Costa County, California",6913,140240,4758,244,12,821,0,754,68.8,3.5,0.2,11.9,0,10.9,31.2,2668,2358,310,88.38,11.62,166,2192,0,310,166,2502,7,0,6.2,"25% - 50% P.O.C.","$108000 - $141000"
"06013321103","Census Tract 3211.03, Contra Costa County, California",4739,123869,3547,107,19,460,0,349,74.8,2.3,0.4,9.7,0,7.4,25.2,1815,1440,375,79.34,20.66,118,1322,10,365,128,1687,8.2,2.7,7.1,"25% - 50% P.O.C.","$108000 - $141000"
"06013321200","Census Tract 3212, Contra Costa County, California",5634,90273,2672,150,0,1644,24,888,47.4,2.7,0,29.2,0.4,15.8,52.6,2336,938,1398,40.15,59.85,39,899,54,1344,93,2243,4.2,3.9,4,"50% - 75% P.O.C.","$80000 - $108000"
"06013322000","Census Tract 3220, Contra Costa County, California",6250,131250,3749,55,23,550,113,1212,60,0.9,0.4,8.8,1.8,19.4,40,2520,2096,424,83.17,16.83,142,1954,51,373,193,2327,6.8,12,7.7,"25% - 50% P.O.C.","$108000 - $141000"
"06013323000","Census Tract 3230, Contra Costa County, California",4476,124583,3111,57,0,438,84,598,69.5,1.3,0,9.8,1.9,13.4,30.5,1732,1383,349,79.85,20.15,45,1338,9,340,54,1678,3.3,2.6,3.1,"25% - 50% P.O.C.","$108000 - $141000"
"06013324001","Census Tract 3240.01, Contra Costa County, California",5480,87917,3454,184,0,825,0,682,63,3.4,0,15.1,0,12.4,37,3135,766,2369,24.43,75.57,63,703,0,2369,63,3072,8.2,0,2,"25% - 50% P.O.C.","$80000 - $108000"
"06013324002","Census Tract 3240.02, Contra Costa County, California",5247,115909,2905,149,0,894,24,900,55.4,2.8,0,17,0.5,17.2,44.6,2324,782,1542,33.65,66.35,17,765,16,1526,33,2291,2.2,1,1.4,"25% - 50% P.O.C.","$108000 - $141000"
"06013325000","Census Tract 3250, Contra Costa County, California",6300,112440,4256,334,0,275,0,1077,67.6,5.3,0,4.4,0,17.1,32.4,2242,1617,625,72.12,27.88,117,1500,0,625,117,2125,7.2,0,5.2,"25% - 50% P.O.C.","$108000 - $141000"
"06013326000","Census Tract 3260, Contra Costa County, California",3810,145273,3056,72,0,306,20,210,80.2,1.9,0,8,0.5,5.5,19.8,1360,1195,165,87.87,12.13,42,1153,32,133,74,1286,3.5,19.4,5.4,"Less than 25% P.O.C.","$141000 or more"
"06013327000","Census Tract 3270, Contra Costa County, California",7430,67469,3148,61,44,801,31,2856,42.4,0.8,0.6,10.8,0.4,38.4,57.6,2855,2054,801,71.94,28.06,89,1965,105,696,194,2661,4.3,13.1,6.8,"50% - 75% P.O.C.","Less than $80000"
"06013328000","Census Tract 3280, Contra Costa County, California",2340,47554,1177,97,0,485,0,473,50.3,4.1,0,20.7,0,20.2,49.7,1357,52,1305,3.83,96.17,0,52,12,1293,12,1345,0,0.9,0.9,"25% - 50% P.O.C.","Less than $80000"
"06013329000","Census Tract 3290, Contra Costa County, California",6115,90536,2854,281,0,532,0,2146,46.7,4.6,0,8.7,0,35.1,53.3,2233,1390,843,62.25,37.75,170,1220,63,780,233,2000,12.2,7.5,10.4,"50% - 75% P.O.C.","$80000 - $108000"
"06013330000","Census Tract 3300, Contra Costa County, California",5592,92543,2826,36,0,826,10,1517,50.5,0.6,0,14.8,0.2,27.1,49.5,1949,1501,448,77.01,22.99,116,1385,74,374,190,1759,7.7,16.5,9.7,"25% - 50% P.O.C.","$80000 - $108000"
"06013331000","Census Tract 3310, Contra Costa County, California",7360,71122,3503,370,46,939,123,2165,47.6,5,0.6,12.8,1.7,29.4,52.4,2814,1613,1201,57.32,42.68,199,1414,115,1086,314,2500,12.3,9.6,11.2,"50% - 75% P.O.C.","Less than $80000"
"06013332000","Census Tract 3320, Contra Costa County, California",8763,109572,4716,106,0,1021,0,2236,53.8,1.2,0,11.7,0,25.5,46.2,2929,2258,671,77.09,22.91,365,1893,74,597,439,2490,16.2,11,15,"25% - 50% P.O.C.","$108000 - $141000"
"06013333101","Census Tract 3331.01, Contra Costa County, California",4441,103553,2725,0,9,551,23,962,61.4,0,0.2,12.4,0.5,21.7,38.6,1492,1076,416,72.12,27.88,106,970,43,373,149,1343,9.9,10.3,10,"25% - 50% P.O.C.","$80000 - $108000"
"06013333102","Census Tract 3331.02, Contra Costa County, California",4274,97072,2450,110,0,699,0,666,57.3,2.6,0,16.4,0,15.6,42.7,1545,1185,360,76.7,23.3,71,1114,30,330,101,1444,6,8.3,6.5,"25% - 50% P.O.C.","$80000 - $108000"
"06013333200","Census Tract 3332, Contra Costa County, California",6070,116887,4033,31,0,590,0,1269,66.4,0.5,0,9.7,0,20.9,33.6,2224,1707,517,76.75,23.25,80,1627,77,440,157,2067,4.7,14.9,7.1,"25% - 50% P.O.C.","$108000 - $141000"
"06013334001","Census Tract 3340.01, Contra Costa County, California",3914,72318,2109,68,16,548,0,847,53.9,1.7,0.4,14,0,21.6,46.1,1475,711,764,48.2,51.8,80,631,43,721,123,1352,11.3,5.6,8.3,"25% - 50% P.O.C.","Less than $80000"
"06013334004","Census Tract 3340.04, Contra Costa County, California",7945,85076,5025,463,0,672,0,1526,63.2,5.8,0,8.5,0,19.2,36.8,3200,1886,1314,58.94,41.06,69,1817,136,1178,205,2995,3.7,10.4,6.4,"25% - 50% P.O.C.","$80000 - $108000"
"06013334006","Census Tract 3340.06, Contra Costa County, California",4755,134815,2821,210,9,869,0,644,59.3,4.4,0.2,18.3,0,13.5,40.7,1726,1342,384,77.75,22.25,106,1236,47,337,153,1573,7.9,12.2,8.9,"25% - 50% P.O.C.","$108000 - $141000"
"06013334200","Census Tract 3342, Contra Costa County, California",7652,128618,5911,313,0,538,23,456,77.2,4.1,0,7,0.3,6,22.8,2691,2180,511,81.01,18.99,245,1935,0,511,245,2446,11.2,0,9.1,"Less than 25% P.O.C.","$108000 - $141000"
"06013335000","Census Tract 3350, Contra Costa County, California",3483,91857,2006,123,0,326,0,836,57.6,3.5,0,9.4,0,24,42.4,1162,779,383,67.04,32.96,43,736,23,360,66,1096,5.5,6,5.7,"25% - 50% P.O.C.","$80000 - $108000"
"06013336101","Census Tract 3361.01, Contra Costa County, California",5236,69022,816,225,11,743,396,2962,15.6,4.3,0.2,14.2,7.6,56.6,84.4,1592,211,1381,13.25,86.75,44,167,397,984,441,1151,20.9,28.7,27.7,"75% or more P.O.C.","Less than $80000"
"06013336102","Census Tract 3361.02, Contra Costa County, California",7319,46061,1412,652,16,962,0,3753,19.3,8.9,0.2,13.1,0,51.3,80.7,2722,375,2347,13.78,86.22,16,359,361,1986,377,2345,4.3,15.4,13.9,"75% or more P.O.C.","Less than $80000"
"06013336201","Census Tract 3362.01, Contra Costa County, California",4056,70608,956,233,8,692,0,1981,23.6,5.7,0.2,17.1,0,48.8,76.4,1248,674,574,54.01,45.99,129,545,108,466,237,1011,19.1,18.8,19,"75% or more P.O.C.","Less than $80000"
"06013336202","Census Tract 3362.02, Contra Costa County, California",6222,48412,752,136,0,700,0,4465,12.1,2.2,0,11.3,0,71.8,87.9,1735,326,1409,18.79,81.21,0,326,435,974,435,1300,0,30.9,25.1,"75% or more P.O.C.","Less than $80000"
"06013337100","Census Tract 3371, Contra Costa County, California",3403,127704,1811,184,13,539,0,656,53.2,5.4,0.4,15.8,0,19.3,46.8,1230,974,256,79.19,20.81,48,926,33,223,81,1149,4.9,12.9,6.6,"25% - 50% P.O.C.","$108000 - $141000"
"06013337200","Census Tract 3372, Contra Costa County, California",8470,75854,3886,277,0,1306,0,2458,45.9,3.3,0,15.4,0,29,54.1,3247,1911,1336,58.85,41.15,118,1793,65,1271,183,3064,6.2,4.9,5.6,"50% - 75% P.O.C.","Less than $80000"
"06013337300","Census Tract 3373, Contra Costa County, California",6097,126950,4130,139,0,873,0,606,67.7,2.3,0,14.3,0,9.9,32.3,2377,1820,557,76.57,23.43,115,1705,0,557,115,2262,6.3,0,4.8,"25% - 50% P.O.C.","$108000 - $141000"
"06013338101","Census Tract 3381.01, Contra Costa County, California",5352,73250,2198,167,7,494,1,2349,41.1,3.1,0.1,9.2,0,43.9,58.9,1887,1058,829,56.07,43.93,159,899,49,780,208,1679,15,5.9,11,"50% - 75% P.O.C.","Less than $80000"
"06013338102","Census Tract 3381.02, Contra Costa County, California",3600,120776,2270,57,0,298,11,654,63.1,1.6,0,8.3,0.3,18.2,36.9,1370,1185,185,86.5,13.5,100,1085,20,165,120,1250,8.4,10.8,8.8,"25% - 50% P.O.C.","$108000 - $141000"
"06013338201","Census Tract 3382.01, Contra Costa County, California",4144,130804,2842,256,0,524,0,345,68.6,6.2,0,12.6,0,8.3,31.4,1451,1273,178,87.73,12.27,128,1145,35,143,163,1288,10.1,19.7,11.2,"25% - 50% P.O.C.","$108000 - $141000"
"06013338203","Census Tract 3382.03, Contra Costa County, California",5685,111219,2980,121,0,1607,0,641,52.4,2.1,0,28.3,0,11.3,47.6,2760,1098,1662,39.78,60.22,28,1070,0,1662,28,2732,2.6,0,1,"25% - 50% P.O.C.","$108000 - $141000"
"06013338204","Census Tract 3382.04, Contra Costa County, California",6817,121010,3824,194,0,1537,94,739,56.1,2.8,0,22.5,1.4,10.8,43.9,2892,1640,1252,56.71,43.29,14,1626,34,1218,48,2844,0.9,2.7,1.7,"25% - 50% P.O.C.","$108000 - $141000"
"06013338301","Census Tract 3383.01, Contra Costa County, California",2990,173816,2136,23,0,457,0,185,71.4,0.8,0,15.3,0,6.2,28.6,1088,933,155,85.75,14.25,108,825,0,155,108,980,11.6,0,9.9,"25% - 50% P.O.C.","$141000 or more"
"06013338302","Census Tract 3383.02, Contra Costa County, California",5996,189010,4056,28,0,940,0,763,67.6,0.5,0,15.7,0,12.7,32.4,2115,1785,330,84.4,15.6,113,1672,73,257,186,1929,6.3,22.1,8.8,"25% - 50% P.O.C.","$141000 or more"
"06013339001","Census Tract 3390.01, Contra Costa County, California",3694,81497,2136,142,0,464,18,696,57.8,3.8,0,12.6,0.5,18.8,42.2,1919,124,1795,6.46,93.54,0,124,57,1738,57,1862,0,3.2,3,"25% - 50% P.O.C.","$80000 - $108000"
"06013339002","Census Tract 3390.02, Contra Costa County, California",6934,107583,4513,50,0,1140,0,663,65.1,0.7,0,16.4,0,9.6,34.9,3661,746,2915,20.38,79.62,86,660,16,2899,102,3559,11.5,0.5,2.8,"25% - 50% P.O.C.","$80000 - $108000"
"06013340001","Census Tract 3400.01, Contra Costa County, California",6154,88243,3960,181,7,867,94,766,64.3,2.9,0.1,14.1,1.5,12.4,35.7,2469,1333,1136,53.99,46.01,70,1263,128,1008,198,2271,5.3,11.3,8,"25% - 50% P.O.C.","$80000 - $108000"
"06013340002","Census Tract 3400.02, Contra Costa County, California",7789,146838,5759,8,21,788,23,754,73.9,0.1,0.3,10.1,0.3,9.7,26.1,3055,2449,606,80.16,19.84,116,2333,70,536,186,2869,4.7,11.6,6.1,"25% - 50% P.O.C.","$141000 or more"
"06013341000","Census Tract 3410, Contra Costa County, California",5240,139545,3862,38,0,664,0,518,73.7,0.7,0,12.7,0,9.9,26.3,2116,1397,719,66.02,33.98,76,1321,26,693,102,2014,5.4,3.6,4.8,"25% - 50% P.O.C.","$108000 - $141000"
"06013343001","Census Tract 3430.01, Contra Costa County, California",4850,110208,3511,71,1,415,45,479,72.4,1.5,0,8.6,0.9,9.9,27.6,2022,987,1035,48.81,51.19,79,908,23,1012,102,1920,8,2.2,5,"25% - 50% P.O.C.","$108000 - $141000"
"06013343002","Census Tract 3430.02, Contra Costa County, California",4859,124063,2938,111,0,763,0,741,60.5,2.3,0,15.7,0,15.3,39.5,1780,1217,563,68.37,31.63,61,1156,29,534,90,1690,5,5.2,5.1,"25% - 50% P.O.C.","$108000 - $141000"
"06013343003","Census Tract 3430.03, Contra Costa County, California",3969,154276,3090,0,17,439,40,236,77.9,0,0.4,11.1,1,5.9,22.1,1452,1265,187,87.12,12.88,94,1171,0,187,94,1358,7.4,0,6.5,"Less than 25% P.O.C.","$141000 or more"
"06013345101","Census Tract 3451.01, Contra Costa County, California",5781,157171,2834,180,24,1659,22,891,49,3.1,0.4,28.7,0.4,15.4,51,1839,1517,322,82.49,17.51,194,1323,0,322,194,1645,12.8,0,10.5,"50% - 75% P.O.C.","$141000 or more"
"06013345102","Census Tract 3451.02, Contra Costa County, California",3907,154569,2257,77,88,1113,0,208,57.8,2,2.3,28.5,0,5.3,42.2,1186,1115,71,94.01,5.99,137,978,28,43,165,1021,12.3,39.4,13.9,"25% - 50% P.O.C.","$141000 or more"
"06013345103","Census Tract 3451.03, Contra Costa County, California",4992,144306,2964,289,0,1100,0,344,59.4,5.8,0,22,0,6.9,40.6,1757,1411,346,80.31,19.69,114,1297,20,326,134,1623,8.1,5.8,7.6,"25% - 50% P.O.C.","$141000 or more"
"06013345105","Census Tract 3451.05, Contra Costa County, California",6525,148229,4758,22,6,760,21,643,72.9,0.3,0.1,11.6,0.3,9.9,27.1,2214,1896,318,85.64,14.36,210,1686,38,280,248,1966,11.1,11.9,11.2,"25% - 50% P.O.C.","$141000 or more"
"06013345108","Census Tract 3451.08, Contra Costa County, California",7299,129279,3636,114,0,2602,0,430,49.8,1.6,0,35.6,0,5.9,50.2,3216,2174,1042,67.6,32.4,161,2013,48,994,209,3007,7.4,4.6,6.5,"50% - 75% P.O.C.","$108000 - $141000"
"06013345111","Census Tract 3451.11, Contra Costa County, California",5217,140000,1648,136,13,2712,0,437,31.6,2.6,0.2,52,0,8.4,68.4,1854,1142,712,61.6,38.4,83,1059,33,679,116,1738,7.3,4.6,6.3,"50% - 75% P.O.C.","$108000 - $141000"
"06013345112","Census Tract 3451.12, Contra Costa County, California",6455,137218,3291,0,0,2502,0,435,51,0,0,38.8,0,6.7,49,2358,1480,878,62.77,37.23,86,1394,37,841,123,2235,5.8,4.2,5.2,"25% - 50% P.O.C.","$108000 - $141000"
"06013345113","Census Tract 3451.13, Contra Costa County, California",4548,185272,2783,38,0,1413,12,131,61.2,0.8,0,31.1,0.3,2.9,38.8,1561,1432,129,91.74,8.26,88,1344,0,129,88,1473,6.1,0,5.6,"25% - 50% P.O.C.","$141000 or more"
"06013345114","Census Tract 3451.14, Contra Costa County, California",6687,154231,5560,106,0,623,0,232,83.1,1.6,0,9.3,0,3.5,16.9,2588,2202,386,85.09,14.91,179,2023,9,377,188,2400,8.1,2.3,7.3,"Less than 25% P.O.C.","$141000 or more"
"06013345115","Census Tract 3451.15, Contra Costa County, California",5910,205026,2817,64,0,2347,0,435,47.7,1.1,0,39.7,0,7.4,52.3,1933,1481,452,76.62,23.38,203,1278,19,433,222,1711,13.7,4.2,11.5,"50% - 75% P.O.C.","$141000 or more"
"06013345116","Census Tract 3451.16, Contra Costa County, California",2794,186528,1511,51,8,769,0,353,54.1,1.8,0.3,27.5,0,12.6,45.9,885,763,122,86.21,13.79,54,709,27,95,81,804,7.1,22.1,9.2,"25% - 50% P.O.C.","$141000 or more"
"06013345202","Census Tract 3452.02, Contra Costa County, California",7688,137819,4276,154,16,1823,147,722,55.6,2,0.2,23.7,1.9,9.4,44.4,3030,1818,1212,60,40,151,1667,44,1168,195,2835,8.3,3.6,6.4,"25% - 50% P.O.C.","$108000 - $141000"
"06013345203","Census Tract 3452.03, Contra Costa County, California",6743,136528,5640,93,0,403,0,448,83.6,1.4,0,6,0,6.6,16.4,2733,1958,775,71.64,28.36,181,1777,84,691,265,2468,9.2,10.8,9.7,"Less than 25% P.O.C.","$108000 - $141000"
"06013345204","Census Tract 3452.04, Contra Costa County, California",3763,219750,3278,0,0,181,0,284,87.1,0,0,4.8,0,7.5,12.9,1246,1183,63,94.94,5.06,157,1026,30,33,187,1059,13.3,47.6,15,"Less than 25% P.O.C.","$141000 or more"
"06013346101","Census Tract 3461.01, Contra Costa County, California",3404,160882,2494,78,0,599,0,127,73.3,2.3,0,17.6,0,3.7,26.7,1320,1239,81,93.86,6.14,57,1182,0,81,57,1263,4.6,0,4.3,"25% - 50% P.O.C.","$141000 or more"
"06013346102","Census Tract 3461.02, Contra Costa County, California",5610,250001,4076,5,8,792,10,546,72.7,0.1,0.1,14.1,0.2,9.7,27.3,1928,1769,159,91.75,8.25,298,1471,0,159,298,1630,16.8,0,15.5,"25% - 50% P.O.C.","$141000 or more"
"06013346201","Census Tract 3462.01, Contra Costa County, California",7859,183958,6443,91,0,823,0,340,82,1.2,0,10.5,0,4.3,18,2865,2557,308,89.25,10.75,205,2352,39,269,244,2621,8,12.7,8.5,"Less than 25% P.O.C.","$141000 or more"
"06013346203","Census Tract 3462.03, Contra Costa County, California",4123,146680,3388,38,0,349,0,186,82.2,0.9,0,8.5,0,4.5,17.8,1475,1405,70,95.25,4.75,150,1255,0,70,150,1325,10.7,0,10.2,"Less than 25% P.O.C.","$141000 or more"
"06013346204","Census Tract 3462.04, Contra Costa County, California",7708,203636,5892,93,0,1009,0,421,76.4,1.2,0,13.1,0,5.5,23.6,2644,2381,263,90.05,9.95,271,2110,0,263,271,2373,11.4,0,10.2,"Less than 25% P.O.C.","$141000 or more"
"06013347000","Census Tract 3470, Contra Costa County, California",6426,188247,5166,39,0,431,0,428,80.4,0.6,0,6.7,0,6.7,19.6,2311,2123,188,91.86,8.14,237,1886,0,188,237,2074,11.2,0,10.3,"Less than 25% P.O.C.","$141000 or more"
"06013348000","Census Tract 3480, Contra Costa County, California",5066,230156,4005,26,6,678,0,165,79.1,0.5,0.1,13.4,0,3.3,20.9,1601,1374,227,85.82,14.18,229,1145,53,174,282,1319,16.7,23.3,17.6,"Less than 25% P.O.C.","$141000 or more"
"06013349000","Census Tract 3490, Contra Costa County, California",5554,127222,4240,54,10,592,0,463,76.3,1,0.2,10.7,0,8.3,23.7,2122,1274,848,60.04,39.96,176,1098,15,833,191,1931,13.8,1.8,9,"Less than 25% P.O.C.","$108000 - $141000"
"06013350000","Census Tract 3500, Contra Costa County, California",6111,118000,4186,18,0,851,32,695,68.5,0.3,0,13.9,0.5,11.4,31.5,2566,1279,1287,49.84,50.16,170,1109,0,1287,170,2396,13.3,0,6.6,"25% - 50% P.O.C.","$108000 - $141000"
"06013351101","Census Tract 3511.01, Contra Costa County, California",2683,66611,2327,10,0,303,0,25,86.7,0.4,0,11.3,0,0.9,13.3,1951,1881,70,96.41,3.59,0,1881,0,70,0,1951,0,0,0,"Less than 25% P.O.C.","Less than $80000"
"06013351102","Census Tract 3511.02, Contra Costa County, California",3791,48447,3320,6,15,346,0,91,87.6,0.2,0.4,9.1,0,2.4,12.4,2773,2485,288,89.61,10.39,0,2485,0,288,0,2773,0,0,0,"Less than 25% P.O.C.","Less than $80000"
"06013351103","Census Tract 3511.03, Contra Costa County, California",2012,89722,1848,1,0,121,0,14,91.8,0,0,6,0,0.7,8.2,1358,1323,35,97.42,2.58,0,1323,0,35,0,1358,0,0,0,"Less than 25% P.O.C.","$80000 - $108000"
"06013351200","Census Tract 3512, Contra Costa County, California",6292,246336,4569,6,0,694,0,649,72.6,0.1,0,11,0,10.3,27.4,2097,1848,249,88.13,11.87,207,1641,106,143,313,1784,11.2,42.6,14.9,"25% - 50% P.O.C.","$141000 or more"
"06013352101","Census Tract 3521.01, Contra Costa County, California",3406,191250,2129,48,14,476,76,453,62.5,1.4,0.4,14,2.2,13.3,37.5,828,773,55,93.36,6.64,61,712,0,55,61,767,7.9,0,7.4,"25% - 50% P.O.C.","$141000 or more"
"06013352102","Census Tract 3521.02, Contra Costa County, California",5669,186652,3975,11,0,897,66,501,70.1,0.2,0,15.8,1.2,8.8,29.9,1841,1684,157,91.47,8.53,112,1572,23,134,135,1706,6.7,14.6,7.3,"25% - 50% P.O.C.","$141000 or more"
"06013352201","Census Tract 3522.01, Contra Costa County, California",6658,122708,4689,36,0,1246,0,414,70.4,0.5,0,18.7,0,6.2,29.6,2446,1837,609,75.1,24.9,166,1671,26,583,192,2254,9,4.3,7.8,"25% - 50% P.O.C.","$108000 - $141000"
"06013352202","Census Tract 3522.02, Contra Costa County, California",2758,125186,1964,8,1,523,10,82,71.2,0.3,0,19,0.4,3,28.8,1081,880,201,81.41,18.59,44,836,54,147,98,983,5,26.9,9.1,"25% - 50% P.O.C.","$108000 - $141000"
"06013353001","Census Tract 3530.01, Contra Costa County, California",4008,224318,2742,102,0,781,0,123,68.4,2.5,0,19.5,0,3.1,31.6,1410,1269,141,90,10,56,1213,0,141,56,1354,4.4,0,4,"25% - 50% P.O.C.","$141000 or more"
"06013353002","Census Tract 3530.02, Contra Costa County, California",4397,239189,3279,62,0,649,1,192,74.6,1.4,0,14.8,0,4.4,25.4,1548,1461,87,94.38,5.62,121,1340,28,59,149,1399,8.3,32.2,9.6,"25% - 50% P.O.C.","$141000 or more"
"06013354001","Census Tract 3540.01, Contra Costa County, California",2136,184750,1561,0,0,332,61,67,73.1,0,0,15.5,2.9,3.1,26.9,761,656,105,86.2,13.8,61,595,0,105,61,700,9.3,0,8,"25% - 50% P.O.C.","$141000 or more"
"06013354002","Census Tract 3540.02, Contra Costa County, California",7169,249651,5311,90,0,938,0,484,74.1,1.3,0,13.1,0,6.8,25.9,2738,2378,360,86.85,13.15,178,2200,12,348,190,2548,7.5,3.3,6.9,"25% - 50% P.O.C.","$141000 or more"
"06013355107","Census Tract 3551.07, Contra Costa County, California",5361,96816,1967,834,13,549,0,1728,36.7,15.6,0.2,10.2,0,32.2,63.3,1649,1424,225,86.36,13.64,237,1187,76,149,313,1336,16.6,33.8,19,"50% - 75% P.O.C.","$80000 - $108000"
"06013355108","Census Tract 3551.08, Contra Costa County, California",13457,109034,2275,3876,0,2193,50,3707,16.9,28.8,0,16.3,0.4,27.5,83.1,3694,2716,978,73.52,26.48,580,2136,289,689,869,2825,21.4,29.6,23.5,"75% or more P.O.C.","$108000 - $141000"
"06013355109","Census Tract 3551.09, Contra Costa County, California",7559,105456,2109,2227,0,926,39,1903,27.9,29.5,0,12.3,0.5,25.2,72.1,2133,1579,554,74.03,25.97,349,1230,96,458,445,1688,22.1,17.3,20.9,"50% - 75% P.O.C.","$80000 - $108000"
"06013355110","Census Tract 3551.10, Contra Costa County, California",4447,87500,1343,859,0,966,0,970,30.2,19.3,0,21.7,0,21.8,69.8,1202,929,273,77.29,22.71,191,738,149,124,340,862,20.6,54.6,28.3,"50% - 75% P.O.C.","$80000 - $108000"
"06013355111","Census Tract 3551.11, Contra Costa County, California",6218,105515,1911,1268,0,763,0,1948,30.7,20.4,0,12.3,0,31.3,69.3,1950,1548,402,79.38,20.62,296,1252,61,341,357,1593,19.1,15.2,18.3,"50% - 75% P.O.C.","$80000 - $108000"
"06013355112","Census Tract 3551.12, Contra Costa County, California",5687,191359,3976,80,0,935,0,407,69.9,1.4,0,16.4,0,7.2,30.1,2069,1814,255,87.68,12.32,98,1716,0,255,98,1971,5.4,0,4.7,"25% - 50% P.O.C.","$141000 or more"
"06013355113","Census Tract 3551.13, Contra Costa County, California",4947,208500,2809,68,0,1485,33,334,56.8,1.4,0,30,0.7,6.8,43.2,1698,1617,81,95.23,4.77,78,1539,8,73,86,1612,4.8,9.9,5.1,"25% - 50% P.O.C.","$141000 or more"
"06013355114","Census Tract 3551.14, Contra Costa County, California",11848,209154,4068,100,2,5987,0,944,34.3,0.8,0,50.5,0,8,65.7,3513,3044,469,86.65,13.35,537,2507,39,430,576,2937,17.6,8.3,16.4,"50% - 75% P.O.C.","$141000 or more"
"06013355115","Census Tract 3551.15, Contra Costa County, California",7981,123750,1684,446,0,4549,0,741,21.1,5.6,0,57,0,9.3,78.9,2672,1286,1386,48.13,51.87,200,1086,106,1280,306,2366,15.6,7.6,11.5,"75% or more P.O.C.","$108000 - $141000"
"06013355116","Census Tract 3551.16, Contra Costa County, California",8933,207303,1602,212,26,6063,60,555,17.9,2.4,0.3,67.9,0.7,6.2,82.1,2487,1935,552,77.8,22.2,426,1509,78,474,504,1983,22,14.1,20.3,"75% or more P.O.C.","$141000 or more"
"06013355117","Census Tract 3551.17, Contra Costa County, California",7292,250001,1121,17,13,5684,39,113,15.4,0.2,0.2,77.9,0.5,1.5,84.6,1933,1748,185,90.43,9.57,336,1412,12,173,348,1585,19.2,6.5,18,"75% or more P.O.C.","$141000 or more"
"06013355200","Census Tract 3552, Contra Costa County, California",11140,117460,1920,1293,0,4619,0,2691,17.2,11.6,0,41.5,0,24.2,82.8,3067,2052,1015,66.91,33.09,470,1582,251,764,721,2346,22.9,24.7,23.5,"75% or more P.O.C.","$108000 - $141000"
"06013355301","Census Tract 3553.01, Contra Costa County, California",8635,148618,5848,20,12,1072,129,1055,67.7,0.2,0.1,12.4,1.5,12.2,32.3,2879,2567,312,89.16,10.84,330,2237,31,281,361,2518,12.9,9.9,12.5,"25% - 50% P.O.C.","$141000 or more"
"06013355302","Census Tract 3553.02, Contra Costa County, California",3515,242083,2410,7,0,649,59,217,68.6,0.2,0,18.5,1.7,6.2,31.4,1227,1135,92,92.5,7.5,127,1008,0,92,127,1100,11.2,0,10.4,"25% - 50% P.O.C.","$141000 or more"
"06013355304","Census Tract 3553.04, Contra Costa County, California",8763,152179,6263,279,15,754,0,975,71.5,3.2,0.2,8.6,0,11.1,28.5,3122,2808,314,89.94,10.06,340,2468,50,264,390,2732,12.1,15.9,12.5,"25% - 50% P.O.C.","$141000 or more"
"06013355306","Census Tract 3553.06, Contra Costa County, California",5315,126042,4387,74,0,214,0,417,82.5,1.4,0,4,0,7.8,17.5,1866,1700,166,91.1,8.9,160,1540,18,148,178,1688,9.4,10.8,9.5,"Less than 25% P.O.C.","$108000 - $141000"
"06013356001","Census Tract 3560.01, Contra Costa County, California",4379,100950,967,403,0,1112,12,1345,22.1,9.2,0,25.4,0.3,30.7,77.9,1261,1026,235,81.36,18.64,296,730,37,198,333,928,28.8,15.7,26.4,"75% or more P.O.C.","$80000 - $108000"
"06013356002","Census Tract 3560.02, Contra Costa County, California",5522,151382,1995,456,10,1531,0,969,36.1,8.3,0.2,27.7,0,17.5,63.9,1937,1678,259,86.63,13.37,211,1467,51,208,262,1675,12.6,19.7,13.5,"50% - 75% P.O.C.","$141000 or more"
"06013357000","Census Tract 3570, Contra Costa County, California",3317,95263,2175,202,26,87,0,653,65.6,6.1,0.8,2.6,0,19.7,34.4,1442,721,721,50,50,49,672,105,616,154,1288,6.8,14.6,10.7,"25% - 50% P.O.C.","$80000 - $108000"
"06013358000","Census Tract 3580, Contra Costa County, California",6285,59567,1529,1146,0,1088,86,2013,24.3,18.2,0,17.3,1.4,32,75.7,2264,992,1272,43.82,56.18,115,877,143,1129,258,2006,11.6,11.2,11.4,"75% or more P.O.C.","Less than $80000"
"06013359102","Census Tract 3591.02, Contra Costa County, California",5982,91866,1433,940,9,1565,0,1692,24,15.7,0.2,26.2,0,28.3,76,1948,1199,749,61.55,38.45,157,1042,115,634,272,1676,13.1,15.4,14,"75% or more P.O.C.","$80000 - $108000"
"06013359103","Census Tract 3591.03, Contra Costa County, California",5237,81989,1655,517,0,1943,1,656,31.6,9.9,0,37.1,0,12.5,68.4,1919,1226,693,63.89,36.11,154,1072,51,642,205,1714,12.6,7.4,10.7,"50% - 75% P.O.C.","$80000 - $108000"
"06013359104","Census Tract 3591.04, Contra Costa County, California",2086,91014,413,432,6,831,0,296,19.8,20.7,0.3,39.8,0,14.2,80.2,922,658,264,71.37,28.63,44,614,0,264,44,878,6.7,0,4.8,"75% or more P.O.C.","$80000 - $108000"
"06013359105","Census Tract 3591.05, Contra Costa County, California",5006,123750,864,937,0,2385,0,582,17.3,18.7,0,47.6,0,11.6,82.7,1728,1497,231,86.63,13.37,191,1306,10,221,201,1527,12.8,4.3,11.6,"75% or more P.O.C.","$108000 - $141000"
"06013359202","Census Tract 3592.02, Contra Costa County, California",6043,107686,2508,472,14,1295,27,1256,41.5,7.8,0.2,21.4,0.4,20.8,58.5,2179,1566,613,71.87,28.13,165,1401,133,480,298,1881,10.5,21.7,13.7,"50% - 75% P.O.C.","$80000 - $108000"
"06013359203","Census Tract 3592.03, Contra Costa County, California",7248,107946,2016,865,0,2760,0,1343,27.8,11.9,0,38.1,0,18.5,72.2,2288,1952,336,85.31,14.69,292,1660,138,198,430,1858,15,41.1,18.8,"50% - 75% P.O.C.","$80000 - $108000"
"06013359204","Census Tract 3592.04, Contra Costa County, California",4915,122232,736,713,0,2215,149,920,15,14.5,0,45.1,3,18.7,85,1525,1252,273,82.1,17.9,182,1070,56,217,238,1287,14.5,20.5,15.6,"75% or more P.O.C.","$108000 - $141000"
"06013360101","Census Tract 3601.01, Contra Costa County, California",4405,87333,1876,359,0,797,0,862,42.6,8.1,0,18.1,0,19.6,57.4,1644,1374,270,83.58,16.42,170,1204,0,270,170,1474,12.4,0,10.3,"50% - 75% P.O.C.","$80000 - $108000"
"06013360102","Census Tract 3601.02, Contra Costa County, California",4115,127125,1690,394,14,1062,0,838,41.1,9.6,0.3,25.8,0,20.4,58.9,1451,1258,193,86.7,13.3,148,1110,20,173,168,1283,11.8,10.4,11.6,"50% - 75% P.O.C.","$108000 - $141000"
"06013360200","Census Tract 3602, Contra Costa County, California",5173,82224,1527,526,11,1325,23,1483,29.5,10.2,0.2,25.6,0.4,28.7,70.5,1775,919,856,51.77,48.23,94,825,55,801,149,1626,10.2,6.4,8.4,"50% - 75% P.O.C.","$80000 - $108000"
"06013361000","Census Tract 3610, Contra Costa County, California",5093,94010,1636,629,0,1172,93,1322,32.1,12.4,0,23,1.8,26,67.9,1765,1072,693,60.74,39.26,141,931,47,646,188,1577,13.2,6.8,10.7,"50% - 75% P.O.C.","$80000 - $108000"
"06013362000","Census Tract 3620, Contra Costa County, California",2798,90400,1440,507,0,260,0,420,51.5,18.1,0,9.3,0,15,48.5,1190,917,273,77.06,22.94,73,844,10,263,83,1107,8,3.7,7,"25% - 50% P.O.C.","$80000 - $108000"
"06013363000","Census Tract 3630, Contra Costa County, California",7408,83444,2347,1460,0,1378,0,1877,31.7,19.7,0,18.6,0,25.3,68.3,2642,1864,778,70.55,29.45,325,1539,32,746,357,2285,17.4,4.1,13.5,"50% - 75% P.O.C.","$80000 - $108000"
"06013364002","Census Tract 3640.02, Contra Costa County, California",5531,77061,1126,792,8,1038,0,2316,20.4,14.3,0.1,18.8,0,41.9,79.6,1791,1128,663,62.98,37.02,193,935,83,580,276,1515,17.1,12.5,15.4,"75% or more P.O.C.","Less than $80000"
"06013365002","Census Tract 3650.02, Contra Costa County, California",5590,53790,226,1021,0,382,15,3832,4,18.3,0,6.8,0.3,68.6,96,1480,664,816,44.86,55.14,248,416,128,688,376,1104,37.3,15.7,25.4,"75% or more P.O.C.","Less than $80000"
"06013365003","Census Tract 3650.03, Contra Costa County, California",5164,73750,1131,1290,43,1148,0,1037,21.9,25,0.8,22.2,0,20.1,78.1,2343,614,1729,26.21,73.79,56,558,142,1587,198,2145,9.1,8.2,8.5,"75% or more P.O.C.","Less than $80000"
"06013366001","Census Tract 3660.01, Contra Costa County, California",4514,64464,331,347,25,886,0,2495,7.3,7.7,0.6,19.6,0,55.3,92.7,1243,649,594,52.21,47.79,159,490,163,431,322,921,24.5,27.4,25.9,"75% or more P.O.C.","Less than $80000"
"06013366002","Census Tract 3660.02, Contra Costa County, California",6627,58869,271,591,6,1064,42,4558,4.1,8.9,0.1,16.1,0.6,68.8,95.9,1810,894,916,49.39,50.61,211,683,262,654,473,1337,23.6,28.6,26.1,"75% or more P.O.C.","Less than $80000"
"06013367100","Census Tract 3671, Contra Costa County, California",5342,57059,409,1572,0,993,116,1928,7.7,29.4,0,18.6,2.2,36.1,92.3,1999,971,1028,48.57,51.43,144,827,61,967,205,1794,14.8,5.9,10.3,"75% or more P.O.C.","Less than $80000"
"06013367200","Census Tract 3672, Contra Costa County, California",6042,64327,440,937,0,1333,145,3058,7.3,15.5,0,22.1,2.4,50.6,92.7,1743,831,912,47.68,52.32,279,552,167,745,446,1297,33.6,18.3,25.6,"75% or more P.O.C.","Less than $80000"
"06013368001","Census Tract 3680.01, Contra Costa County, California",4817,52050,329,204,0,227,0,3864,6.8,4.2,0,4.7,0,80.2,93.2,1309,485,824,37.05,62.95,95,390,249,575,344,965,19.6,30.2,26.3,"75% or more P.O.C.","Less than $80000"
"06013368002","Census Tract 3680.02, Contra Costa County, California",3782,54821,148,433,19,312,29,2765,3.9,11.4,0.5,8.2,0.8,73.1,96.1,1118,402,716,35.96,64.04,80,322,172,544,252,866,19.9,24,22.5,"75% or more P.O.C.","Less than $80000"
"06013369001","Census Tract 3690.01, Contra Costa County, California",7254,43218,864,918,0,1863,2,3445,11.9,12.7,0,25.7,0,47.5,88.1,2324,640,1684,27.54,72.46,159,481,312,1372,471,1853,24.8,18.5,20.3,"75% or more P.O.C.","Less than $80000"
"06013369002","Census Tract 3690.02, Contra Costa County, California",3045,77800,753,444,0,429,0,1266,24.7,14.6,0,14.1,0,41.6,75.3,1064,544,520,51.13,48.87,36,508,48,472,84,980,6.6,9.2,7.9,"75% or more P.O.C.","Less than $80000"
"06013370000","Census Tract 3700, Contra Costa County, California",2850,102450,1235,371,8,540,0,557,43.3,13,0.3,18.9,0,19.5,56.7,1137,803,334,70.62,29.38,30,773,50,284,80,1057,3.7,15,7,"50% - 75% P.O.C.","$80000 - $108000"
"06013371000","Census Tract 3710, Contra Costa County, California",5960,84591,1423,623,0,924,35,2786,23.9,10.5,0,15.5,0.6,46.7,76.1,1947,1171,776,60.14,39.86,203,968,189,587,392,1555,17.3,24.4,20.1,"75% or more P.O.C.","$80000 - $108000"
"06013372000","Census Tract 3720, Contra Costa County, California",7541,67047,953,523,8,1449,14,4292,12.6,6.9,0.1,19.2,0.2,56.9,87.4,2295,1390,905,60.57,39.43,192,1198,205,700,397,1898,13.8,22.7,17.3,"75% or more P.O.C.","Less than $80000"
"06013373000","Census Tract 3730, Contra Costa County, California",4468,54049,137,448,41,404,0,3428,3.1,10,0.9,9,0,76.7,96.9,1153,556,597,48.22,51.78,128,428,202,395,330,823,23,33.8,28.6,"75% or more P.O.C.","Less than $80000"
"06013374000","Census Tract 3740, Contra Costa County, California",4752,56675,845,875,0,439,0,2426,17.8,18.4,0,9.2,0,51.1,82.2,1771,810,961,45.74,54.26,73,737,103,858,176,1595,9,10.7,9.9,"75% or more P.O.C.","Less than $80000"
"06013375000","Census Tract 3750, Contra Costa County, California",4897,61196,368,610,0,268,0,3504,7.5,12.5,0,5.5,0,71.6,92.5,1231,385,846,31.28,68.72,134,251,207,639,341,890,34.8,24.5,27.7,"75% or more P.O.C.","Less than $80000"
"06013376000","Census Tract 3760, Contra Costa County, California",6245,51250,112,777,0,719,0,4581,1.8,12.4,0,11.5,0,73.4,98.2,1644,616,1028,37.47,62.53,203,413,253,775,456,1188,33,24.6,27.7,"75% or more P.O.C.","Less than $80000"
"06013377000","Census Tract 3770, Contra Costa County, California",7323,39232,651,1506,82,1317,0,3620,8.9,20.6,1.1,18,0,49.4,91.1,2265,858,1407,37.88,62.12,120,738,216,1191,336,1929,14,15.4,14.8,"75% or more P.O.C.","Less than $80000"
"06013378000","Census Tract 3780, Contra Costa County, California",3327,102057,2264,131,0,192,0,614,68,3.9,0,5.8,0,18.5,32,1739,1081,658,62.16,37.84,19,1062,0,658,19,1720,1.8,0,1.1,"25% - 50% P.O.C.","$80000 - $108000"
"06013379000","Census Tract 3790, Contra Costa County, California",7003,46382,227,1685,7,101,0,4477,3.2,24.1,0.1,1.4,0,63.9,96.8,1909,712,1197,37.3,62.7,163,549,301,896,464,1445,22.9,25.1,24.3,"75% or more P.O.C.","Less than $80000"
"06013380000","Census Tract 3800, Contra Costa County, California",5931,80110,1628,1399,27,1079,58,1368,27.4,23.6,0.5,18.2,1,23.1,72.6,2808,1432,1376,51,49,64,1368,14,1362,78,2730,4.5,1,2.8,"50% - 75% P.O.C.","$80000 - $108000"
"06013381000","Census Tract 3810, Contra Costa County, California",6521,51783,392,1872,83,352,9,3525,6,28.7,1.3,5.4,0.1,54.1,94,2001,761,1240,38.03,61.97,189,572,260,980,449,1552,24.8,21,22.4,"75% or more P.O.C.","Less than $80000"
"06013382000","Census Tract 3820, Contra Costa County, California",8159,44464,883,4008,11,683,84,2170,10.8,49.1,0.1,8.4,1,26.6,89.2,2791,894,1897,32.03,67.97,57,837,222,1675,279,2512,6.4,11.7,10,"75% or more P.O.C.","Less than $80000"
"06013383000","Census Tract 3830, Contra Costa County, California",4877,79746,2337,285,0,1203,0,880,47.9,5.8,0,24.7,0,18,52.1,2032,1161,871,57.14,42.86,26,1135,97,774,123,1909,2.2,11.1,6.1,"50% - 75% P.O.C.","Less than $80000"
"06013384000","Census Tract 3840, Contra Costa County, California",3913,121076,2359,247,10,656,7,372,60.3,6.3,0.3,16.8,0.2,9.5,39.7,1631,1387,244,85.04,14.96,13,1374,13,231,26,1605,0.9,5.3,1.6,"25% - 50% P.O.C.","$108000 - $141000"
"06013385100","Census Tract 3851, Contra Costa County, California",2940,167600,1678,130,0,707,0,235,57.1,4.4,0,24,0,8,42.9,1110,965,145,86.94,13.06,37,928,2,143,39,1071,3.8,1.4,3.5,"25% - 50% P.O.C.","$141000 or more"
"06013385200","Census Tract 3852, Contra Costa County, California",1308,143226,668,43,4,436,0,69,51.1,3.3,0.3,33.3,0,5.3,48.9,510,383,127,75.1,24.9,19,364,3,124,22,488,5,2.4,4.3,"25% - 50% P.O.C.","$141000 or more"
"06013386000","Census Tract 3860, Contra Costa County, California",3538,63839,1074,271,29,1595,41,350,30.4,7.7,0.8,45.1,1.2,9.9,69.6,1473,516,957,35.03,64.97,12,504,36,921,48,1425,2.3,3.8,3.3,"50% - 75% P.O.C.","Less than $80000"
"06013387000","Census Tract 3870, Contra Costa County, California",2928,67813,1263,117,6,993,0,305,43.1,4,0.2,33.9,0,10.4,56.9,1110,468,642,42.16,57.84,16,452,74,568,90,1020,3.4,11.5,8.1,"50% - 75% P.O.C.","Less than $80000"
"06013388000","Census Tract 3880, Contra Costa County, California",2741,101776,1382,71,18,835,0,278,50.4,2.6,0.7,30.5,0,10.1,49.6,1129,530,599,46.94,53.06,10,520,60,539,70,1059,1.9,10,6.2,"25% - 50% P.O.C.","$80000 - $108000"
"06013389100","Census Tract 3891, Contra Costa County, California",2271,107813,814,163,5,744,96,280,35.8,7.2,0.2,32.8,4.2,12.3,64.2,886,348,538,39.28,60.72,14,334,62,476,76,810,4,11.5,8.6,"50% - 75% P.O.C.","$80000 - $108000"
"06013389200","Census Tract 3892, Contra Costa County, California",1779,78929,364,61,44,823,14,420,20.5,3.4,2.5,46.3,0.8,23.6,79.5,670,98,572,14.63,85.37,21,77,51,521,72,598,21.4,8.9,10.7,"75% or more P.O.C.","Less than $80000"
"06013390100","Census Tract 3901, Contra Costa County, California",2454,154398,1560,73,0,463,3,194,63.6,3,0,18.9,0.1,7.9,36.4,915,816,99,89.18,10.82,35,781,16,83,51,864,4.3,16.2,5.6,"25% - 50% P.O.C.","$141000 or more"
"06013390200","Census Tract 3902, Contra Costa County, California",1797,124028,1102,20,0,469,0,126,61.3,1.1,0,26.1,0,7,38.7,743,595,148,80.08,19.92,1,594,11,137,12,731,0.2,7.4,1.6,"25% - 50% P.O.C.","$108000 - $141000"
"06013391000","Census Tract 3910, Contra Costa County, California",2676,150909,1717,69,0,296,0,423,64.2,2.6,0,11.1,0,15.8,35.8,1140,910,230,79.82,20.18,37,873,7,223,44,1096,4.1,3,3.9,"25% - 50% P.O.C.","$141000 or more"
"06013392000","Census Tract 3920, Contra Costa County, California",2653,141543,1996,55,9,325,0,113,75.2,2.1,0.3,12.3,0,4.3,24.8,1114,988,126,88.69,11.31,91,897,25,101,116,998,9.2,19.8,10.4,"Less than 25% P.O.C.","$141000 or more"
"06013392200","Census Tract 3922, Contra Costa County, California",11304,84604,1852,1906,32,2107,17,4964,16.4,16.9,0.3,18.6,0.2,43.9,83.6,3065,1901,1164,62.02,37.98,354,1547,189,975,543,2522,18.6,16.2,17.7,"75% or more P.O.C.","$80000 - $108000"
"06013392300","Census Tract 3923, Contra Costa County, California",3126,156307,251,504,0,2076,0,246,8,16.1,0,66.4,0,7.9,92,851,658,193,77.32,22.68,179,479,18,175,197,654,27.2,9.3,23.1,"75% or more P.O.C.","$141000 or more"
"06013990000","Census Tract 9900, Contra Costa County, California",0,NA,0,0,0,0,0,0,NA,NA,NA,NA,NA,NA,NA,0,0,0,NA,NA,0,0,0,0,0,0,NA,NA,NA,"N/A","N/A"
"06041101100","Census Tract 1011, Marin County, California",2677,147581,2201,0,0,208,0,174,82.2,0,0,7.8,0,6.5,17.8,1098,940,158,85.61,14.39,86,854,13,145,99,999,9.1,8.2,9,"Less than 25% P.O.C.","$141000 or more"
"06041101200","Census Tract 1012, Marin County, California",3015,118167,2079,0,0,188,0,698,69,0,0,6.2,0,23.2,31,1186,986,200,83.14,16.86,42,944,46,154,88,1098,4.3,23,7.4,"25% - 50% P.O.C.","$108000 - $141000"
"06041102100","Census Tract 1021, Marin County, California",2421,142396,1956,16,0,85,0,287,80.8,0.7,0,3.5,0,11.9,19.2,1005,823,182,81.89,18.11,22,801,22,160,44,961,2.7,12.1,4.4,"Less than 25% P.O.C.","$141000 or more"
"06041102202","Census Tract 1022.02, Marin County, California",6142,125833,4487,263,0,264,0,843,73.1,4.3,0,4.3,0,13.7,26.9,2360,1783,577,75.55,24.45,55,1728,15,562,70,2290,3.1,2.6,3,"25% - 50% P.O.C.","$108000 - $141000"
"06041102203","Census Tract 1022.03, Marin County, California",5761,70344,2839,270,0,396,0,1898,49.3,4.7,0,6.9,0,32.9,50.7,2201,884,1317,40.16,59.84,22,862,182,1135,204,1997,2.5,13.8,9.3,"50% - 75% P.O.C.","Less than $80000"
"06041103100","Census Tract 1031, Marin County, California",7887,140143,6502,114,0,297,14,525,82.4,1.4,0,3.8,0.2,6.7,17.6,2912,2647,265,90.9,9.1,150,2497,72,193,222,2690,5.7,27.2,7.6,"Less than 25% P.O.C.","$108000 - $141000"
"06041103200","Census Tract 1032, Marin County, California",7290,115847,4569,275,31,713,0,1314,62.7,3.8,0.4,9.8,0,18,37.3,2865,2018,847,70.44,29.56,78,1940,133,714,211,2654,3.9,15.7,7.4,"25% - 50% P.O.C.","$108000 - $141000"
"06041104101","Census Tract 1041.01, Marin County, California",8039,92614,5307,216,28,620,38,1429,66,2.7,0.3,7.7,0.5,17.8,34,3283,2036,1247,62.02,37.98,95,1941,224,1023,319,2964,4.7,18,9.7,"25% - 50% P.O.C.","$80000 - $108000"
"06041104102","Census Tract 1041.02, Marin County, California",5760,95750,2733,71,37,588,0,1909,47.4,1.2,0.6,10.2,0,33.1,52.6,2216,1254,962,56.59,43.41,19,1235,154,808,173,2043,1.5,16,7.8,"50% - 75% P.O.C.","$80000 - $108000"
"06041104200","Census Tract 1042, Marin County, California",5894,96113,4039,116,0,394,0,951,68.5,2,0,6.7,0,16.1,31.5,2545,1471,1074,57.8,42.2,26,1445,165,909,191,2354,1.8,15.4,7.5,"25% - 50% P.O.C.","$80000 - $108000"
"06041104300","Census Tract 1043, Marin County, California",1653,133693,1367,42,14,102,0,69,82.7,2.5,0.8,6.2,0,4.2,17.3,665,608,57,91.43,8.57,17,591,14,43,31,634,2.8,24.6,4.7,"Less than 25% P.O.C.","$108000 - $141000"
"06041105000","Census Tract 1050, Marin County, California",7077,83700,3658,587,0,766,10,1246,51.7,8.3,0,10.8,0.1,17.6,48.3,2790,2041,749,73.15,26.85,206,1835,62,687,268,2522,10.1,8.3,9.6,"25% - 50% P.O.C.","$80000 - $108000"
"06041106001","Census Tract 1060.01, Marin County, California",4582,91630,2872,119,3,590,0,770,62.7,2.6,0.1,12.9,0,16.8,37.3,2138,1017,1121,47.57,52.43,0,1017,0,1121,0,2138,0,0,0,"25% - 50% P.O.C.","$80000 - $108000"
"06041106002","Census Tract 1060.02, Marin County, California",5598,95638,4001,230,0,432,56,368,71.5,4.1,0,7.7,1,6.6,28.5,2235,1826,409,81.7,18.3,128,1698,17,392,145,2090,7,4.2,6.5,"25% - 50% P.O.C.","$80000 - $108000"
"06041107000","Census Tract 1070, Marin County, California",6803,138534,5038,7,0,400,0,886,74.1,0.1,0,5.9,0,13,25.9,2426,2151,275,88.66,11.34,241,1910,77,198,318,2108,11.2,28,13.1,"25% - 50% P.O.C.","$108000 - $141000"
"06041108100","Census Tract 1081, Marin County, California",6543,119014,5432,36,13,305,0,511,83,0.6,0.2,4.7,0,7.8,17,2638,2211,427,83.81,16.19,48,2163,0,427,48,2590,2.2,0,1.8,"Less than 25% P.O.C.","$108000 - $141000"
"06041108200","Census Tract 1082, Marin County, California",6901,87713,3575,80,56,907,0,1713,51.8,1.2,0.8,13.1,0,24.8,48.2,2911,1403,1508,48.2,51.8,97,1306,201,1307,298,2613,6.9,13.3,10.2,"25% - 50% P.O.C.","$80000 - $108000"
"06041109001","Census Tract 1090.01, Marin County, California",4280,103344,2665,53,0,199,0,1140,62.3,1.2,0,4.6,0,26.6,37.7,1819,773,1046,42.5,57.5,70,703,61,985,131,1688,9.1,5.8,7.2,"25% - 50% P.O.C.","$80000 - $108000"
"06041109002","Census Tract 1090.02, Marin County, California",3851,111888,3278,68,0,227,0,179,85.1,1.8,0,5.9,0,4.6,14.9,1735,1030,705,59.37,40.63,35,995,9,696,44,1691,3.4,1.3,2.5,"Less than 25% P.O.C.","$108000 - $141000"
"06041110100","Census Tract 1101, Marin County, California",5903,101875,4320,93,0,449,0,959,73.2,1.6,0,7.6,0,16.2,26.8,2366,1239,1127,52.37,47.63,74,1165,125,1002,199,2167,6,11.1,8.4,"25% - 50% P.O.C.","$80000 - $108000"
"06041110200","Census Tract 1102, Marin County, California",5016,182064,4360,18,0,317,0,103,86.9,0.4,0,6.3,0,2.1,13.1,2175,1942,233,89.29,10.71,78,1864,0,233,78,2097,4,0,3.6,"Less than 25% P.O.C.","$141000 or more"
"06041111000","Census Tract 1110, Marin County, California",5204,79500,3644,182,0,174,0,1136,70,3.5,0,3.3,0,21.8,30,2804,696,2108,24.82,75.18,0,696,0,2108,0,2804,0,0,0,"25% - 50% P.O.C.","Less than $80000"
"06041112100","Census Tract 1121, Marin County, California",4512,96313,2729,29,0,131,0,1467,60.5,0.6,0,2.9,0,32.5,39.5,1881,973,908,51.73,48.27,39,934,106,802,145,1736,4,11.7,7.7,"25% - 50% P.O.C.","$80000 - $108000"
"06041112201","Census Tract 1122.01, Marin County, California",8175,49333,463,55,6,203,4,7279,5.7,0.7,0.1,2.5,0,89,94.3,1890,161,1729,8.52,91.48,50,111,677,1052,727,1163,31.1,39.2,38.5,"75% or more P.O.C.","Less than $80000"
"06041112202","Census Tract 1122.02, Marin County, California",4771,62886,989,24,0,454,0,3182,20.7,0.5,0,9.5,0,66.7,79.3,1323,484,839,36.58,63.42,74,410,305,534,379,944,15.3,36.4,28.6,"75% or more P.O.C.","Less than $80000"
"06041113000","Census Tract 1130, Marin County, California",3371,97321,2891,3,22,16,10,372,85.8,0.1,0.7,0.5,0.3,11,14.2,1485,1102,383,74.21,25.79,63,1039,52,331,115,1370,5.7,13.6,7.7,"Less than 25% P.O.C.","$80000 - $108000"
"06041114100","Census Tract 1141, Marin County, California",5206,111060,4274,2,0,292,24,398,82.1,0,0,5.6,0.5,7.6,17.9,2217,1504,713,67.84,32.16,50,1454,0,713,50,2167,3.3,0,2.3,"Less than 25% P.O.C.","$108000 - $141000"
"06041114200","Census Tract 1142, Marin County, California",3242,96591,2636,32,0,78,5,383,81.3,1,0,2.4,0.2,11.8,18.7,1440,875,565,60.76,39.24,21,854,9,556,30,1410,2.4,1.6,2.1,"Less than 25% P.O.C.","$80000 - $108000"
"06041115000","Census Tract 1150, Marin County, California",7528,146343,6486,0,0,179,0,708,86.2,0,0,2.4,0,9.4,13.8,2668,2248,420,84.26,15.74,173,2075,41,379,214,2454,7.7,9.8,8,"Less than 25% P.O.C.","$141000 or more"
"06041116000","Census Tract 1160, Marin County, California",3154,137802,2691,33,0,125,0,113,85.3,1,0,4,0,3.6,14.7,1309,876,433,66.92,33.08,83,793,0,433,83,1226,9.5,0,6.3,"Less than 25% P.O.C.","$108000 - $141000"
"06041117000","Census Tract 1170, Marin County, California",4212,105863,3643,63,0,173,0,298,86.5,1.5,0,4.1,0,7.1,13.5,1969,1116,853,56.68,43.32,115,1001,0,853,115,1854,10.3,0,5.8,"Less than 25% P.O.C.","$80000 - $108000"
"06041118100","Census Tract 1181, Marin County, California",2290,224500,2041,69,0,88,0,80,89.1,3,0,3.8,0,3.5,10.9,812,670,142,82.51,17.49,62,608,34,108,96,716,9.3,23.9,11.8,"Less than 25% P.O.C.","$141000 or more"
"06041119100","Census Tract 1191, Marin County, California",4983,233500,4486,0,0,139,0,213,90,0,0,2.8,0,4.3,10,1874,1449,425,77.32,22.68,159,1290,37,388,196,1678,11,8.7,10.5,"Less than 25% P.O.C.","$141000 or more"
"06041119201","Census Tract 1192.01, Marin County, California",3601,84056,2382,49,0,399,0,651,66.1,1.4,0,11.1,0,18.1,33.9,1880,587,1293,31.22,68.78,0,587,9,1284,9,1871,0,0.7,0.5,"25% - 50% P.O.C.","$80000 - $108000"
"06041119202","Census Tract 1192.02, Marin County, California",3546,194808,2773,16,0,221,14,335,78.2,0.5,0,6.2,0.4,9.4,21.8,1202,1107,95,92.1,7.9,146,961,11,84,157,1045,13.2,11.6,13.1,"Less than 25% P.O.C.","$141000 or more"
"06041120000","Census Tract 1200, Marin County, California",5857,122685,5134,24,44,170,0,172,87.7,0.4,0.8,2.9,0,2.9,12.3,2678,1768,910,66.02,33.98,139,1629,0,910,139,2539,7.9,0,5.2,"Less than 25% P.O.C.","$108000 - $141000"
"06041121100","Census Tract 1211, Marin County, California",5453,147763,4082,124,0,329,0,617,74.9,2.3,0,6,0,11.3,25.1,2234,1408,826,63.03,36.97,64,1344,0,826,64,2170,4.5,0,2.9,"25% - 50% P.O.C.","$141000 or more"
"06041121200","Census Tract 1212, Marin County, California",6414,145000,4879,119,22,423,5,632,76.1,1.9,0.3,6.6,0.1,9.9,23.9,2472,1352,1120,54.69,45.31,173,1179,65,1055,238,2234,12.8,5.8,9.6,"Less than 25% P.O.C.","$141000 or more"
"06041122000","Census Tract 1220, Marin County, California",2649,NA,496,775,57,79,47,959,18.7,29.3,2.2,3,1.8,36.2,81.3,0,0,0,NA,NA,0,0,0,0,0,0,NA,NA,NA,"75% or more P.O.C.","N/A"
"06041123000","Census Tract 1230, Marin County, California",2124,246250,1960,0,0,43,0,108,92.3,0,0,2,0,5.1,7.7,890,678,212,76.18,23.82,40,638,24,188,64,826,5.9,11.3,7.2,"Less than 25% P.O.C.","$141000 or more"
"06041124100","Census Tract 1241, Marin County, California",5889,159963,4718,0,0,374,0,444,80.1,0,0,6.4,0,7.5,19.9,2287,1585,702,69.3,30.7,124,1461,39,663,163,2124,7.8,5.6,7.1,"Less than 25% P.O.C.","$141000 or more"
"06041124200","Census Tract 1242, Marin County, California",5716,153512,4635,127,15,144,0,393,81.1,2.2,0.3,2.5,0,6.9,18.9,2520,1583,937,62.82,37.18,167,1416,95,842,262,2258,10.5,10.1,10.4,"Less than 25% P.O.C.","$141000 or more"
"06041125000","Census Tract 1250, Marin County, California",4177,98750,3104,65,0,503,22,317,74.3,1.6,0,12,0.5,7.6,25.7,1875,904,971,48.21,51.79,71,833,16,955,87,1788,7.9,1.6,4.6,"25% - 50% P.O.C.","$80000 - $108000"
"06041126100","Census Tract 1261, Marin County, California",6195,213811,5502,15,0,291,0,203,88.8,0.2,0,4.7,0,3.3,11.2,2467,1822,645,73.85,26.15,186,1636,43,602,229,2238,10.2,6.7,9.3,"Less than 25% P.O.C.","$141000 or more"
"06041126200","Census Tract 1262, Marin County, California",4224,116528,3491,3,0,246,0,308,82.6,0.1,0,5.8,0,7.3,17.4,1953,1065,888,54.53,45.47,34,1031,18,870,52,1901,3.2,2,2.7,"Less than 25% P.O.C.","$108000 - $141000"
"06041127000","Census Tract 1270, Marin County, California",4583,176776,3955,88,0,190,0,152,86.3,1.9,0,4.1,0,3.3,13.7,1959,1575,384,80.4,19.6,120,1455,0,384,120,1839,7.6,0,6.1,"Less than 25% P.O.C.","$141000 or more"
"06041128100","Census Tract 1281, Marin County, California",6911,160417,5758,0,0,405,0,366,83.3,0,0,5.9,0,5.3,16.7,2863,2157,706,75.34,24.66,160,1997,41,665,201,2662,7.4,5.8,7,"Less than 25% P.O.C.","$141000 or more"
"06041128200","Census Tract 1282, Marin County, California",4957,157321,4068,153,0,283,0,287,82.1,3.1,0,5.7,0,5.8,17.9,1918,1471,447,76.69,23.31,106,1365,68,379,174,1744,7.2,15.2,9.1,"Less than 25% P.O.C.","$141000 or more"
"06041129000","Census Tract 1290, Marin County, California",2939,38958,846,679,0,210,0,774,28.8,23.1,0,7.1,0,26.3,71.2,1229,219,1010,17.82,82.18,9,210,38,972,47,1182,4.1,3.8,3.8,"50% - 75% P.O.C.","Less than $80000"
"06041130201","Census Tract 1302.01, Marin County, California",3232,133611,2787,19,15,94,0,305,86.2,0.6,0.5,2.9,0,9.4,13.8,1834,933,901,50.87,49.13,24,909,11,890,35,1799,2.6,1.2,1.9,"Less than 25% P.O.C.","$108000 - $141000"
"06041130202","Census Tract 1302.02, Marin County, California",4377,105913,3855,42,0,133,0,288,88.1,1,0,3,0,6.6,11.9,2495,1548,947,62.04,37.96,35,1513,21,926,56,2439,2.3,2.2,2.2,"Less than 25% P.O.C.","$80000 - $108000"
"06041131100","Census Tract 1311, Marin County, California",1234,138750,1059,46,1,4,0,51,85.8,3.7,0.1,0.3,0,4.1,14.2,448,257,191,57.37,42.63,10,247,5,186,15,433,3.9,2.6,3.3,"Less than 25% P.O.C.","$108000 - $141000"
"06041132100","Census Tract 1321, Marin County, California",1825,85903,1596,0,0,22,0,90,87.5,0,0,1.2,0,4.9,12.5,913,568,345,62.21,37.79,11,557,7,338,18,895,1.9,2,2,"Less than 25% P.O.C.","$80000 - $108000"
"06041132200","Census Tract 1322, Marin County, California",1641,95441,1470,17,0,0,0,142,89.6,1,0,0,0,8.7,10.4,874,537,337,61.44,38.56,0,537,0,337,0,874,0,0,0,"Less than 25% P.O.C.","$80000 - $108000"
"06041133000","Census Tract 1330, Marin County, California",2658,96667,2159,0,74,48,0,332,81.2,0,2.8,1.8,0,12.5,18.8,1200,754,446,62.83,37.17,53,701,47,399,100,1100,7,10.5,8.3,"Less than 25% P.O.C.","$80000 - $108000"
"06041990100","Census Tract 9901, Marin County, California",0,NA,0,0,0,0,0,0,NA,NA,NA,NA,NA,NA,NA,0,0,0,NA,NA,0,0,0,0,0,0,NA,NA,NA,"N/A","N/A"
"06055200201","Census Tract 2002.01, Napa County, California",3528,79013,1998,20,0,33,0,1477,56.6,0.6,0,0.9,0,41.9,43.4,1260,578,682,45.87,54.13,47,531,118,564,165,1095,8.1,17.3,13.1,"25% - 50% P.O.C.","Less than $80000"
"06055200202","Census Tract 2002.02, Napa County, California",2461,63355,1259,77,0,51,24,1014,51.2,3.1,0,2.1,1,41.2,48.8,1037,364,673,35.1,64.9,0,364,69,604,69,968,0,10.3,6.7,"25% - 50% P.O.C.","Less than $80000"
"06055200203","Census Tract 2002.03, Napa County, California",2231,66806,980,6,0,0,0,1091,43.9,0.3,0,0,0,48.9,56.1,791,388,403,49.05,50.95,58,330,35,368,93,698,14.9,8.7,11.8,"50% - 75% P.O.C.","Less than $80000"
"06055200301","Census Tract 2003.01, Napa County, California",6037,80300,2404,21,0,170,0,3323,39.8,0.3,0,2.8,0,55,60.2,1850,967,883,52.27,47.73,137,830,321,562,458,1392,14.2,36.4,24.8,"50% - 75% P.O.C.","$80000 - $108000"
"06055200302","Census Tract 2003.02, Napa County, California",2755,110568,1363,30,0,205,0,1073,49.5,1.1,0,7.4,0,38.9,50.5,915,692,223,75.63,24.37,68,624,42,181,110,805,9.8,18.8,12,"50% - 75% P.O.C.","$108000 - $141000"
"06055200400","Census Tract 2004, Napa County, California",3747,94750,2820,13,0,81,0,672,75.3,0.3,0,2.2,0,17.9,24.7,1501,980,521,65.29,34.71,100,880,66,455,166,1335,10.2,12.7,11.1,"Less than 25% P.O.C.","$80000 - $108000"
"06055200501","Census Tract 2005.01, Napa County, California",5011,68950,1669,0,66,40,0,3107,33.3,0,1.3,0.8,0,62,66.7,1604,798,806,49.75,50.25,165,633,181,625,346,1258,20.7,22.5,21.6,"50% - 75% P.O.C.","Less than $80000"
"06055200503","Census Tract 2005.03, Napa County, California",1706,66683,887,9,15,31,0,744,52,0.5,0.9,1.8,0,43.6,48,711,175,536,24.61,75.39,28,147,43,493,71,640,16,8,10,"25% - 50% P.O.C.","Less than $80000"
"06055200504","Census Tract 2005.04, Napa County, California",6064,82886,2519,13,32,341,0,2903,41.5,0.2,0.5,5.6,0,47.9,58.5,2039,1053,986,51.64,48.36,107,946,140,846,247,1792,10.2,14.2,12.1,"50% - 75% P.O.C.","$80000 - $108000"
"06055200505","Census Tract 2005.05, Napa County, California",2583,78315,1043,16,0,303,0,1149,40.4,0.6,0,11.7,0,44.5,59.6,971,240,731,24.72,75.28,28,212,72,659,100,871,11.7,9.8,10.3,"50% - 75% P.O.C.","Less than $80000"
"06055200601","Census Tract 2006.01, Napa County, California",5633,106912,2986,4,0,179,0,2318,53,0.1,0,3.2,0,41.2,47,1566,1303,263,83.21,16.79,325,978,96,167,421,1145,24.9,36.5,26.9,"25% - 50% P.O.C.","$80000 - $108000"
"06055200602","Census Tract 2006.02, Napa County, California",4124,74707,2524,7,0,137,0,1422,61.2,0.2,0,3.3,0,34.5,38.8,1751,980,771,55.97,44.03,104,876,40,731,144,1607,10.6,5.2,8.2,"25% - 50% P.O.C.","Less than $80000"
"06055200703","Census Tract 2007.03, Napa County, California",2860,129290,2544,73,8,57,0,120,89,2.6,0.3,2,0,4.2,11,1139,1055,84,92.63,7.37,10,1045,8,76,18,1121,0.9,9.5,1.6,"Less than 25% P.O.C.","$108000 - $141000"
"06055200704","Census Tract 2007.04, Napa County, California",5312,64141,2730,9,1,108,34,2278,51.4,0.2,0,2,0.6,42.9,48.6,1729,1097,632,63.45,36.55,230,867,87,545,317,1412,21,13.8,18.3,"25% - 50% P.O.C.","Less than $80000"
"06055200705","Census Tract 2007.05, Napa County, California",3017,78946,1603,82,23,81,0,1101,53.1,2.7,0.8,2.7,0,36.5,46.9,1027,505,522,49.17,50.83,22,483,44,478,66,961,4.4,8.4,6.4,"25% - 50% P.O.C.","Less than $80000"
"06055200706","Census Tract 2007.06, Napa County, California",3213,113036,2216,0,0,156,0,819,69,0,0,4.9,0,25.5,31,1116,964,152,86.38,13.62,76,888,3,149,79,1037,7.9,2,7.1,"25% - 50% P.O.C.","$108000 - $141000"
"06055200707","Census Tract 2007.07, Napa County, California",3240,90951,2251,25,0,55,0,818,69.5,0.8,0,1.7,0,25.2,30.5,1320,777,543,58.86,41.14,12,765,35,508,47,1273,1.5,6.4,3.6,"25% - 50% P.O.C.","$80000 - $108000"
"06055200802","Census Tract 2008.02, Napa County, California",6228,99036,3141,30,13,207,42,2559,50.4,0.5,0.2,3.3,0.7,41.1,49.6,2311,969,1342,41.93,58.07,83,886,113,1229,196,2115,8.6,8.4,8.5,"25% - 50% P.O.C.","$80000 - $108000"
"06055200803","Census Tract 2008.03, Napa County, California",2133,108750,1555,28,0,106,0,407,72.9,1.3,0,5,0,19.1,27.1,854,568,286,66.51,33.49,24,544,33,253,57,797,4.2,11.5,6.7,"25% - 50% P.O.C.","$108000 - $141000"
"06055200804","Census Tract 2008.04, Napa County, California",5573,75125,1448,0,0,23,5,3888,26,0,0,0.4,0.1,69.8,74,1610,792,818,49.19,50.81,67,725,377,441,444,1166,8.5,46.1,27.6,"50% - 75% P.O.C.","Less than $80000"
"06055200900","Census Tract 2009, Napa County, California",757,9191,384,164,0,48,27,131,50.7,21.7,0,6.3,3.6,17.3,49.3,49,0,49,0,100,0,0,0,49,0,49,NA,0,0,"25% - 50% P.O.C.","Less than $80000"
"06055201003","Census Tract 2010.03, Napa County, California",5197,136250,865,685,0,2433,0,861,16.6,13.2,0,46.8,0,16.6,83.4,1349,913,436,67.68,32.32,308,605,44,392,352,997,33.7,10.1,26.1,"75% or more P.O.C.","$108000 - $141000"
"06055201004","Census Tract 2010.04, Napa County, California",5980,76844,1275,536,0,2135,32,1747,21.3,9,0,35.7,0.5,29.2,78.7,1744,1497,247,85.84,14.16,273,1224,70,177,343,1401,18.2,28.3,19.7,"75% or more P.O.C.","Less than $80000"
"06055201005","Census Tract 2010.05, Napa County, California",2500,104183,658,84,9,798,0,766,26.3,3.4,0.4,31.9,0,30.6,73.7,603,490,113,81.26,18.74,133,357,63,50,196,407,27.1,55.8,32.5,"50% - 75% P.O.C.","$80000 - $108000"
"06055201006","Census Tract 2010.06, Napa County, California",3314,104042,1118,73,3,914,0,1112,33.7,2.2,0.1,27.6,0,33.6,66.3,843,692,151,82.09,17.91,150,542,44,107,194,649,21.7,29.1,23,"50% - 75% P.O.C.","$80000 - $108000"
"06055201007","Census Tract 2010.07, Napa County, California",4058,108194,958,160,115,1180,87,1291,23.6,3.9,2.8,29.1,2.1,31.8,76.4,1012,756,256,74.7,25.3,210,546,64,192,274,738,27.8,25,27.1,"75% or more P.O.C.","$108000 - $141000"
"06055201101","Census Tract 2011.01, Napa County, California",2054,124000,1599,3,0,52,0,375,77.8,0.1,0,2.5,0,18.3,22.2,778,691,87,88.82,11.18,41,650,10,77,51,727,5.9,11.5,6.6,"Less than 25% P.O.C.","$108000 - $141000"
"06055201102","Census Tract 2011.02, Napa County, California",1904,119926,1535,0,74,103,0,172,80.6,0,3.9,5.4,0,9,19.4,717,554,163,77.27,22.73,22,532,15,148,37,680,4,9.2,5.2,"Less than 25% P.O.C.","$108000 - $141000"
"06055201200","Census Tract 2012, Napa County, California",5081,78011,3182,0,0,126,0,1693,62.6,0,0,2.5,0,33.3,37.4,2055,1810,245,88.08,11.92,66,1744,61,184,127,1928,3.6,24.9,6.2,"25% - 50% P.O.C.","Less than $80000"
"06055201300","Census Tract 2013, Napa County, California",2987,69300,2198,75,9,95,0,509,73.6,2.5,0.3,3.2,0,17,26.4,1372,865,507,63.05,36.95,16,849,7,500,23,1349,1.8,1.4,1.7,"25% - 50% P.O.C.","Less than $80000"
"06055201401","Census Tract 2014.01, Napa County, California",3024,135238,2525,98,0,11,0,228,83.5,3.2,0,0.4,0,7.5,16.5,1188,1045,143,87.96,12.04,58,987,18,125,76,1112,5.6,12.6,6.4,"Less than 25% P.O.C.","$108000 - $141000"
"06055201402","Census Tract 2014.02, Napa County, California",2917,169265,2719,2,0,38,0,132,93.2,0.1,0,1.3,0,4.5,6.8,1206,1052,154,87.23,12.77,8,1044,21,133,29,1177,0.8,13.6,2.4,"Less than 25% P.O.C.","$141000 or more"
"06055201403","Census Tract 2014.03, Napa County, California",738,167656,567,0,0,20,0,139,76.8,0,0,2.7,0,18.8,23.2,257,214,43,83.27,16.73,22,192,19,24,41,216,10.3,44.2,16,"Less than 25% P.O.C.","$141000 or more"
"06055201500","Census Tract 2015, Napa County, California",1846,129519,1161,3,0,59,0,523,62.9,0.2,0,3.2,0,28.3,37.1,717,543,174,75.73,24.27,14,529,20,154,34,683,2.6,11.5,4.7,"25% - 50% P.O.C.","$108000 - $141000"
"06055201601","Census Tract 2016.01, Napa County, California",2783,83750,1558,17,0,35,0,1138,56,0.6,0,1.3,0,40.9,44,1126,553,573,49.11,50.89,11,542,58,515,69,1057,2,10.1,6.1,"25% - 50% P.O.C.","$80000 - $108000"
"06055201602","Census Tract 2016.02, Napa County, California",3318,91889,2415,79,0,44,0,748,72.8,2.4,0,1.3,0,22.5,27.2,1576,1037,539,65.8,34.2,9,1028,51,488,60,1516,0.9,9.5,3.8,"25% - 50% P.O.C.","$80000 - $108000"
"06055201700","Census Tract 2017, Napa County, California",5288,96705,3047,291,19,573,15,1124,57.6,5.5,0.4,10.8,0.3,21.3,42.4,1591,1019,572,64.05,35.95,90,929,27,545,117,1474,8.8,4.7,7.4,"25% - 50% P.O.C.","$80000 - $108000"
"06055201800","Census Tract 2018, Napa County, California",1737,66600,1356,47,20,8,0,303,78.1,2.7,1.2,0.5,0,17.4,21.9,734,595,139,81.06,18.94,22,573,19,120,41,693,3.7,13.7,5.6,"Less than 25% P.O.C.","Less than $80000"
"06055201900","Census Tract 2019, Napa County, California",1413,103333,899,0,0,80,0,378,63.6,0,0,5.7,0,26.8,36.4,562,413,149,73.49,26.51,19,394,22,127,41,521,4.6,14.8,7.3,"25% - 50% P.O.C.","$80000 - $108000"
"06055202000","Census Tract 2020, Napa County, California",5271,67119,3251,0,0,80,18,1891,61.7,0,0,1.5,0.3,35.9,38.3,2124,1292,832,60.83,39.17,68,1224,88,744,156,1968,5.3,10.6,7.3,"25% - 50% P.O.C.","Less than $80000"
"06075010100","Census Tract 101, San Francisco County, California",3889,62414,1517,236,0,1534,0,475,39,6.1,0,39.4,0,12.2,61,2028,171,1857,8.43,91.57,0,171,26,1831,26,2002,0,1.4,1.3,"50% - 75% P.O.C.","Less than $80000"
"06075010200","Census Tract 102, San Francisco County, California",4167,151453,3363,84,0,503,0,136,80.7,2,0,12.1,0,3.3,19.3,2515,967,1548,38.45,61.55,30,937,11,1537,41,2474,3.1,0.7,1.6,"Less than 25% P.O.C.","$141000 or more"
"06075010300","Census Tract 103, San Francisco County, California",4359,150972,2591,0,0,1266,0,407,59.4,0,0,29,0,9.3,40.6,1971,473,1498,24,76,0,473,69,1429,69,1902,0,4.6,3.5,"25% - 50% P.O.C.","$141000 or more"
"06075010400","Census Tract 104, San Francisco County, California",4536,130732,2855,9,8,1024,22,344,62.9,0.2,0.2,22.6,0.5,7.6,37.1,2452,939,1513,38.3,61.7,45,894,44,1469,89,2363,4.8,2.9,3.6,"25% - 50% P.O.C.","$108000 - $141000"
"06075010500","Census Tract 105, San Francisco County, California",2779,135300,1384,252,0,658,0,210,49.8,9.1,0,23.7,0,7.6,50.2,1722,313,1409,18.18,81.82,0,313,0,1409,0,1722,0,0,0,"50% - 75% P.O.C.","$108000 - $141000"
"06075010600","Census Tract 106, San Francisco County, California",3429,63281,1213,64,0,1910,0,147,35.4,1.9,0,55.7,0,4.3,64.6,1817,221,1596,12.16,87.84,0,221,41,1555,41,1776,0,2.6,2.3,"50% - 75% P.O.C.","Less than $80000"
"06075010700","Census Tract 107, San Francisco County, California",5548,25323,814,0,33,4308,0,333,14.7,0,0.6,77.6,0,6,85.3,2540,136,2404,5.35,94.65,13,123,6,2398,19,2521,9.6,0.2,0.7,"75% or more P.O.C.","Less than $80000"
"06075010800","Census Tract 108, San Francisco County, California",5038,108879,2335,111,0,2149,0,312,46.3,2.2,0,42.7,0,6.2,53.7,2452,589,1863,24.02,75.98,25,564,41,1822,66,2386,4.2,2.2,2.7,"50% - 75% P.O.C.","$108000 - $141000"
"06075010900","Census Tract 109, San Francisco County, California",4486,141544,2954,69,0,1112,0,195,65.8,1.5,0,24.8,0,4.3,34.2,2496,473,2023,18.95,81.05,0,473,43,1980,43,2453,0,2.1,1.7,"25% - 50% P.O.C.","$141000 or more"
"06075011000","Census Tract 110, San Francisco County, California",5127,121523,2644,107,0,2061,0,315,51.6,2.1,0,40.2,0,6.1,48.4,2654,471,2183,17.75,82.25,0,471,47,2136,47,2607,0,2.2,1.8,"25% - 50% P.O.C.","$108000 - $141000"
"06075011100","Census Tract 111, San Francisco County, California",4835,108198,2226,202,0,1727,0,490,46,4.2,0,35.7,0,10.1,54,3086,206,2880,6.68,93.32,0,206,22,2858,22,3064,0,0.8,0.7,"50% - 75% P.O.C.","$108000 - $141000"
"06075011200","Census Tract 112, San Francisco County, California",3329,128333,1955,169,0,952,0,150,58.7,5.1,0,28.6,0,4.5,41.3,1844,538,1306,29.18,70.82,29,509,0,1306,29,1815,5.4,0,1.6,"25% - 50% P.O.C.","$108000 - $141000"
"06075011300","Census Tract 113, San Francisco County, California",2843,39292,441,0,0,2223,0,75,15.5,0,0,78.2,0,2.6,84.5,1509,164,1345,10.87,89.13,0,164,104,1241,104,1405,0,7.7,6.9,"75% or more P.O.C.","Less than $80000"
"06075011700","Census Tract 117, San Francisco County, California",1790,63250,562,67,0,860,0,185,31.4,3.7,0,48,0,10.3,68.6,1078,69,1009,6.4,93.6,0,69,8,1001,8,1070,0,0.8,0.7,"50% - 75% P.O.C.","Less than $80000"
"06075011800","Census Tract 118, San Francisco County, California",1570,37656,193,9,0,1310,0,24,12.3,0.6,0,83.4,0,1.5,87.7,749,7,742,0.93,99.07,0,7,26,716,26,723,0,3.5,3.5,"75% or more P.O.C.","Less than $80000"
"06075011901","Census Tract 119.01, San Francisco County, California",2699,103835,1401,59,0,629,14,363,51.9,2.2,0,23.3,0.5,13.4,48.1,1527,431,1096,28.23,71.77,0,431,0,1096,0,1527,0,0,0,"25% - 50% P.O.C.","$80000 - $108000"
"06075011902","Census Tract 119.02, San Francisco County, California",2712,84073,1510,25,0,829,12,202,55.7,0.9,0,30.6,0.4,7.4,44.3,1661,128,1533,7.71,92.29,12,116,8,1525,20,1641,9.4,0.5,1.2,"25% - 50% P.O.C.","$80000 - $108000"
"06075012000","Census Tract 120, San Francisco County, California",3973,51788,1555,241,9,1296,0,608,39.1,6.1,0.2,32.6,0,15.3,60.9,2501,61,2440,2.44,97.56,0,61,0,2440,0,2501,0,0,0,"50% - 75% P.O.C.","Less than $80000"
"06075012100","Census Tract 121, San Francisco County, California",3859,75711,1702,175,0,1133,0,700,44.1,4.5,0,29.4,0,18.1,55.9,2176,138,2038,6.34,93.66,0,138,52,1986,52,2124,0,2.6,2.4,"50% - 75% P.O.C.","Less than $80000"
"06075012201","Census Tract 122.01, San Francisco County, California",4620,67569,1869,278,0,827,0,1343,40.5,6,0,17.9,0,29.1,59.5,2615,115,2500,4.4,95.6,0,115,167,2333,167,2448,0,6.7,6.4,"50% - 75% P.O.C.","Less than $80000"
"06075012202","Census Tract 122.02, San Francisco County, California",3181,31538,1149,429,44,762,13,605,36.1,13.5,1.4,24,0.4,19,63.9,1616,99,1517,6.13,93.87,0,99,46,1471,46,1570,0,3,2.8,"50% - 75% P.O.C.","Less than $80000"
"06075012301","Census Tract 123.01, San Francisco County, California",2117,30366,640,112,0,717,0,596,30.2,5.3,0,33.9,0,28.2,69.8,1295,11,1284,0.85,99.15,0,11,63,1221,63,1232,0,4.9,4.9,"50% - 75% P.O.C.","Less than $80000"
"06075012302","Census Tract 123.02, San Francisco County, California",2713,56295,1087,137,0,797,0,615,40.1,5,0,29.4,0,22.7,59.9,1971,0,1971,0,100,0,0,8,1963,8,1963,NA,0.4,0.4,"50% - 75% P.O.C.","Less than $80000"
"06075012401","Census Tract 124.01, San Francisco County, California",4667,32571,1497,521,6,1180,48,1262,32.1,11.2,0.1,25.3,1,27,67.9,2762,0,2762,0,100,0,0,106,2656,106,2656,NA,3.8,3.8,"50% - 75% P.O.C.","Less than $80000"
"06075012402","Census Tract 124.02, San Francisco County, California",4662,60356,1546,391,2,1470,47,1011,33.2,8.4,0,31.5,1,21.7,66.8,2859,144,2715,5.04,94.96,0,144,18,2697,18,2841,0,0.7,0.6,"50% - 75% P.O.C.","Less than $80000"
"06075012501","Census Tract 125.01, San Francisco County, California",4293,24956,1012,396,17,1442,0,1193,23.6,9.2,0.4,33.6,0,27.8,76.4,2275,65,2210,2.86,97.14,0,65,145,2065,145,2130,0,6.6,6.4,"75% or more P.O.C.","Less than $80000"
"06075012502","Census Tract 125.02, San Francisco County, California",3674,16129,727,546,277,1443,0,592,19.8,14.9,7.5,39.3,0,16.1,80.2,2256,16,2240,0.71,99.29,0,16,30,2210,30,2226,0,1.3,1.3,"75% or more P.O.C.","Less than $80000"
"06075012601","Census Tract 126.01, San Francisco County, California",2516,149485,1913,62,0,292,0,238,76,2.5,0,11.6,0,9.5,24,1485,319,1166,21.48,78.52,8,311,0,1166,8,1477,2.5,0,0.5,"Less than 25% P.O.C.","$141000 or more"
"06075012602","Census Tract 126.02, San Francisco County, California",2844,158109,2158,13,0,496,0,111,75.9,0.5,0,17.4,0,3.9,24.1,1557,416,1141,26.72,73.28,25,391,11,1130,36,1521,6,1,2.3,"Less than 25% P.O.C.","$141000 or more"
"06075012700","Census Tract 127, San Francisco County, California",4092,153615,3167,36,0,384,0,295,77.4,0.9,0,9.4,0,7.2,22.6,2253,697,1556,30.94,69.06,36,661,10,1546,46,2207,5.2,0.6,2,"Less than 25% P.O.C.","$141000 or more"
"06075012800","Census Tract 128, San Francisco County, California",4556,182368,3575,2,0,373,0,531,78.5,0,0,8.2,0,11.7,21.5,2250,764,1486,33.96,66.04,71,693,0,1486,71,2179,9.3,0,3.2,"Less than 25% P.O.C.","$141000 or more"
"06075012901","Census Tract 129.01, San Francisco County, California",2783,154798,2148,1,9,365,25,150,77.2,0,0.3,13.1,0.9,5.4,22.8,1567,323,1244,20.61,79.39,11,312,0,1244,11,1556,3.4,0,0.7,"Less than 25% P.O.C.","$141000 or more"
"06075012902","Census Tract 129.02, San Francisco County, California",3865,132563,3061,83,10,353,0,238,79.2,2.1,0.3,9.1,0,6.2,20.8,2078,460,1618,22.14,77.86,12,448,0,1618,12,2066,2.6,0,0.6,"Less than 25% P.O.C.","$108000 - $141000"
"06075013000","Census Tract 130, San Francisco County, California",4719,170792,3930,0,31,403,0,246,83.3,0,0.7,8.5,0,5.2,16.7,2393,481,1912,20.1,79.9,83,398,35,1877,118,2275,17.3,1.8,4.9,"Less than 25% P.O.C.","$141000 or more"
"06075013101","Census Tract 131.01, San Francisco County, California",4061,181161,2920,85,0,629,0,290,71.9,2.1,0,15.5,0,7.1,28.1,2385,413,1972,17.32,82.68,0,413,0,1972,0,2385,0,0,0,"25% - 50% P.O.C.","$141000 or more"
"06075013102","Census Tract 131.02, San Francisco County, California",3012,171333,1971,9,0,569,0,239,65.4,0.3,0,18.9,0,7.9,34.6,1536,327,1209,21.29,78.71,0,327,0,1209,0,1536,0,0,0,"25% - 50% P.O.C.","$141000 or more"
"06075013200","Census Tract 132, San Francisco County, California",4292,204909,2943,115,0,793,0,335,68.6,2.7,0,18.5,0,7.8,31.4,2199,767,1432,34.88,65.12,61,706,0,1432,61,2138,8,0,2.8,"25% - 50% P.O.C.","$141000 or more"
"06075013300","Census Tract 133, San Francisco County, California",4634,166103,3343,76,0,616,0,340,72.1,1.6,0,13.3,0,7.3,27.9,1969,941,1028,47.79,52.21,86,855,31,997,117,1852,9.1,3,5.9,"25% - 50% P.O.C.","$141000 or more"
"06075013400","Census Tract 134, San Francisco County, California",3742,194412,2515,33,0,631,0,276,67.2,0.9,0,16.9,0,7.4,32.8,1850,648,1202,35.03,64.97,87,561,0,1202,87,1763,13.4,0,4.7,"25% - 50% P.O.C.","$141000 or more"
"06075013500","Census Tract 135, San Francisco County, California",2606,153148,1639,62,24,586,0,156,62.9,2.4,0.9,22.5,0,6,37.1,1542,402,1140,26.07,73.93,0,402,19,1121,19,1523,0,1.7,1.2,"25% - 50% P.O.C.","$141000 or more"
"06075015100","Census Tract 151, San Francisco County, California",2624,107568,1309,68,0,978,0,148,49.9,2.6,0,37.3,0,5.6,50.1,1662,526,1136,31.65,68.35,0,526,0,1136,0,1662,0,0,0,"50% - 75% P.O.C.","$80000 - $108000"
"06075015200","Census Tract 152, San Francisco County, California",4277,101475,2466,186,0,1048,0,395,57.7,4.3,0,24.5,0,9.2,42.3,2327,474,1853,20.37,79.63,0,474,15,1838,15,2312,0,0.8,0.6,"25% - 50% P.O.C.","$80000 - $108000"
"06075015300","Census Tract 153, San Francisco County, California",2289,153750,1326,266,0,298,22,275,57.9,11.6,0,13,1,12,42.1,976,371,605,38.01,61.99,14,357,0,605,14,962,3.8,0,1.4,"25% - 50% P.O.C.","$141000 or more"
"06075015400","Census Tract 154, San Francisco County, California",5951,136250,3831,36,0,1351,7,313,64.4,0.6,0,22.7,0.1,5.3,35.6,2836,882,1954,31.1,68.9,64,818,43,1911,107,2729,7.3,2.2,3.8,"25% - 50% P.O.C.","$108000 - $141000"
"06075015500","Census Tract 155, San Francisco County, California",3551,79783,1641,58,8,1163,27,329,46.2,1.6,0.2,32.8,0.8,9.3,53.8,2266,303,1963,13.37,86.63,0,303,0,1963,0,2266,0,0,0,"50% - 75% P.O.C.","Less than $80000"
"06075015600","Census Tract 156, San Francisco County, California",3506,112702,1343,88,14,1270,0,512,38.3,2.5,0.4,36.2,0,14.6,61.7,1483,390,1093,26.3,73.7,25,365,84,1009,109,1374,6.4,7.7,7.3,"50% - 75% P.O.C.","$108000 - $141000"
"06075015700","Census Tract 157, San Francisco County, California",8904,124942,4212,545,0,2140,10,1139,47.3,6.1,0,24,0.1,12.8,52.7,2634,941,1693,35.73,64.27,63,878,132,1561,195,2439,6.7,7.8,7.4,"50% - 75% P.O.C.","$108000 - $141000"
"06075015801","Census Tract 158.01, San Francisco County, California",3837,88636,1541,1015,0,763,0,240,40.2,26.5,0,19.9,0,6.3,59.8,1740,536,1204,30.8,69.2,0,536,22,1182,22,1718,0,1.8,1.3,"50% - 75% P.O.C.","$80000 - $108000"
"06075015802","Census Tract 158.02, San Francisco County, California",3412,135536,2141,261,0,307,16,356,62.7,7.6,0,9,0.5,10.4,37.3,1630,304,1326,18.65,81.35,0,304,25,1301,25,1605,0,1.9,1.5,"25% - 50% P.O.C.","$108000 - $141000"
"06075015900","Census Tract 159, San Francisco County, California",4832,80781,1479,365,71,2026,13,596,30.6,7.6,1.5,41.9,0.3,12.3,69.4,2231,611,1620,27.39,72.61,0,611,28,1592,28,2203,0,1.7,1.3,"50% - 75% P.O.C.","$80000 - $108000"
"06075016000","Census Tract 160, San Francisco County, California",2562,76989,1297,250,0,681,0,187,50.6,9.8,0,26.6,0,7.3,49.4,1687,407,1280,24.13,75.87,0,407,2,1278,2,1685,0,0.2,0.1,"25% - 50% P.O.C.","Less than $80000"
"06075016100","Census Tract 161, San Francisco County, California",5340,24450,1114,1890,0,1375,0,575,20.9,35.4,0,25.7,0,10.8,79.1,2727,262,2465,9.61,90.39,7,255,42,2423,49,2678,2.7,1.7,1.8,"75% or more P.O.C.","Less than $80000"
"06075016200","Census Tract 162, San Francisco County, California",3278,121406,1860,184,0,804,0,275,56.7,5.6,0,24.5,0,8.4,43.3,1839,291,1548,15.82,84.18,0,291,26,1522,26,1813,0,1.7,1.4,"25% - 50% P.O.C.","$108000 - $141000"
"06075016300","Census Tract 163, San Francisco County, California",4658,145054,2726,336,0,587,8,606,58.5,7.2,0,12.6,0.2,13,41.5,2040,413,1627,20.25,79.75,12,401,67,1560,79,1961,2.9,4.1,3.9,"25% - 50% P.O.C.","$141000 or more"
"06075016400","Census Tract 164, San Francisco County, California",4008,182868,2752,279,16,304,0,448,68.7,7,0.4,7.6,0,11.2,31.3,1769,384,1385,21.71,78.29,0,384,36,1349,36,1733,0,2.6,2,"25% - 50% P.O.C.","$141000 or more"
"06075016500","Census Tract 165, San Francisco County, California",5267,168536,3653,273,0,586,0,420,69.4,5.2,0,11.1,0,8,30.6,2225,663,1562,29.8,70.2,0,663,63,1499,63,2162,0,4,2.8,"25% - 50% P.O.C.","$141000 or more"
"06075016600","Census Tract 166, San Francisco County, California",5691,153672,4289,257,0,643,0,208,75.4,4.5,0,11.3,0,3.7,24.6,2439,535,1904,21.94,78.06,44,491,121,1783,165,2274,8.2,6.4,6.8,"Less than 25% P.O.C.","$141000 or more"
"06075016700","Census Tract 167, San Francisco County, California",5376,179867,3592,362,0,532,0,664,66.8,6.7,0,9.9,0,12.4,33.2,2373,668,1705,28.15,71.85,20,648,18,1687,38,2335,3,1.1,1.6,"25% - 50% P.O.C.","$141000 or more"
"06075016801","Census Tract 168.01, San Francisco County, California",4145,143333,2470,102,0,613,0,673,59.6,2.5,0,14.8,0,16.2,40.4,1950,418,1532,21.44,78.56,5,413,79,1453,84,1866,1.2,5.2,4.3,"25% - 50% P.O.C.","$141000 or more"
"06075016802","Census Tract 168.02, San Francisco County, California",3622,93542,1799,337,24,717,0,642,49.7,9.3,0.7,19.8,0,17.7,50.3,2054,450,1604,21.91,78.09,0,450,0,1604,0,2054,0,0,0,"50% - 75% P.O.C.","$80000 - $108000"
"06075016900","Census Tract 169, San Francisco County, California",3254,128594,2025,154,37,539,9,337,62.2,4.7,1.1,16.6,0.3,10.4,37.8,1657,457,1200,27.58,72.42,22,435,20,1180,42,1615,4.8,1.7,2.5,"25% - 50% P.O.C.","$108000 - $141000"
"06075017000","Census Tract 170, San Francisco County, California",4287,204821,3014,75,0,693,23,219,70.3,1.7,0,16.2,0.5,5.1,29.7,2183,1111,1072,50.89,49.11,0,1111,13,1059,13,2170,0,1.2,0.6,"25% - 50% P.O.C.","$141000 or more"
"06075017101","Census Tract 171.01, San Francisco County, California",4113,196447,3164,186,0,456,0,87,76.9,4.5,0,11.1,0,2.1,23.1,1732,757,975,43.71,56.29,59,698,5,970,64,1668,7.8,0.5,3.7,"Less than 25% P.O.C.","$141000 or more"
"06075017102","Census Tract 171.02, San Francisco County, California",4095,177396,2839,81,1,414,0,494,69.3,2,0,10.1,0,12.1,30.7,1679,701,978,41.75,58.25,45,656,15,963,60,1619,6.4,1.5,3.6,"25% - 50% P.O.C.","$141000 or more"
"06075017601","Census Tract 176.01, San Francisco County, California",10343,55998,2388,1107,0,4132,42,2109,23.1,10.7,0,39.9,0.4,20.4,76.9,5919,293,5626,4.95,95.05,12,281,162,5464,174,5745,4.1,2.9,2.9,"75% or more P.O.C.","Less than $80000"
"06075017700","Census Tract 177, San Francisco County, California",1915,129531,671,61,10,435,0,632,35,3.2,0.5,22.7,0,33,65,726,147,579,20.25,79.75,8,139,79,500,87,639,5.4,13.6,12,"50% - 75% P.O.C.","$108000 - $141000"
"06075017801","Census Tract 178.01, San Francisco County, California",3891,25472,1092,110,0,2265,0,314,28.1,2.8,0,58.2,0,8.1,71.9,2453,517,1936,21.08,78.92,0,517,0,1936,0,2453,0,0,0,"50% - 75% P.O.C.","Less than $80000"
"06075017802","Census Tract 178.02, San Francisco County, California",6367,95076,2106,483,6,2130,69,1206,33.1,7.6,0.1,33.5,1.1,18.9,66.9,2762,629,2133,22.77,77.23,18,611,78,2055,96,2666,2.9,3.7,3.5,"50% - 75% P.O.C.","$80000 - $108000"
"06075017902","Census Tract 179.02, San Francisco County, California",3008,54375,840,669,25,310,81,783,27.9,22.2,0.8,10.3,2.7,26,72.1,606,0,606,0,100,0,0,57,549,57,549,NA,9.4,9.4,"50% - 75% P.O.C.","Less than $80000"
"06075018000","Census Tract 180, San Francisco County, California",3457,179444,1594,390,27,784,26,408,46.1,11.3,0.8,22.7,0.8,11.8,53.9,1406,561,845,39.9,60.1,0,561,7,838,7,1399,0,0.8,0.5,"50% - 75% P.O.C.","$141000 or more"
"06075020100","Census Tract 201, San Francisco County, California",6343,71750,2056,597,6,1289,0,2142,32.4,9.4,0.1,20.3,0,33.8,67.6,3280,623,2657,18.99,81.01,29,594,73,2584,102,3178,4.7,2.7,3.1,"50% - 75% P.O.C.","Less than $80000"
"06075020200","Census Tract 202, San Francisco County, California",6131,106404,3256,397,47,1096,55,845,53.1,6.5,0.8,17.9,0.9,13.8,46.9,3137,623,2514,19.86,80.14,0,623,49,2465,49,3088,0,1.9,1.6,"25% - 50% P.O.C.","$80000 - $108000"
"06075020300","Census Tract 203, San Francisco County, California",3548,151750,2267,174,0,511,0,349,63.9,4.9,0,14.4,0,9.8,36.1,1820,505,1315,27.75,72.25,0,505,2,1313,2,1818,0,0.2,0.1,"25% - 50% P.O.C.","$141000 or more"
"06075020401","Census Tract 204.01, San Francisco County, California",3176,164423,2196,69,0,502,0,238,69.1,2.2,0,15.8,0,7.5,30.9,1538,797,741,51.82,48.18,9,788,14,727,23,1515,1.1,1.9,1.5,"25% - 50% P.O.C.","$141000 or more"
"06075020402","Census Tract 204.02, San Francisco County, California",4564,118625,2999,46,0,593,0,740,65.7,1,0,13,0,16.2,34.3,2469,669,1800,27.1,72.9,9,660,0,1800,9,2460,1.3,0,0.4,"25% - 50% P.O.C.","$108000 - $141000"
"06075020500","Census Tract 205, San Francisco County, California",3046,156250,2274,56,0,431,0,195,74.7,1.8,0,14.1,0,6.4,25.3,1400,572,828,40.86,59.14,50,522,41,787,91,1309,8.7,5,6.5,"25% - 50% P.O.C.","$141000 or more"
"06075020600","Census Tract 206, San Francisco County, California",5191,149057,3727,180,0,562,23,469,71.8,3.5,0,10.8,0.4,9,28.2,2732,987,1745,36.13,63.87,43,944,31,1714,74,2658,4.4,1.8,2.7,"25% - 50% P.O.C.","$141000 or more"
"06075020700","Census Tract 207, San Francisco County, California",4793,179018,2843,73,0,488,0,1080,59.3,1.5,0,10.2,0,22.5,40.7,2406,651,1755,27.06,72.94,0,651,0,1755,0,2406,0,0,0,"25% - 50% P.O.C.","$141000 or more"
"06075020800","Census Tract 208, San Francisco County, California",6458,105039,2486,180,85,1040,7,2351,38.5,2.8,1.3,16.1,0.1,36.4,61.5,2766,431,2335,15.58,84.42,16,415,152,2183,168,2598,3.7,6.5,6.1,"50% - 75% P.O.C.","$80000 - $108000"
"06075020900","Census Tract 209, San Francisco County, California",4597,132813,1937,111,0,606,0,1797,42.1,2.4,0,13.2,0,39.1,57.9,1882,331,1551,17.59,82.41,0,331,85,1466,85,1797,0,5.5,4.5,"50% - 75% P.O.C.","$108000 - $141000"
"06075021000","Census Tract 210, San Francisco County, California",4523,160789,2675,93,0,542,0,864,59.1,2.1,0,12,0,19.1,40.9,2078,530,1548,25.51,74.49,44,486,49,1499,93,1985,8.3,3.2,4.5,"25% - 50% P.O.C.","$141000 or more"
"06075021100","Census Tract 211, San Francisco County, California",4080,184620,2742,12,0,599,0,493,67.2,0.3,0,14.7,0,12.1,32.8,1865,897,968,48.1,51.9,16,881,28,940,44,1821,1.8,2.9,2.4,"25% - 50% P.O.C.","$141000 or more"
"06075021200","Census Tract 212, San Francisco County, California",3105,195375,2155,44,1,288,0,285,69.4,1.4,0,9.3,0,9.2,30.6,1411,851,560,60.31,39.69,34,817,11,549,45,1366,4,2,3.2,"25% - 50% P.O.C.","$141000 or more"
"06075021300","Census Tract 213, San Francisco County, California",2590,156458,1863,45,0,350,0,211,71.9,1.7,0,13.5,0,8.1,28.1,1213,681,532,56.14,43.86,20,661,0,532,20,1193,2.9,0,1.6,"25% - 50% P.O.C.","$141000 or more"
"06075021400","Census Tract 214, San Francisco County, California",3823,195905,2669,9,0,616,29,409,69.8,0.2,0,16.1,0.8,10.7,30.2,1681,789,892,46.94,53.06,27,762,0,892,27,1654,3.4,0,1.6,"25% - 50% P.O.C.","$141000 or more"
"06075021500","Census Tract 215, San Francisco County, California",5674,196500,3449,189,20,742,0,826,60.8,3.3,0.4,13.1,0,14.6,39.2,2516,1231,1285,48.93,51.07,37,1194,0,1285,37,2479,3,0,1.5,"25% - 50% P.O.C.","$141000 or more"
"06075021600","Census Tract 216, San Francisco County, California",4135,147229,2489,177,0,712,0,478,60.2,4.3,0,17.2,0,11.6,39.8,2101,1255,846,59.73,40.27,0,1255,0,846,0,2101,0,0,0,"25% - 50% P.O.C.","$141000 or more"
"06075021700","Census Tract 217, San Francisco County, California",4556,160417,2404,464,0,984,0,390,52.8,10.2,0,21.6,0,8.6,47.2,1814,1311,503,72.27,27.73,62,1249,7,496,69,1745,4.7,1.4,3.8,"25% - 50% P.O.C.","$141000 or more"
"06075021800","Census Tract 218, San Francisco County, California",4095,176469,2662,134,0,479,0,652,65,3.3,0,11.7,0,15.9,35,1829,1131,698,61.84,38.16,12,1119,18,680,30,1799,1.1,2.6,1.6,"25% - 50% P.O.C.","$141000 or more"
"06075022600","Census Tract 226, San Francisco County, California",3213,203158,1719,140,0,824,0,308,53.5,4.4,0,25.6,0,9.6,46.5,1536,565,971,36.78,63.22,0,565,6,965,6,1530,0,0.6,0.4,"25% - 50% P.O.C.","$141000 or more"
"06075022702","Census Tract 227.02, San Francisco County, California",2298,193804,1534,44,0,291,0,317,66.8,1.9,0,12.7,0,13.8,33.2,1056,420,636,39.77,60.23,15,405,13,623,28,1028,3.6,2,2.7,"25% - 50% P.O.C.","$141000 or more"
"06075022704","Census Tract 227.04, San Francisco County, California",3367,192231,2101,29,0,657,0,214,62.4,0.9,0,19.5,0,6.4,37.6,1538,976,562,63.46,36.54,64,912,0,562,64,1474,6.6,0,4.2,"25% - 50% P.O.C.","$141000 or more"
"06075022801","Census Tract 228.01, San Francisco County, California",5769,144318,2155,32,0,975,0,2355,37.4,0.6,0,16.9,0,40.8,62.6,1902,741,1161,38.96,61.04,57,684,198,963,255,1647,7.7,17.1,13.4,"50% - 75% P.O.C.","$141000 or more"
"06075022802","Census Tract 228.02, San Francisco County, California",2438,113281,863,154,0,445,0,877,35.4,6.3,0,18.3,0,36,64.6,687,191,496,27.8,72.2,16,175,65,431,81,606,8.4,13.1,11.8,"50% - 75% P.O.C.","$108000 - $141000"
"06075022803","Census Tract 228.03, San Francisco County, California",5224,137807,1658,137,0,635,0,2665,31.7,2.6,0,12.2,0,51,68.3,1540,608,932,39.48,60.52,81,527,168,764,249,1291,13.3,18,16.2,"50% - 75% P.O.C.","$108000 - $141000"
"06075022901","Census Tract 229.01, San Francisco County, California",4856,88368,1558,88,0,353,0,2710,32.1,1.8,0,7.3,0,55.8,67.9,1513,329,1184,21.74,78.26,46,283,209,975,255,1258,14,17.7,16.9,"50% - 75% P.O.C.","$80000 - $108000"
"06075022902","Census Tract 229.02, San Francisco County, California",2483,138571,922,102,0,295,0,1035,37.1,4.1,0,11.9,0,41.7,62.9,782,334,448,42.71,57.29,6,328,69,379,75,707,1.8,15.4,9.6,"50% - 75% P.O.C.","$108000 - $141000"
"06075022903","Census Tract 229.03, San Francisco County, California",3240,117313,1069,126,36,304,0,1609,33,3.9,1.1,9.4,0,49.7,67,1073,401,672,37.37,62.63,52,349,111,561,163,910,13,16.5,15.2,"50% - 75% P.O.C.","$108000 - $141000"
"06075023001","Census Tract 230.01, San Francisco County, California",5398,75223,263,598,0,3988,0,414,4.9,11.1,0,73.9,0,7.7,95.1,1381,990,391,71.69,28.31,256,734,80,311,336,1045,25.9,20.5,24.3,"75% or more P.O.C.","Less than $80000"
"06075023003","Census Tract 230.03, San Francisco County, California",4084,91845,329,862,0,2031,0,823,8.1,21.1,0,49.7,0,20.2,91.9,1225,1009,216,82.37,17.63,212,797,26,190,238,987,21,12,19.4,"75% or more P.O.C.","$80000 - $108000"
"06075023102","Census Tract 231.02, San Francisco County, California",4549,37981,239,2335,0,602,342,945,5.3,51.3,0,13.2,7.5,20.8,94.7,1557,503,1054,32.31,67.69,63,440,157,897,220,1337,12.5,14.9,14.1,"75% or more P.O.C.","Less than $80000"
"06075023103","Census Tract 231.03, San Francisco County, California",2890,24474,105,1470,0,334,186,653,3.6,50.9,0,11.6,6.4,22.6,96.4,954,113,841,11.84,88.16,10,103,67,774,77,877,8.8,8,8.1,"75% or more P.O.C.","Less than $80000"
"06075023200","Census Tract 232, San Francisco County, California",3972,81958,403,1085,0,672,0,1734,10.1,27.3,0,16.9,0,43.7,89.9,1209,743,466,61.46,38.54,117,626,57,409,174,1035,15.7,12.2,14.4,"75% or more P.O.C.","$80000 - $108000"
"06075023300","Census Tract 233, San Francisco County, California",3739,60104,257,530,0,2005,0,919,6.9,14.2,0,53.6,0,24.6,93.1,1209,576,633,47.64,52.36,134,442,81,552,215,994,23.3,12.8,17.8,"75% or more P.O.C.","Less than $80000"
"06075023400","Census Tract 234, San Francisco County, California",3661,51971,315,656,0,761,150,1507,8.6,17.9,0,20.8,4.1,41.2,91.4,1003,552,451,55.03,44.97,142,410,87,364,229,774,25.7,19.3,22.8,"75% or more P.O.C.","Less than $80000"
"06075025100","Census Tract 251, San Francisco County, California",3473,159375,1726,289,45,598,15,582,49.7,8.3,1.3,17.2,0.4,16.8,50.3,1305,888,417,68.05,31.95,88,800,18,399,106,1199,9.9,4.3,8.1,"50% - 75% P.O.C.","$141000 or more"
"06075025200","Census Tract 252, San Francisco County, California",5256,152813,3249,75,14,555,0,1161,61.8,1.4,0.3,10.6,0,22.1,38.2,2020,1327,693,65.69,34.31,78,1249,94,599,172,1848,5.9,13.6,8.5,"25% - 50% P.O.C.","$141000 or more"
"06075025300","Census Tract 253, San Francisco County, California",4454,138811,2380,40,46,585,0,1154,53.4,0.9,1,13.1,0,25.9,46.6,1846,832,1014,45.07,54.93,18,814,20,994,38,1808,2.2,2,2.1,"25% - 50% P.O.C.","$108000 - $141000"
"06075025401","Census Tract 254.01, San Francisco County, California",3775,141806,2178,43,0,362,0,1003,57.7,1.1,0,9.6,0,26.6,42.3,1439,638,801,44.34,55.66,16,622,51,750,67,1372,2.5,6.4,4.7,"25% - 50% P.O.C.","$141000 or more"
"06075025402","Census Tract 254.02, San Francisco County, California",3427,136172,1180,161,0,886,0,1125,34.4,4.7,0,25.9,0,32.8,65.6,1153,762,391,66.09,33.91,82,680,62,329,144,1009,10.8,15.9,12.5,"50% - 75% P.O.C.","$108000 - $141000"
"06075025403","Census Tract 254.03, San Francisco County, California",4782,108698,1294,417,6,1307,0,1588,27.1,8.7,0.1,27.3,0,33.2,72.9,1433,861,572,60.08,39.92,146,715,84,488,230,1203,17,14.7,16.1,"50% - 75% P.O.C.","$108000 - $141000"
"06075025500","Census Tract 255, San Francisco County, California",9684,117745,2092,135,0,4085,0,3017,21.6,1.4,0,42.2,0,31.2,78.4,2722,1945,777,71.45,28.55,399,1546,103,674,502,2220,20.5,13.3,18.4,"75% or more P.O.C.","$108000 - $141000"
"06075025600","Census Tract 256, San Francisco County, California",5314,92813,787,90,0,3074,0,1131,14.8,1.7,0,57.8,0,21.3,85.2,1480,1152,328,77.84,22.16,275,877,59,269,334,1146,23.9,18,22.6,"75% or more P.O.C.","$80000 - $108000"
"06075025701","Census Tract 257.01, San Francisco County, California",5088,89375,549,70,0,2989,10,1408,10.8,1.4,0,58.7,0.2,27.7,89.2,1440,1065,375,73.96,26.04,235,830,102,273,337,1103,22.1,27.2,23.4,"75% or more P.O.C.","$80000 - $108000"
"06075025702","Census Tract 257.02, San Francisco County, California",4401,75385,408,25,14,2728,35,1120,9.3,0.6,0.3,62,0.8,25.4,90.7,1298,702,596,54.08,45.92,205,497,114,482,319,979,29.2,19.1,24.6,"75% or more P.O.C.","Less than $80000"
"06075025800","Census Tract 258, San Francisco County, California",2224,93750,296,154,0,1096,0,642,13.3,6.9,0,49.3,0,28.9,86.7,640,336,304,52.5,47.5,91,245,48,256,139,501,27.1,15.8,21.7,"75% or more P.O.C.","$80000 - $108000"
"06075025900","Census Tract 259, San Francisco County, California",4618,105875,1204,434,0,2092,0,781,26.1,9.4,0,45.3,0,16.9,73.9,1475,1120,355,75.93,24.07,111,1009,45,310,156,1319,9.9,12.7,10.6,"50% - 75% P.O.C.","$80000 - $108000"
"06075026001","Census Tract 260.01, San Francisco County, California",5986,77534,644,120,5,2070,0,2950,10.8,2,0.1,34.6,0,49.3,89.2,1667,966,701,57.95,42.05,196,770,156,545,352,1315,20.3,22.3,21.1,"75% or more P.O.C.","Less than $80000"
"06075026002","Census Tract 260.02, San Francisco County, California",3644,119116,857,172,0,1408,0,1045,23.5,4.7,0,38.6,0,28.7,76.5,1009,792,217,78.49,21.51,121,671,40,177,161,848,15.3,18.4,16,"75% or more P.O.C.","$108000 - $141000"
"06075026003","Census Tract 260.03, San Francisco County, California",5126,95595,788,55,31,2112,0,2089,15.4,1.1,0.6,41.2,0,40.8,84.6,1402,959,443,68.4,31.6,171,788,126,317,297,1105,17.8,28.4,21.2,"75% or more P.O.C.","$80000 - $108000"
"06075026004","Census Tract 260.04, San Francisco County, California",4649,90625,603,96,50,1907,18,1844,13,2.1,1.1,41,0.4,39.7,87,1295,897,398,69.27,30.73,186,711,117,281,303,992,20.7,29.4,23.4,"75% or more P.O.C.","$80000 - $108000"
"06075026100","Census Tract 261, San Francisco County, California",7455,99283,537,94,0,4652,78,1898,7.2,1.3,0,62.4,1,25.5,92.8,2015,1195,820,59.31,40.69,254,941,171,649,425,1590,21.3,20.9,21.1,"75% or more P.O.C.","$80000 - $108000"
"06075026200","Census Tract 262, San Francisco County, California",7903,80784,377,84,0,5016,0,2244,4.8,1.1,0,63.5,0,28.4,95.2,2048,1273,775,62.16,37.84,449,824,93,682,542,1506,35.3,12,26.5,"75% or more P.O.C.","$80000 - $108000"
"06075026301","Census Tract 263.01, San Francisco County, California",5083,71182,591,45,7,3319,0,1111,11.6,0.9,0.1,65.3,0,21.9,88.4,1378,859,519,62.34,37.66,215,644,163,356,378,1000,25,31.4,27.4,"75% or more P.O.C.","Less than $80000"
"06075026302","Census Tract 263.02, San Francisco County, California",5255,88339,609,168,0,3070,0,1244,11.6,3.2,0,58.4,0,23.7,88.4,1461,935,526,64,36,105,830,154,372,259,1202,11.2,29.3,17.7,"75% or more P.O.C.","$80000 - $108000"
"06075026303","Census Tract 263.03, San Francisco County, California",4822,94286,666,33,0,2771,0,1332,13.8,0.7,0,57.5,0,27.6,86.2,1284,829,455,64.56,35.44,226,603,131,324,357,927,27.3,28.8,27.8,"75% or more P.O.C.","$80000 - $108000"
"06075026401","Census Tract 264.01, San Francisco County, California",3738,78891,127,359,0,2706,73,431,3.4,9.6,0,72.4,2,11.5,96.6,1013,786,227,77.59,22.41,163,623,29,198,192,821,20.7,12.8,19,"75% or more P.O.C.","Less than $80000"
"06075026402","Census Tract 264.02, San Francisco County, California",5102,83824,458,395,28,2361,0,1600,9,7.7,0.5,46.3,0,31.4,91,1274,782,492,61.38,38.62,204,578,93,399,297,977,26.1,18.9,23.3,"75% or more P.O.C.","$80000 - $108000"
"06075026403","Census Tract 264.03, San Francisco County, California",4082,80250,308,137,0,2616,15,988,7.5,3.4,0,64.1,0.4,24.2,92.5,1165,574,591,49.27,50.73,202,372,76,515,278,887,35.2,12.9,23.9,"75% or more P.O.C.","$80000 - $108000"
"06075026404","Census Tract 264.04, San Francisco County, California",2897,59018,103,331,0,1465,159,718,3.6,11.4,0,50.6,5.5,24.8,96.4,715,407,308,56.92,43.08,157,250,68,240,225,490,38.6,22.1,31.5,"75% or more P.O.C.","Less than $80000"
"06075030101","Census Tract 301.01, San Francisco County, California",5048,130050,2929,66,44,1318,18,432,58,1.3,0.9,26.1,0.4,8.6,42,2077,584,1493,28.12,71.88,22,562,23,1470,45,2032,3.8,1.5,2.2,"25% - 50% P.O.C.","$108000 - $141000"
"06075030102","Census Tract 301.02, San Francisco County, California",5262,139203,3381,86,0,1211,0,399,64.3,1.6,0,23,0,7.6,35.7,2316,1137,1179,49.09,50.91,33,1104,17,1162,50,2266,2.9,1.4,2.2,"25% - 50% P.O.C.","$108000 - $141000"
"06075030201","Census Tract 302.01, San Francisco County, California",4529,117663,2031,144,0,1605,9,401,44.8,3.2,0,35.4,0.2,8.9,55.2,1927,571,1356,29.63,70.37,42,529,16,1340,58,1869,7.4,1.2,3,"50% - 75% P.O.C.","$108000 - $141000"
"06075030202","Census Tract 302.02, San Francisco County, California",4438,128417,2297,89,0,1459,0,468,51.8,2,0,32.9,0,10.5,48.2,2141,564,1577,26.34,73.66,0,564,33,1544,33,2108,0,2.1,1.5,"25% - 50% P.O.C.","$108000 - $141000"
"06075030301","Census Tract 303.01, San Francisco County, California",5914,152900,2322,124,0,2604,0,441,39.3,2.1,0,44,0,7.5,60.7,2332,1321,1011,56.65,43.35,93,1228,40,971,133,2199,7,4,5.7,"50% - 75% P.O.C.","$141000 or more"
"06075030302","Census Tract 303.02, San Francisco County, California",4348,146111,1451,214,0,2003,11,429,33.4,4.9,0,46.1,0.3,9.9,66.6,1440,1095,345,76.04,23.96,149,946,0,345,149,1291,13.6,0,10.3,"50% - 75% P.O.C.","$141000 or more"
"06075030400","Census Tract 304, San Francisco County, California",5573,163942,2726,51,9,1962,36,479,48.9,0.9,0.2,35.2,0.6,8.6,51.1,1997,1563,434,78.27,21.73,148,1415,0,434,148,1849,9.5,0,7.4,"50% - 75% P.O.C.","$141000 or more"
"06075030500","Census Tract 305, San Francisco County, California",3230,151696,1478,210,0,963,28,342,45.8,6.5,0,29.8,0.9,10.6,54.2,1014,730,284,71.99,28.01,56,674,9,275,65,949,7.7,3.2,6.4,"50% - 75% P.O.C.","$141000 or more"
"06075030600","Census Tract 306, San Francisco County, California",2495,179228,1251,54,0,646,0,339,50.1,2.2,0,25.9,0,13.6,49.9,899,749,150,83.31,16.69,59,690,21,129,80,819,7.9,14,8.9,"25% - 50% P.O.C.","$141000 or more"
"06075030700","Census Tract 307, San Francisco County, California",7024,168828,3758,250,17,1945,0,715,53.5,3.6,0.2,27.7,0,10.2,46.5,2623,2072,551,78.99,21.01,134,1938,0,551,134,2489,6.5,0,5.1,"25% - 50% P.O.C.","$141000 or more"
"06075030800","Census Tract 308, San Francisco County, California",6226,173500,3285,277,13,2113,26,395,52.8,4.4,0.2,33.9,0.4,6.3,47.2,2304,1703,601,73.91,26.09,161,1542,16,585,177,2127,9.5,2.7,7.7,"25% - 50% P.O.C.","$141000 or more"
"06075030900","Census Tract 309, San Francisco County, California",7103,177694,3000,128,17,3163,2,482,42.2,1.8,0.2,44.5,0,6.8,57.8,2317,2169,148,93.61,6.39,309,1860,35,113,344,1973,14.2,23.6,14.8,"50% - 75% P.O.C.","$141000 or more"
"06075031000","Census Tract 310, San Francisco County, California",3804,138182,1894,56,0,1377,0,348,49.8,1.5,0,36.2,0,9.1,50.2,1444,1086,358,75.21,24.79,63,1023,8,350,71,1373,5.8,2.2,4.9,"50% - 75% P.O.C.","$108000 - $141000"
"06075031100","Census Tract 311, San Francisco County, California",6437,141843,2848,125,0,1812,12,1248,44.2,1.9,0,28.1,0.2,19.4,55.8,2333,1549,784,66.4,33.6,218,1331,56,728,274,2059,14.1,7.1,11.7,"50% - 75% P.O.C.","$141000 or more"
"06075031201","Census Tract 312.01, San Francisco County, California",6690,82222,1214,215,7,4080,0,1047,18.1,3.2,0.1,61,0,15.7,81.9,1886,1101,785,58.38,41.62,289,812,94,691,383,1503,26.2,12,20.3,"75% or more P.O.C.","$80000 - $108000"
"06075031202","Census Tract 312.02, San Francisco County, California",3394,93438,221,556,0,2009,20,361,6.5,16.4,0,59.2,0.6,10.6,93.5,877,627,250,71.49,28.51,164,463,24,226,188,689,26.2,9.6,21.4,"75% or more P.O.C.","$80000 - $108000"
"06075031301","Census Tract 313.01, San Francisco County, California",4241,108454,787,572,0,2284,0,406,18.6,13.5,0,53.9,0,9.6,81.4,1313,1000,313,76.16,23.84,138,862,45,268,183,1130,13.8,14.4,13.9,"75% or more P.O.C.","$108000 - $141000"
"06075031302","Census Tract 313.02, San Francisco County, California",6109,85250,665,686,0,3488,0,1022,10.9,11.2,0,57.1,0,16.7,89.1,1917,1391,526,72.56,27.44,202,1189,129,397,331,1586,14.5,24.5,17.3,"75% or more P.O.C.","$80000 - $108000"
"06075031400","Census Tract 314, San Francisco County, California",7096,84357,792,788,26,4040,0,1274,11.2,11.1,0.4,56.9,0,18,88.8,1880,1335,545,71.01,28.99,366,969,61,484,427,1453,27.4,11.2,22.7,"75% or more P.O.C.","$80000 - $108000"
"06075032601","Census Tract 326.01, San Francisco County, California",5211,120260,1633,181,0,2443,40,584,31.3,3.5,0,46.9,0.8,11.2,68.7,1789,739,1050,41.31,58.69,125,614,86,964,211,1578,16.9,8.2,11.8,"50% - 75% P.O.C.","$108000 - $141000"
"06075032602","Census Tract 326.02, San Francisco County, California",4753,108179,1524,14,0,2852,0,304,32.1,0.3,0,60,0,6.4,67.9,1778,819,959,46.06,53.94,72,747,37,922,109,1669,8.8,3.9,6.1,"50% - 75% P.O.C.","$108000 - $141000"
"06075032700","Census Tract 327, San Francisco County, California",6898,131270,2538,31,0,3391,72,471,36.8,0.4,0,49.2,1,6.8,63.2,2449,1779,670,72.64,27.36,252,1527,0,670,252,2197,14.2,0,10.3,"50% - 75% P.O.C.","$108000 - $141000"
"06075032801","Census Tract 328.01, San Francisco County, California",4401,111250,1036,127,0,2708,0,359,23.5,2.9,0,61.5,0,8.2,76.5,1567,956,611,61.01,38.99,141,815,34,577,175,1392,14.7,5.6,11.2,"75% or more P.O.C.","$108000 - $141000"
"06075032802","Census Tract 328.02, San Francisco County, California",4432,116473,1293,33,12,2506,0,361,29.2,0.7,0.3,56.5,0,8.1,70.8,1563,996,567,63.72,36.28,83,913,29,538,112,1451,8.3,5.1,7.2,"50% - 75% P.O.C.","$108000 - $141000"
"06075032901","Census Tract 329.01, San Francisco County, California",5615,128681,1264,13,0,3717,28,383,22.5,0.2,0,66.2,0.5,6.8,77.5,1749,1358,391,77.64,22.36,304,1054,58,333,362,1387,22.4,14.8,20.7,"75% or more P.O.C.","$108000 - $141000"
"06075032902","Census Tract 329.02, San Francisco County, California",4457,106307,1216,0,0,3019,0,137,27.3,0,0,67.7,0,3.1,72.7,1399,1007,392,71.98,28.02,151,856,85,307,236,1163,15,21.7,16.9,"50% - 75% P.O.C.","$80000 - $108000"
"06075033000","Census Tract 330, San Francisco County, California",8127,127219,3011,60,0,3894,0,678,37,0.7,0,47.9,0,8.3,63,2789,1734,1055,62.17,37.83,144,1590,150,905,294,2495,8.3,14.2,10.5,"50% - 75% P.O.C.","$108000 - $141000"
"06075033100","Census Tract 331, San Francisco County, California",3895,120508,1452,17,0,1973,20,165,37.3,0.4,0,50.7,0.5,4.2,62.7,1415,1202,213,84.95,15.05,126,1076,28,185,154,1261,10.5,13.1,10.9,"50% - 75% P.O.C.","$108000 - $141000"
"06075033201","Census Tract 332.01, San Francisco County, California",4551,35377,1342,322,0,994,27,1618,29.5,7.1,0,21.8,0.6,35.6,70.5,645,0,645,0,100,0,0,82,563,82,563,NA,12.7,12.7,"50% - 75% P.O.C.","Less than $80000"
"06075033203","Census Tract 332.03, San Francisco County, California",3956,54861,1796,134,0,1220,0,615,45.4,3.4,0,30.8,0,15.5,54.6,1575,99,1476,6.29,93.71,0,99,86,1390,86,1489,0,5.8,5.5,"50% - 75% P.O.C.","Less than $80000"
"06075033204","Census Tract 332.04, San Francisco County, California",4698,73250,1381,398,50,1420,0,1020,29.4,8.5,1.1,30.2,0,21.7,70.6,1676,0,1676,0,100,0,0,215,1461,215,1461,NA,12.8,12.8,"50% - 75% P.O.C.","Less than $80000"
"06075035100","Census Tract 351, San Francisco County, California",9116,142859,2737,126,25,4605,94,691,30,1.4,0.3,50.5,1,7.6,70,2881,1767,1114,61.33,38.67,293,1474,109,1005,402,2479,16.6,9.8,14,"50% - 75% P.O.C.","$141000 or more"
"06075035201","Census Tract 352.01, San Francisco County, California",5704,98485,2043,34,15,3061,0,419,35.8,0.6,0.3,53.7,0,7.3,64.2,1910,1351,559,70.73,29.27,201,1150,26,533,227,1683,14.9,4.7,11.9,"50% - 75% P.O.C.","$80000 - $108000"
"06075035202","Census Tract 352.02, San Francisco County, California",5244,89732,2114,371,39,1541,274,584,40.3,7.1,0.7,29.4,5.2,11.1,59.7,1885,680,1205,36.07,63.93,112,568,86,1119,198,1687,16.5,7.1,10.5,"50% - 75% P.O.C.","$80000 - $108000"
"06075035300","Census Tract 353, San Francisco County, California",7487,100266,2267,0,11,4321,0,589,30.3,0,0.1,57.7,0,7.9,69.7,2553,1718,835,67.29,32.71,231,1487,110,725,341,2212,13.4,13.2,13.4,"50% - 75% P.O.C.","$80000 - $108000"
"06075035400","Census Tract 354, San Francisco County, California",7342,107151,2521,186,0,3630,0,462,34.3,2.5,0,49.4,0,6.3,65.7,2550,1705,845,66.86,33.14,274,1431,0,845,274,2276,16.1,0,10.7,"50% - 75% P.O.C.","$80000 - $108000"
"06075040100","Census Tract 401, San Francisco County, California",4560,110849,2263,36,0,1741,0,350,49.6,0.8,0,38.2,0,7.7,50.4,1912,520,1392,27.2,72.8,61,459,60,1332,121,1791,11.7,4.3,6.3,"50% - 75% P.O.C.","$108000 - $141000"
"06075040200","Census Tract 402, San Francisco County, California",5600,107475,3175,49,0,1768,0,381,56.7,0.9,0,31.6,0,6.8,43.3,2433,1026,1407,42.17,57.83,85,941,41,1366,126,2307,8.3,2.9,5.2,"25% - 50% P.O.C.","$80000 - $108000"
"06075042601","Census Tract 426.01, San Francisco County, California",4004,96382,1843,197,6,1356,0,338,46,4.9,0.1,33.9,0,8.4,54,1789,500,1289,27.95,72.05,18,482,34,1255,52,1737,3.6,2.6,2.9,"50% - 75% P.O.C.","$80000 - $108000"
"06075042602","Census Tract 426.02, San Francisco County, California",2861,130742,1495,36,0,992,0,139,52.3,1.3,0,34.7,0,4.9,47.7,1349,465,884,34.47,65.53,15,450,7,877,22,1327,3.2,0.8,1.6,"25% - 50% P.O.C.","$108000 - $141000"
"06075042700","Census Tract 427, San Francisco County, California",5379,93250,2060,351,0,2337,0,433,38.3,6.5,0,43.4,0,8,61.7,2334,679,1655,29.09,70.91,25,654,61,1594,86,2248,3.7,3.7,3.7,"50% - 75% P.O.C.","$80000 - $108000"
"06075042800","Census Tract 428, San Francisco County, California",2507,169455,1705,0,0,462,0,104,68,0,0,18.4,0,4.1,32,891,671,220,75.31,24.69,107,564,6,214,113,778,15.9,2.7,12.7,"25% - 50% P.O.C.","$141000 or more"
"06075045100","Census Tract 451, San Francisco County, California",5126,141912,2321,142,29,1954,0,583,45.3,2.8,0.6,38.1,0,11.4,54.7,2052,823,1229,40.11,59.89,14,809,36,1193,50,2002,1.7,2.9,2.4,"50% - 75% P.O.C.","$141000 or more"
"06075045200","Census Tract 452, San Francisco County, California",7286,115292,3193,197,0,2905,0,519,43.8,2.7,0,39.9,0,7.1,56.2,2988,976,2012,32.66,67.34,109,867,74,1938,183,2805,11.2,3.7,6.1,"50% - 75% P.O.C.","$108000 - $141000"
"06075047600","Census Tract 476, San Francisco County, California",5670,113944,2211,26,0,2439,70,381,39,0.5,0,43,1.2,6.7,61,2320,878,1442,37.84,62.16,0,878,81,1361,81,2239,0,5.6,3.5,"50% - 75% P.O.C.","$108000 - $141000"
"06075047701","Census Tract 477.01, San Francisco County, California",4569,88846,1797,0,0,2070,0,324,39.3,0,0,45.3,0,7.1,60.7,2006,652,1354,32.5,67.5,82,570,32,1322,114,1892,12.6,2.4,5.7,"50% - 75% P.O.C.","$80000 - $108000"
"06075047702","Census Tract 477.02, San Francisco County, California",3927,114205,1567,23,0,2012,0,204,39.9,0.6,0,51.2,0,5.2,60.1,1499,685,814,45.7,54.3,76,609,45,769,121,1378,11.1,5.5,8.1,"50% - 75% P.O.C.","$108000 - $141000"
"06075047801","Census Tract 478.01, San Francisco County, California",4421,106016,1674,88,5,2027,0,251,37.9,2,0.1,45.8,0,5.7,62.1,1705,871,834,51.09,48.91,67,804,90,744,157,1548,7.7,10.8,9.2,"50% - 75% P.O.C.","$80000 - $108000"
"06075047802","Census Tract 478.02, San Francisco County, California",3869,96496,1565,20,0,1733,19,388,40.4,0.5,0,44.8,0.5,10,59.6,1411,580,831,41.11,58.89,88,492,48,783,136,1275,15.2,5.8,9.6,"50% - 75% P.O.C.","$80000 - $108000"
"06075047901","Census Tract 479.01, San Francisco County, California",7589,99917,2962,124,0,3734,0,365,39,1.6,0,49.2,0,4.8,61,2716,1372,1344,50.52,49.48,290,1082,44,1300,334,2382,21.1,3.3,12.3,"50% - 75% P.O.C.","$80000 - $108000"
"06075047902","Census Tract 479.02, San Francisco County, California",3632,108850,1661,0,0,1435,0,181,45.7,0,0,39.5,0,5,54.3,1523,752,771,49.38,50.62,52,700,42,729,94,1429,6.9,5.4,6.2,"50% - 75% P.O.C.","$108000 - $141000"
"06075060100","Census Tract 601, San Francisco County, California",4226,208000,2910,89,55,355,0,588,68.9,2.1,1.3,8.4,0,13.9,31.1,1324,34,1290,2.57,97.43,0,34,110,1180,110,1214,0,8.5,8.3,"25% - 50% P.O.C.","$141000 or more"
"06075060400","Census Tract 604, San Francisco County, California",1596,69182,814,83,10,407,0,167,51,5.2,0.6,25.5,0,10.5,49,1028,154,874,14.98,85.02,0,154,11,863,11,1017,0,1.3,1.1,"25% - 50% P.O.C.","Less than $80000"
"06075060502","Census Tract 605.02, San Francisco County, California",3511,29471,96,951,0,1170,238,923,2.7,27.1,0,33.3,6.8,26.3,97.3,993,206,787,20.75,79.25,84,122,116,671,200,793,40.8,14.7,20.1,"75% or more P.O.C.","Less than $80000"
"06075060700","Census Tract 607, San Francisco County, California",13222,161496,4862,294,0,5931,0,1666,36.8,2.2,0,44.9,0,12.6,63.2,6312,2157,4155,34.17,65.83,166,1991,70,4085,236,6076,7.7,1.7,3.7,"50% - 75% P.O.C.","$141000 or more"
"06075061000","Census Tract 610, San Francisco County, California",4839,80500,572,728,0,2905,29,451,11.8,15,0,60,0.6,9.3,88.2,1740,1037,703,59.6,40.4,170,867,18,685,188,1552,16.4,2.6,10.8,"75% or more P.O.C.","$80000 - $108000"
"06075061100","Census Tract 611, San Francisco County, California",4477,20373,133,10,44,4198,35,8,3,0.2,1,93.8,0.8,0.2,97,2109,114,1995,5.41,94.59,0,114,95,1900,95,2014,0,4.8,4.5,"75% or more P.O.C.","Less than $80000"
"06075061200","Census Tract 612, San Francisco County, California",3842,67625,308,1074,24,1129,22,1248,8,28,0.6,29.4,0.6,32.5,92,1209,496,713,41.03,58.97,81,415,108,605,189,1020,16.3,15.1,15.6,"75% or more P.O.C.","Less than $80000"
"06075061400","Census Tract 614, San Francisco County, California",6283,135638,2478,613,26,1394,0,1385,39.4,9.8,0.4,22.2,0,22,60.6,2627,1106,1521,42.1,57.9,45,1061,0,1521,45,2582,4.1,0,1.7,"50% - 75% P.O.C.","$108000 - $141000"
"06075061500","Census Tract 615, San Francisco County, California",16968,208425,7579,298,0,7295,41,1134,44.7,1.8,0,43,0.2,6.7,55.3,8497,3259,5238,38.35,61.65,92,3167,52,5186,144,8353,2.8,1,1.7,"50% - 75% P.O.C.","$141000 or more"
"06075980200","Census Tract 9802, San Francisco County, California",312,154167,146,50,0,105,0,11,46.8,16,0,33.7,0,3.5,53.2,70,44,26,62.86,37.14,0,44,0,26,0,70,0,0,0,"50% - 75% P.O.C.","$141000 or more"
"06075980300","Census Tract 9803, San Francisco County, California",63,139375,58,0,0,5,0,0,92.1,0,0,7.9,0,0,7.9,48,0,48,0,100,0,0,0,48,0,48,NA,0,0,"Less than 25% P.O.C.","$108000 - $141000"
"06075980401","Census Tract 9804.01, San Francisco County, California",0,NA,0,0,0,0,0,0,NA,NA,NA,NA,NA,NA,NA,0,0,0,NA,NA,0,0,0,0,0,0,NA,NA,NA,"N/A","N/A"
"06075980501","Census Tract 9805.01, San Francisco County, California",507,12340,0,114,0,258,34,101,0,22.5,0,50.9,6.7,19.9,100,239,35,204,14.64,85.36,5,30,0,204,5,234,14.3,0,2.1,"75% or more P.O.C.","Less than $80000"
"06075980600","Census Tract 9806, San Francisco County, California",690,66042,97,233,0,170,0,147,14.1,33.8,0,24.6,0,21.3,85.9,297,176,121,59.26,40.74,4,172,0,121,4,293,2.3,0,1.3,"75% or more P.O.C.","Less than $80000"
"06075980900","Census Tract 9809, San Francisco County, California",253,NA,131,18,0,56,0,48,51.8,7.1,0,22.1,0,19,48.2,141,11,130,7.8,92.2,0,11,0,130,0,141,0,0,0,"25% - 50% P.O.C.","N/A"
"06075990100","Census Tract 9901, San Francisco County, California",0,NA,0,0,0,0,0,0,NA,NA,NA,NA,NA,NA,NA,0,0,0,NA,NA,0,0,0,0,0,0,NA,NA,NA,"N/A","N/A"
"06081600100","Census Tract 6001, San Mateo County, California",5051,113484,2142,131,0,1673,0,862,42.4,2.6,0,33.1,0,17.1,57.6,2061,1555,506,75.45,24.55,106,1449,36,470,142,1919,6.8,7.1,6.9,"50% - 75% P.O.C.","$108000 - $141000"
"06081600200","Census Tract 6002, San Mateo County, California",4279,82702,133,105,0,2359,365,1177,3.1,2.5,0,55.1,8.5,27.5,96.9,1199,685,514,57.13,42.87,148,537,101,413,249,950,21.6,19.6,20.8,"75% or more P.O.C.","$80000 - $108000"
"06081600300","Census Tract 6003, San Mateo County, California",4100,140164,711,154,0,2399,0,692,17.3,3.8,0,58.5,0,16.9,82.7,1328,1173,155,88.33,11.67,154,1019,41,114,195,1133,13.1,26.5,14.7,"75% or more P.O.C.","$108000 - $141000"
"06081600401","Census Tract 6004.01, San Mateo County, California",3115,92803,351,56,0,2074,0,436,11.3,1.8,0,66.6,0,14,88.7,1072,847,225,79.01,20.99,86,761,30,195,116,956,10.2,13.3,10.8,"75% or more P.O.C.","$80000 - $108000"
"06081600402","Census Tract 6004.02, San Mateo County, California",5068,101083,364,123,0,2995,0,1465,7.2,2.4,0,59.1,0,28.9,92.8,1254,947,307,75.52,24.48,266,681,65,242,331,923,28.1,21.2,26.4,"75% or more P.O.C.","$80000 - $108000"
"06081600500","Census Tract 6005, San Mateo County, California",8445,121676,614,0,27,4548,0,3140,7.3,0,0.3,53.9,0,37.2,92.7,2221,1407,814,63.35,36.65,157,1250,362,452,519,1702,11.2,44.5,23.4,"75% or more P.O.C.","$108000 - $141000"
"06081600600","Census Tract 6006, San Mateo County, California",5637,96400,231,93,0,2586,0,2574,4.1,1.6,0,45.9,0,45.7,95.9,1500,874,626,58.27,41.73,262,612,98,528,360,1140,30,15.7,24,"75% or more P.O.C.","$80000 - $108000"
"06081600700","Census Tract 6007, San Mateo County, California",7466,77053,660,266,17,4108,0,2289,8.8,3.6,0.2,55,0,30.7,91.2,2084,1166,918,55.95,44.05,302,864,171,747,473,1611,25.9,18.6,22.7,"75% or more P.O.C.","Less than $80000"
"06081600800","Census Tract 6008, San Mateo County, California",7804,68520,892,690,0,4126,0,1703,11.4,8.8,0,52.9,0,21.8,88.6,2787,187,2600,6.71,93.29,0,187,327,2273,327,2460,0,12.6,11.7,"75% or more P.O.C.","Less than $80000"
"06081600900","Census Tract 6009, San Mateo County, California",3965,114904,1441,10,0,2056,0,266,36.3,0.3,0,51.9,0,6.7,63.7,1366,1039,327,76.06,23.94,99,940,35,292,134,1232,9.5,10.7,9.8,"50% - 75% P.O.C.","$108000 - $141000"
"06081601000","Census Tract 6010, San Mateo County, California",7094,117639,1134,478,12,3880,100,1256,16,6.7,0.2,54.7,1.4,17.7,84,2049,1644,405,80.23,19.77,265,1379,93,312,358,1691,16.1,23,17.5,"75% or more P.O.C.","$108000 - $141000"
"06081601100","Census Tract 6011, San Mateo County, California",6406,133250,1039,353,10,3386,480,882,16.2,5.5,0.2,52.9,7.5,13.8,83.8,1891,1523,368,80.54,19.46,160,1363,125,243,285,1606,10.5,34,15.1,"75% or more P.O.C.","$108000 - $141000"
"06081601200","Census Tract 6012, San Mateo County, California",6940,94336,1403,39,0,3425,0,1867,20.2,0.6,0,49.4,0,26.9,79.8,2146,1296,850,60.39,39.61,36,1260,206,644,242,1904,2.8,24.2,11.3,"75% or more P.O.C.","$80000 - $108000"
"06081601300","Census Tract 6013, San Mateo County, California",8524,75321,503,247,8,4221,0,3189,5.9,2.9,0.1,49.5,0,37.4,94.1,2554,468,2086,18.32,81.68,84,384,324,1762,408,2146,17.9,15.5,16,"75% or more P.O.C.","Less than $80000"
"06081601400","Census Tract 6014, San Mateo County, California",7059,86462,1118,24,0,4655,0,1078,15.8,0.3,0,65.9,0,15.3,84.2,2172,1495,677,68.83,31.17,211,1284,160,517,371,1801,14.1,23.6,17.1,"75% or more P.O.C.","$80000 - $108000"
"06081601501","Census Tract 6015.01, San Mateo County, California",5256,110221,519,60,55,3884,132,525,9.9,1.1,1,73.9,2.5,10,90.1,1349,961,388,71.24,28.76,225,736,184,204,409,940,23.4,47.4,30.3,"75% or more P.O.C.","$108000 - $141000"
"06081601502","Census Tract 6015.02, San Mateo County, California",5685,70895,590,327,0,3258,72,1349,10.4,5.8,0,57.3,1.3,23.7,89.6,1844,231,1613,12.53,87.47,63,168,112,1501,175,1669,27.3,6.9,9.5,"75% or more P.O.C.","Less than $80000"
"06081601601","Census Tract 6016.01, San Mateo County, California",2810,90625,588,53,0,1096,0,960,20.9,1.9,0,39,0,34.2,79.1,914,626,288,68.49,31.51,89,537,32,256,121,793,14.2,11.1,13.2,"75% or more P.O.C.","$80000 - $108000"
"06081601603","Census Tract 6016.03, San Mateo County, California",6009,111339,842,204,0,3896,224,752,14,3.4,0,64.8,3.7,12.5,86,1901,1271,630,66.86,33.14,202,1069,107,523,309,1592,15.9,17,16.3,"75% or more P.O.C.","$108000 - $141000"
"06081601604","Census Tract 6016.04, San Mateo County, California",2513,98523,745,168,0,1219,0,229,29.6,6.7,0,48.5,0,9.1,70.4,1106,797,309,72.06,27.94,27,770,18,291,45,1061,3.4,5.8,4.1,"50% - 75% P.O.C.","$80000 - $108000"
"06081601605","Census Tract 6016.05, San Mateo County, California",6310,125500,519,60,0,4586,0,832,8.2,1,0,72.7,0,13.2,91.8,1684,1403,281,83.31,16.69,303,1100,63,218,366,1318,21.6,22.4,21.7,"75% or more P.O.C.","$108000 - $141000"
"06081601700","Census Tract 6017, San Mateo County, California",4335,124496,1407,33,0,1736,0,1071,32.5,0.8,0,40,0,24.7,67.5,1317,1144,173,86.86,13.14,126,1018,10,163,136,1181,11,5.8,10.3,"50% - 75% P.O.C.","$108000 - $141000"
"06081601800","Census Tract 6018, San Mateo County, California",6697,126588,1890,82,0,3010,92,1398,28.2,1.2,0,44.9,1.4,20.9,71.8,2081,1542,539,74.1,25.9,198,1344,10,529,208,1873,12.8,1.9,10,"50% - 75% P.O.C.","$108000 - $141000"
"06081601901","Census Tract 6019.01, San Mateo County, California",4363,101711,920,16,0,1664,0,1659,21.1,0.4,0,38.1,0,38,78.9,1386,983,403,70.92,29.08,142,841,64,339,206,1180,14.4,15.9,14.9,"75% or more P.O.C.","$80000 - $108000"
"06081601902","Census Tract 6019.02, San Mateo County, California",5604,111875,1435,46,0,2518,0,1519,25.6,0.8,0,44.9,0,27.1,74.4,2206,709,1497,32.14,67.86,71,638,108,1389,179,2027,10,7.2,8.1,"50% - 75% P.O.C.","$108000 - $141000"
"06081602000","Census Tract 6020, San Mateo County, California",8593,106402,1369,18,0,3418,180,3400,15.9,0.2,0,39.8,2.1,39.6,84.1,2554,1989,565,77.88,22.12,303,1686,127,438,430,2124,15.2,22.5,16.8,"75% or more P.O.C.","$80000 - $108000"
"06081602100","Census Tract 6021, San Mateo County, California",3700,71506,433,138,7,689,160,2205,11.7,3.7,0.2,18.6,4.3,59.6,88.3,1041,284,757,27.28,72.72,49,235,161,596,210,831,17.3,21.3,20.2,"75% or more P.O.C.","Less than $80000"
"06081602200","Census Tract 6022, San Mateo County, California",8444,78185,1252,168,0,1468,0,5241,14.8,2,0,17.4,0,62.1,85.2,2465,453,2012,18.38,81.62,195,258,386,1626,581,1884,43,19.2,23.6,"75% or more P.O.C.","Less than $80000"
"06081602300","Census Tract 6023, San Mateo County, California",4196,106080,418,146,10,1013,117,2405,10,3.5,0.2,24.1,2.8,57.3,90,1139,796,343,69.89,30.11,154,642,73,270,227,912,19.3,21.3,19.9,"75% or more P.O.C.","$80000 - $108000"
"06081602400","Census Tract 6024, San Mateo County, California",7554,101151,2702,93,0,2134,41,1968,35.8,1.2,0,28.2,0.5,26.1,64.2,2652,1602,1050,60.41,39.59,191,1411,98,952,289,2363,11.9,9.3,10.9,"50% - 75% P.O.C.","$80000 - $108000"
"06081602500","Census Tract 6025, San Mateo County, California",5143,133906,795,270,0,3220,10,633,15.5,5.2,0,62.6,0.2,12.3,84.5,1534,1414,120,92.18,7.82,133,1281,45,75,178,1356,9.4,37.5,11.6,"75% or more P.O.C.","$108000 - $141000"
"06081602600","Census Tract 6026, San Mateo County, California",8489,124063,811,174,44,6038,121,960,9.6,2,0.5,71.1,1.4,11.3,90.4,2816,2025,791,71.91,28.09,225,1800,124,667,349,2467,11.1,15.7,12.4,"75% or more P.O.C.","$108000 - $141000"
"06081602700","Census Tract 6027, San Mateo County, California",6464,121842,1573,207,0,2438,714,1194,24.3,3.2,0,37.7,11,18.5,75.7,1942,1250,692,64.37,35.63,128,1122,53,639,181,1761,10.2,7.7,9.3,"75% or more P.O.C.","$108000 - $141000"
"06081602800","Census Tract 6028, San Mateo County, California",4902,128594,1551,183,0,1790,0,1210,31.6,3.7,0,36.5,0,24.7,68.4,1486,1173,313,78.94,21.06,170,1003,85,228,255,1231,14.5,27.2,17.2,"50% - 75% P.O.C.","$108000 - $141000"
"06081602900","Census Tract 6029, San Mateo County, California",3775,117575,1869,148,0,825,1,689,49.5,3.9,0,21.9,0,18.3,50.5,1597,847,750,53.04,46.96,37,810,35,715,72,1525,4.4,4.7,4.5,"50% - 75% P.O.C.","$108000 - $141000"
"06081603000","Census Tract 6030, San Mateo County, California",4371,122148,2746,92,39,489,47,643,62.8,2.1,0.9,11.2,1.1,14.7,37.2,1783,924,859,51.82,48.18,49,875,36,823,85,1698,5.3,4.2,4.8,"25% - 50% P.O.C.","$108000 - $141000"
"06081603100","Census Tract 6031, San Mateo County, California",3388,140000,2116,80,1,337,0,649,62.5,2.4,0,9.9,0,19.2,37.5,1194,1027,167,86.01,13.99,115,912,10,157,125,1069,11.2,6,10.5,"25% - 50% P.O.C.","$108000 - $141000"
"06081603200","Census Tract 6032, San Mateo County, California",3760,131375,2676,29,0,309,0,613,71.2,0.8,0,8.2,0,16.3,28.8,1343,1049,294,78.11,21.89,51,998,42,252,93,1250,4.9,14.3,6.9,"25% - 50% P.O.C.","$108000 - $141000"
"06081603300","Census Tract 6033, San Mateo County, California",6395,121513,4088,156,0,855,0,1020,63.9,2.4,0,13.4,0,15.9,36.1,2391,1978,413,82.73,17.27,120,1858,23,390,143,2248,6.1,5.6,6,"25% - 50% P.O.C.","$108000 - $141000"
"06081603400","Census Tract 6034, San Mateo County, California",5929,128016,3638,0,20,664,0,1291,61.4,0,0.3,11.2,0,21.8,38.6,2014,1474,540,73.19,26.81,148,1326,85,455,233,1781,10,15.7,11.6,"25% - 50% P.O.C.","$108000 - $141000"
"06081603700","Census Tract 6037, San Mateo County, California",5819,122308,1891,71,17,2105,114,1125,32.5,1.2,0.3,36.2,2,19.3,67.5,1790,1478,312,82.57,17.43,146,1332,69,243,215,1575,9.9,22.1,12,"50% - 75% P.O.C.","$108000 - $141000"
"06081603801","Census Tract 6038.01, San Mateo County, California",2384,82109,691,2,0,1178,0,368,29,0.1,0,49.4,0,15.4,71,1191,676,515,56.76,43.24,33,643,0,515,33,1158,4.9,0,2.8,"50% - 75% P.O.C.","$80000 - $108000"
"06081603802","Census Tract 6038.02, San Mateo County, California",5083,131920,2418,36,0,1446,0,896,47.6,0.7,0,28.4,0,17.6,52.4,1881,1411,470,75.01,24.99,90,1321,36,434,126,1755,6.4,7.7,6.7,"50% - 75% P.O.C.","$108000 - $141000"
"06081603900","Census Tract 6039, San Mateo County, California",5586,124983,2802,112,17,1449,0,1181,50.2,2,0.3,25.9,0,21.1,49.8,1989,1201,788,60.38,39.62,102,1099,71,717,173,1816,8.5,9,8.7,"25% - 50% P.O.C.","$108000 - $141000"
"06081604000","Census Tract 6040, San Mateo County, California",3326,125750,1527,0,0,854,0,862,45.9,0,0,25.7,0,25.9,54.1,1137,898,239,78.98,21.02,57,841,18,221,75,1062,6.3,7.5,6.6,"50% - 75% P.O.C.","$108000 - $141000"
"06081604101","Census Tract 6041.01, San Mateo County, California",8053,85915,1574,17,0,1950,715,3488,19.5,0.2,0,24.2,8.9,43.3,80.5,2484,706,1778,28.42,71.58,189,517,230,1548,419,2065,26.8,12.9,16.9,"75% or more P.O.C.","$80000 - $108000"
"06081604102","Census Tract 6041.02, San Mateo County, California",3020,98750,943,96,0,1239,176,368,31.2,3.2,0,41,5.8,12.2,68.8,1659,426,1233,25.68,74.32,5,421,20,1213,25,1634,1.2,1.6,1.5,"50% - 75% P.O.C.","$80000 - $108000"
"06081604200","Census Tract 6042, San Mateo County, California",4135,95588,754,44,6,643,163,2037,18.2,1.1,0.1,15.6,3.9,49.3,81.8,1114,774,340,69.48,30.52,244,530,0,340,244,870,31.5,0,21.9,"75% or more P.O.C.","$80000 - $108000"
"06081604400","Census Tract 6044, San Mateo County, California",5271,102805,1468,49,1,2369,4,999,27.9,0.9,0,44.9,0.1,19,72.1,1792,632,1160,35.27,64.73,76,556,95,1065,171,1621,12,8.2,9.5,"50% - 75% P.O.C.","$80000 - $108000"
"06081604500","Census Tract 6045, San Mateo County, California",3811,130577,1571,44,0,1585,4,381,41.2,1.2,0,41.6,0.1,10,58.8,1270,940,330,74.02,25.98,98,842,66,264,164,1106,10.4,20,12.9,"50% - 75% P.O.C.","$108000 - $141000"
"06081604600","Census Tract 6046, San Mateo County, California",2722,140708,1053,9,4,1388,0,94,38.7,0.3,0.1,51,0,3.5,61.3,923,841,82,91.12,8.88,86,755,49,33,135,788,10.2,59.8,14.6,"50% - 75% P.O.C.","$108000 - $141000"
"06081604700","Census Tract 6047, San Mateo County, California",2781,163947,1073,5,14,1349,0,230,38.6,0.2,0.5,48.5,0,8.3,61.4,950,780,170,82.11,17.89,85,695,22,148,107,843,10.9,12.9,11.3,"50% - 75% P.O.C.","$141000 or more"
"06081604800","Census Tract 6048, San Mateo County, California",5028,131020,1708,29,0,2538,0,548,34,0.6,0,50.5,0,10.9,66,1859,898,961,48.31,51.69,53,845,50,911,103,1756,5.9,5.2,5.5,"50% - 75% P.O.C.","$108000 - $141000"
"06081604900","Census Tract 6049, San Mateo County, California",3012,104412,786,3,2,1814,0,318,26.1,0.1,0.1,60.2,0,10.6,73.9,1182,989,193,83.67,16.33,81,908,0,193,81,1101,8.2,0,6.9,"50% - 75% P.O.C.","$80000 - $108000"
"06081605000","Census Tract 6050, San Mateo County, California",8376,156863,3607,174,0,3417,23,577,43.1,2.1,0,40.8,0.3,6.9,56.9,2878,1827,1051,63.48,36.52,185,1642,80,971,265,2613,10.1,7.6,9.2,"50% - 75% P.O.C.","$141000 or more"
"06081605100","Census Tract 6051, San Mateo County, California",3181,112984,1796,41,0,733,0,404,56.5,1.3,0,23,0,12.7,43.5,1322,410,912,31.01,68.99,14,396,50,862,64,1258,3.4,5.5,4.8,"25% - 50% P.O.C.","$108000 - $141000"
"06081605200","Census Tract 6052, San Mateo County, California",3494,198875,2332,1,0,819,14,166,66.7,0,0,23.4,0.4,4.8,33.3,1241,1036,205,83.48,16.52,113,923,0,205,113,1128,10.9,0,9.1,"25% - 50% P.O.C.","$141000 or more"
"06081605300","Census Tract 6053, San Mateo County, California",4651,130375,2515,36,0,1185,0,613,54.1,0.8,0,25.5,0,13.2,45.9,1807,1035,772,57.28,42.72,80,955,28,744,108,1699,7.7,3.6,6,"25% - 50% P.O.C.","$108000 - $141000"
"06081605400","Census Tract 6054, San Mateo County, California",6142,128795,3432,22,0,1288,0,1098,55.9,0.4,0,21,0,17.9,44.1,2583,1148,1435,44.44,55.56,116,1032,52,1383,168,2415,10.1,3.6,6.5,"25% - 50% P.O.C.","$108000 - $141000"
"06081605500","Census Tract 6055, San Mateo County, California",5469,110536,2881,93,0,1268,0,1051,52.7,1.7,0,23.2,0,19.2,47.3,2598,638,1960,24.56,75.44,21,617,52,1908,73,2525,3.3,2.7,2.8,"25% - 50% P.O.C.","$108000 - $141000"
"06081605600","Census Tract 6056, San Mateo County, California",6099,250001,3370,0,0,1986,22,290,55.3,0,0,32.6,0.4,4.8,44.7,1895,1744,151,92.03,7.97,307,1437,44,107,351,1544,17.6,29.1,18.5,"25% - 50% P.O.C.","$141000 or more"
"06081605700","Census Tract 6057, San Mateo County, California",5348,250001,3132,124,0,1619,0,176,58.6,2.3,0,30.3,0,3.3,41.4,1738,1645,93,94.65,5.35,260,1385,33,60,293,1445,15.8,35.5,16.9,"25% - 50% P.O.C.","$141000 or more"
"06081605800","Census Tract 6058, San Mateo County, California",2572,184625,1861,0,0,456,0,170,72.4,0,0,17.7,0,6.6,27.6,987,766,221,77.61,22.39,69,697,0,221,69,918,9,0,7,"25% - 50% P.O.C.","$141000 or more"
"06081605900","Census Tract 6059, San Mateo County, California",5880,101688,2386,68,17,1252,83,1641,40.6,1.2,0.3,21.3,1.4,27.9,59.4,2560,736,1824,28.75,71.25,16,720,107,1717,123,2437,2.2,5.9,4.8,"50% - 75% P.O.C.","$80000 - $108000"
"06081606000","Census Tract 6060, San Mateo County, California",5162,79031,1738,197,0,678,116,2227,33.7,3.8,0,13.1,2.2,43.1,66.3,2091,1028,1063,49.16,50.84,16,1012,237,826,253,1838,1.6,22.3,12.1,"50% - 75% P.O.C.","Less than $80000"
"06081606100","Census Tract 6061, San Mateo County, California",5378,100375,1217,83,0,740,633,2565,22.6,1.5,0,13.8,11.8,47.7,77.4,1359,845,514,62.18,37.82,168,677,195,319,363,996,19.9,37.9,26.7,"75% or more P.O.C.","$80000 - $108000"
"06081606200","Census Tract 6062, San Mateo County, California",7788,81231,1071,463,40,1381,208,4235,13.8,5.9,0.5,17.7,2.7,54.4,86.2,2219,899,1320,40.51,59.49,188,711,273,1047,461,1758,20.9,20.7,20.8,"75% or more P.O.C.","$80000 - $108000"
"06081606300","Census Tract 6063, San Mateo County, California",4110,92007,1796,107,15,1051,0,993,43.7,2.6,0.4,25.6,0,24.2,56.3,1805,918,887,50.86,49.14,44,874,126,761,170,1635,4.8,14.2,9.4,"50% - 75% P.O.C.","$80000 - $108000"
"06081606400","Census Tract 6064, San Mateo County, California",5134,167165,2896,16,0,1277,0,632,56.4,0.3,0,24.9,0,12.3,43.6,2413,978,1435,40.53,59.47,37,941,28,1407,65,2348,3.8,2,2.7,"25% - 50% P.O.C.","$141000 or more"
"06081606500","Census Tract 6065, San Mateo County, California",3501,250001,2318,40,0,620,1,282,66.2,1.1,0,17.7,0,8.1,33.8,1276,1152,124,90.28,9.72,110,1042,0,124,110,1166,9.5,0,8.6,"25% - 50% P.O.C.","$141000 or more"
"06081606600","Census Tract 6066, San Mateo County, California",3723,151369,1904,4,0,643,45,812,51.1,0.1,0,17.3,1.2,21.8,48.9,1404,755,649,53.77,46.23,73,682,25,624,98,1306,9.7,3.9,7,"25% - 50% P.O.C.","$141000 or more"
"06081606700","Census Tract 6067, San Mateo County, California",2455,144479,1524,0,0,638,0,113,62.1,0,0,26,0,4.6,37.9,977,782,195,80.04,19.96,49,733,5,190,54,923,6.3,2.6,5.5,"25% - 50% P.O.C.","$141000 or more"
"06081606800","Census Tract 6068, San Mateo County, California",3535,183173,2013,42,0,1311,0,59,56.9,1.2,0,37.1,0,1.7,43.1,1311,1032,279,78.72,21.28,42,990,0,279,42,1269,4.1,0,3.2,"25% - 50% P.O.C.","$141000 or more"
"06081606900","Census Tract 6069, San Mateo County, California",2898,183958,1510,72,0,811,60,258,52.1,2.5,0,28,2.1,8.9,47.9,963,812,151,84.32,15.68,48,764,9,142,57,906,5.9,6,5.9,"25% - 50% P.O.C.","$141000 or more"
"06081607000","Census Tract 6070, San Mateo County, California",3588,153125,1850,37,135,1030,0,267,51.6,1,3.8,28.7,0,7.4,48.4,1425,914,511,64.14,35.86,27,887,11,500,38,1387,3,2.2,2.7,"25% - 50% P.O.C.","$141000 or more"
"06081607100","Census Tract 6071, San Mateo County, California",3111,216037,1889,24,0,832,0,117,60.7,0.8,0,26.7,0,3.8,39.3,1078,961,117,89.15,10.85,67,894,25,92,92,986,7,21.4,8.5,"25% - 50% P.O.C.","$141000 or more"
"06081607200","Census Tract 6072, San Mateo County, California",4089,94688,1637,46,6,1103,68,1146,40,1.1,0.1,27,1.7,28,60,1619,365,1254,22.54,77.46,27,338,111,1143,138,1481,7.4,8.9,8.5,"50% - 75% P.O.C.","$80000 - $108000"
"06081607300","Census Tract 6073, San Mateo County, California",3642,177927,2111,0,0,823,0,461,58,0,0,22.6,0,12.7,42,1318,1091,227,82.78,17.22,21,1070,21,206,42,1276,1.9,9.3,3.2,"25% - 50% P.O.C.","$141000 or more"
"06081607400","Census Tract 6074, San Mateo County, California",4870,109355,2159,50,0,1228,0,1062,44.3,1,0,25.2,0,21.8,55.7,1996,959,1037,48.05,51.95,66,893,21,1016,87,1909,6.9,2,4.4,"50% - 75% P.O.C.","$108000 - $141000"
"06081607500","Census Tract 6075, San Mateo County, California",6150,133438,1918,213,0,2124,119,1466,31.2,3.5,0,34.5,1.9,23.8,68.8,2326,880,1446,37.83,62.17,47,833,82,1364,129,2197,5.3,5.7,5.5,"50% - 75% P.O.C.","$108000 - $141000"
"06081607600","Census Tract 6076, San Mateo County, California",3611,122614,1634,68,0,936,0,862,45.3,1.9,0,25.9,0,23.9,54.7,1275,829,446,65.02,34.98,63,766,69,377,132,1143,7.6,15.5,10.4,"50% - 75% P.O.C.","$108000 - $141000"
"06081607701","Census Tract 6077.01, San Mateo County, California",4396,107625,1089,27,20,881,571,1646,24.8,0.6,0.5,20,13,37.4,75.2,1207,724,483,59.98,40.02,142,582,88,395,230,977,19.6,18.2,19.1,"75% or more P.O.C.","$80000 - $108000"
"06081607702","Census Tract 6077.02, San Mateo County, California",3324,128068,781,102,7,630,367,1114,23.5,3.1,0.2,19,11,33.5,76.5,815,658,157,80.74,19.26,176,482,29,128,205,610,26.7,18.5,25.2,"75% or more P.O.C.","$108000 - $141000"
"06081607800","Census Tract 6078, San Mateo County, California",3380,138625,1397,63,0,901,131,672,41.3,1.9,0,26.7,3.9,19.9,58.7,1004,897,107,89.34,10.66,132,765,27,80,159,845,14.7,25.2,15.8,"50% - 75% P.O.C.","$108000 - $141000"
"06081607900","Census Tract 6079, San Mateo County, California",2988,109179,1684,71,0,904,0,206,56.4,2.4,0,30.3,0,6.9,43.6,1651,898,753,54.39,45.61,0,898,22,731,22,1629,0,2.9,1.3,"25% - 50% P.O.C.","$108000 - $141000"
"06081608001","Census Tract 6080.01, San Mateo County, California",3818,148676,1576,71,11,1706,23,251,41.3,1.9,0.3,44.7,0.6,6.6,58.7,1500,690,810,46,54,31,659,41,769,72,1428,4.5,5.1,4.8,"50% - 75% P.O.C.","$141000 or more"
"06081608002","Census Tract 6080.02, San Mateo County, California",3640,161847,1561,97,19,1492,0,260,42.9,2.7,0.5,41,0,7.1,57.1,1399,1150,249,82.2,17.8,30,1120,32,217,62,1337,2.6,12.9,4.4,"50% - 75% P.O.C.","$141000 or more"
"06081608004","Census Tract 6080.04, San Mateo County, California",8738,158494,2817,100,0,4435,0,977,32.2,1.1,0,50.8,0,11.2,67.8,3293,1169,2124,35.5,64.5,96,1073,79,2045,175,3118,8.2,3.7,5.3,"50% - 75% P.O.C.","$141000 or more"
"06081608013","Census Tract 6080.13, San Mateo County, California",4011,151506,1636,109,0,1909,0,258,40.8,2.7,0,47.6,0,6.4,59.2,1557,876,681,56.26,43.74,44,832,50,631,94,1463,5,7.3,6,"50% - 75% P.O.C.","$141000 or more"
"06081608023","Census Tract 6080.23, San Mateo County, California",2598,174063,869,57,2,1388,0,195,33.4,2.2,0.1,53.4,0,7.5,66.6,864,717,147,82.99,17.01,68,649,14,133,82,782,9.5,9.5,9.5,"50% - 75% P.O.C.","$141000 or more"
"06081608100","Census Tract 6081, San Mateo County, California",3775,140804,1440,176,21,1760,31,176,38.1,4.7,0.6,46.6,0.8,4.7,61.9,1393,957,436,68.7,31.3,40,917,45,391,85,1308,4.2,10.3,6.1,"50% - 75% P.O.C.","$108000 - $141000"
"06081608200","Census Tract 6082, San Mateo County, California",3833,167639,1628,34,0,1535,0,426,42.5,0.9,0,40,0,11.1,57.5,1330,875,455,65.79,34.21,94,781,43,412,137,1193,10.7,9.5,10.3,"50% - 75% P.O.C.","$141000 or more"
"06081608300","Census Tract 6083, San Mateo County, California",3584,162111,1015,184,0,1937,0,315,28.3,5.1,0,54,0,8.8,71.7,1354,817,537,60.34,39.66,59,758,26,511,85,1269,7.2,4.8,6.3,"50% - 75% P.O.C.","$141000 or more"
"06081608400","Census Tract 6084, San Mateo County, California",6030,128646,1297,172,0,2239,127,1805,21.5,2.9,0,37.1,2.1,29.9,78.5,2202,856,1346,38.87,61.13,129,727,142,1204,271,1931,15.1,10.5,12.3,"75% or more P.O.C.","$108000 - $141000"
"06081608501","Census Tract 6085.01, San Mateo County, California",5110,146985,2355,50,13,984,42,1171,46.1,1,0.3,19.3,0.8,22.9,53.9,1701,1011,690,59.44,40.56,113,898,27,663,140,1561,11.2,3.9,8.2,"50% - 75% P.O.C.","$141000 or more"
"06081608502","Census Tract 6085.02, San Mateo County, California",2675,129226,1188,39,12,826,46,459,44.4,1.5,0.4,30.9,1.7,17.2,55.6,1137,604,533,53.12,46.88,8,596,12,521,20,1117,1.3,2.3,1.8,"50% - 75% P.O.C.","$108000 - $141000"
"06081608600","Census Tract 6086, San Mateo County, California",4614,131161,1781,57,0,1684,160,727,38.6,1.2,0,36.5,3.5,15.8,61.4,1807,724,1083,40.07,59.93,47,677,71,1012,118,1689,6.5,6.6,6.5,"50% - 75% P.O.C.","$108000 - $141000"
"06081608700","Census Tract 6087, San Mateo County, California",6999,148839,4029,75,0,1716,15,861,57.6,1.1,0,24.5,0.2,12.3,42.4,2528,1807,721,71.48,28.52,78,1729,16,705,94,2434,4.3,2.2,3.7,"25% - 50% P.O.C.","$141000 or more"
"06081608800","Census Tract 6088, San Mateo County, California",6328,218583,3894,17,20,1573,0,552,61.5,0.3,0.3,24.9,0,8.7,38.5,2152,2013,139,93.54,6.46,117,1896,0,139,117,2035,5.8,0,5.4,"25% - 50% P.O.C.","$141000 or more"
"06081608900","Census Tract 6089, San Mateo County, California",6948,143295,3540,23,16,2154,82,846,50.9,0.3,0.2,31,1.2,12.2,49.1,2975,1169,1806,39.29,60.71,71,1098,80,1726,151,2824,6.1,4.4,5.1,"25% - 50% P.O.C.","$141000 or more"
"06081609000","Census Tract 6090, San Mateo County, California",2470,118080,1554,103,25,350,0,298,62.9,4.2,1,14.2,0,12.1,37.1,957,663,294,69.28,30.72,37,626,20,274,57,900,5.6,6.8,6,"25% - 50% P.O.C.","$108000 - $141000"
"06081609100","Census Tract 6091, San Mateo County, California",1534,145000,976,14,2,198,0,139,63.6,0.9,0.1,12.9,0,9.1,36.4,548,441,107,80.47,19.53,69,372,8,99,77,471,15.6,7.5,14.1,"25% - 50% P.O.C.","$141000 or more"
"06081609201","Census Tract 6092.01, San Mateo County, California",3628,160708,2750,26,0,398,0,221,75.8,0.7,0,11,0,6.1,24.2,1497,954,543,63.73,36.27,58,896,0,543,58,1439,6.1,0,3.9,"Less than 25% P.O.C.","$141000 or more"
"06081609202","Census Tract 6092.02, San Mateo County, California",4838,117045,2555,106,0,1115,40,827,52.8,2.2,0,23,0.8,17.1,47.2,1922,685,1237,35.64,64.36,24,661,72,1165,96,1826,3.5,5.8,5,"25% - 50% P.O.C.","$108000 - $141000"
"06081609300","Census Tract 6093, San Mateo County, California",3431,185893,2554,0,0,291,0,374,74.4,0,0,8.5,0,10.9,25.6,1187,941,246,79.28,20.72,93,848,10,236,103,1084,9.9,4.1,8.7,"25% - 50% P.O.C.","$141000 or more"
"06081609400","Census Tract 6094, San Mateo County, California",3359,220694,2676,0,0,337,0,131,79.7,0,0,10,0,3.9,20.3,1095,938,157,85.66,14.34,90,848,12,145,102,993,9.6,7.6,9.3,"Less than 25% P.O.C.","$141000 or more"
"06081609500","Census Tract 6095, San Mateo County, California",4930,224188,3111,0,0,982,0,638,63.1,0,0,19.9,0,12.9,36.9,1677,1461,216,87.12,12.88,160,1301,0,216,160,1517,11,0,9.5,"25% - 50% P.O.C.","$141000 or more"
"06081609601","Census Tract 6096.01, San Mateo County, California",3363,238846,2273,66,0,596,0,135,67.6,2,0,17.7,0,4,32.4,1234,948,286,76.82,23.18,103,845,0,286,103,1131,10.9,0,8.3,"25% - 50% P.O.C.","$141000 or more"
"06081609602","Census Tract 6096.02, San Mateo County, California",1803,198929,1240,0,0,321,0,137,68.8,0,0,17.8,0,7.6,31.2,666,589,77,88.44,11.56,52,537,0,77,52,614,8.8,0,7.8,"25% - 50% P.O.C.","$141000 or more"
"06081609603","Census Tract 6096.03, San Mateo County, California",5226,189914,3890,31,0,668,0,309,74.4,0.6,0,12.8,0,5.9,25.6,2038,1799,239,88.27,11.73,74,1725,0,239,74,1964,4.1,0,3.6,"25% - 50% P.O.C.","$141000 or more"
"06081609700","Census Tract 6097, San Mateo County, California",4936,248667,3930,49,0,296,0,432,79.6,1,0,6,0,8.8,20.4,1706,1523,183,89.27,10.73,131,1392,0,183,131,1575,8.6,0,7.7,"Less than 25% P.O.C.","$141000 or more"
"06081609800","Census Tract 6098, San Mateo County, California",4884,148333,3342,66,0,504,0,791,68.4,1.4,0,10.3,0,16.2,31.6,1704,1334,370,78.29,21.71,115,1219,15,355,130,1574,8.6,4.1,7.6,"25% - 50% P.O.C.","$141000 or more"
"06081609900","Census Tract 6099, San Mateo County, California",3206,196739,2543,0,20,52,45,413,79.3,0,0.6,1.6,1.4,12.9,20.7,1102,963,139,87.39,12.61,73,890,42,97,115,987,7.6,30.2,10.4,"Less than 25% P.O.C.","$141000 or more"
"06081610000","Census Tract 6100, San Mateo County, California",4985,134398,3046,42,8,672,0,1083,61.1,0.8,0.2,13.5,0,21.7,38.9,2041,946,1095,46.35,53.65,97,849,18,1077,115,1926,10.3,1.6,5.6,"25% - 50% P.O.C.","$108000 - $141000"
"06081610100","Census Tract 6101, San Mateo County, California",2544,82768,1149,80,21,138,0,1066,45.2,3.1,0.8,5.4,0,41.9,54.8,979,449,530,45.86,54.14,21,428,60,470,81,898,4.7,11.3,8.3,"50% - 75% P.O.C.","$80000 - $108000"
"06081610201","Census Tract 6102.01, San Mateo County, California",5568,60658,900,238,0,406,44,3853,16.2,4.3,0,7.3,0.8,69.2,83.8,1788,417,1371,23.32,76.68,136,281,195,1176,331,1457,32.6,14.2,18.5,"75% or more P.O.C.","Less than $80000"
"06081610202","Census Tract 6102.02, San Mateo County, California",4013,136103,1790,169,8,801,15,1049,44.6,4.2,0.2,20,0.4,26.1,55.4,1721,26,1695,1.51,98.49,0,26,39,1656,39,1682,0,2.3,2.3,"50% - 75% P.O.C.","$108000 - $141000"
"06081610203","Census Tract 6102.03, San Mateo County, California",3878,65161,310,39,0,115,183,3161,8,1,0,3,4.7,81.5,92,1076,120,956,11.15,88.85,29,91,215,741,244,832,24.2,22.5,22.7,"75% or more P.O.C.","Less than $80000"
"06081610302","Census Tract 6103.02, San Mateo County, California",3751,107885,1463,31,12,642,60,1497,39,0.8,0.3,17.1,1.6,39.9,61,1282,734,548,57.25,42.75,83,651,17,531,100,1182,11.3,3.1,7.8,"50% - 75% P.O.C.","$80000 - $108000"
"06081610303","Census Tract 6103.03, San Mateo County, California",8045,189634,3059,61,40,3719,79,379,38,0.8,0.5,46.2,1,4.7,62,3320,2247,1073,67.68,32.32,87,2160,74,999,161,3159,3.9,6.9,4.8,"50% - 75% P.O.C.","$141000 or more"
"06081610304","Census Tract 6103.04, San Mateo County, California",4416,145855,2176,38,0,1425,0,537,49.3,0.9,0,32.3,0,12.2,50.7,1877,1421,456,75.71,24.29,46,1375,12,444,58,1819,3.2,2.6,3.1,"50% - 75% P.O.C.","$141000 or more"
"06081610400","Census Tract 6104, San Mateo County, California",6049,71250,1290,138,8,390,230,3905,21.3,2.3,0.1,6.4,3.8,64.6,78.7,1698,708,990,41.7,58.3,73,635,312,678,385,1313,10.3,31.5,22.7,"75% or more P.O.C.","Less than $80000"
"06081610500","Census Tract 6105, San Mateo County, California",5245,73036,620,32,0,153,0,4385,11.8,0.6,0,2.9,0,83.6,88.2,1370,832,538,60.73,39.27,259,573,205,333,464,906,31.1,38.1,33.9,"75% or more P.O.C.","Less than $80000"
"06081610601","Census Tract 6106.01, San Mateo County, California",5432,61602,499,66,0,358,0,4389,9.2,1.2,0,6.6,0,80.8,90.8,1609,522,1087,32.44,67.56,159,363,149,938,308,1301,30.5,13.7,19.1,"75% or more P.O.C.","Less than $80000"
"06081610602","Census Tract 6106.02, San Mateo County, California",3695,138375,1423,76,9,310,0,1776,38.5,2.1,0.2,8.4,0,48.1,61.5,1204,820,384,68.11,31.89,56,764,104,280,160,1044,6.8,27.1,13.3,"50% - 75% P.O.C.","$108000 - $141000"
"06081610700","Census Tract 6107, San Mateo County, California",5801,107779,2648,26,4,652,80,2244,45.6,0.4,0.1,11.2,1.4,38.7,54.4,2109,875,1234,41.49,58.51,27,848,155,1079,182,1927,3.1,12.6,8.6,"50% - 75% P.O.C.","$80000 - $108000"
"06081610800","Census Tract 6108, San Mateo County, California",4871,70938,1278,163,0,428,0,2869,26.2,3.3,0,8.8,0,58.9,73.8,1640,254,1386,15.49,84.51,0,254,230,1156,230,1410,0,16.6,14,"50% - 75% P.O.C.","Less than $80000"
"06081610900","Census Tract 6109, San Mateo County, California",7137,68269,2446,52,22,443,0,3994,34.3,0.7,0.3,6.2,0,56,65.7,2528,639,1889,25.28,74.72,52,587,247,1642,299,2229,8.1,13.1,11.8,"50% - 75% P.O.C.","Less than $80000"
"06081611000","Census Tract 6110, San Mateo County, California",6965,136075,3205,108,0,656,0,2754,46,1.6,0,9.4,0,39.5,54,2381,1244,1137,52.25,47.75,110,1134,89,1048,199,2182,8.8,7.8,8.4,"50% - 75% P.O.C.","$108000 - $141000"
"06081611100","Census Tract 6111, San Mateo County, California",6453,178578,4763,4,101,795,65,546,73.8,0.1,1.6,12.3,1,8.5,26.2,2331,2045,286,87.73,12.27,171,1874,17,269,188,2143,8.4,5.9,8.1,"25% - 50% P.O.C.","$141000 or more"
"06081611200","Census Tract 6112, San Mateo County, California",2816,173125,1867,62,0,262,0,496,66.3,2.2,0,9.3,0,17.6,33.7,1045,888,157,84.98,15.02,48,840,24,133,72,973,5.4,15.3,6.9,"25% - 50% P.O.C.","$141000 or more"
"06081611300","Census Tract 6113, San Mateo County, California",5377,131086,3548,11,0,513,0,1094,66,0.2,0,9.5,0,20.3,34,1991,1339,652,67.25,32.75,77,1262,42,610,119,1872,5.8,6.4,6,"25% - 50% P.O.C.","$108000 - $141000"
"06081611400","Census Tract 6114, San Mateo County, California",4332,250001,3061,44,0,846,14,224,70.7,1,0,19.5,0.3,5.2,29.3,1302,1209,93,92.86,7.14,161,1048,7,86,168,1134,13.3,7.5,12.9,"25% - 50% P.O.C.","$141000 or more"
"06081611500","Census Tract 6115, San Mateo County, California",2836,250001,1905,13,0,637,10,91,67.2,0.5,0,22.5,0.4,3.2,32.8,913,856,57,93.76,6.24,91,765,18,39,109,804,10.6,31.6,11.9,"25% - 50% P.O.C.","$141000 or more"
"06081611600","Census Tract 6116, San Mateo County, California",2451,220859,1667,53,9,381,0,211,68,2.2,0.4,15.5,0,8.6,32,779,665,114,85.37,14.63,68,597,0,114,68,711,10.2,0,8.7,"25% - 50% P.O.C.","$141000 or more"
"06081611700","Census Tract 6117, San Mateo County, California",5801,65613,613,951,0,182,622,3265,10.6,16.4,0,3.1,10.7,56.3,89.4,1451,656,795,45.21,54.79,267,389,114,681,381,1070,40.7,14.3,26.3,"75% or more P.O.C.","Less than $80000"
"06081611800","Census Tract 6118, San Mateo County, California",4479,68083,179,801,0,171,538,2684,4,17.9,0,3.8,12,59.9,96,951,635,316,66.77,33.23,192,443,175,141,367,584,30.2,55.4,38.6,"75% or more P.O.C.","Less than $80000"
"06081611900","Census Tract 6119, San Mateo County, California",10368,100038,1519,1458,10,636,293,6020,14.7,14.1,0.1,6.1,2.8,58.1,85.3,2720,1466,1254,53.9,46.1,287,1179,474,780,761,1959,19.6,37.8,28,"75% or more P.O.C.","$80000 - $108000"
"06081612000","Census Tract 6120, San Mateo County, California",7091,71234,269,601,0,305,394,5307,3.8,8.5,0,4.3,5.6,74.8,96.2,1590,836,754,52.58,47.42,300,536,294,460,594,996,35.9,39,37.4,"75% or more P.O.C.","Less than $80000"
"06081612100","Census Tract 6121, San Mateo County, California",8646,57627,1606,368,0,731,122,5557,18.6,4.3,0,8.5,1.4,64.3,81.4,2824,403,2421,14.27,85.73,34,369,401,2020,435,2389,8.4,16.6,15.4,"75% or more P.O.C.","Less than $80000"
"06081612500","Census Tract 6125, San Mateo County, California",4470,153700,3061,144,0,624,0,478,68.5,3.2,0,14,0,10.7,31.5,1860,718,1142,38.6,61.4,79,639,14,1128,93,1767,11,1.2,5,"25% - 50% P.O.C.","$141000 or more"
"06081612600","Census Tract 6126, San Mateo County, California",4538,128429,3377,5,0,795,2,167,74.4,0.1,0,17.5,0,3.7,25.6,2074,590,1484,28.45,71.55,0,590,21,1463,21,2053,0,1.4,1,"25% - 50% P.O.C.","$108000 - $141000"
"06081612700","Census Tract 6127, San Mateo County, California",2219,250001,1872,3,0,126,0,111,84.4,0.1,0,5.7,0,5,15.6,779,701,78,89.99,10.01,68,633,21,57,89,690,9.7,26.9,11.4,"Less than 25% P.O.C.","$141000 or more"
"06081612800","Census Tract 6128, San Mateo County, California",3591,250001,2894,2,0,262,4,159,80.6,0.1,0,7.3,0.1,4.4,19.4,1062,968,94,91.15,8.85,218,750,10,84,228,834,22.5,10.6,21.5,"Less than 25% P.O.C.","$141000 or more"
"06081612900","Census Tract 6129, San Mateo County, California",4788,187292,3422,93,0,806,0,254,71.5,1.9,0,16.8,0,5.3,28.5,1772,1325,447,74.77,25.23,67,1258,31,416,98,1674,5.1,6.9,5.5,"25% - 50% P.O.C.","$141000 or more"
"06081613000","Census Tract 6130, San Mateo County, California",3774,140625,2481,2,0,815,0,257,65.7,0.1,0,21.6,0,6.8,34.3,1386,956,430,68.98,31.02,112,844,14,416,126,1260,11.7,3.3,9.1,"25% - 50% P.O.C.","$108000 - $141000"
"06081613200","Census Tract 6132, San Mateo County, California",7148,237163,5894,17,3,472,0,456,82.5,0.2,0,6.6,0,6.4,17.5,2489,2049,440,82.32,17.68,186,1863,14,426,200,2289,9.1,3.2,8,"Less than 25% P.O.C.","$141000 or more"
"06081613300","Census Tract 6133, San Mateo County, California",2970,250001,2227,52,0,272,0,294,75,1.8,0,9.2,0,9.9,25,933,884,49,94.75,5.25,128,756,10,39,138,795,14.5,20.4,14.8,"25% - 50% P.O.C.","$141000 or more"
"06081613400","Census Tract 6134, San Mateo County, California",3154,250001,2604,0,0,163,0,288,82.6,0,0,5.2,0,9.1,17.4,1093,912,181,83.44,16.56,65,847,28,153,93,1000,7.1,15.5,8.5,"Less than 25% P.O.C.","$141000 or more"
"06081613501","Census Tract 6135.01, San Mateo County, California",5341,133413,2779,24,3,289,3,2149,52,0.4,0.1,5.4,0.1,40.2,48,1541,1095,446,71.06,28.94,155,940,162,284,317,1224,14.2,36.3,20.6,"25% - 50% P.O.C.","$108000 - $141000"
"06081613502","Census Tract 6135.02, San Mateo County, California",6519,158333,5120,38,0,313,2,875,78.5,0.6,0,4.8,0,13.4,21.5,2404,1991,413,82.82,17.18,68,1923,0,413,68,2336,3.4,0,2.8,"Less than 25% P.O.C.","$141000 or more"
"06081613600","Census Tract 6136, San Mateo County, California",6108,105066,4376,17,37,140,0,1043,71.6,0.3,0.6,2.3,0,17.1,28.4,2272,1779,493,78.3,21.7,130,1649,54,439,184,2088,7.3,11,8.1,"25% - 50% P.O.C.","$80000 - $108000"
"06081613700","Census Tract 6137, San Mateo County, California",8999,137446,5818,25,0,517,60,2371,64.7,0.3,0,5.7,0.7,26.3,35.3,3631,2598,1033,71.55,28.45,113,2485,134,899,247,3384,4.3,13,6.8,"25% - 50% P.O.C.","$108000 - $141000"
"06081613800","Census Tract 6138, San Mateo County, California",3944,147545,3259,24,0,54,9,407,82.6,0.6,0,1.4,0.2,10.3,17.4,1368,1006,362,73.54,26.46,89,917,0,362,89,1279,8.8,0,6.5,"Less than 25% P.O.C.","$141000 or more"
"06081613900","Census Tract 6139, San Mateo County, California",7097,207083,4161,268,151,1489,71,595,58.6,3.8,2.1,21,1,8.4,41.4,2231,1478,753,66.25,33.75,172,1306,55,698,227,2004,11.6,7.3,10.2,"25% - 50% P.O.C.","$141000 or more"
"06081614000","Census Tract 6140, San Mateo County, California",5695,139828,1524,36,0,2420,88,1217,26.8,0.6,0,42.5,1.5,21.4,73.2,1818,1297,521,71.34,28.66,209,1088,51,470,260,1558,16.1,9.8,14.3,"50% - 75% P.O.C.","$108000 - $141000"
"06081984300","Census Tract 9843, San Mateo County, California",0,NA,0,0,0,0,0,0,NA,NA,NA,NA,NA,NA,NA,0,0,0,NA,NA,0,0,0,0,0,0,NA,NA,NA,"N/A","N/A"
"06081990100","Census Tract 9901, San Mateo County, California",0,NA,0,0,0,0,0,0,NA,NA,NA,NA,NA,NA,NA,0,0,0,NA,NA,0,0,0,0,0,0,NA,NA,NA,"N/A","N/A"
"06085500100","Census Tract 5001, Santa Clara County, California",8306,104830,1107,231,6,1996,0,4595,13.3,2.8,0.1,24,0,55.3,86.7,2617,1158,1459,44.25,55.75,126,1032,208,1251,334,2283,10.9,14.3,12.8,"75% or more P.O.C.","$80000 - $108000"
"06085500200","Census Tract 5002, Santa Clara County, California",5969,126923,1810,405,95,1178,0,2208,30.3,6.8,1.6,19.7,0,37,69.7,2018,583,1435,28.89,71.11,32,551,86,1349,118,1900,5.5,6,5.8,"50% - 75% P.O.C.","$108000 - $141000"
"06085500300","Census Tract 5003, Santa Clara County, California",3788,121543,1477,202,15,625,15,1199,39,5.3,0.4,16.5,0.4,31.7,61,1502,725,777,48.27,51.73,28,697,36,741,64,1438,3.9,4.6,4.3,"50% - 75% P.O.C.","$108000 - $141000"
"06085500400","Census Tract 5004, Santa Clara County, California",2657,92284,1038,135,12,289,0,1024,39.1,5.1,0.5,10.9,0,38.5,60.9,1045,360,685,34.45,65.55,41,319,33,652,74,971,11.4,4.8,7.1,"50% - 75% P.O.C.","$80000 - $108000"
"06085500500","Census Tract 5005, Santa Clara County, California",5500,133162,3135,189,30,865,0,1130,57,3.4,0.5,15.7,0,20.5,43,2093,1361,732,65.03,34.97,32,1329,55,677,87,2006,2.4,7.5,4.2,"25% - 50% P.O.C.","$108000 - $141000"
"06085500600","Census Tract 5006, Santa Clara County, California",5884,109292,2578,342,22,1184,0,1056,43.8,5.8,0.4,20.1,0,17.9,56.2,2503,785,1718,31.36,68.64,59,726,67,1651,126,2377,7.5,3.9,5,"50% - 75% P.O.C.","$108000 - $141000"
"06085500800","Census Tract 5008, Santa Clara County, California",4180,120909,1692,284,0,809,0,1189,40.5,6.8,0,19.4,0,28.4,59.5,2228,615,1613,27.6,72.4,12,603,67,1546,79,2149,2,4.2,3.5,"50% - 75% P.O.C.","$108000 - $141000"
"06085500901","Census Tract 5009.01, Santa Clara County, California",4197,90822,1314,214,0,1605,16,849,31.3,5.1,0,38.2,0.4,20.2,68.7,2171,408,1763,18.79,81.21,40,368,69,1694,109,2062,9.8,3.9,5,"50% - 75% P.O.C.","$80000 - $108000"
"06085500902","Census Tract 5009.02, Santa Clara County, California",5659,45000,1303,448,0,1731,58,1796,23,7.9,0,30.6,1,31.7,77,562,14,548,2.49,97.51,4,10,60,488,64,498,28.6,10.9,11.4,"75% or more P.O.C.","Less than $80000"
"06085501000","Census Tract 5010, Santa Clara County, California",5414,40453,1239,495,0,1102,30,2280,22.9,9.1,0,20.4,0.6,42.1,77.1,2334,175,2159,7.5,92.5,34,141,108,2051,142,2192,19.4,5,6.1,"75% or more P.O.C.","Less than $80000"
"06085501101","Census Tract 5011.01, Santa Clara County, California",4695,78301,1216,253,0,1327,26,1703,25.9,5.4,0,28.3,0.6,36.3,74.1,1999,420,1579,21.01,78.99,32,388,117,1462,149,1850,7.6,7.4,7.5,"50% - 75% P.O.C.","Less than $80000"
"06085501102","Census Tract 5011.02, Santa Clara County, California",4305,102946,1181,81,0,391,0,2389,27.4,1.9,0,9.1,0,55.5,72.6,1335,889,446,66.59,33.41,90,799,80,366,170,1165,10.1,17.9,12.7,"50% - 75% P.O.C.","$80000 - $108000"
"06085501200","Census Tract 5012, Santa Clara County, California",4111,92500,1161,109,25,390,0,2272,28.2,2.7,0.6,9.5,0,55.3,71.8,1268,537,731,42.35,57.65,139,398,53,678,192,1076,25.9,7.3,15.1,"50% - 75% P.O.C.","$80000 - $108000"
"06085501300","Census Tract 5013, Santa Clara County, California",3951,116250,1957,190,14,770,22,809,49.5,4.8,0.4,19.5,0.6,20.5,50.5,1084,527,557,48.62,51.38,30,497,58,499,88,996,5.7,10.4,8.1,"50% - 75% P.O.C.","$108000 - $141000"
"06085501401","Census Tract 5014.01, Santa Clara County, California",3226,50346,367,266,0,422,0,2116,11.4,8.2,0,13.1,0,65.6,88.6,1047,344,703,32.86,67.14,74,270,91,612,165,882,21.5,12.9,15.8,"75% or more P.O.C.","Less than $80000"
"06085501402","Census Tract 5014.02, Santa Clara County, California",3046,74760,585,36,0,226,26,2135,19.2,1.2,0,7.4,0.9,70.1,80.8,813,266,547,32.72,67.28,65,201,145,402,210,603,24.4,26.5,25.8,"75% or more P.O.C.","Less than $80000"
"06085501501","Census Tract 5015.01, Santa Clara County, California",4623,61828,241,146,0,1238,0,2979,5.2,3.2,0,26.8,0,64.4,94.8,1266,597,669,47.16,52.84,168,429,205,464,373,893,28.1,30.6,29.5,"75% or more P.O.C.","Less than $80000"
"06085501502","Census Tract 5015.02, Santa Clara County, California",4843,67067,572,69,0,857,0,3171,11.8,1.4,0,17.7,0,65.5,88.2,1235,545,690,44.13,55.87,78,467,206,484,284,951,14.3,29.9,23,"75% or more P.O.C.","Less than $80000"
"06085501600","Census Tract 5016, Santa Clara County, California",7716,62932,1733,144,36,1411,220,3777,22.5,1.9,0.5,18.3,2.9,49,77.5,2553,526,2027,20.6,79.4,86,440,402,1625,488,2065,16.3,19.8,19.1,"75% or more P.O.C.","Less than $80000"
"06085501700","Census Tract 5017, Santa Clara County, California",4982,54797,636,53,0,123,12,3893,12.8,1.1,0,2.5,0.2,78.1,87.2,1366,218,1148,15.96,84.04,68,150,296,852,364,1002,31.2,25.8,26.6,"75% or more P.O.C.","Less than $80000"
"06085501800","Census Tract 5018, Santa Clara County, California",4823,121786,1985,78,64,430,45,2094,41.2,1.6,1.3,8.9,0.9,43.4,58.8,1770,1117,653,63.11,36.89,59,1058,100,553,159,1611,5.3,15.3,9,"50% - 75% P.O.C.","$108000 - $141000"
"06085501900","Census Tract 5019, Santa Clara County, California",5401,76922,1874,434,0,1192,0,1307,34.7,8,0,22.1,0,24.2,65.3,2733,732,2001,26.78,73.22,16,716,58,1943,74,2659,2.2,2.9,2.7,"50% - 75% P.O.C.","Less than $80000"
"06085502001","Census Tract 5020.01, Santa Clara County, California",5093,84966,1657,43,9,644,37,2254,32.5,0.8,0.2,12.6,0.7,44.3,67.5,2017,773,1244,38.32,61.68,44,729,60,1184,104,1913,5.7,4.8,5.2,"50% - 75% P.O.C.","$80000 - $108000"
"06085502002","Census Tract 5020.02, Santa Clara County, California",6052,83580,1293,216,0,474,0,3872,21.4,3.6,0,7.8,0,64,78.6,1819,497,1322,27.32,72.68,68,429,364,958,432,1387,13.7,27.5,23.7,"75% or more P.O.C.","$80000 - $108000"
"06085502101","Census Tract 5021.01, Santa Clara County, California",5081,109450,2173,186,57,1158,149,1123,42.8,3.7,1.1,22.8,2.9,22.1,57.2,1947,1230,717,63.17,36.83,43,1187,0,717,43,1904,3.5,0,2.2,"50% - 75% P.O.C.","$108000 - $141000"
"06085502102","Census Tract 5021.02, Santa Clara County, California",7726,75515,2245,454,16,903,47,3960,29.1,5.9,0.2,11.7,0.6,51.3,70.9,2653,766,1887,28.87,71.13,29,737,351,1536,380,2273,3.8,18.6,14.3,"50% - 75% P.O.C.","Less than $80000"
"06085502201","Census Tract 5022.01, Santa Clara County, California",7541,70398,2821,489,0,1540,0,1948,37.4,6.5,0,20.4,0,25.8,62.6,3134,599,2535,19.11,80.89,69,530,95,2440,164,2970,11.5,3.7,5.2,"50% - 75% P.O.C.","Less than $80000"
"06085502202","Census Tract 5022.02, Santa Clara County, California",2735,91544,1724,103,0,331,0,439,63,3.8,0,12.1,0,16.1,37,1341,749,592,55.85,44.15,13,736,23,569,36,1305,1.7,3.9,2.7,"25% - 50% P.O.C.","$80000 - $108000"
"06085502301","Census Tract 5023.01, Santa Clara County, California",3535,162235,2348,89,0,271,14,562,66.4,2.5,0,7.7,0.4,15.9,33.6,1351,842,509,62.32,37.68,82,760,21,488,103,1248,9.7,4.1,7.6,"25% - 50% P.O.C.","$141000 or more"
"06085502302","Census Tract 5023.02, Santa Clara County, California",3000,104615,1493,74,0,237,0,1113,49.8,2.5,0,7.9,0,37.1,50.2,1274,398,876,31.24,68.76,19,379,42,834,61,1213,4.8,4.8,4.8,"50% - 75% P.O.C.","$80000 - $108000"
"06085502400","Census Tract 5024, Santa Clara County, California",6909,128889,4583,123,0,838,0,1120,66.3,1.8,0,12.1,0,16.2,33.7,2920,2159,761,73.94,26.06,116,2043,0,761,116,2804,5.4,0,4,"25% - 50% P.O.C.","$108000 - $141000"
"06085502500","Census Tract 5025, Santa Clara County, California",6746,179205,4387,135,0,747,0,1057,65,2,0,11.1,0,15.7,35,2369,2094,275,88.39,11.61,266,1828,31,244,297,2072,12.7,11.3,12.5,"25% - 50% P.O.C.","$141000 or more"
"06085502601","Census Tract 5026.01, Santa Clara County, California",2673,109563,1960,11,0,247,2,394,73.3,0.4,0,9.2,0.1,14.7,26.7,1179,807,372,68.45,31.55,66,741,17,355,83,1096,8.2,4.6,7,"25% - 50% P.O.C.","$108000 - $141000"
"06085502603","Census Tract 5026.03, Santa Clara County, California",2830,151696,1785,16,5,258,6,607,63.1,0.6,0.2,9.1,0.2,21.4,36.9,1001,632,369,63.14,36.86,40,592,48,321,88,913,6.3,13,8.8,"25% - 50% P.O.C.","$141000 or more"
"06085502604","Census Tract 5026.04, Santa Clara County, California",4116,97550,2467,187,74,606,0,658,59.9,4.5,1.8,14.7,0,16,40.1,2099,496,1603,23.63,76.37,0,496,21,1582,21,2078,0,1.3,1,"25% - 50% P.O.C.","$80000 - $108000"
"06085502701","Census Tract 5027.01, Santa Clara County, California",5235,122050,2437,257,40,1048,0,1224,46.6,4.9,0.8,20,0,23.4,53.4,1943,1004,939,51.67,48.33,46,958,70,869,116,1827,4.6,7.5,6,"50% - 75% P.O.C.","$108000 - $141000"
"06085502702","Census Tract 5027.02, Santa Clara County, California",8456,162933,4560,212,16,2053,7,1137,53.9,2.5,0.2,24.3,0.1,13.4,46.1,3082,1971,1111,63.95,36.05,129,1842,34,1077,163,2919,6.5,3.1,5.3,"25% - 50% P.O.C.","$141000 or more"
"06085502800","Census Tract 5028, Santa Clara County, California",4363,144870,2332,21,0,857,0,818,53.4,0.5,0,19.6,0,18.7,46.6,1359,1144,215,84.18,15.82,128,1016,55,160,183,1176,11.2,25.6,13.5,"25% - 50% P.O.C.","$141000 or more"
"06085502901","Census Tract 5029.01, Santa Clara County, California",6104,122614,3404,114,51,1086,0,1336,55.8,1.9,0.8,17.8,0,21.9,44.2,2207,1334,873,60.44,39.56,44,1290,150,723,194,2013,3.3,17.2,8.8,"25% - 50% P.O.C.","$108000 - $141000"
"06085502902","Census Tract 5029.02, Santa Clara County, California",7893,162045,4726,59,0,1604,0,1238,59.9,0.7,0,20.3,0,15.7,40.1,2812,2239,573,79.62,20.38,106,2133,130,443,236,2576,4.7,22.7,8.4,"25% - 50% P.O.C.","$141000 or more"
"06085502903","Census Tract 5029.03, Santa Clara County, California",5172,150139,3198,9,23,553,0,1027,61.8,0.2,0.4,10.7,0,19.9,38.2,1919,1600,319,83.38,16.62,144,1456,40,279,184,1735,9,12.5,9.6,"25% - 50% P.O.C.","$141000 or more"
"06085502906","Census Tract 5029.06, Santa Clara County, California",4542,104000,2226,82,0,1210,0,889,49,1.8,0,26.6,0,19.6,51,1508,967,541,64.12,35.88,38,929,92,449,130,1378,3.9,17,8.6,"50% - 75% P.O.C.","$80000 - $108000"
"06085502907","Census Tract 5029.07, Santa Clara County, California",3936,146389,2404,14,6,737,24,501,61.1,0.4,0.2,18.7,0.6,12.7,38.9,1288,1139,149,88.43,11.57,111,1028,8,141,119,1169,9.7,5.4,9.2,"25% - 50% P.O.C.","$141000 or more"
"06085502908","Census Tract 5029.08, Santa Clara County, California",7294,136563,3831,61,0,1089,0,1940,52.5,0.8,0,14.9,0,26.6,47.5,2376,1690,686,71.13,28.87,72,1618,207,479,279,2097,4.3,30.2,11.7,"25% - 50% P.O.C.","$108000 - $141000"
"06085502909","Census Tract 5029.09, Santa Clara County, California",5416,104634,2295,93,0,1061,0,1630,42.4,1.7,0,19.6,0,30.1,57.6,2021,1124,897,55.62,44.38,12,1112,77,820,89,1932,1.1,8.6,4.4,"50% - 75% P.O.C.","$80000 - $108000"
"06085502910","Census Tract 5029.10, Santa Clara County, California",3733,94821,1851,78,59,590,0,949,49.6,2.1,1.6,15.8,0,25.4,50.4,1406,659,747,46.87,53.13,59,600,77,670,136,1270,9,10.3,9.7,"50% - 75% P.O.C.","$80000 - $108000"
"06085503001","Census Tract 5030.01, Santa Clara County, California",4123,188674,2752,75,0,505,0,529,66.7,1.8,0,12.2,0,12.8,33.3,1589,1321,268,83.13,16.87,45,1276,0,268,45,1544,3.4,0,2.8,"25% - 50% P.O.C.","$141000 or more"
"06085503002","Census Tract 5030.02, Santa Clara County, California",3589,146600,2214,209,0,668,0,383,61.7,5.8,0,18.6,0,10.7,38.3,1240,984,256,79.35,20.65,63,921,16,240,79,1161,6.4,6.2,6.4,"25% - 50% P.O.C.","$141000 or more"
"06085503003","Census Tract 5030.03, Santa Clara County, California",5388,139500,3233,37,0,879,51,722,60,0.7,0,16.3,0.9,13.4,40,1838,1538,300,83.68,16.32,134,1404,44,256,178,1660,8.7,14.7,9.7,"25% - 50% P.O.C.","$108000 - $141000"
"06085503105","Census Tract 5031.05, Santa Clara County, California",2460,44545,118,0,0,1531,18,763,4.8,0,0,62.2,0.7,31,95.2,762,215,547,28.22,71.78,66,149,96,451,162,600,30.7,17.6,21.3,"75% or more P.O.C.","Less than $80000"
"06085503108","Census Tract 5031.08, Santa Clara County, California",8222,111618,2041,637,39,2851,40,2419,24.8,7.7,0.5,34.7,0.5,29.4,75.2,3048,990,2058,32.48,67.52,99,891,91,1967,190,2858,10,4.4,6.2,"75% or more P.O.C.","$108000 - $141000"
"06085503110","Census Tract 5031.10, Santa Clara County, California",4917,49844,165,61,23,1359,42,3267,3.4,1.2,0.5,27.6,0.9,66.4,96.6,1130,212,918,18.76,81.24,80,132,376,542,456,674,37.7,41,40.4,"75% or more P.O.C.","Less than $80000"
"06085503111","Census Tract 5031.11, Santa Clara County, California",5132,99423,177,17,0,2675,11,2252,3.4,0.3,0,52.1,0.2,43.9,96.6,1068,712,356,66.67,33.33,241,471,243,113,484,584,33.8,68.3,45.3,"75% or more P.O.C.","$80000 - $108000"
"06085503112","Census Tract 5031.12, Santa Clara County, California",4141,53050,599,313,0,948,0,2227,14.5,7.6,0,22.9,0,53.8,85.5,1531,500,1031,32.66,67.34,89,411,120,911,209,1322,17.8,11.6,13.7,"75% or more P.O.C.","Less than $80000"
"06085503113","Census Tract 5031.13, Santa Clara County, California",5052,76528,532,71,0,485,0,3892,10.5,1.4,0,9.6,0,77,89.5,1325,512,813,38.64,61.36,47,465,248,565,295,1030,9.2,30.5,22.3,"75% or more P.O.C.","Less than $80000"
"06085503115","Census Tract 5031.15, Santa Clara County, California",7372,105929,2765,113,0,2705,26,1484,37.5,1.5,0,36.7,0.4,20.1,62.5,3020,2389,631,79.11,20.89,84,2305,107,524,191,2829,3.5,17,6.3,"50% - 75% P.O.C.","$80000 - $108000"
"06085503116","Census Tract 5031.16, Santa Clara County, California",6178,91791,1970,137,0,2046,0,1714,31.9,2.2,0,33.1,0,27.7,68.1,2307,1174,1133,50.89,49.11,146,1028,103,1030,249,2058,12.4,9.1,10.8,"50% - 75% P.O.C.","$80000 - $108000"
"06085503117","Census Tract 5031.17, Santa Clara County, California",3071,57857,60,34,0,1111,31,1806,2,1.1,0,36.2,1,58.8,98,786,216,570,27.48,72.52,72,144,176,394,248,538,33.3,30.9,31.6,"75% or more P.O.C.","Less than $80000"
"06085503118","Census Tract 5031.18, Santa Clara County, California",5286,83162,530,206,10,2190,0,2238,10,3.9,0.2,41.4,0,42.3,90,1653,460,1193,27.83,72.17,98,362,238,955,336,1317,21.3,19.9,20.3,"75% or more P.O.C.","$80000 - $108000"
"06085503121","Census Tract 5031.21, Santa Clara County, California",4788,55719,626,57,10,784,0,3142,13.1,1.2,0.2,16.4,0,65.6,86.9,1489,419,1070,28.14,71.86,72,347,155,915,227,1262,17.2,14.5,15.2,"75% or more P.O.C.","Less than $80000"
"06085503122","Census Tract 5031.22, Santa Clara County, California",3602,26019,181,113,0,1766,0,1457,5,3.1,0,49,0,40.4,95,1287,449,838,34.89,65.11,90,359,163,675,253,1034,20,19.5,19.7,"75% or more P.O.C.","Less than $80000"
"06085503123","Census Tract 5031.23, Santa Clara County, California",3901,47636,1026,92,0,559,125,1958,26.3,2.4,0,14.3,3.2,50.2,73.7,1620,482,1138,29.75,70.25,35,447,104,1034,139,1481,7.3,9.1,8.6,"50% - 75% P.O.C.","Less than $80000"
"06085503204","Census Tract 5032.04, Santa Clara County, California",8105,69921,486,175,9,2415,0,4733,6,2.2,0.1,29.8,0,58.4,94,2266,1454,812,64.17,35.83,390,1064,253,559,643,1623,26.8,31.2,28.4,"75% or more P.O.C.","Less than $80000"
"06085503207","Census Tract 5032.07, Santa Clara County, California",4150,98233,243,140,14,2928,0,754,5.9,3.4,0.3,70.6,0,18.2,94.1,1051,782,269,74.41,25.59,213,569,89,180,302,749,27.2,33.1,28.7,"75% or more P.O.C.","$80000 - $108000"
"06085503208","Census Tract 5032.08, Santa Clara County, California",4631,105655,214,197,29,1251,0,2880,4.6,4.3,0.6,27,0,62.2,95.4,887,695,192,78.35,21.65,247,448,41,151,288,599,35.5,21.4,32.5,"75% or more P.O.C.","$80000 - $108000"
"06085503210","Census Tract 5032.10, Santa Clara County, California",4254,93021,370,31,0,2216,8,1552,8.7,0.7,0,52.1,0.2,36.5,91.3,993,692,301,69.69,30.31,234,458,42,259,276,717,33.8,14,27.8,"75% or more P.O.C.","$80000 - $108000"
"06085503211","Census Tract 5032.11, Santa Clara County, California",4592,108125,507,66,0,2500,102,1295,11,1.4,0,54.4,2.2,28.2,89,1176,869,307,73.89,26.11,175,694,127,180,302,874,20.1,41.4,25.7,"75% or more P.O.C.","$108000 - $141000"
"06085503212","Census Tract 5032.12, Santa Clara County, California",4379,117879,192,252,1,2676,0,1157,4.4,5.8,0,61.1,0,26.4,95.6,986,751,235,76.17,23.83,228,523,117,118,345,641,30.4,49.8,35,"75% or more P.O.C.","$108000 - $141000"
"06085503213","Census Tract 5032.13, Santa Clara County, California",4925,72847,295,27,10,2994,0,1379,6,0.5,0.2,60.8,0,28,94,1271,874,397,68.76,31.24,285,589,92,305,377,894,32.6,23.2,29.7,"75% or more P.O.C.","Less than $80000"
"06085503214","Census Tract 5032.14, Santa Clara County, California",8468,60136,228,0,0,4582,247,3276,2.7,0,0,54.1,2.9,38.7,97.3,2349,1266,1083,53.9,46.1,311,955,161,922,472,1877,24.6,14.9,20.1,"75% or more P.O.C.","Less than $80000"
"06085503217","Census Tract 5032.17, Santa Clara County, California",4834,77786,199,40,0,913,16,3518,4.1,0.8,0,18.9,0.3,72.8,95.9,1132,583,549,51.5,48.5,141,442,220,329,361,771,24.2,40.1,31.9,"75% or more P.O.C.","Less than $80000"
"06085503218","Census Tract 5032.18, Santa Clara County, California",5118,54250,225,48,0,1493,0,3334,4.4,0.9,0,29.2,0,65.1,95.6,1187,408,779,34.37,65.63,140,268,262,517,402,785,34.3,33.6,33.9,"75% or more P.O.C.","Less than $80000"
"06085503304","Census Tract 5033.04, Santa Clara County, California",7213,80529,595,197,54,3688,24,2606,8.2,2.7,0.7,51.1,0.3,36.1,91.8,1832,996,836,54.37,45.63,328,668,186,650,514,1318,32.9,22.2,28.1,"75% or more P.O.C.","$80000 - $108000"
"06085503305","Census Tract 5033.05, Santa Clara County, California",5810,85809,152,54,0,3060,85,2263,2.6,0.9,0,52.7,1.5,39,97.4,1481,881,600,59.49,40.51,208,673,185,415,393,1088,23.6,30.8,26.5,"75% or more P.O.C.","$80000 - $108000"
"06085503306","Census Tract 5033.06, Santa Clara County, California",4373,87361,119,50,9,1544,0,2604,2.7,1.1,0.2,35.3,0,59.5,97.3,922,656,266,71.15,28.85,248,408,98,168,346,576,37.8,36.8,37.5,"75% or more P.O.C.","$80000 - $108000"
"06085503312","Census Tract 5033.12, Santa Clara County, California",4027,115893,741,38,0,1424,36,1709,18.4,0.9,0,35.4,0.9,42.4,81.6,1080,869,211,80.46,19.54,182,687,74,137,256,824,20.9,35.1,23.7,"75% or more P.O.C.","$108000 - $141000"
"06085503313","Census Tract 5033.13, Santa Clara County, California",4629,159826,719,69,0,2681,138,914,15.5,1.5,0,57.9,3,19.7,84.5,1314,1193,121,90.79,9.21,259,934,39,82,298,1016,21.7,32.2,22.7,"75% or more P.O.C.","$141000 or more"
"06085503315","Census Tract 5033.15, Santa Clara County, California",8637,107500,524,101,0,4298,0,3605,6.1,1.2,0,49.8,0,41.7,93.9,2064,1358,706,65.79,34.21,437,921,182,524,619,1445,32.2,25.8,30,"75% or more P.O.C.","$80000 - $108000"
"06085503321","Census Tract 5033.21, Santa Clara County, California",4690,156667,264,44,0,3802,0,542,5.6,0.9,0,81.1,0,11.6,94.4,1124,1023,101,91.01,8.99,321,702,30,71,351,773,31.4,29.7,31.2,"75% or more P.O.C.","$141000 or more"
"06085503322","Census Tract 5033.22, Santa Clara County, California",4495,120250,442,196,0,2084,16,1715,9.8,4.4,0,46.4,0.4,38.2,90.2,1053,847,206,80.44,19.56,266,581,121,85,387,666,31.4,58.7,36.8,"75% or more P.O.C.","$108000 - $141000"
"06085503323","Census Tract 5033.23, Santa Clara County, California",4763,135877,513,251,0,2224,0,1724,10.8,5.3,0,46.7,0,36.2,89.2,1236,898,338,72.65,27.35,117,781,154,184,271,965,13,45.6,21.9,"75% or more P.O.C.","$108000 - $141000"
"06085503324","Census Tract 5033.24, Santa Clara County, California",3625,140192,268,102,0,2528,0,636,7.4,2.8,0,69.7,0,17.5,92.6,892,746,146,83.63,16.37,190,556,69,77,259,633,25.5,47.3,29,"75% or more P.O.C.","$108000 - $141000"
"06085503325","Census Tract 5033.25, Santa Clara County, California",4722,140938,337,232,0,3261,0,839,7.1,4.9,0,69.1,0,17.8,92.9,1169,946,223,80.92,19.08,230,716,73,150,303,866,24.3,32.7,25.9,"75% or more P.O.C.","$108000 - $141000"
"06085503326","Census Tract 5033.26, Santa Clara County, California",7263,193466,606,25,0,5774,40,669,8.3,0.3,0,79.5,0.6,9.2,91.7,1803,1662,141,92.18,7.82,409,1253,62,79,471,1332,24.6,44,26.1,"75% or more P.O.C.","$141000 or more"
"06085503327","Census Tract 5033.27, Santa Clara County, California",4504,94063,523,85,0,2460,0,1282,11.6,1.9,0,54.6,0,28.5,88.4,1363,937,426,68.75,31.25,148,789,34,392,182,1181,15.8,8,13.4,"75% or more P.O.C.","$80000 - $108000"
"06085503329","Census Tract 5033.29, Santa Clara County, California",4107,190282,358,108,0,3103,22,423,8.7,2.6,0,75.6,0.5,10.3,91.3,1129,1027,102,90.97,9.03,155,872,19,83,174,955,15.1,18.6,15.4,"75% or more P.O.C.","$141000 or more"
"06085503330","Census Tract 5033.30, Santa Clara County, California",7849,210313,760,0,36,6266,0,685,9.7,0,0.5,79.8,0,8.7,90.3,2137,1778,359,83.2,16.8,246,1532,43,316,289,1848,13.8,12,13.5,"75% or more P.O.C.","$141000 or more"
"06085503331","Census Tract 5033.31, Santa Clara County, California",3405,103661,1295,70,2,1212,0,722,38,2.1,0.1,35.6,0,21.2,62,1358,1144,214,84.24,15.76,90,1054,9,205,99,1259,7.9,4.2,7.3,"50% - 75% P.O.C.","$80000 - $108000"
"06085503332","Census Tract 5033.32, Santa Clara County, California",5642,109344,3386,64,0,1430,34,401,60,1.1,0,25.3,0.6,7.1,40,2569,2375,194,92.45,7.55,178,2197,0,194,178,2391,7.5,0,6.9,"25% - 50% P.O.C.","$108000 - $141000"
"06085503333","Census Tract 5033.33, Santa Clara County, California",4896,166319,1030,322,0,2260,14,1109,21,6.6,0,46.2,0.3,22.7,79,1350,1167,183,86.44,13.56,203,964,70,113,273,1077,17.4,38.3,20.2,"75% or more P.O.C.","$141000 or more"
"06085503334","Census Tract 5033.34, Santa Clara County, California",8938,250001,1816,147,19,5736,43,757,20.3,1.6,0.2,64.2,0.5,8.5,79.7,2609,2462,147,94.37,5.63,389,2073,0,147,389,2220,15.8,0,14.9,"75% or more P.O.C.","$141000 or more"
"06085503336","Census Tract 5033.36, Santa Clara County, California",3580,112554,144,65,0,2109,0,1203,4,1.8,0,58.9,0,33.6,96,875,705,170,80.57,19.43,209,496,78,92,287,588,29.6,45.9,32.8,"75% or more P.O.C.","$108000 - $141000"
"06085503337","Census Tract 5033.37, Santa Clara County, California",3455,87639,269,112,75,2282,20,673,7.8,3.2,2.2,66,0.6,19.5,92.2,957,769,188,80.36,19.64,121,648,50,138,171,786,15.7,26.6,17.9,"75% or more P.O.C.","$80000 - $108000"
"06085503401","Census Tract 5034.01, Santa Clara County, California",4468,79318,107,50,0,642,261,3398,2.4,1.1,0,14.4,5.8,76.1,97.6,950,715,235,75.26,24.74,281,434,108,127,389,561,39.3,46,40.9,"75% or more P.O.C.","Less than $80000"
"06085503402","Census Tract 5034.02, Santa Clara County, California",5286,63267,171,22,0,1588,34,3449,3.2,0.4,0,30,0.6,65.2,96.8,1160,483,677,41.64,58.36,207,276,307,370,514,646,42.9,45.3,44.3,"75% or more P.O.C.","Less than $80000"
"06085503504","Census Tract 5035.04, Santa Clara County, California",6346,98378,19,46,0,1401,128,4740,0.3,0.7,0,22.1,2,74.7,99.7,1194,815,379,68.26,31.74,409,406,218,161,627,567,50.2,57.5,52.5,"75% or more P.O.C.","$80000 - $108000"
"06085503506","Census Tract 5035.06, Santa Clara County, California",6816,95357,186,101,30,2062,0,4301,2.7,1.5,0.4,30.3,0,63.1,97.3,1250,645,605,51.6,48.4,288,357,392,213,680,570,44.7,64.8,54.4,"75% or more P.O.C.","$80000 - $108000"
"06085503507","Census Tract 5035.07, Santa Clara County, California",2397,117500,21,0,0,713,0,1642,0.9,0,0,29.7,0,68.5,99.1,380,310,70,81.58,18.42,195,115,46,24,241,139,62.9,65.7,63.4,"75% or more P.O.C.","$108000 - $141000"
"06085503508","Census Tract 5035.08, Santa Clara County, California",6533,94861,249,138,0,883,198,4574,3.8,2.1,0,13.5,3,70,96.2,1341,917,424,68.38,31.62,399,518,271,153,670,671,43.5,63.9,50,"75% or more P.O.C.","$80000 - $108000"
"06085503509","Census Tract 5035.09, Santa Clara County, California",4449,96979,253,70,0,1360,0,2699,5.7,1.6,0,30.6,0,60.7,94.3,894,650,244,72.71,27.29,237,413,150,94,387,507,36.5,61.5,43.3,"75% or more P.O.C.","$80000 - $108000"
"06085503510","Census Tract 5035.10, Santa Clara County, California",5826,74607,423,60,0,1114,13,4117,7.3,1,0,19.1,0.2,70.7,92.7,1386,796,590,57.43,42.57,331,465,132,458,463,923,41.6,22.4,33.4,"75% or more P.O.C.","Less than $80000"
"06085503511","Census Tract 5035.11, Santa Clara County, California",3620,107098,288,72,0,1564,0,1635,8,2,0,43.2,0,45.2,92,855,692,163,80.94,19.06,223,469,80,83,303,552,32.2,49.1,35.4,"75% or more P.O.C.","$80000 - $108000"
"06085503601","Census Tract 5036.01, Santa Clara County, California",3383,68663,712,31,32,674,0,1798,21,0.9,0.9,19.9,0,53.1,79,902,307,595,34.04,65.96,36,271,217,378,253,649,11.7,36.5,28,"75% or more P.O.C.","Less than $80000"
"06085503602","Census Tract 5036.02, Santa Clara County, California",5602,66058,301,151,0,1340,0,3755,5.4,2.7,0,23.9,0,67,94.6,1379,589,790,42.71,57.29,213,376,242,548,455,924,36.2,30.6,33,"75% or more P.O.C.","Less than $80000"
"06085503703","Census Tract 5037.03, Santa Clara County, California",4073,66667,60,170,0,1137,0,2649,1.5,4.2,0,27.9,0,65,98.5,926,473,453,51.08,48.92,110,363,161,292,271,655,23.3,35.5,29.3,"75% or more P.O.C.","Less than $80000"
"06085503707","Census Tract 5037.07, Santa Clara County, California",6087,92647,167,292,0,2165,35,3301,2.7,4.8,0,35.6,0.6,54.2,97.3,1424,600,824,42.13,57.87,169,431,356,468,525,899,28.2,43.2,36.9,"75% or more P.O.C.","$80000 - $108000"
"06085503708","Census Tract 5037.08, Santa Clara County, California",2955,94740,165,45,10,2061,37,565,5.6,1.5,0.3,69.7,1.3,19.1,94.4,777,421,356,54.18,45.82,107,314,95,261,202,575,25.4,26.7,26,"75% or more P.O.C.","$80000 - $108000"
"06085503709","Census Tract 5037.09, Santa Clara County, California",6457,30724,220,29,12,3820,22,2342,3.4,0.4,0.2,59.2,0.3,36.3,96.6,1981,353,1628,17.82,82.18,79,274,219,1409,298,1683,22.4,13.5,15,"75% or more P.O.C.","Less than $80000"
"06085503710","Census Tract 5037.10, Santa Clara County, California",3858,44688,176,14,17,794,0,2655,4.6,0.4,0.4,20.6,0,68.8,95.4,1084,277,807,25.55,74.45,134,143,141,666,275,809,48.4,17.5,25.4,"75% or more P.O.C.","Less than $80000"
"06085503711","Census Tract 5037.11, Santa Clara County, California",5368,84464,146,83,0,887,10,4153,2.7,1.5,0,16.5,0.2,77.4,97.3,1057,413,644,39.07,60.93,167,246,348,296,515,542,40.4,54,48.7,"75% or more P.O.C.","$80000 - $108000"
"06085503712","Census Tract 5037.12, Santa Clara County, California",4484,44911,463,20,6,1833,0,2132,10.3,0.4,0.1,40.9,0,47.5,89.7,1420,339,1081,23.87,76.13,37,302,123,958,160,1260,10.9,11.4,11.3,"75% or more P.O.C.","Less than $80000"
"06085503713","Census Tract 5037.13, Santa Clara County, California",3550,62560,170,92,0,995,155,2090,4.8,2.6,0,28,4.4,58.9,95.2,1126,259,867,23,77,31,228,235,632,266,860,12,27.1,23.6,"75% or more P.O.C.","Less than $80000"
"06085503802","Census Tract 5038.02, Santa Clara County, California",8810,99619,1322,192,0,3092,40,3953,15,2.2,0,35.1,0.5,44.9,85,2322,1463,859,63.01,36.99,313,1150,150,709,463,1859,21.4,17.5,19.9,"75% or more P.O.C.","$80000 - $108000"
"06085503803","Census Tract 5038.03, Santa Clara County, California",4704,108224,506,105,0,2990,23,975,10.8,2.2,0,63.6,0.5,20.7,89.2,1368,1001,367,73.17,26.83,114,887,153,214,267,1101,11.4,41.7,19.5,"75% or more P.O.C.","$108000 - $141000"
"06085503804","Census Tract 5038.04, Santa Clara County, California",5285,105036,816,39,0,2787,0,1502,15.4,0.7,0,52.7,0,28.4,84.6,1663,1127,536,67.77,32.23,156,971,126,410,282,1381,13.8,23.5,17,"75% or more P.O.C.","$80000 - $108000"
"06085503902","Census Tract 5039.02, Santa Clara County, California",5973,84234,476,63,21,1234,0,4040,8,1.1,0.4,20.7,0,67.6,92,1537,924,613,60.12,39.88,245,679,129,484,374,1163,26.5,21,24.3,"75% or more P.O.C.","$80000 - $108000"
"06085503903","Census Tract 5039.03, Santa Clara County, California",3773,101563,343,41,12,1622,0,1741,9.1,1.1,0.3,43,0,46.1,90.9,949,570,379,60.06,39.94,164,406,126,253,290,659,28.8,33.2,30.6,"75% or more P.O.C.","$80000 - $108000"
"06085504001","Census Tract 5040.01, Santa Clara County, California",6078,63614,285,69,0,1158,0,4363,4.7,1.1,0,19.1,0,71.8,95.3,1537,721,816,46.91,53.09,183,538,270,546,453,1084,25.4,33.1,29.5,"75% or more P.O.C.","Less than $80000"
"06085504002","Census Tract 5040.02, Santa Clara County, California",6772,82726,170,94,17,2013,0,4261,2.5,1.4,0.3,29.7,0,62.9,97.5,1375,601,774,43.71,56.29,405,196,249,525,654,721,67.4,32.2,47.6,"75% or more P.O.C.","$80000 - $108000"
"06085504101","Census Tract 5041.01, Santa Clara County, California",5095,94531,425,45,4,721,4,3768,8.3,0.9,0.1,14.2,0.1,74,91.7,1091,788,303,72.23,27.77,251,537,95,208,346,745,31.9,31.4,31.7,"75% or more P.O.C.","$80000 - $108000"
"06085504102","Census Tract 5041.02, Santa Clara County, California",5883,84583,413,34,0,941,0,4489,7,0.6,0,16,0,76.3,93,1321,1000,321,75.7,24.3,372,628,156,165,528,793,37.2,48.6,40,"75% or more P.O.C.","$80000 - $108000"
"06085504201","Census Tract 5042.01, Santa Clara County, California",5079,156088,2260,100,1,814,0,1724,44.5,2,0,16,0,33.9,55.5,1613,1313,300,81.4,18.6,133,1180,61,239,194,1419,10.1,20.3,12,"50% - 75% P.O.C.","$141000 or more"
"06085504202","Census Tract 5042.02, Santa Clara County, California",4359,148500,1723,58,17,1389,0,1087,39.5,1.3,0.4,31.9,0,24.9,60.5,1396,1202,194,86.1,13.9,103,1099,64,130,167,1229,8.6,33,12,"50% - 75% P.O.C.","$141000 or more"
"06085504307","Census Tract 5043.07, Santa Clara County, California",5532,111765,600,51,0,3712,0,997,10.8,0.9,0,67.1,0,18,89.2,1766,1446,320,81.88,18.12,181,1265,53,267,234,1532,12.5,16.6,13.3,"75% or more P.O.C.","$108000 - $141000"
"06085504308","Census Tract 5043.08, Santa Clara County, California",4537,128462,1053,78,0,2327,0,876,23.2,1.7,0,51.3,0,19.3,76.8,1524,1217,307,79.86,20.14,174,1043,74,233,248,1276,14.3,24.1,16.3,"75% or more P.O.C.","$108000 - $141000"
"06085504311","Census Tract 5043.11, Santa Clara County, California",7331,145000,747,18,0,5710,27,518,10.2,0.2,0,77.9,0.4,7.1,89.8,2586,1742,844,67.36,32.64,94,1648,138,706,232,2354,5.4,16.4,9,"75% or more P.O.C.","$141000 or more"
"06085504314","Census Tract 5043.14, Santa Clara County, California",4897,120964,558,67,0,3275,0,875,11.4,1.4,0,66.9,0,17.9,88.6,1313,1056,257,80.43,19.57,196,860,70,187,266,1047,18.6,27.2,20.3,"75% or more P.O.C.","$108000 - $141000"
"06085504315","Census Tract 5043.15, Santa Clara County, California",6781,128485,812,34,6,4707,0,1091,12,0.5,0.1,69.4,0,16.1,88,1946,1612,334,82.84,17.16,259,1353,65,269,324,1622,16.1,19.5,16.6,"75% or more P.O.C.","$108000 - $141000"
"06085504316","Census Tract 5043.16, Santa Clara County, California",4760,124904,472,153,11,3417,13,589,9.9,3.2,0.2,71.8,0.3,12.4,90.1,1425,967,458,67.86,32.14,112,855,93,365,205,1220,11.6,20.3,14.4,"75% or more P.O.C.","$108000 - $141000"
"06085504317","Census Tract 5043.17, Santa Clara County, California",4786,124844,470,9,0,3579,6,548,9.8,0.2,0,74.8,0.1,11.5,90.2,1217,949,268,77.98,22.02,224,725,56,212,280,937,23.6,20.9,23,"75% or more P.O.C.","$108000 - $141000"
"06085504318","Census Tract 5043.18, Santa Clara County, California",6095,91971,571,40,11,2991,0,2385,9.4,0.7,0.2,49.1,0,39.1,90.6,1693,1509,184,89.13,10.87,341,1168,66,118,407,1286,22.6,35.9,24,"75% or more P.O.C.","$80000 - $108000"
"06085504319","Census Tract 5043.19, Santa Clara County, California",7633,124963,705,184,71,5099,0,1428,9.2,2.4,0.9,66.8,0,18.7,90.8,2461,1864,597,75.74,24.26,203,1661,95,502,298,2163,10.9,15.9,12.1,"75% or more P.O.C.","$108000 - $141000"
"06085504320","Census Tract 5043.20, Santa Clara County, California",2931,161979,522,22,0,2049,10,221,17.8,0.8,0,69.9,0.3,7.5,82.2,837,667,170,79.69,20.31,109,558,33,137,142,695,16.3,19.4,17,"75% or more P.O.C.","$141000 or more"
"06085504321","Census Tract 5043.21, Santa Clara County, California",5574,108854,471,80,21,4006,4,915,8.4,1.4,0.4,71.9,0.1,16.4,91.6,1657,1056,601,63.73,36.27,170,886,117,484,287,1370,16.1,19.5,17.3,"75% or more P.O.C.","$108000 - $141000"
"06085504322","Census Tract 5043.22, Santa Clara County, California",5936,118795,736,612,0,4113,0,441,12.4,10.3,0,69.3,0,7.4,87.6,2113,793,1320,37.53,62.47,41,752,256,1064,297,1816,5.2,19.4,14.1,"75% or more P.O.C.","$108000 - $141000"
"06085504323","Census Tract 5043.23, Santa Clara County, California",6005,110521,411,74,31,4528,73,747,6.8,1.2,0.5,75.4,1.2,12.4,93.2,1857,874,983,47.07,52.93,119,755,90,893,209,1648,13.6,9.2,11.3,"75% or more P.O.C.","$108000 - $141000"
"06085504410","Census Tract 5044.10, Santa Clara County, California",4724,114554,574,163,0,2890,0,876,12.2,3.5,0,61.2,0,18.5,87.8,1172,719,453,61.35,38.65,234,485,135,318,369,803,32.5,29.8,31.5,"75% or more P.O.C.","$108000 - $141000"
"06085504411","Census Tract 5044.11, Santa Clara County, California",5884,134773,909,112,0,3872,10,827,15.4,1.9,0,65.8,0.2,14.1,84.6,1530,1184,346,77.39,22.61,220,964,152,194,372,1158,18.6,43.9,24.3,"75% or more P.O.C.","$108000 - $141000"
"06085504412","Census Tract 5044.12, Santa Clara County, California",4873,82966,635,35,0,3013,22,999,13,0.7,0,61.8,0.5,20.5,87,1339,678,661,50.63,49.37,150,528,190,471,340,999,22.1,28.7,25.4,"75% or more P.O.C.","$80000 - $108000"
"06085504413","Census Tract 5044.13, Santa Clara County, California",1981,123125,324,12,0,1416,0,105,16.4,0.6,0,71.5,0,5.3,83.6,729,395,334,54.18,45.82,41,354,15,319,56,673,10.4,4.5,7.7,"75% or more P.O.C.","$108000 - $141000"
"06085504414","Census Tract 5044.14, Santa Clara County, California",5221,190843,522,15,0,4279,100,207,10,0.3,0,82,1.9,4,90,1579,1331,248,84.29,15.71,180,1151,54,194,234,1345,13.5,21.8,14.8,"75% or more P.O.C.","$141000 or more"
"06085504415","Census Tract 5044.15, Santa Clara County, California",5836,151944,951,445,10,4036,0,288,16.3,7.6,0.2,69.2,0,4.9,83.7,1622,1375,247,84.77,15.23,227,1148,134,113,361,1261,16.5,54.3,22.3,"75% or more P.O.C.","$141000 or more"
"06085504416","Census Tract 5044.16, Santa Clara County, California",3777,143373,435,272,0,2440,0,488,11.5,7.2,0,64.6,0,12.9,88.5,1089,880,209,80.81,19.19,138,742,96,113,234,855,15.7,45.9,21.5,"75% or more P.O.C.","$141000 or more"
"06085504417","Census Tract 5044.17, Santa Clara County, California",269,109583,105,9,0,145,0,10,39,3.3,0,53.9,0,3.7,61,107,98,9,91.59,8.41,4,94,0,9,4,103,4.1,0,3.7,"50% - 75% P.O.C.","$108000 - $141000"
"06085504418","Census Tract 5044.18, Santa Clara County, California",5115,102344,539,142,0,3215,0,1117,10.5,2.8,0,62.9,0,21.8,89.5,1435,724,711,50.45,49.55,159,565,55,656,214,1221,22,7.7,14.9,"75% or more P.O.C.","$80000 - $108000"
"06085504420","Census Tract 5044.20, Santa Clara County, California",4694,143864,694,0,0,3402,0,487,14.8,0,0,72.5,0,10.4,85.2,1502,1120,382,74.57,25.43,152,968,45,337,197,1305,13.6,11.8,13.1,"75% or more P.O.C.","$141000 or more"
"06085504421","Census Tract 5044.21, Santa Clara County, California",5437,155893,561,266,0,3926,2,340,10.3,4.9,0,72.2,0,6.3,89.7,1395,1130,265,81,19,276,854,45,220,321,1074,24.4,17,23,"75% or more P.O.C.","$141000 or more"
"06085504422","Census Tract 5044.22, Santa Clara County, California",3849,99792,277,125,0,2262,0,1036,7.2,3.2,0,58.8,0,26.9,92.8,1053,744,309,70.66,29.34,192,552,68,241,260,793,25.8,22,24.7,"75% or more P.O.C.","$80000 - $108000"
"06085504423","Census Tract 5044.23, Santa Clara County, California",2551,124015,575,154,0,1142,15,578,22.5,6,0,44.8,0.6,22.7,77.5,672,550,122,81.85,18.15,133,417,22,100,155,517,24.2,18,23.1,"75% or more P.O.C.","$108000 - $141000"
"06085504504","Census Tract 5045.04, Santa Clara County, California",12367,155461,1081,676,45,7725,14,2135,8.7,5.5,0.4,62.5,0.1,17.3,91.3,3644,1607,2037,44.1,55.9,56,1551,200,1837,256,3388,3.5,9.8,7,"75% or more P.O.C.","$141000 or more"
"06085504505","Census Tract 5045.05, Santa Clara County, California",9011,140772,1093,79,22,6500,0,965,12.1,0.9,0.2,72.1,0,10.7,87.9,3048,1933,1115,63.42,36.58,249,1684,99,1016,348,2700,12.9,8.9,11.4,"75% or more P.O.C.","$108000 - $141000"
"06085504506","Census Tract 5045.06, Santa Clara County, California",7088,116046,460,213,15,4755,54,1026,6.5,3,0.2,67.1,0.8,14.5,93.5,2199,1163,1036,52.89,47.11,90,1073,155,881,245,1954,7.7,15,11.1,"75% or more P.O.C.","$108000 - $141000"
"06085504507","Census Tract 5045.07, Santa Clara County, California",6459,118972,659,95,89,3912,50,1435,10.2,1.5,1.4,60.6,0.8,22.2,89.8,1785,1316,469,73.73,26.27,294,1022,42,427,336,1449,22.3,9,18.8,"75% or more P.O.C.","$108000 - $141000"
"06085504601","Census Tract 5046.01, Santa Clara County, California",1016,74904,391,0,0,250,0,335,38.5,0,0,24.6,0,33,61.5,365,291,74,79.73,20.27,27,264,16,58,43,322,9.3,21.6,11.8,"50% - 75% P.O.C.","Less than $80000"
"06085504602","Census Tract 5046.02, Santa Clara County, California",2355,95500,476,122,35,326,0,1388,20.2,5.2,1.5,13.8,0,58.9,79.8,628,419,209,66.72,33.28,118,301,31,178,149,479,28.2,14.8,23.7,"75% or more P.O.C.","$80000 - $108000"
"06085504700","Census Tract 5047, Santa Clara County, California",588,103438,443,14,0,5,0,109,75.3,2.4,0,0.9,0,18.5,24.7,143,0,143,0,100,0,0,44,99,44,99,NA,30.8,30.8,"Less than 25% P.O.C.","$80000 - $108000"
"06085504802","Census Tract 5048.02, Santa Clara County, California",5516,102311,1091,126,0,2697,0,1511,19.8,2.3,0,48.9,0,27.4,80.2,1694,1120,574,66.12,33.88,215,905,48,526,263,1431,19.2,8.4,15.5,"75% or more P.O.C.","$80000 - $108000"
"06085504803","Census Tract 5048.03, Santa Clara County, California",7021,143764,1195,141,0,4160,0,1337,17,2,0,59.3,0,19,83,2781,1105,1676,39.73,60.27,74,1031,186,1490,260,2521,6.7,11.1,9.3,"75% or more P.O.C.","$141000 or more"
"06085504805","Census Tract 5048.05, Santa Clara County, California",7286,108048,3084,275,0,2388,0,1313,42.3,3.8,0,32.8,0,18,57.7,2957,1916,1041,64.8,35.2,146,1770,12,1029,158,2799,7.6,1.2,5.3,"50% - 75% P.O.C.","$108000 - $141000"
"06085504806","Census Tract 5048.06, Santa Clara County, California",3052,134500,553,14,0,1328,27,890,18.1,0.5,0,43.5,0.9,29.2,81.9,796,570,226,71.61,28.39,142,428,48,178,190,606,24.9,21.2,23.9,"75% or more P.O.C.","$108000 - $141000"
"06085504901","Census Tract 5049.01, Santa Clara County, California",9956,161505,2235,110,0,6618,0,527,22.4,1.1,0,66.5,0,5.3,77.6,3962,1489,2473,37.58,62.42,119,1370,45,2428,164,3798,8,1.8,4.1,"75% or more P.O.C.","$141000 or more"
"06085505001","Census Tract 5050.01, Santa Clara County, California",10204,149500,2197,691,13,5386,0,1530,21.5,6.8,0.1,52.8,0,15,78.5,3588,1534,2054,42.75,57.25,271,1263,114,1940,385,3203,17.7,5.6,10.7,"75% or more P.O.C.","$141000 or more"
"06085505006","Census Tract 5050.06, Santa Clara County, California",11441,166174,2774,249,0,7732,0,487,24.2,2.2,0,67.6,0,4.3,75.8,5335,746,4589,13.98,86.02,22,724,41,4548,63,5272,2.9,0.9,1.2,"75% or more P.O.C.","$141000 or more"
"06085505007","Census Tract 5050.07, Santa Clara County, California",4239,114236,1037,230,0,1997,13,832,24.5,5.4,0,47.1,0.3,19.6,75.5,953,627,326,65.79,34.21,150,477,128,198,278,675,23.9,39.3,29.2,"75% or more P.O.C.","$108000 - $141000"
"06085505008","Census Tract 5050.08, Santa Clara County, California",7769,142540,1785,378,0,4717,0,546,23,4.9,0,60.7,0,7,77,3489,14,3475,0.4,99.6,0,14,29,3446,29,3460,0,0.8,0.8,"75% or more P.O.C.","$141000 or more"
"06085505009","Census Tract 5050.09, Santa Clara County, California",11332,134844,2308,929,0,4846,333,2462,20.4,8.2,0,42.8,2.9,21.7,79.6,4103,1328,2775,32.37,67.63,331,997,264,2511,595,3508,24.9,9.5,14.5,"75% or more P.O.C.","$108000 - $141000"
"06085505100","Census Tract 5051, Santa Clara County, California",4076,82841,903,257,0,1402,0,1378,22.2,6.3,0,34.4,0,33.8,77.8,2039,532,1507,26.09,73.91,29,503,68,1439,97,1942,5.5,4.5,4.8,"75% or more P.O.C.","$80000 - $108000"
"06085505202","Census Tract 5052.02, Santa Clara County, California",6936,84063,1805,181,0,1831,207,2400,26,2.6,0,26.4,3,34.6,74,2538,605,1933,23.84,76.16,61,544,279,1654,340,2198,10.1,14.4,13.4,"50% - 75% P.O.C.","$80000 - $108000"
"06085505203","Census Tract 5052.03, Santa Clara County, California",5964,128424,2881,182,0,1328,0,1269,48.3,3.1,0,22.3,0,21.3,51.7,1282,563,719,43.92,56.08,34,529,25,694,59,1223,6,3.5,4.6,"50% - 75% P.O.C.","$108000 - $141000"
"06085505301","Census Tract 5053.01, Santa Clara County, California",5197,128800,1263,223,0,2571,64,958,24.3,4.3,0,49.5,1.2,18.4,75.7,1758,654,1104,37.2,62.8,80,574,180,924,260,1498,12.2,16.3,14.8,"75% or more P.O.C.","$108000 - $141000"
"06085505302","Census Tract 5053.02, Santa Clara County, California",4168,99125,1346,214,0,1543,46,842,32.3,5.1,0,37,1.1,20.2,67.7,1503,898,605,59.75,40.25,90,808,77,528,167,1336,10,12.7,11.1,"50% - 75% P.O.C.","$80000 - $108000"
"06085505303","Census Tract 5053.03, Santa Clara County, California",6345,101196,1672,130,0,2547,0,1663,26.4,2,0,40.1,0,26.2,73.6,2118,896,1222,42.3,57.7,89,807,177,1045,266,1852,9.9,14.5,12.6,"50% - 75% P.O.C.","$80000 - $108000"
"06085505304","Census Tract 5053.04, Santa Clara County, California",3266,157050,1146,87,10,1321,0,638,35.1,2.7,0.3,40.4,0,19.5,64.9,1067,857,210,80.32,19.68,126,731,20,190,146,921,14.7,9.5,13.7,"50% - 75% P.O.C.","$141000 or more"
"06085505305","Census Tract 5053.05, Santa Clara County, California",5859,123500,2089,93,34,2702,22,851,35.7,1.6,0.6,46.1,0.4,14.5,64.3,2120,1177,943,55.52,44.48,165,1012,86,857,251,1869,14,9.1,11.8,"50% - 75% P.O.C.","$108000 - $141000"
"06085505401","Census Tract 5054.01, Santa Clara County, California",7423,134258,1608,53,70,4149,0,1393,21.7,0.7,0.9,55.9,0,18.8,78.3,2714,758,1956,27.93,72.07,41,717,93,1863,134,2580,5.4,4.8,4.9,"75% or more P.O.C.","$108000 - $141000"
"06085505402","Census Tract 5054.02, Santa Clara County, California",3125,134688,1032,72,1,1071,0,740,33,2.3,0,34.3,0,23.7,67,1130,691,439,61.15,38.85,63,628,44,395,107,1023,9.1,10,9.5,"50% - 75% P.O.C.","$108000 - $141000"
"06085505403","Census Tract 5054.03, Santa Clara County, California",8742,129359,2277,50,0,3843,344,1797,26,0.6,0,44,3.9,20.6,74,3332,1072,2260,32.17,67.83,50,1022,96,2164,146,3186,4.7,4.2,4.4,"50% - 75% P.O.C.","$108000 - $141000"
"06085505500","Census Tract 5055, Santa Clara County, California",4365,115398,1780,222,0,942,0,1073,40.8,5.1,0,21.6,0,24.6,59.2,1597,839,758,52.54,47.46,89,750,34,724,123,1474,10.6,4.5,7.7,"50% - 75% P.O.C.","$108000 - $141000"
"06085505600","Census Tract 5056, Santa Clara County, California",4557,81538,2391,140,0,949,0,930,52.5,3.1,0,20.8,0,20.4,47.5,1162,279,883,24.01,75.99,72,207,55,828,127,1035,25.8,6.2,10.9,"25% - 50% P.O.C.","$80000 - $108000"
"06085505700","Census Tract 5057, Santa Clara County, California",6726,88333,2397,358,0,1736,0,1642,35.6,5.3,0,25.8,0,24.4,64.4,2246,494,1752,21.99,78.01,39,455,323,1429,362,1884,7.9,18.4,16.1,"50% - 75% P.O.C.","$80000 - $108000"
"06085505800","Census Tract 5058, Santa Clara County, California",4279,135662,2204,95,0,629,3,1164,51.5,2.2,0,14.7,0.1,27.2,48.5,1584,941,643,59.41,40.59,97,844,75,568,172,1412,10.3,11.7,10.9,"25% - 50% P.O.C.","$108000 - $141000"
"06085505900","Census Tract 5059, Santa Clara County, California",7393,113398,3593,180,0,2208,85,1170,48.6,2.4,0,29.9,1.1,15.8,51.4,3205,1302,1903,40.62,59.38,118,1184,58,1845,176,3029,9.1,3,5.5,"50% - 75% P.O.C.","$108000 - $141000"
"06085506000","Census Tract 5060, Santa Clara County, California",4752,118000,2380,111,0,1275,0,856,50.1,2.3,0,26.8,0,18,49.9,1762,948,814,53.8,46.2,80,868,71,743,151,1611,8.4,8.7,8.6,"25% - 50% P.O.C.","$108000 - $141000"
"06085506101","Census Tract 5061.01, Santa Clara County, California",4381,126127,1837,47,0,1830,11,505,41.9,1.1,0,41.8,0.3,11.5,58.1,1560,1036,524,66.41,33.59,66,970,52,472,118,1442,6.4,9.9,7.6,"50% - 75% P.O.C.","$108000 - $141000"
"06085506102","Census Tract 5061.02, Santa Clara County, California",4158,149583,1551,126,0,1959,18,370,37.3,3,0,47.1,0.4,8.9,62.7,1602,977,625,60.99,39.01,54,923,41,584,95,1507,5.5,6.6,5.9,"50% - 75% P.O.C.","$141000 or more"
"06085506103","Census Tract 5061.03, Santa Clara County, California",5090,124750,1515,62,0,2875,24,390,29.8,1.2,0,56.5,0.5,7.7,70.2,1659,992,667,59.8,40.2,140,852,97,570,237,1422,14.1,14.5,14.3,"50% - 75% P.O.C.","$108000 - $141000"
"06085506202","Census Tract 5062.02, Santa Clara County, California",7389,156169,2934,112,0,3536,0,440,39.7,1.5,0,47.9,0,6,60.3,2564,1532,1032,59.75,40.25,119,1413,45,987,164,2400,7.8,4.4,6.4,"50% - 75% P.O.C.","$141000 or more"
"06085506203","Census Tract 5062.03, Santa Clara County, California",6589,105417,1210,241,54,4168,0,805,18.4,3.7,0.8,63.3,0,12.2,81.6,2300,599,1701,26.04,73.96,34,565,124,1577,158,2142,5.7,7.3,6.9,"75% or more P.O.C.","$80000 - $108000"
"06085506204","Census Tract 5062.04, Santa Clara County, California",5568,108478,1328,221,0,3261,0,475,23.9,4,0,58.6,0,8.5,76.1,2026,1439,587,71.03,28.97,36,1403,60,527,96,1930,2.5,10.2,4.7,"75% or more P.O.C.","$108000 - $141000"
"06085506301","Census Tract 5063.01, Santa Clara County, California",5443,90333,2181,396,2,1607,0,1033,40.1,7.3,0,29.5,0,19,59.9,2238,613,1625,27.39,72.61,32,581,101,1524,133,2105,5.2,6.2,5.9,"50% - 75% P.O.C.","$80000 - $108000"
"06085506302","Census Tract 5063.02, Santa Clara County, California",6778,138750,3272,235,46,1804,0,1279,48.3,3.5,0.7,26.6,0,18.9,51.7,2267,1311,956,57.83,42.17,65,1246,71,885,136,2131,5,7.4,6,"50% - 75% P.O.C.","$108000 - $141000"
"06085506304","Census Tract 5063.04, Santa Clara County, California",5262,108787,1461,121,0,2118,133,1357,27.8,2.3,0,40.3,2.5,25.8,72.2,2161,558,1603,25.82,74.18,69,489,80,1523,149,2012,12.4,5,6.9,"50% - 75% P.O.C.","$108000 - $141000"
"06085506305","Census Tract 5063.05, Santa Clara County, California",6726,68917,2119,1210,0,1228,25,2033,31.5,18,0,18.3,0.4,30.2,68.5,2412,485,1927,20.11,79.89,45,440,129,1798,174,2238,9.3,6.7,7.2,"50% - 75% P.O.C.","Less than $80000"
"06085506401","Census Tract 5064.01, Santa Clara County, California",5017,89853,2063,323,0,1084,0,1229,41.1,6.4,0,21.6,0,24.5,58.9,2230,613,1617,27.49,72.51,28,585,26,1591,54,2176,4.6,1.6,2.4,"50% - 75% P.O.C.","$80000 - $108000"
"06085506402","Census Tract 5064.02, Santa Clara County, California",5784,95107,2162,283,0,850,4,2301,37.4,4.9,0,14.7,0.1,39.8,62.6,2189,788,1401,36,64,26,762,112,1289,138,2051,3.3,8,6.3,"50% - 75% P.O.C.","$80000 - $108000"
"06085506501","Census Tract 5065.01, Santa Clara County, California",7421,69704,1648,326,0,1926,0,3106,22.2,4.4,0,26,0,41.9,77.8,2455,860,1595,35.03,64.97,39,821,348,1247,387,2068,4.5,21.8,15.8,"75% or more P.O.C.","Less than $80000"
"06085506502","Census Tract 5065.02, Santa Clara County, California",3941,123623,2438,139,11,445,0,731,61.9,3.5,0.3,11.3,0,18.5,38.1,1817,886,931,48.76,51.24,11,875,27,904,38,1779,1.2,2.9,2.1,"25% - 50% P.O.C.","$108000 - $141000"
"06085506503","Census Tract 5065.03, Santa Clara County, California",6241,92969,3041,244,0,1269,0,1514,48.7,3.9,0,20.3,0,24.3,51.3,2721,953,1768,35.02,64.98,90,863,51,1717,141,2580,9.4,2.9,5.2,"50% - 75% P.O.C.","$80000 - $108000"
"06085506601","Census Tract 5066.01, Santa Clara County, California",4568,101719,1759,124,0,1474,25,988,38.5,2.7,0,32.3,0.5,21.6,61.5,1685,743,942,44.09,55.91,55,688,63,879,118,1567,7.4,6.7,7,"50% - 75% P.O.C.","$80000 - $108000"
"06085506603","Census Tract 5066.03, Santa Clara County, California",3923,173000,2056,53,2,933,167,502,52.4,1.4,0.1,23.8,4.3,12.8,47.6,1354,1001,353,73.93,26.07,71,930,89,264,160,1194,7.1,25.2,11.8,"25% - 50% P.O.C.","$141000 or more"
"06085506604","Census Tract 5066.04, Santa Clara County, California",7753,156711,3741,4,0,2844,21,847,48.3,0.1,0,36.7,0.3,10.9,51.7,2618,2019,599,77.12,22.88,199,1820,55,544,254,2364,9.9,9.2,9.7,"50% - 75% P.O.C.","$141000 or more"
"06085506605","Census Tract 5066.05, Santa Clara County, California",4387,102436,1965,164,0,1210,0,666,44.8,3.7,0,27.6,0,15.2,55.2,1624,718,906,44.21,55.79,87,631,110,796,197,1427,12.1,12.1,12.1,"50% - 75% P.O.C.","$80000 - $108000"
"06085506606","Census Tract 5066.06, Santa Clara County, California",4468,117917,1940,126,0,1171,0,1048,43.4,2.8,0,26.2,0,23.5,56.6,1503,739,764,49.17,50.83,79,660,93,671,172,1331,10.7,12.2,11.4,"50% - 75% P.O.C.","$108000 - $141000"
"06085506701","Census Tract 5067.01, Santa Clara County, California",3998,160577,1846,0,0,1220,20,700,46.2,0,0,30.5,0.5,17.5,53.8,1262,1009,253,79.95,20.05,63,946,59,194,122,1140,6.2,23.3,9.7,"50% - 75% P.O.C.","$141000 or more"
"06085506702","Census Tract 5067.02, Santa Clara County, California",5860,141250,3070,152,23,1219,0,1155,52.4,2.6,0.4,20.8,0,19.7,47.6,1874,1043,831,55.66,44.34,124,919,156,675,280,1594,11.9,18.8,14.9,"25% - 50% P.O.C.","$141000 or more"
"06085506703","Census Tract 5067.03, Santa Clara County, California",3564,138000,1801,78,0,1002,1,447,50.5,2.2,0,28.1,0,12.5,49.5,1308,744,564,56.88,43.12,44,700,23,541,67,1241,5.9,4.1,5.1,"25% - 50% P.O.C.","$108000 - $141000"
"06085506801","Census Tract 5068.01, Santa Clara County, California",5832,150500,4231,35,0,708,0,587,72.5,0.6,0,12.1,0,10.1,27.5,2078,1279,799,61.55,38.45,118,1161,34,765,152,1926,9.2,4.3,7.3,"25% - 50% P.O.C.","$141000 or more"
"06085506802","Census Tract 5068.02, Santa Clara County, California",5674,152045,3337,54,0,1258,0,804,58.8,1,0,22.2,0,14.2,41.2,1882,1328,554,70.56,29.44,116,1212,48,506,164,1718,8.7,8.7,8.7,"25% - 50% P.O.C.","$141000 or more"
"06085506803","Census Tract 5068.03, Santa Clara County, California",7344,158750,3833,135,0,2194,0,1023,52.2,1.8,0,29.9,0,13.9,47.8,2350,1661,689,70.68,29.32,325,1336,44,645,369,1981,19.6,6.4,15.7,"25% - 50% P.O.C.","$141000 or more"
"06085506804","Census Tract 5068.04, Santa Clara County, California",3920,161806,2512,43,10,917,32,184,64.1,1.1,0.3,23.4,0.8,4.7,35.9,1341,1122,219,83.67,16.33,71,1051,0,219,71,1270,6.3,0,5.3,"25% - 50% P.O.C.","$141000 or more"
"06085506900","Census Tract 5069, Santa Clara County, California",7939,193667,5232,105,0,1521,0,623,65.9,1.3,0,19.2,0,7.8,34.1,2696,2264,432,83.98,16.02,196,2068,21,411,217,2479,8.7,4.9,8,"25% - 50% P.O.C.","$141000 or more"
"06085507001","Census Tract 5070.01, Santa Clara County, California",7095,190313,5858,63,0,591,0,470,82.6,0.9,0,8.3,0,6.6,17.4,2957,1975,982,66.79,33.21,188,1787,0,982,188,2769,9.5,0,6.4,"Less than 25% P.O.C.","$141000 or more"
"06085507002","Census Tract 5070.02, Santa Clara County, California",3050,250001,2472,8,0,322,0,99,81,0.3,0,10.6,0,3.2,19,988,861,127,87.15,12.85,146,715,15,112,161,827,17,11.8,16.3,"Less than 25% P.O.C.","$141000 or more"
"06085507100","Census Tract 5071, Santa Clara County, California",3211,140250,2293,0,0,282,0,529,71.4,0,0,8.8,0,16.5,28.6,1344,519,825,38.62,61.38,16,503,53,772,69,1275,3.1,6.4,5.1,"25% - 50% P.O.C.","$108000 - $141000"
"06085507203","Census Tract 5072.03, Santa Clara County, California",2971,167875,1759,16,0,564,0,518,59.2,0.5,0,19,0,17.4,40.8,1174,631,543,53.75,46.25,50,581,14,529,64,1110,7.9,2.6,5.5,"25% - 50% P.O.C.","$141000 or more"
"06085507205","Census Tract 5072.05, Santa Clara County, California",4853,183875,3304,30,0,1014,0,264,68.1,0.6,0,20.9,0,5.4,31.9,1867,1629,238,87.25,12.75,106,1523,0,238,106,1761,6.5,0,5.7,"25% - 50% P.O.C.","$141000 or more"
"06085507206","Census Tract 5072.06, Santa Clara County, California",2426,250001,1754,4,0,477,0,127,72.3,0.2,0,19.7,0,5.2,27.7,864,786,78,90.97,9.03,98,688,0,78,98,766,12.5,0,11.3,"25% - 50% P.O.C.","$141000 or more"
"06085507301","Census Tract 5073.01, Santa Clara County, California",6602,189527,3144,2,30,2925,0,282,47.6,0,0.5,44.3,0,4.3,52.4,2468,1915,553,77.59,22.41,185,1730,24,529,209,2259,9.7,4.3,8.5,"50% - 75% P.O.C.","$141000 or more"
"06085507302","Census Tract 5073.02, Santa Clara County, California",2892,234821,1771,8,0,759,0,65,61.2,0.3,0,26.2,0,2.2,38.8,1008,826,182,81.94,18.06,64,762,28,154,92,916,7.7,15.4,9.1,"25% - 50% P.O.C.","$141000 or more"
"06085507401","Census Tract 5074.01, Santa Clara County, California",5858,205726,1920,3,25,3550,0,135,32.8,0.1,0.4,60.6,0,2.3,67.2,1992,1721,271,86.4,13.6,128,1593,41,230,169,1823,7.4,15.1,8.5,"50% - 75% P.O.C.","$141000 or more"
"06085507402","Census Tract 5074.02, Santa Clara County, California",4013,172639,2431,18,0,1124,0,188,60.6,0.4,0,28,0,4.7,39.4,1437,1165,272,81.07,18.93,110,1055,22,250,132,1305,9.4,8.1,9.2,"25% - 50% P.O.C.","$141000 or more"
"06085507500","Census Tract 5075, Santa Clara County, California",5927,159493,1872,36,0,3817,0,95,31.6,0.6,0,64.4,0,1.6,68.4,2078,1852,226,89.12,10.88,97,1755,94,132,191,1887,5.2,41.6,9.2,"50% - 75% P.O.C.","$141000 or more"
"06085507600","Census Tract 5076, Santa Clara County, California",5566,199479,2848,73,5,2345,0,187,51.2,1.3,0.1,42.1,0,3.4,48.8,2035,1832,203,90.02,9.98,91,1741,0,203,91,1944,5,0,4.5,"25% - 50% P.O.C.","$141000 or more"
"06085507701","Census Tract 5077.01, Santa Clara County, California",3534,161571,1029,30,0,2340,0,48,29.1,0.8,0,66.2,0,1.4,70.9,1326,963,363,72.62,27.38,75,888,31,332,106,1220,7.8,8.5,8,"50% - 75% P.O.C.","$141000 or more"
"06085507702","Census Tract 5077.02, Santa Clara County, California",6161,188846,1316,0,0,4549,133,0,21.4,0,0,73.8,2.2,0,78.6,2066,1809,257,87.56,12.44,95,1714,48,209,143,1923,5.3,18.7,6.9,"75% or more P.O.C.","$141000 or more"
"06085507703","Census Tract 5077.03, Santa Clara County, California",8116,197031,2983,13,0,4621,4,242,36.8,0.2,0,56.9,0,3,63.2,2750,1646,1104,59.85,40.15,98,1548,70,1034,168,2582,6,6.3,6.1,"50% - 75% P.O.C.","$141000 or more"
"06085507805","Census Tract 5078.05, Santa Clara County, California",5465,143043,1464,0,0,3329,0,425,26.8,0,0,60.9,0,7.8,73.2,2044,800,1244,39.14,60.86,62,738,27,1217,89,1955,7.8,2.2,4.4,"50% - 75% P.O.C.","$141000 or more"
"06085507806","Census Tract 5078.06, Santa Clara County, California",5971,155972,785,0,29,4826,0,155,13.1,0,0.5,80.8,0,2.6,86.9,2014,634,1380,31.48,68.52,51,583,45,1335,96,1918,8,3.3,4.8,"75% or more P.O.C.","$141000 or more"
"06085507807","Census Tract 5078.07, Santa Clara County, California",3383,192979,514,0,0,2585,23,171,15.2,0,0,76.4,0.7,5.1,84.8,1050,662,388,63.05,36.95,52,610,33,355,85,965,7.9,8.5,8.1,"75% or more P.O.C.","$141000 or more"
"06085507808","Census Tract 5078.08, Santa Clara County, California",5580,218229,1094,0,0,4188,23,100,19.6,0,0,75.1,0.4,1.8,80.4,1775,1363,412,76.79,23.21,84,1279,49,363,133,1642,6.2,11.9,7.5,"75% or more P.O.C.","$141000 or more"
"06085507903","Census Tract 5079.03, Santa Clara County, California",4968,192813,1004,41,0,3699,0,66,20.2,0.8,0,74.5,0,1.3,79.8,1597,1410,187,88.29,11.71,136,1274,29,158,165,1432,9.6,15.5,10.3,"75% or more P.O.C.","$141000 or more"
"06085507904","Census Tract 5079.04, Santa Clara County, California",3195,206607,853,0,63,2097,0,105,26.7,0,2,65.6,0,3.3,73.3,1084,969,115,89.39,10.61,38,931,17,98,55,1029,3.9,14.8,5.1,"50% - 75% P.O.C.","$141000 or more"
"06085507905","Census Tract 5079.05, Santa Clara County, California",6063,149514,1173,0,0,4321,0,383,19.3,0,0,71.3,0,6.3,80.7,2113,995,1118,47.09,52.91,84,911,67,1051,151,1962,8.4,6,7.1,"75% or more P.O.C.","$141000 or more"
"06085507906","Census Tract 5079.06, Santa Clara County, California",4286,211250,907,29,9,3194,0,59,21.2,0.7,0.2,74.5,0,1.4,78.8,1377,1216,161,88.31,11.69,86,1130,42,119,128,1249,7.1,26.1,9.3,"75% or more P.O.C.","$141000 or more"
"06085508001","Census Tract 5080.01, Santa Clara County, California",7487,158826,1697,0,0,5358,0,158,22.7,0,0,71.6,0,2.1,77.3,2911,1660,1251,57.03,42.97,78,1582,15,1236,93,2818,4.7,1.2,3.2,"75% or more P.O.C.","$141000 or more"
"06085508003","Census Tract 5080.03, Santa Clara County, California",2480,161324,819,106,9,1357,10,120,33,4.3,0.4,54.7,0.4,4.8,67,776,435,341,56.06,43.94,55,380,57,284,112,664,12.6,16.7,14.4,"50% - 75% P.O.C.","$141000 or more"
"06085508004","Census Tract 5080.04, Santa Clara County, California",6221,139056,1311,392,0,3978,0,402,21.1,6.3,0,63.9,0,6.5,78.9,1995,1086,909,54.44,45.56,189,897,108,801,297,1698,17.4,11.9,14.9,"75% or more P.O.C.","$108000 - $141000"
"06085508101","Census Tract 5081.01, Santa Clara County, California",6768,200625,1685,1,0,4797,0,150,24.9,0,0,70.9,0,2.2,75.1,2332,1428,904,61.23,38.77,66,1362,40,864,106,2226,4.6,4.4,4.5,"75% or more P.O.C.","$141000 or more"
"06085508102","Census Tract 5081.02, Santa Clara County, California",3408,171324,989,0,55,2103,0,153,29,0,1.6,61.7,0,4.5,71,1328,621,707,46.76,53.24,24,597,9,698,33,1295,3.9,1.3,2.5,"50% - 75% P.O.C.","$141000 or more"
"06085508202","Census Tract 5082.02, Santa Clara County, California",7600,161683,2477,145,0,3777,21,684,32.6,1.9,0,49.7,0.3,9,67.4,2628,1585,1043,60.31,39.69,59,1526,145,898,204,2424,3.7,13.9,7.8,"50% - 75% P.O.C.","$141000 or more"
"06085508203","Census Tract 5082.03, Santa Clara County, California",5630,194375,1750,20,0,3336,0,224,31.1,0.4,0,59.3,0,4,68.9,1801,1205,596,66.91,33.09,98,1107,75,521,173,1628,8.1,12.6,9.6,"50% - 75% P.O.C.","$141000 or more"
"06085508204","Census Tract 5082.04, Santa Clara County, California",4122,176818,1584,18,0,2154,0,196,38.4,0.4,0,52.3,0,4.8,61.6,1440,1030,410,71.53,28.47,28,1002,48,362,76,1364,2.7,11.7,5.3,"50% - 75% P.O.C.","$141000 or more"
"06085508301","Census Tract 5083.01, Santa Clara County, California",4667,199861,1994,51,0,2179,0,193,42.7,1.1,0,46.7,0,4.1,57.3,1573,1179,394,74.95,25.05,68,1111,70,324,138,1435,5.8,17.8,8.8,"50% - 75% P.O.C.","$141000 or more"
"06085508303","Census Tract 5083.03, Santa Clara County, California",2518,186250,1290,0,0,1039,0,85,51.2,0,0,41.3,0,3.4,48.8,872,792,80,90.83,9.17,66,726,14,66,80,792,8.3,17.5,9.2,"25% - 50% P.O.C.","$141000 or more"
"06085508304","Census Tract 5083.04, Santa Clara County, California",8452,102011,1942,346,24,4641,224,990,23,4.1,0.3,54.9,2.7,11.7,77,3019,883,2136,29.25,70.75,101,782,173,1963,274,2745,11.4,8.1,9.1,"75% or more P.O.C.","$80000 - $108000"
"06085508401","Census Tract 5084.01, Santa Clara County, California",7144,169512,3435,33,9,2940,2,448,48.1,0.5,0.1,41.2,0,6.3,51.9,2478,1554,924,62.71,37.29,131,1423,59,865,190,2288,8.4,6.4,7.7,"50% - 75% P.O.C.","$141000 or more"
"06085508403","Census Tract 5084.03, Santa Clara County, California",3131,179688,1543,12,0,1136,0,152,49.3,0.4,0,36.3,0,4.9,50.7,1048,809,239,77.19,22.81,73,736,32,207,105,943,9,13.4,10,"50% - 75% P.O.C.","$141000 or more"
"06085508404","Census Tract 5084.04, Santa Clara County, California",6947,162097,2813,0,106,3025,0,781,40.5,0,1.5,43.5,0,11.2,59.5,2394,1504,890,62.82,37.18,276,1228,104,786,380,2014,18.4,11.7,15.9,"50% - 75% P.O.C.","$141000 or more"
"06085508503","Census Tract 5085.03, Santa Clara County, California",6575,147632,1642,17,0,4058,0,591,25,0.3,0,61.7,0,9,75,2562,745,1817,29.08,70.92,47,698,47,1770,94,2468,6.3,2.6,3.7,"75% or more P.O.C.","$141000 or more"
"06085508504","Census Tract 5085.04, Santa Clara County, California",8604,114300,1584,89,0,4940,0,1363,18.4,1,0,57.4,0,15.8,81.6,3348,512,2836,15.29,84.71,21,491,135,2701,156,3192,4.1,4.8,4.7,"75% or more P.O.C.","$108000 - $141000"
"06085508505","Census Tract 5085.05, Santa Clara County, California",4871,152969,1941,0,19,2366,0,416,39.8,0,0.4,48.6,0,8.5,60.2,1919,873,1046,45.49,54.51,47,826,63,983,110,1809,5.4,6,5.7,"50% - 75% P.O.C.","$141000 or more"
"06085508507","Census Tract 5085.07, Santa Clara County, California",2926,115313,650,100,0,1700,0,286,22.2,3.4,0,58.1,0,9.8,77.8,1302,318,984,24.42,75.58,0,318,44,940,44,1258,0,4.5,3.4,"75% or more P.O.C.","$108000 - $141000"
"06085508508","Census Tract 5085.08, Santa Clara County, California",5576,121439,1711,32,0,2681,0,777,30.7,0.6,0,48.1,0,13.9,69.3,1980,747,1233,37.73,62.27,65,682,84,1149,149,1831,8.7,6.8,7.5,"50% - 75% P.O.C.","$108000 - $141000"
"06085508601","Census Tract 5086.01, Santa Clara County, California",3722,167109,1299,0,0,1580,0,562,34.9,0,0,42.5,0,15.1,65.1,1339,913,426,68.19,31.81,95,818,31,395,126,1213,10.4,7.3,9.4,"50% - 75% P.O.C.","$141000 or more"
"06085508602","Census Tract 5086.02, Santa Clara County, California",5054,141186,2163,47,23,1440,21,1084,42.8,0.9,0.5,28.5,0.4,21.4,57.2,2242,507,1735,22.61,77.39,38,469,102,1633,140,2102,7.5,5.9,6.2,"50% - 75% P.O.C.","$141000 or more"
"06085508703","Census Tract 5087.03, Santa Clara County, California",8274,157357,2098,222,7,4616,0,1103,25.4,2.7,0.1,55.8,0,13.3,74.6,3163,1085,2078,34.3,65.7,22,1063,90,1988,112,3051,2,4.3,3.5,"50% - 75% P.O.C.","$141000 or more"
"06085508704","Census Tract 5087.04, Santa Clara County, California",7587,145500,1962,303,9,3587,3,1491,25.9,4,0.1,47.3,0,19.7,74.1,3010,1016,1994,33.75,66.25,97,919,66,1928,163,2847,9.5,3.3,5.4,"50% - 75% P.O.C.","$141000 or more"
"06085508800","Census Tract 5088, Santa Clara County, California",3884,127870,1158,49,0,1332,2,1086,29.8,1.3,0,34.3,0.1,28,70.2,1444,426,1018,29.5,70.5,36,390,74,944,110,1334,8.5,7.3,7.6,"50% - 75% P.O.C.","$108000 - $141000"
"06085508900","Census Tract 5089, Santa Clara County, California",5184,101250,953,135,0,2048,62,1880,18.4,2.6,0,39.5,1.2,36.3,81.6,1649,739,910,44.82,55.18,132,607,129,781,261,1388,17.9,14.2,15.8,"75% or more P.O.C.","$80000 - $108000"
"06085509000","Census Tract 5090, Santa Clara County, California",7570,92448,1758,30,92,2089,24,3230,23.2,0.4,1.2,27.6,0.3,42.7,76.8,2553,1255,1298,49.16,50.84,126,1129,144,1154,270,2283,10,11.1,10.6,"75% or more P.O.C.","$80000 - $108000"
"06085509102","Census Tract 5091.02, Santa Clara County, California",5051,167288,1324,126,0,2967,0,406,26.2,2.5,0,58.7,0,8,73.8,2285,880,1405,38.51,61.49,19,861,0,1405,19,2266,2.2,0,0.8,"50% - 75% P.O.C.","$141000 or more"
"06085509105","Census Tract 5091.05, Santa Clara County, California",7166,151386,2768,50,0,2945,0,1216,38.6,0.7,0,41.1,0,17,61.4,3077,1160,1917,37.7,62.3,72,1088,69,1848,141,2936,6.2,3.6,4.6,"50% - 75% P.O.C.","$141000 or more"
"06085509106","Census Tract 5091.06, Santa Clara County, California",4473,149333,1317,36,8,1678,0,1247,29.4,0.8,0.2,37.5,0,27.9,70.6,1682,492,1190,29.25,70.75,37,455,122,1068,159,1523,7.5,10.3,9.5,"50% - 75% P.O.C.","$141000 or more"
"06085509107","Census Tract 5091.07, Santa Clara County, California",4957,131004,1370,110,22,2128,0,1243,27.6,2.2,0.4,42.9,0,25.1,72.4,1945,33,1912,1.7,98.3,0,33,121,1791,121,1824,0,6.3,6.2,"50% - 75% P.O.C.","$108000 - $141000"
"06085509108","Census Tract 5091.08, Santa Clara County, California",4428,126285,1829,63,9,1582,0,733,41.3,1.4,0.2,35.7,0,16.6,58.7,1925,708,1217,36.78,63.22,15,693,58,1159,73,1852,2.1,4.8,3.8,"50% - 75% P.O.C.","$108000 - $141000"
"06085509109","Census Tract 5091.09, Santa Clara County, California",4978,183787,2340,19,34,1822,0,429,47,0.4,0.7,36.6,0,8.6,53,2093,1172,921,56,44,48,1124,52,869,100,1993,4.1,5.6,4.8,"50% - 75% P.O.C.","$141000 or more"
"06085509201","Census Tract 5092.01, Santa Clara County, California",5524,129338,2900,447,15,1573,0,396,52.5,8.1,0.3,28.5,0,7.2,47.5,2585,934,1651,36.13,63.87,25,909,23,1628,48,2537,2.7,1.4,1.9,"25% - 50% P.O.C.","$108000 - $141000"
"06085509202","Census Tract 5092.02, Santa Clara County, California",4708,144145,1837,129,0,1563,0,880,39,2.7,0,33.2,0,18.7,61,1795,933,862,51.98,48.02,122,811,60,802,182,1613,13.1,7,10.1,"50% - 75% P.O.C.","$141000 or more"
"06085509302","Census Tract 5093.02, Santa Clara County, California",3241,139028,1966,33,0,619,93,341,60.7,1,0,19.1,2.9,10.5,39.3,1239,851,388,68.68,31.32,71,780,5,383,76,1163,8.3,1.3,6.1,"25% - 50% P.O.C.","$108000 - $141000"
"06085509303","Census Tract 5093.03, Santa Clara County, California",3563,123438,1300,152,0,1266,0,545,36.5,4.3,0,35.5,0,15.3,63.5,1734,605,1129,34.89,65.11,31,574,51,1078,82,1652,5.1,4.5,4.7,"50% - 75% P.O.C.","$108000 - $141000"
"06085509304","Census Tract 5093.04, Santa Clara County, California",3607,122180,1302,13,0,940,0,1214,36.1,0.4,0,26.1,0,33.7,63.9,1415,557,858,39.36,60.64,4,553,86,772,90,1325,0.7,10,6.4,"50% - 75% P.O.C.","$108000 - $141000"
"06085509401","Census Tract 5094.01, Santa Clara County, California",3806,109828,1291,131,0,1650,0,575,33.9,3.4,0,43.4,0,15.1,66.1,1716,364,1352,21.21,78.79,50,314,61,1291,111,1605,13.7,4.5,6.5,"50% - 75% P.O.C.","$108000 - $141000"
"06085509403","Census Tract 5094.03, Santa Clara County, California",5779,112278,1707,138,26,1815,0,1980,29.5,2.4,0.4,31.4,0,34.3,70.5,2266,202,2064,8.91,91.09,0,202,133,1931,133,2133,0,6.4,5.9,"50% - 75% P.O.C.","$108000 - $141000"
"06085509404","Census Tract 5094.04, Santa Clara County, California",7129,124803,2440,36,0,2512,0,2027,34.2,0.5,0,35.2,0,28.4,65.8,2841,868,1973,30.55,69.45,57,811,153,1820,210,2631,6.6,7.8,7.4,"50% - 75% P.O.C.","$108000 - $141000"
"06085509500","Census Tract 5095, Santa Clara County, California",5729,111520,2101,212,0,1417,30,1847,36.7,3.7,0,24.7,0.5,32.2,63.3,2275,277,1998,12.18,87.82,0,277,103,1895,103,2172,0,5.2,4.5,"50% - 75% P.O.C.","$108000 - $141000"
"06085509600","Census Tract 5096, Santa Clara County, California",3686,194471,1828,47,0,1060,0,589,49.6,1.3,0,28.8,0,16,50.4,1595,543,1052,34.04,65.96,36,507,34,1018,70,1525,6.6,3.2,4.4,"50% - 75% P.O.C.","$141000 or more"
"06085509700","Census Tract 5097, Santa Clara County, California",3135,151000,1910,32,0,621,0,417,60.9,1,0,19.8,0,13.3,39.1,1436,644,792,44.85,55.15,16,628,27,765,43,1393,2.5,3.4,3,"25% - 50% P.O.C.","$141000 or more"
"06085509801","Census Tract 5098.01, Santa Clara County, California",5606,134496,3148,55,0,1463,0,626,56.2,1,0,26.1,0,11.2,43.8,2279,1421,858,62.35,37.65,144,1277,20,838,164,2115,10.1,2.3,7.2,"25% - 50% P.O.C.","$108000 - $141000"
"06085509802","Census Tract 5098.02, Santa Clara County, California",3167,210529,1566,14,0,1126,98,191,49.4,0.4,0,35.6,3.1,6,50.6,1149,740,409,64.4,35.6,47,693,15,394,62,1087,6.4,3.7,5.4,"50% - 75% P.O.C.","$141000 or more"
"06085509901","Census Tract 5099.01, Santa Clara County, California",1938,184821,1198,0,0,559,0,98,61.8,0,0,28.8,0,5.1,38.2,741,594,147,80.16,19.84,21,573,0,147,21,720,3.5,0,2.8,"25% - 50% P.O.C.","$141000 or more"
"06085509902","Census Tract 5099.02, Santa Clara County, California",5125,145089,2597,26,51,1662,3,623,50.7,0.5,1,32.4,0.1,12.2,49.3,1845,1391,454,75.39,24.61,120,1271,26,428,146,1699,8.6,5.7,7.9,"25% - 50% P.O.C.","$141000 or more"
"06085510001","Census Tract 5100.01, Santa Clara County, California",6564,250001,3595,10,0,2291,0,265,54.8,0.2,0,34.9,0,4,45.2,2012,1881,131,93.49,6.51,340,1541,25,106,365,1647,18.1,19.1,18.1,"25% - 50% P.O.C.","$141000 or more"
"06085510002","Census Tract 5100.02, Santa Clara County, California",3616,223068,1868,16,0,1253,0,304,51.7,0.4,0,34.7,0,8.4,48.3,1250,1094,156,87.52,12.48,108,986,19,137,127,1123,9.9,12.2,10.2,"25% - 50% P.O.C.","$141000 or more"
"06085510100","Census Tract 5101, Santa Clara County, California",2906,215250,1722,0,22,910,0,103,59.3,0,0.8,31.3,0,3.5,40.7,1037,972,65,93.73,6.27,76,896,0,65,76,961,7.8,0,7.3,"25% - 50% P.O.C.","$141000 or more"
"06085510200","Census Tract 5102, Santa Clara County, California",4624,250001,2917,55,0,1240,0,201,63.1,1.2,0,26.8,0,4.3,36.9,1434,1275,159,88.91,11.09,180,1095,15,144,195,1239,14.1,9.4,13.6,"25% - 50% P.O.C.","$141000 or more"
"06085510300","Census Tract 5103, Santa Clara County, California",4246,198468,2689,22,0,1154,0,141,63.3,0.5,0,27.2,0,3.3,36.7,1716,1199,517,69.87,30.13,92,1107,24,493,116,1600,7.7,4.6,6.8,"25% - 50% P.O.C.","$141000 or more"
"06085510400","Census Tract 5104, Santa Clara County, California",3705,248333,1988,24,2,1220,0,152,53.7,0.6,0.1,32.9,0,4.1,46.3,1302,931,371,71.51,28.49,67,864,73,298,140,1162,7.2,19.7,10.8,"25% - 50% P.O.C.","$141000 or more"
"06085510500","Census Tract 5105, Santa Clara County, California",4541,210491,2886,10,0,1381,0,99,63.6,0.2,0,30.4,0,2.2,36.4,1693,1344,349,79.39,20.61,100,1244,18,331,118,1575,7.4,5.2,7,"25% - 50% P.O.C.","$141000 or more"
"06085510600","Census Tract 5106, Santa Clara County, California",5761,136065,3102,103,0,1758,0,564,53.8,1.8,0,30.5,0,9.8,46.2,2212,1235,977,55.83,44.17,41,1194,116,861,157,2055,3.3,11.9,7.1,"25% - 50% P.O.C.","$108000 - $141000"
"06085510700","Census Tract 5107, Santa Clara County, California",5240,157313,2279,212,0,2382,0,140,43.5,4,0,45.5,0,2.7,56.5,2025,967,1058,47.75,52.25,89,878,73,985,162,1863,9.2,6.9,8,"50% - 75% P.O.C.","$141000 or more"
"06085510801","Census Tract 5108.01, Santa Clara County, California",5954,156638,2959,80,0,2505,0,111,49.7,1.3,0,42.1,0,1.9,50.3,2266,1455,811,64.21,35.79,56,1399,39,772,95,2171,3.8,4.8,4.2,"50% - 75% P.O.C.","$141000 or more"
"06085510802","Census Tract 5108.02, Santa Clara County, California",2038,186154,1050,37,0,620,0,178,51.5,1.8,0,30.4,0,8.7,48.5,704,561,143,79.69,20.31,77,484,6,137,83,621,13.7,4.2,11.8,"25% - 50% P.O.C.","$141000 or more"
"06085510803","Census Tract 5108.03, Santa Clara County, California",2700,136544,1112,62,0,1161,0,304,41.2,2.3,0,43,0,11.3,58.8,1031,541,490,52.47,47.53,52,489,41,449,93,938,9.6,8.4,9,"50% - 75% P.O.C.","$108000 - $141000"
"06085510900","Census Tract 5109, Santa Clara County, California",5494,137311,2871,78,0,1943,0,416,52.3,1.4,0,35.4,0,7.6,47.7,2073,1222,851,58.95,41.05,56,1166,30,821,86,1987,4.6,3.5,4.1,"25% - 50% P.O.C.","$108000 - $141000"
"06085511000","Census Tract 5110, Santa Clara County, California",6833,189453,3097,61,0,2823,31,335,45.3,0.9,0,41.3,0.5,4.9,54.7,2393,1483,910,61.97,38.03,117,1366,129,781,246,2147,7.9,14.2,10.3,"50% - 75% P.O.C.","$141000 or more"
"06085511100","Census Tract 5111, Santa Clara County, California",5543,248750,3022,61,5,1893,0,273,54.5,1.1,0.1,34.2,0,4.9,45.5,1852,1544,308,83.37,16.63,181,1363,62,246,243,1609,11.7,20.1,13.1,"25% - 50% P.O.C.","$141000 or more"
"06085511200","Census Tract 5112, Santa Clara County, California",4698,218906,3125,59,0,1171,25,72,66.5,1.3,0,24.9,0.5,1.5,33.5,1731,1313,418,75.85,24.15,89,1224,60,358,149,1582,6.8,14.4,8.6,"25% - 50% P.O.C.","$141000 or more"
"06085511301","Census Tract 5113.01, Santa Clara County, California",3888,118708,2714,167,0,499,1,257,69.8,4.3,0,12.8,0,6.6,30.2,1749,669,1080,38.25,61.75,66,603,50,1030,116,1633,9.9,4.6,6.6,"25% - 50% P.O.C.","$108000 - $141000"
"06085511302","Census Tract 5113.02, Santa Clara County, California",3998,109263,2387,70,0,1057,0,316,59.7,1.8,0,26.4,0,7.9,40.3,2003,519,1484,25.91,74.09,39,480,30,1454,69,1934,7.5,2,3.4,"25% - 50% P.O.C.","$108000 - $141000"
"06085511400","Census Tract 5114, Santa Clara County, California",3505,247955,1976,0,60,984,0,190,56.4,0,1.7,28.1,0,5.4,43.6,1296,951,345,73.38,26.62,80,871,42,303,122,1174,8.4,12.2,9.4,"25% - 50% P.O.C.","$141000 or more"
"06085511500","Census Tract 5115, Santa Clara County, California",7992,184028,5150,112,72,1724,0,489,64.4,1.4,0.9,21.6,0,6.1,35.6,2955,1844,1111,62.4,37.6,141,1703,61,1050,202,2753,7.6,5.5,6.8,"25% - 50% P.O.C.","$141000 or more"
"06085511608","Census Tract 5116.08, Santa Clara County, California",3302,63000,1357,166,19,731,5,784,41.1,5,0.6,22.1,0.2,23.7,58.9,106,4,102,3.77,96.23,0,4,4,98,4,102,0,3.9,3.8,"50% - 75% P.O.C.","Less than $80000"
"06085511609","Census Tract 5116.09, Santa Clara County, California",3407,117750,2256,53,0,744,0,208,66.2,1.6,0,21.8,0,6.1,33.8,1715,147,1568,8.57,91.43,0,147,17,1551,17,1698,0,1.1,1,"25% - 50% P.O.C.","$108000 - $141000"
"06085511701","Census Tract 5117.01, Santa Clara County, California",4392,250001,2562,52,0,1362,0,258,58.3,1.2,0,31,0,5.9,41.7,1552,1387,165,89.37,10.63,118,1269,42,123,160,1392,8.5,25.5,10.3,"25% - 50% P.O.C.","$141000 or more"
"06085511702","Census Tract 5117.02, Santa Clara County, California",2635,244250,1684,5,8,615,0,121,63.9,0.2,0.3,23.3,0,4.6,36.1,910,828,82,90.99,9.01,71,757,19,63,90,820,8.6,23.2,9.9,"25% - 50% P.O.C.","$141000 or more"
"06085511704","Census Tract 5117.04, Santa Clara County, California",4789,250001,2807,0,0,1687,12,135,58.6,0,0,35.2,0.3,2.8,41.4,1653,1525,128,92.26,7.74,127,1398,33,95,160,1493,8.3,25.8,9.7,"25% - 50% P.O.C.","$141000 or more"
"06085511705","Census Tract 5117.05, Santa Clara County, California",1113,240313,679,54,0,256,0,41,61,4.9,0,23,0,3.7,39,369,290,79,78.59,21.41,30,260,19,60,49,320,10.3,24.1,13.3,"25% - 50% P.O.C.","$141000 or more"
"06085511707","Census Tract 5117.07, Santa Clara County, California",2820,169896,1886,56,10,665,0,131,66.9,2,0.4,23.6,0,4.6,33.1,1211,1083,128,89.43,10.57,39,1044,15,113,54,1157,3.6,11.7,4.5,"25% - 50% P.O.C.","$141000 or more"
"06085511800","Census Tract 5118, Santa Clara County, California",4335,176042,3803,3,0,172,0,192,87.7,0.1,0,4,0,4.4,12.3,1468,1291,177,87.94,12.06,174,1117,9,168,183,1285,13.5,5.1,12.5,"Less than 25% P.O.C.","$141000 or more"
"06085511905","Census Tract 5119.05, Santa Clara County, California",3408,209167,1564,20,0,1498,0,168,45.9,0.6,0,44,0,4.9,54.1,1020,874,146,85.69,14.31,120,754,26,120,146,874,13.7,17.8,14.3,"50% - 75% P.O.C.","$141000 or more"
"06085511907","Census Tract 5119.07, Santa Clara County, California",4223,185795,1632,150,36,1888,0,392,38.6,3.6,0.9,44.7,0,9.3,61.4,1351,1127,224,83.42,16.58,120,1007,33,191,153,1198,10.6,14.7,11.3,"50% - 75% P.O.C.","$141000 or more"
"06085511909","Census Tract 5119.09, Santa Clara County, California",7737,221538,3328,0,0,3632,0,346,43,0,0,46.9,0,4.5,57,2652,2528,124,95.32,4.68,186,2342,0,124,186,2466,7.4,0,7,"50% - 75% P.O.C.","$141000 or more"
"06085511910","Census Tract 5119.10, Santa Clara County, California",3145,233125,1912,80,12,798,0,101,60.8,2.5,0.4,25.4,0,3.2,39.2,1078,957,121,88.78,11.22,85,872,17,104,102,976,8.9,14,9.5,"25% - 50% P.O.C.","$141000 or more"
"06085511911","Census Tract 5119.11, Santa Clara County, California",4934,133219,2677,430,11,1266,0,327,54.3,8.7,0.2,25.7,0,6.6,45.7,1863,1480,383,79.44,20.56,133,1347,32,351,165,1698,9,8.4,8.9,"25% - 50% P.O.C.","$108000 - $141000"
"06085511912","Census Tract 5119.12, Santa Clara County, California",5678,234861,1957,121,44,2801,0,422,34.5,2.1,0.8,49.3,0,7.4,65.5,1762,1536,226,87.17,12.83,141,1395,42,184,183,1579,9.2,18.6,10.4,"50% - 75% P.O.C.","$141000 or more"
"06085511913","Census Tract 5119.13, Santa Clara County, California",4320,184821,2647,26,0,1000,18,525,61.3,0.6,0,23.1,0.4,12.2,38.7,1401,1363,38,97.29,2.71,151,1212,0,38,151,1250,11.1,0,10.8,"25% - 50% P.O.C.","$141000 or more"
"06085511914","Census Tract 5119.14, Santa Clara County, California",5722,200673,3309,277,0,1294,0,467,57.8,4.8,0,22.6,0,8.2,42.2,1872,1650,222,88.14,11.86,185,1465,33,189,218,1654,11.2,14.9,11.6,"25% - 50% P.O.C.","$141000 or more"
"06085511915","Census Tract 5119.15, Santa Clara County, California",3664,86181,1252,273,0,551,0,1531,34.2,7.5,0,15,0,41.8,65.8,1157,370,787,31.98,68.02,5,365,181,606,186,971,1.4,23,16.1,"50% - 75% P.O.C.","$80000 - $108000"
"06085511916","Census Tract 5119.16, Santa Clara County, California",4797,160921,2379,95,0,1364,7,543,49.6,2,0,28.4,0.1,11.3,50.4,1664,1255,409,75.42,24.58,108,1147,33,376,141,1523,8.6,8.1,8.5,"50% - 75% P.O.C.","$141000 or more"
"06085512001","Census Tract 5120.01, Santa Clara County, California",6868,206689,1708,6,0,3266,0,1620,24.9,0.1,0,47.6,0,23.6,75.1,2066,1792,274,86.74,13.26,231,1561,105,169,336,1730,12.9,38.3,16.3,"75% or more P.O.C.","$141000 or more"
"06085512005","Census Tract 5120.05, Santa Clara County, California",6817,135298,3488,129,0,1171,11,1673,51.2,1.9,0,17.2,0.2,24.5,48.8,2140,1670,470,78.04,21.96,138,1532,126,344,264,1876,8.3,26.8,12.3,"25% - 50% P.O.C.","$108000 - $141000"
"06085512017","Census Tract 5120.17, Santa Clara County, California",7565,92855,1649,196,37,1667,0,3696,21.8,2.6,0.5,22,0,48.9,78.2,2145,1508,637,70.3,29.7,372,1136,152,485,524,1621,24.7,23.9,24.4,"75% or more P.O.C.","$80000 - $108000"
"06085512019","Census Tract 5120.19, Santa Clara County, California",4863,120313,1391,314,49,1246,149,1479,28.6,6.5,1,25.6,3.1,30.4,71.4,1504,844,660,56.12,43.88,113,731,121,539,234,1270,13.4,18.3,15.6,"50% - 75% P.O.C.","$108000 - $141000"
"06085512020","Census Tract 5120.20, Santa Clara County, California",7825,102401,1908,107,0,2421,0,2676,24.4,1.4,0,30.9,0,34.2,75.6,2562,495,2067,19.32,80.68,160,335,319,1748,479,2083,32.3,15.4,18.7,"75% or more P.O.C.","$80000 - $108000"
"06085512021","Census Tract 5120.21, Santa Clara County, California",6491,130460,2000,275,50,1748,0,2127,30.8,4.2,0.8,26.9,0,32.8,69.2,2082,1673,409,80.36,19.64,192,1481,147,262,339,1743,11.5,35.9,16.3,"50% - 75% P.O.C.","$108000 - $141000"
"06085512022","Census Tract 5120.22, Santa Clara County, California",5523,84417,1501,164,32,1797,0,1846,27.2,3,0.6,32.5,0,33.4,72.8,1850,1103,747,59.62,40.38,156,947,140,607,296,1554,14.1,18.7,16,"50% - 75% P.O.C.","$80000 - $108000"
"06085512023","Census Tract 5120.23, Santa Clara County, California",5553,78607,1403,384,31,1083,0,2442,25.3,6.9,0.6,19.5,0,44,74.7,1980,976,1004,49.29,50.71,56,920,117,887,173,1807,5.7,11.7,8.7,"50% - 75% P.O.C.","Less than $80000"
"06085512024","Census Tract 5120.24, Santa Clara County, California",5187,112356,2146,312,5,1085,0,1336,41.4,6,0.1,20.9,0,25.8,58.6,1764,993,771,56.29,43.71,91,902,160,611,251,1513,9.2,20.8,14.2,"50% - 75% P.O.C.","$108000 - $141000"
"06085512025","Census Tract 5120.25, Santa Clara County, California",3124,139125,1268,231,0,758,0,837,40.6,7.4,0,24.3,0,26.8,59.4,1035,893,142,86.28,13.72,56,837,47,95,103,932,6.3,33.1,10,"50% - 75% P.O.C.","$108000 - $141000"
"06085512026","Census Tract 5120.26, Santa Clara County, California",4120,103611,937,302,11,1032,0,1667,22.7,7.3,0.3,25,0,40.5,77.3,1352,900,452,66.57,33.43,75,825,93,359,168,1184,8.3,20.6,12.4,"75% or more P.O.C.","$80000 - $108000"
"06085512027","Census Tract 5120.27, Santa Clara County, California",4830,112422,1595,188,27,1507,0,1252,33,3.9,0.6,31.2,0,25.9,67,1563,688,875,44.02,55.98,141,547,100,775,241,1322,20.5,11.4,15.4,"50% - 75% P.O.C.","$108000 - $141000"
"06085512029","Census Tract 5120.29, Santa Clara County, California",6698,127739,3000,152,0,1114,0,2120,44.8,2.3,0,16.6,0,31.7,55.2,2307,1804,503,78.2,21.8,121,1683,62,441,183,2124,6.7,12.3,7.9,"50% - 75% P.O.C.","$108000 - $141000"
"06085512030","Census Tract 5120.30, Santa Clara County, California",3350,150833,1606,63,8,672,0,861,47.9,1.9,0.2,20.1,0,25.7,52.1,998,832,166,83.37,16.63,114,718,47,119,161,837,13.7,28.3,16.1,"50% - 75% P.O.C.","$141000 or more"
"06085512031","Census Tract 5120.31, Santa Clara County, California",4661,156250,2126,68,6,786,17,1204,45.6,1.5,0.1,16.9,0.4,25.8,54.4,1372,1032,340,75.22,24.78,134,898,43,297,177,1195,13,12.6,12.9,"50% - 75% P.O.C.","$141000 or more"
"06085512032","Census Tract 5120.32, Santa Clara County, California",2997,116932,1292,48,0,576,0,941,43.1,1.6,0,19.2,0,31.4,56.9,1052,933,119,88.69,11.31,45,888,42,77,87,965,4.8,35.3,8.3,"50% - 75% P.O.C.","$108000 - $141000"
"06085512033","Census Tract 5120.33, Santa Clara County, California",9884,116098,3381,391,59,2780,0,2680,34.2,4,0.6,28.1,0,27.1,65.8,3419,1720,1699,50.31,49.69,293,1427,155,1544,448,2971,17,9.1,13.1,"50% - 75% P.O.C.","$108000 - $141000"
"06085512034","Census Tract 5120.34, Santa Clara County, California",3082,135769,1360,11,0,802,0,667,44.1,0.4,0,26,0,21.6,55.9,1006,851,155,84.59,15.41,55,796,0,155,55,951,6.5,0,5.5,"50% - 75% P.O.C.","$108000 - $141000"
"06085512035","Census Tract 5120.35, Santa Clara County, California",4924,142019,2088,84,0,1049,0,1489,42.4,1.7,0,21.3,0,30.2,57.6,1403,1127,276,80.33,19.67,171,956,101,175,272,1131,15.2,36.6,19.4,"50% - 75% P.O.C.","$141000 or more"
"06085512036","Census Tract 5120.36, Santa Clara County, California",5187,143514,1897,181,0,1645,0,1171,36.6,3.5,0,31.7,0,22.6,63.4,1892,690,1202,36.47,63.53,63,627,33,1169,96,1796,9.1,2.7,5.1,"50% - 75% P.O.C.","$141000 or more"
"06085512037","Census Tract 5120.37, Santa Clara County, California",3416,156023,1504,44,0,682,0,871,44,1.3,0,20,0,25.5,56,1005,806,199,80.2,19.8,133,673,65,134,198,807,16.5,32.7,19.7,"50% - 75% P.O.C.","$141000 or more"
"06085512038","Census Tract 5120.38, Santa Clara County, California",3254,84091,1305,27,0,1006,0,862,40.1,0.8,0,30.9,0,26.5,59.9,1102,739,363,67.06,32.94,59,680,52,311,111,991,8,14.3,10.1,"50% - 75% P.O.C.","$80000 - $108000"
"06085512039","Census Tract 5120.39, Santa Clara County, California",5402,116250,737,283,0,2569,0,1719,13.6,5.2,0,47.6,0,31.8,86.4,1451,1240,211,85.46,14.54,346,894,42,169,388,1063,27.9,19.9,26.7,"75% or more P.O.C.","$108000 - $141000"
"06085512042","Census Tract 5120.42, Santa Clara County, California",3020,78382,275,124,65,1226,72,1134,9.1,4.1,2.2,40.6,2.4,37.5,90.9,878,478,400,54.44,45.56,125,353,43,357,168,710,26.2,10.8,19.1,"75% or more P.O.C.","Less than $80000"
"06085512043","Census Tract 5120.43, Santa Clara County, California",6583,54179,547,248,0,1576,1,4109,8.3,3.8,0,23.9,0,62.4,91.7,1577,660,917,41.85,58.15,152,508,380,537,532,1045,23,41.4,33.7,"75% or more P.O.C.","Less than $80000"
"06085512045","Census Tract 5120.45, Santa Clara County, California",5653,131900,3001,97,0,1273,0,957,53.1,1.7,0,22.5,0,16.9,46.9,1800,1579,221,87.72,12.28,214,1365,39,182,253,1547,13.6,17.6,14.1,"25% - 50% P.O.C.","$108000 - $141000"
"06085512047","Census Tract 5120.47, Santa Clara County, California",5808,160758,2682,79,0,1186,0,1667,46.2,1.4,0,20.4,0,28.7,53.8,1708,1413,295,82.73,17.27,208,1205,69,226,277,1431,14.7,23.4,16.2,"50% - 75% P.O.C.","$141000 or more"
"06085512052","Census Tract 5120.52, Santa Clara County, California",4473,89231,2252,43,0,679,0,1293,50.3,1,0,15.2,0,28.9,49.7,1746,868,878,49.71,50.29,88,780,27,851,115,1631,10.1,3.1,6.6,"25% - 50% P.O.C.","$80000 - $108000"
"06085512053","Census Tract 5120.53, Santa Clara County, California",4451,106081,1697,205,0,739,73,1539,38.1,4.6,0,16.6,1.6,34.6,61.9,1457,940,517,64.52,35.48,62,878,42,475,104,1353,6.6,8.1,7.1,"50% - 75% P.O.C.","$80000 - $108000"
"06085512100","Census Tract 5121, Santa Clara County, California",1527,98393,512,0,0,226,0,777,33.5,0,0,14.8,0,50.9,66.5,469,321,148,68.44,31.56,45,276,37,111,82,387,14,25,17.5,"50% - 75% P.O.C.","$80000 - $108000"
"06085512200","Census Tract 5122, Santa Clara County, California",3859,139479,2580,51,0,427,0,645,66.9,1.3,0,11.1,0,16.7,33.1,1503,1324,179,88.09,11.91,128,1196,20,159,148,1355,9.7,11.2,9.8,"25% - 50% P.O.C.","$108000 - $141000"
"06085512305","Census Tract 5123.05, Santa Clara County, California",5039,167196,2336,50,0,1051,12,1310,46.4,1,0,20.9,0.2,26,53.6,1583,1397,186,88.25,11.75,228,1169,29,157,257,1326,16.3,15.6,16.2,"50% - 75% P.O.C.","$141000 or more"
"06085512307","Census Tract 5123.07, Santa Clara County, California",6884,134375,3957,78,0,878,27,1548,57.5,1.1,0,12.8,0.4,22.5,42.5,2412,1952,460,80.93,19.07,374,1578,61,399,435,1977,19.2,13.3,18,"25% - 50% P.O.C.","$108000 - $141000"
"06085512308","Census Tract 5123.08, Santa Clara County, California",8784,184091,4750,191,0,1306,0,1999,54.1,2.2,0,14.9,0,22.8,45.9,2642,2448,194,92.66,7.34,354,2094,25,169,379,2263,14.5,12.9,14.3,"25% - 50% P.O.C.","$141000 or more"
"06085512309","Census Tract 5123.09, Santa Clara County, California",5026,136118,3138,32,7,293,0,1291,62.4,0.6,0.1,5.8,0,25.7,37.6,1756,1457,299,82.97,17.03,121,1336,22,277,143,1613,8.3,7.4,8.1,"25% - 50% P.O.C.","$108000 - $141000"
"06085512310","Census Tract 5123.10, Santa Clara County, California",5050,81607,1839,127,0,848,0,2052,36.4,2.5,0,16.8,0,40.6,63.6,1818,915,903,50.33,49.67,86,829,99,804,185,1633,9.4,11,10.2,"50% - 75% P.O.C.","$80000 - $108000"
"06085512311","Census Tract 5123.11, Santa Clara County, California",4211,115664,1857,136,0,500,0,1635,44.1,3.2,0,11.9,0,38.8,55.9,1321,1069,252,80.92,19.08,155,914,51,201,206,1115,14.5,20.2,15.6,"50% - 75% P.O.C.","$108000 - $141000"
"06085512312","Census Tract 5123.12, Santa Clara County, California",3624,128646,1685,27,0,477,0,1176,46.5,0.7,0,13.2,0,32.5,53.5,1261,1046,215,82.95,17.05,98,948,40,175,138,1123,9.4,18.6,10.9,"50% - 75% P.O.C.","$108000 - $141000"
"06085512313","Census Tract 5123.13, Santa Clara County, California",3843,81579,1141,137,6,411,2,2027,29.7,3.6,0.2,10.7,0.1,52.7,70.3,1136,409,727,36,64,98,311,133,594,231,905,24,18.3,20.3,"50% - 75% P.O.C.","$80000 - $108000"
"06085512314","Census Tract 5123.14, Santa Clara County, California",6522,81875,3014,33,0,663,0,2672,46.2,0.5,0,10.2,0,41,53.8,2237,1344,893,60.08,39.92,130,1214,81,812,211,2026,9.7,9.1,9.4,"50% - 75% P.O.C.","$80000 - $108000"
"06085512401","Census Tract 5124.01, Santa Clara County, California",4635,103315,2134,169,0,153,35,2002,46,3.6,0,3.3,0.8,43.2,54,1323,968,355,73.17,26.83,193,775,90,265,283,1040,19.9,25.4,21.4,"50% - 75% P.O.C.","$80000 - $108000"
"06085512402","Census Tract 5124.02, Santa Clara County, California",5030,122614,2079,42,33,438,0,2173,41.3,0.8,0.7,8.7,0,43.2,58.7,1443,982,461,68.05,31.95,179,803,60,401,239,1204,18.2,13,16.6,"50% - 75% P.O.C.","$108000 - $141000"
"06085512503","Census Tract 5125.03, Santa Clara County, California",9105,159127,4716,78,0,1157,0,2887,51.8,0.9,0,12.7,0,31.7,48.2,2639,2192,447,83.06,16.94,429,1763,126,321,555,2084,19.6,28.2,21,"25% - 50% P.O.C.","$141000 or more"
"06085512505","Census Tract 5125.05, Santa Clara County, California",8465,106862,1796,67,0,816,0,5538,21.2,0.8,0,9.6,0,65.4,78.8,2301,1309,992,56.89,43.11,491,818,213,779,704,1597,37.5,21.5,30.6,"75% or more P.O.C.","$80000 - $108000"
"06085512506","Census Tract 5125.06, Santa Clara County, California",7227,92045,1243,38,62,486,0,5199,17.2,0.5,0.9,6.7,0,71.9,82.8,1948,1055,893,54.16,45.84,249,806,200,693,449,1499,23.6,22.4,23,"75% or more P.O.C.","$80000 - $108000"
"06085512508","Census Tract 5125.08, Santa Clara County, California",8351,79792,2564,11,13,480,0,5132,30.7,0.1,0.2,5.7,0,61.5,69.3,2553,1435,1118,56.21,43.79,292,1143,348,770,640,1913,20.3,31.1,25.1,"50% - 75% P.O.C.","Less than $80000"
"06085512509","Census Tract 5125.09, Santa Clara County, California",5952,121214,1507,267,0,733,0,3192,25.3,4.5,0,12.3,0,53.6,74.7,1622,1317,305,81.2,18.8,287,1030,85,220,372,1250,21.8,27.9,22.9,"50% - 75% P.O.C.","$108000 - $141000"
"06085512510","Census Tract 5125.10, Santa Clara County, California",7345,94095,2557,98,0,912,0,3547,34.8,1.3,0,12.4,0,48.3,65.2,2493,1582,911,63.46,36.54,218,1364,150,761,368,2125,13.8,16.5,14.8,"50% - 75% P.O.C.","$80000 - $108000"
"06085512602","Census Tract 5126.02, Santa Clara County, California",2404,99000,1093,9,0,290,0,991,45.5,0.4,0,12.1,0,41.2,54.5,758,429,329,56.6,43.4,73,356,11,318,84,674,17,3.3,11.1,"50% - 75% P.O.C.","$80000 - $108000"
"06085512603","Census Tract 5126.03, Santa Clara County, California",4634,66176,439,10,29,171,0,3977,9.5,0.2,0.6,3.7,0,85.8,90.5,1122,273,849,24.33,75.67,93,180,281,568,374,748,34.1,33.1,33.3,"75% or more P.O.C.","Less than $80000"
"06085512604","Census Tract 5126.04, Santa Clara County, California",4886,74421,491,29,9,124,0,4192,10,0.6,0.2,2.5,0,85.8,90,1211,519,692,42.86,57.14,136,383,243,449,379,832,26.2,35.1,31.3,"75% or more P.O.C.","Less than $80000"
"06085513000","Census Tract 5130, Santa Clara County, California",9578,40703,3982,250,10,3233,21,1466,41.6,2.6,0.1,33.8,0.2,15.3,58.4,2539,51,2488,2.01,97.99,22,29,34,2454,56,2483,43.1,1.4,2.2,"50% - 75% P.O.C.","Less than $80000"
"06085513500","Census Tract 5135, Santa Clara County, California",1202,104643,527,25,0,115,4,472,43.8,2.1,0,9.6,0.3,39.3,56.2,384,273,111,71.09,28.91,30,243,28,83,58,326,11,25.2,15.1,"50% - 75% P.O.C.","$80000 - $108000"
"06095250103","Census Tract 2501.03, Solano County, California",4873,73862,1005,1137,0,1337,226,939,20.6,23.3,0,27.4,4.6,19.3,79.4,1605,979,626,61,39,112,867,100,526,212,1393,11.4,16,13.2,"75% or more P.O.C.","Less than $80000"
"06095250104","Census Tract 2501.04, Solano County, California",2233,100333,539,193,21,1030,0,216,24.1,8.6,0.9,46.1,0,9.7,75.9,770,459,311,59.61,40.39,70,389,37,274,107,663,15.3,11.9,13.9,"75% or more P.O.C.","$80000 - $108000"
"06095250105","Census Tract 2501.05, Solano County, California",6655,94233,1369,629,18,3385,47,869,20.6,9.5,0.3,50.9,0.7,13.1,79.4,2425,1566,859,64.58,35.42,226,1340,79,780,305,2120,14.4,9.2,12.6,"75% or more P.O.C.","$80000 - $108000"
"06095250106","Census Tract 2501.06, Solano County, California",4541,148646,1178,783,0,1891,0,337,25.9,17.2,0,41.6,0,7.4,74.1,1398,1210,188,86.55,13.45,117,1093,51,137,168,1230,9.7,27.1,12,"50% - 75% P.O.C.","$141000 or more"
"06095250200","Census Tract 2502, Solano County, California",4355,61739,1417,702,4,891,58,1040,32.5,16.1,0.1,20.5,1.3,23.9,67.5,1472,764,708,51.9,48.1,80,684,98,610,178,1294,10.5,13.8,12.1,"50% - 75% P.O.C.","Less than $80000"
"06095250300","Census Tract 2503, Solano County, California",3038,55802,863,628,0,669,0,756,28.4,20.7,0,22,0,24.9,71.6,1107,608,499,54.92,45.08,77,531,78,421,155,952,12.7,15.6,14,"50% - 75% P.O.C.","Less than $80000"
"06095250400","Census Tract 2504, Solano County, California",3002,63291,1617,78,0,260,0,782,53.9,2.6,0,8.7,0,26,46.1,1143,790,353,69.12,30.88,31,759,97,256,128,1015,3.9,27.5,11.2,"25% - 50% P.O.C.","Less than $80000"
"06095250501","Census Tract 2505.01, Solano County, California",2189,85625,809,395,0,88,16,743,37,18,0,4,0.7,33.9,63,732,460,272,62.84,37.16,61,399,62,210,123,609,13.3,22.8,16.8,"50% - 75% P.O.C.","$80000 - $108000"
"06095250502","Census Tract 2505.02, Solano County, California",3578,83194,843,370,0,877,0,1028,23.6,10.3,0,24.5,0,28.7,76.4,1071,817,254,76.28,23.72,124,693,8,246,132,939,15.2,3.1,12.3,"75% or more P.O.C.","$80000 - $108000"
"06095250601","Census Tract 2506.01, Solano County, California",5289,80083,936,1091,0,550,0,2480,17.7,20.6,0,10.4,0,46.9,82.3,1463,951,512,65,35,125,826,198,314,323,1140,13.1,38.7,22.1,"75% or more P.O.C.","$80000 - $108000"
"06095250604","Census Tract 2506.04, Solano County, California",4017,83657,1179,667,0,1383,22,540,29.4,16.6,0,34.4,0.5,13.4,70.6,1453,1082,371,74.47,25.53,130,952,53,318,183,1270,12,14.3,12.6,"50% - 75% P.O.C.","$80000 - $108000"
"06095250605","Census Tract 2506.05, Solano County, California",3630,96333,1163,687,0,1275,0,426,32,18.9,0,35.1,0,11.7,68,1422,1023,399,71.94,28.06,48,975,6,393,54,1368,4.7,1.5,3.8,"50% - 75% P.O.C.","$80000 - $108000"
"06095250701","Census Tract 2507.01, Solano County, California",3529,64441,618,742,0,337,0,1643,17.5,21,0,9.5,0,46.6,82.5,1107,609,498,55.01,44.99,64,545,36,462,100,1007,10.5,7.2,9,"75% or more P.O.C.","Less than $80000"
"06095250801","Census Tract 2508.01, Solano County, California",4135,64299,1029,1317,0,618,155,857,24.9,31.9,0,14.9,3.7,20.7,75.1,1533,645,888,42.07,57.93,72,573,31,857,103,1430,11.2,3.5,6.7,"75% or more P.O.C.","Less than $80000"
"06095250900","Census Tract 2509, Solano County, California",2654,22188,508,1329,0,344,0,283,19.1,50.1,0,13,0,10.7,80.9,1357,130,1227,9.58,90.42,0,130,93,1134,93,1264,0,7.6,6.9,"75% or more P.O.C.","Less than $80000"
"06095251000","Census Tract 2510, Solano County, California",2654,50306,998,252,23,226,0,1129,37.6,9.5,0.9,8.5,0,42.5,62.4,1091,396,695,36.3,63.7,44,352,37,658,81,1010,11.1,5.3,7.4,"50% - 75% P.O.C.","Less than $80000"
"06095251100","Census Tract 2511, Solano County, California",3124,54358,530,788,16,183,0,1520,17,25.2,0.5,5.9,0,48.7,83,1119,495,624,44.24,55.76,69,426,140,484,209,910,13.9,22.4,18.7,"75% or more P.O.C.","Less than $80000"
"06095251200","Census Tract 2512, Solano County, California",3663,58611,794,465,0,530,14,1685,21.7,12.7,0,14.5,0.4,46,78.3,1238,512,726,41.36,58.64,129,383,73,653,202,1036,25.2,10.1,16.3,"75% or more P.O.C.","Less than $80000"
"06095251300","Census Tract 2513, Solano County, California",2969,82292,1390,202,9,340,44,732,46.8,6.8,0.3,11.5,1.5,24.7,53.2,1180,851,329,72.12,27.88,30,821,41,288,71,1109,3.5,12.5,6,"50% - 75% P.O.C.","$80000 - $108000"
"06095251400","Census Tract 2514, Solano County, California",5899,71224,2579,808,20,579,76,1591,43.7,13.7,0.3,9.8,1.3,27,56.3,2107,1244,863,59.04,40.96,162,1082,83,780,245,1862,13,9.6,11.6,"50% - 75% P.O.C.","Less than $80000"
"06095251500","Census Tract 2515, Solano County, California",4326,40174,820,1331,0,183,0,1686,19,30.8,0,4.2,0,39,81,1410,380,1030,26.95,73.05,83,297,101,929,184,1226,21.8,9.8,13,"75% or more P.O.C.","Less than $80000"
"06095251600","Census Tract 2516, Solano County, California",2580,41699,735,722,0,107,0,854,28.5,28,0,4.1,0,33.1,71.5,1159,234,925,20.19,79.81,15,219,69,856,84,1075,6.4,7.5,7.2,"50% - 75% P.O.C.","Less than $80000"
"06095251701","Census Tract 2517.01, Solano County, California",3211,57634,1184,658,5,383,12,899,36.9,20.5,0.2,11.9,0.4,28,63.1,1385,445,940,32.13,67.87,14,431,33,907,47,1338,3.1,3.5,3.4,"50% - 75% P.O.C.","Less than $80000"
"06095251702","Census Tract 2517.02, Solano County, California",2623,70417,419,748,0,671,84,577,16,28.5,0,25.6,3.2,22,84,1033,583,450,56.44,43.56,59,524,45,405,104,929,10.1,10,10.1,"75% or more P.O.C.","Less than $80000"
"06095251802","Census Tract 2518.02, Solano County, California",2770,26181,382,817,0,378,2,1056,13.8,29.5,0,13.6,0.1,38.1,86.2,1273,417,856,32.76,67.24,62,355,0,856,62,1211,14.9,0,4.9,"75% or more P.O.C.","Less than $80000"
"06095251803","Census Tract 2518.03, Solano County, California",4846,77739,717,759,6,996,23,2244,14.8,15.7,0.1,20.6,0.5,46.3,85.2,1373,903,470,65.77,34.23,164,739,137,333,301,1072,18.2,29.1,21.9,"75% or more P.O.C.","Less than $80000"
"06095251804","Census Tract 2518.04, Solano County, California",3485,94036,612,653,0,1488,63,435,17.6,18.7,0,42.7,1.8,12.5,82.4,997,684,313,68.61,31.39,100,584,89,224,189,808,14.6,28.4,19,"75% or more P.O.C.","$80000 - $108000"
"06095251901","Census Tract 2519.01, Solano County, California",5119,56116,881,1387,0,1518,0,1107,17.2,27.1,0,29.7,0,21.6,82.8,1859,890,969,47.88,52.12,98,792,75,894,173,1686,11,7.7,9.3,"75% or more P.O.C.","Less than $80000"
"06095251902","Census Tract 2519.02, Solano County, California",6173,62222,630,764,0,1686,64,2656,10.2,12.4,0,27.3,1,43,89.8,1716,1100,616,64.1,35.9,276,824,218,398,494,1222,25.1,35.4,28.8,"75% or more P.O.C.","Less than $80000"
"06095251903","Census Tract 2519.03, Solano County, California",5963,74506,596,2283,0,1202,255,1402,10,38.3,0,20.2,4.3,23.5,90,1705,1218,487,71.44,28.56,211,1007,165,322,376,1329,17.3,33.9,22.1,"75% or more P.O.C.","Less than $80000"
"06095252000","Census Tract 2520, Solano County, California",4739,89554,3422,56,0,328,0,622,72.2,1.2,0,6.9,0,13.1,27.8,2264,1360,904,60.07,39.93,67,1293,14,890,81,2183,4.9,1.5,3.6,"25% - 50% P.O.C.","$80000 - $108000"
"06095252102","Census Tract 2521.02, Solano County, California",3900,86797,2578,6,0,222,0,637,66.1,0.2,0,5.7,0,16.3,33.9,1468,1018,450,69.35,30.65,60,958,54,396,114,1354,5.9,12,7.8,"25% - 50% P.O.C.","$80000 - $108000"
"06095252103","Census Tract 2521.03, Solano County, California",5753,91389,1343,991,0,2090,0,713,23.3,17.2,0,36.3,0,12.4,76.7,1872,979,893,52.3,47.7,239,740,103,790,342,1530,24.4,11.5,18.3,"75% or more P.O.C.","$80000 - $108000"
"06095252104","Census Tract 2521.04, Solano County, California",5659,145943,2798,419,0,1115,52,694,49.4,7.4,0,19.7,0.9,12.3,50.6,1886,1584,302,83.99,16.01,138,1446,33,269,171,1715,8.7,10.9,9.1,"50% - 75% P.O.C.","$141000 or more"
"06095252105","Census Tract 2521.05, Solano County, California",3305,113319,2150,29,0,548,0,360,65.1,0.9,0,16.6,0,10.9,34.9,1363,1124,239,82.47,17.53,28,1096,9,230,37,1326,2.5,3.8,2.7,"25% - 50% P.O.C.","$108000 - $141000"
"06095252106","Census Tract 2521.06, Solano County, California",4186,104875,2938,102,0,505,16,418,70.2,2.4,0,12.1,0.4,10,29.8,1688,1104,584,65.4,34.6,92,1012,71,513,163,1525,8.3,12.2,9.7,"25% - 50% P.O.C.","$80000 - $108000"
"06095252107","Census Tract 2521.07, Solano County, California",3739,109306,2624,122,0,264,0,521,70.2,3.3,0,7.1,0,13.9,29.8,1437,1079,358,75.09,24.91,60,1019,66,292,126,1311,5.6,18.4,8.8,"25% - 50% P.O.C.","$108000 - $141000"
"06095252108","Census Tract 2521.08, Solano County, California",3153,91503,2148,210,0,270,0,381,68.1,6.7,0,8.6,0,12.1,31.9,1343,965,378,71.85,28.15,25,940,34,344,59,1284,2.6,9,4.4,"25% - 50% P.O.C.","$80000 - $108000"
"06095252201","Census Tract 2522.01, Solano County, California",9421,129600,4542,734,13,2174,280,1166,48.2,7.8,0.1,23.1,3,12.4,51.8,3072,2543,529,82.78,17.22,268,2275,138,391,406,2666,10.5,26.1,13.2,"50% - 75% P.O.C.","$108000 - $141000"
"06095252202","Census Tract 2522.02, Solano County, California",11383,116775,3511,1155,96,3560,49,2248,30.8,10.1,0.8,31.3,0.4,19.7,69.2,3440,2955,485,85.9,14.1,481,2474,128,357,609,2831,16.3,26.4,17.7,"50% - 75% P.O.C.","$108000 - $141000"
"06095252305","Census Tract 2523.05, Solano County, California",5336,105542,3055,349,0,975,0,659,57.3,6.5,0,18.3,0,12.4,42.7,1845,1166,679,63.2,36.8,129,1037,41,638,170,1675,11.1,6,9.2,"25% - 50% P.O.C.","$80000 - $108000"
"06095252306","Census Tract 2523.06, Solano County, California",3353,88576,1639,329,0,315,0,879,48.9,9.8,0,9.4,0,26.2,51.1,1209,918,291,75.93,24.07,164,754,24,267,188,1021,17.9,8.2,15.6,"50% - 75% P.O.C.","$80000 - $108000"
"06095252310","Census Tract 2523.10, Solano County, California",2913,155104,1599,268,0,557,0,257,54.9,9.2,0,19.1,0,8.8,45.1,1103,881,222,79.87,20.13,130,751,9,213,139,964,14.8,4.1,12.6,"25% - 50% P.O.C.","$141000 or more"
"06095252311","Census Tract 2523.11, Solano County, California",4312,130786,1498,793,0,822,24,786,34.7,18.4,0,19.1,0.6,18.2,65.3,1536,1103,433,71.81,28.19,137,966,11,422,148,1388,12.4,2.5,9.6,"50% - 75% P.O.C.","$108000 - $141000"
"06095252312","Census Tract 2523.12, Solano County, California",4038,78693,1504,544,0,643,76,965,37.2,13.5,0,15.9,1.9,23.9,62.8,1365,698,667,51.14,48.86,139,559,77,590,216,1149,19.9,11.5,15.8,"50% - 75% P.O.C.","Less than $80000"
"06095252313","Census Tract 2523.13, Solano County, California",5627,86610,2656,771,0,1121,25,718,47.2,13.7,0,19.9,0.4,12.8,52.8,2257,1391,866,61.63,38.37,175,1216,13,853,188,2069,12.6,1.5,8.3,"50% - 75% P.O.C.","$80000 - $108000"
"06095252314","Census Tract 2523.14, Solano County, California",4221,83750,1528,540,0,541,150,1204,36.2,12.8,0,12.8,3.6,28.5,63.8,1376,837,539,60.83,39.17,145,692,77,462,222,1154,17.3,14.3,16.1,"50% - 75% P.O.C.","$80000 - $108000"
"06095252315","Census Tract 2523.15, Solano County, California",4035,109681,1527,604,53,824,81,722,37.8,15,1.3,20.4,2,17.9,62.2,1428,1020,408,71.43,28.57,67,953,27,381,94,1334,6.6,6.6,6.6,"50% - 75% P.O.C.","$108000 - $141000"
"06095252316","Census Tract 2523.16, Solano County, California",3498,91985,806,523,32,1369,0,613,23,15,0.9,39.1,0,17.5,77,1065,693,372,65.07,34.93,140,553,96,276,236,829,20.2,25.8,22.2,"75% or more P.O.C.","$80000 - $108000"
"06095252317","Census Tract 2523.17, Solano County, California",10131,124874,2878,1525,11,2800,57,1931,28.4,15.1,0.1,27.6,0.6,19.1,71.6,2766,2254,512,81.49,18.51,498,1756,85,427,583,2183,22.1,16.6,21.1,"50% - 75% P.O.C.","$108000 - $141000"
"06095252401","Census Tract 2524.01, Solano County, California",4705,77961,1019,751,0,382,8,2339,21.7,16,0,8.1,0.2,49.7,78.3,1449,788,661,54.38,45.62,111,677,121,540,232,1217,14.1,18.3,16,"75% or more P.O.C.","Less than $80000"
"06095252402","Census Tract 2524.02, Solano County, California",5549,61719,1163,557,88,700,98,2623,21,10,1.6,12.6,1.8,47.3,79,1744,876,868,50.23,49.77,119,757,132,736,251,1493,13.6,15.2,14.4,"75% or more P.O.C.","Less than $80000"
"06095252501","Census Tract 2525.01, Solano County, California",2816,49677,659,447,0,105,0,1578,23.4,15.9,0,3.7,0,56,76.6,932,307,625,32.94,67.06,35,272,113,512,148,784,11.4,18.1,15.9,"75% or more P.O.C.","Less than $80000"
"06095252502","Census Tract 2525.02, Solano County, California",2106,44438,720,492,0,145,8,414,34.2,23.4,0,6.9,0.4,19.7,65.8,629,110,519,17.49,82.51,0,110,75,444,75,554,0,14.5,11.9,"50% - 75% P.O.C.","Less than $80000"
"06095252604","Census Tract 2526.04, Solano County, California",3900,72337,970,761,0,540,0,1388,24.9,19.5,0,13.8,0,35.6,75.1,1157,485,672,41.92,58.08,84,401,123,549,207,950,17.3,18.3,17.9,"75% or more P.O.C.","Less than $80000"
"06095252605","Census Tract 2526.05, Solano County, California",6226,49989,1120,1230,79,643,108,2816,18,19.8,1.3,10.3,1.7,45.2,82,2011,659,1352,32.77,67.23,96,563,249,1103,345,1666,14.6,18.4,17.2,"75% or more P.O.C.","Less than $80000"
"06095252606","Census Tract 2526.06, Solano County, California",5465,55273,941,1074,5,480,84,2704,17.2,19.7,0.1,8.8,1.5,49.5,82.8,1672,660,1012,39.47,60.53,189,471,208,804,397,1275,28.6,20.6,23.7,"75% or more P.O.C.","Less than $80000"
"06095252607","Census Tract 2526.07, Solano County, California",3898,48815,665,523,0,232,0,2296,17.1,13.4,0,6,0,58.9,82.9,1191,493,698,41.39,58.61,97,396,172,526,269,922,19.7,24.6,22.6,"75% or more P.O.C.","Less than $80000"
"06095252608","Census Tract 2526.08, Solano County, California",4160,53042,759,1062,47,445,0,1735,18.2,25.5,1.1,10.7,0,41.7,81.8,1304,537,767,41.18,58.82,52,485,209,558,261,1043,9.7,27.2,20,"75% or more P.O.C.","Less than $80000"
"06095252610","Census Tract 2526.10, Solano County, California",3134,82500,919,508,0,302,0,1063,29.3,16.2,0,9.6,0,33.9,70.7,1036,710,326,68.53,31.47,120,590,35,291,155,881,16.9,10.7,15,"50% - 75% P.O.C.","$80000 - $108000"
"06095252611","Census Tract 2526.11, Solano County, California",4011,65855,580,812,51,135,382,1807,14.5,20.2,1.3,3.4,9.5,45.1,85.5,1104,504,600,45.65,54.35,152,352,130,470,282,822,30.2,21.7,25.5,"75% or more P.O.C.","Less than $80000"
"06095252702","Census Tract 2527.02, Solano County, California",6598,77478,1851,1058,0,1628,0,1580,28.1,16,0,24.7,0,23.9,71.9,2319,1346,973,58.04,41.96,68,1278,138,835,206,2113,5.1,14.2,8.9,"50% - 75% P.O.C.","Less than $80000"
"06095252703","Census Tract 2527.03, Solano County, California",4437,74161,678,799,46,1065,74,1643,15.3,18,1,24,1.7,37,84.7,1343,842,501,62.7,37.3,115,727,122,379,237,1106,13.7,24.4,17.6,"75% or more P.O.C.","Less than $80000"
"06095252704","Census Tract 2527.04, Solano County, California",5410,79974,1623,1375,9,997,33,1044,30,25.4,0.2,18.4,0.6,19.3,70,1743,766,977,43.95,56.05,115,651,177,800,292,1451,15,18.1,16.8,"50% - 75% P.O.C.","Less than $80000"
"06095252705","Census Tract 2527.05, Solano County, California",5937,93011,1679,1365,46,975,0,1480,28.3,23,0.8,16.4,0,24.9,71.7,1793,1412,381,78.75,21.25,228,1184,132,249,360,1433,16.1,34.6,20.1,"50% - 75% P.O.C.","$80000 - $108000"
"06095252706","Census Tract 2527.06, Solano County, California",4087,102230,1031,805,0,915,0,1094,25.2,19.7,0,22.4,0,26.8,74.8,1264,945,319,74.76,25.24,79,866,139,180,218,1046,8.4,43.6,17.2,"50% - 75% P.O.C.","$80000 - $108000"
"06095252707","Census Tract 2527.07, Solano County, California",5233,62218,1847,1006,6,399,31,1604,35.3,19.2,0.1,7.6,0.6,30.7,64.7,1719,1137,582,66.14,33.86,164,973,93,489,257,1462,14.4,16,15,"50% - 75% P.O.C.","Less than $80000"
"06095252801","Census Tract 2528.01, Solano County, California",3014,79519,1646,443,0,193,68,478,54.6,14.7,0,6.4,2.3,15.9,45.4,867,16,851,1.85,98.15,6,10,122,729,128,739,37.5,14.3,14.8,"25% - 50% P.O.C.","Less than $80000"
"06095252802","Census Tract 2528.02, Solano County, California",938,59219,493,166,0,25,24,173,52.6,17.7,0,2.7,2.6,18.4,47.4,196,0,196,0,100,0,0,17,179,17,179,NA,8.7,8.7,"25% - 50% P.O.C.","Less than $80000"
"06095252903","Census Tract 2529.03, Solano County, California",3857,114792,3061,45,14,188,0,435,79.4,1.2,0.4,4.9,0,11.3,20.6,1525,1266,259,83.02,16.98,108,1158,29,230,137,1388,8.5,11.2,9,"Less than 25% P.O.C.","$108000 - $141000"
"06095252904","Census Tract 2529.04, Solano County, California",7116,100484,3355,681,50,973,19,1755,47.1,9.6,0.7,13.7,0.3,24.7,52.9,2592,1802,790,69.52,30.48,225,1577,12,778,237,2355,12.5,1.5,9.1,"50% - 75% P.O.C.","$80000 - $108000"
"06095252908","Census Tract 2529.08, Solano County, California",3993,79359,2323,221,11,427,29,662,58.2,5.5,0.3,10.7,0.7,16.6,41.8,1308,617,691,47.17,52.83,98,519,112,579,210,1098,15.9,16.2,16.1,"25% - 50% P.O.C.","Less than $80000"
"06095252909","Census Tract 2529.09, Solano County, California",3471,112335,2048,234,0,112,33,755,59,6.7,0,3.2,1,21.8,41,1049,821,228,78.27,21.73,165,656,62,166,227,822,20.1,27.2,21.6,"25% - 50% P.O.C.","$108000 - $141000"
"06095252910","Census Tract 2529.10, Solano County, California",5610,98056,2876,319,39,407,0,1495,51.3,5.7,0.7,7.3,0,26.6,48.7,1966,1413,553,71.87,28.13,117,1296,68,485,185,1781,8.3,12.3,9.4,"25% - 50% P.O.C.","$80000 - $108000"
"06095252911","Census Tract 2529.11, Solano County, California",4818,60151,3610,260,8,309,0,527,74.9,5.4,0.2,6.4,0,10.9,25.1,2632,1652,980,62.77,37.23,27,1625,0,980,27,2605,1.6,0,1,"25% - 50% P.O.C.","Less than $80000"
"06095252912","Census Tract 2529.12, Solano County, California",5668,131389,3542,260,0,310,58,1060,62.5,4.6,0,5.5,1,18.7,37.5,1888,1544,344,81.78,18.22,200,1344,41,303,241,1647,13,11.9,12.8,"25% - 50% P.O.C.","$108000 - $141000"
"06095252913","Census Tract 2529.13, Solano County, California",4856,95000,2682,511,0,292,56,1024,55.2,10.5,0,6,1.2,21.1,44.8,1652,1185,467,71.73,28.27,166,1019,142,325,308,1344,14,30.4,18.6,"25% - 50% P.O.C.","$80000 - $108000"
"06095252914","Census Tract 2529.14, Solano County, California",6330,102625,3041,664,13,565,43,1584,48,10.5,0.2,8.9,0.7,25,52,2001,1268,733,63.37,36.63,304,964,18,715,322,1679,24,2.5,16.1,"50% - 75% P.O.C.","$80000 - $108000"
"06095252915","Census Tract 2529.15, Solano County, California",5326,129343,2164,446,0,609,385,1219,40.6,8.4,0,11.4,7.2,22.9,59.4,1615,1324,291,81.98,18.02,199,1125,0,291,199,1416,15,0,12.3,"50% - 75% P.O.C.","$108000 - $141000"
"06095253000","Census Tract 2530, Solano County, California",6720,NA,1500,2954,122,291,94,1571,22.3,44,1.8,4.3,1.4,23.4,77.7,0,0,0,NA,NA,0,0,0,0,0,0,NA,NA,NA,"75% or more P.O.C.","N/A"
"06095253101","Census Tract 2531.01, Solano County, California",5512,84457,3033,60,18,202,0,1857,55,1.1,0.3,3.7,0,33.7,45,1982,1228,754,61.96,38.04,119,1109,121,633,240,1742,9.7,16,12.1,"25% - 50% P.O.C.","$80000 - $108000"
"06095253105","Census Tract 2531.05, Solano County, California",6584,53617,2670,962,44,425,0,1889,40.6,14.6,0.7,6.5,0,28.7,59.4,2513,749,1764,29.81,70.19,14,735,191,1573,205,2308,1.9,10.8,8.2,"50% - 75% P.O.C.","Less than $80000"
"06095253106","Census Tract 2531.06, Solano County, California",3675,94318,2010,417,0,335,0,778,54.7,11.3,0,9.1,0,21.2,45.3,1260,738,522,58.57,41.43,135,603,42,480,177,1083,18.3,8,14,"25% - 50% P.O.C.","$80000 - $108000"
"06095253107","Census Tract 2531.07, Solano County, California",6141,53685,2790,467,20,532,69,2007,45.4,7.6,0.3,8.7,1.1,32.7,54.6,2312,937,1375,40.53,59.47,60,877,182,1193,242,2070,6.4,13.2,10.5,"50% - 75% P.O.C.","Less than $80000"
"06095253108","Census Tract 2531.08, Solano County, California",4747,71360,1978,294,10,613,23,1241,41.7,6.2,0.2,12.9,0.5,26.1,58.3,1594,960,634,60.23,39.77,221,739,92,542,313,1281,23,14.5,19.6,"50% - 75% P.O.C.","Less than $80000"
"06095253201","Census Tract 2532.01, Solano County, California",4788,107688,3468,192,79,58,0,684,72.4,4,1.6,1.2,0,14.3,27.6,1831,1622,209,88.59,11.41,112,1510,88,121,200,1631,6.9,42.1,10.9,"25% - 50% P.O.C.","$80000 - $108000"
"06095253203","Census Tract 2532.03, Solano County, California",4123,70337,2483,313,0,160,0,960,60.2,7.6,0,3.9,0,23.3,39.8,1462,785,677,53.69,46.31,123,662,24,653,147,1315,15.7,3.5,10.1,"25% - 50% P.O.C.","Less than $80000"
"06095253204","Census Tract 2532.04, Solano County, California",7286,73350,2775,435,0,347,0,3392,38.1,6,0,4.8,0,46.6,61.9,2417,1319,1098,54.57,45.43,195,1124,166,932,361,2056,14.8,15.1,14.9,"50% - 75% P.O.C.","Less than $80000"
"06095253205","Census Tract 2532.05, Solano County, California",2971,73636,1548,112,0,220,1,910,52.1,3.8,0,7.4,0,30.6,47.9,1038,594,444,57.23,42.77,71,523,61,383,132,906,12,13.7,12.7,"25% - 50% P.O.C.","Less than $80000"
"06095253206","Census Tract 2532.06, Solano County, California",3236,134268,2111,20,0,496,36,372,65.2,0.6,0,15.3,1.1,11.5,34.8,1098,874,224,79.6,20.4,53,821,38,186,91,1007,6.1,17,8.3,"25% - 50% P.O.C.","$108000 - $141000"
"06095253300","Census Tract 2533, Solano County, California",2648,87639,1429,10,64,26,0,1077,54,0.4,2.4,1,0,40.7,46,839,486,353,57.93,42.07,30,456,49,304,79,760,6.2,13.9,9.4,"25% - 50% P.O.C.","$80000 - $108000"
"06095253402","Census Tract 2534.02, Solano County, California",8343,76779,3042,169,0,574,0,4155,36.5,2,0,6.9,0,49.8,63.5,2455,1589,866,64.73,35.27,409,1180,167,699,576,1879,25.7,19.3,23.5,"50% - 75% P.O.C.","Less than $80000"
"06095253403","Census Tract 2534.03, Solano County, California",4991,103607,2783,9,0,249,13,1721,55.8,0.2,0,5,0.3,34.5,44.2,1539,1369,170,88.95,11.05,234,1135,54,116,288,1251,17.1,31.8,18.7,"25% - 50% P.O.C.","$80000 - $108000"
"06095253404","Census Tract 2534.04, Solano County, California",6894,84944,3421,196,37,175,77,2647,49.6,2.8,0.5,2.5,1.1,38.4,50.4,2154,1345,809,62.44,37.56,139,1206,393,416,532,1622,10.3,48.6,24.7,"50% - 75% P.O.C.","$80000 - $108000"
"06095253500","Census Tract 2535, Solano County, California",10676,68284,6870,712,21,598,86,2227,64.3,6.7,0.2,5.6,0.8,20.9,35.7,5184,3952,1232,76.23,23.77,19,3933,175,1057,194,4990,0.5,14.2,3.7,"25% - 50% P.O.C.","Less than $80000"
"06095980000","Census Tract 9800, Solano County, California",0,NA,0,0,0,0,0,0,NA,NA,NA,NA,NA,NA,NA,0,0,0,NA,NA,0,0,0,0,0,0,NA,NA,NA,"N/A","N/A"
"06097150100","Census Tract 1501, Sonoma County, California",2631,103393,2188,0,0,23,0,409,83.2,0,0,0.9,0,15.5,16.8,1041,663,378,63.69,36.31,74,589,0,378,74,967,11.2,0,7.1,"Less than 25% P.O.C.","$80000 - $108000"
"06097150202","Census Tract 1502.02, Sonoma County, California",4927,94280,3220,27,0,329,0,1098,65.4,0.5,0,6.7,0,22.3,34.6,2238,1414,824,63.18,36.82,28,1386,63,761,91,2147,2,7.6,4.1,"25% - 50% P.O.C.","$80000 - $108000"
"06097150203","Census Tract 1502.03, Sonoma County, California",4561,71875,3568,15,0,124,0,766,78.2,0.3,0,2.7,0,16.8,21.8,2160,1426,734,66.02,33.98,25,1401,0,734,25,2135,1.8,0,1.2,"Less than 25% P.O.C.","Less than $80000"
"06097150204","Census Tract 1502.04, Sonoma County, California",3633,83648,2866,0,8,39,0,642,78.9,0,0.2,1.1,0,17.7,21.1,1711,1029,682,60.14,39.86,50,979,37,645,87,1624,4.9,5.4,5.1,"Less than 25% P.O.C.","$80000 - $108000"
"06097150303","Census Tract 1503.03, Sonoma County, California",4493,81827,3894,0,0,29,0,341,86.7,0,0,0.6,0,7.6,13.3,2223,2026,197,91.14,8.86,105,1921,17,180,122,2101,5.2,8.6,5.5,"Less than 25% P.O.C.","$80000 - $108000"
"06097150304","Census Tract 1503.04, Sonoma County, California",5610,105253,3738,138,0,68,24,1642,66.6,2.5,0,1.2,0.4,29.3,33.4,2234,1528,706,68.4,31.6,214,1314,47,659,261,1973,14,6.7,11.7,"25% - 50% P.O.C.","$80000 - $108000"
"06097150305","Census Tract 1503.05, Sonoma County, California",6183,66510,1648,37,0,28,0,3926,26.7,0.6,0,0.5,0,63.5,73.3,1799,793,1006,44.08,55.92,80,713,387,619,467,1332,10.1,38.5,26,"50% - 75% P.O.C.","Less than $80000"
"06097150306","Census Tract 1503.06, Sonoma County, California",4225,68180,2631,0,0,81,12,1179,62.3,0,0,1.9,0.3,27.9,37.7,1811,1145,666,63.22,36.78,86,1059,62,604,148,1663,7.5,9.3,8.2,"25% - 50% P.O.C.","Less than $80000"
"06097150500","Census Tract 1505, Sonoma County, California",4782,117167,3974,20,40,144,0,253,83.1,0.4,0.8,3,0,5.3,16.9,1900,1423,477,74.89,25.11,130,1293,76,401,206,1694,9.1,15.9,10.8,"Less than 25% P.O.C.","$108000 - $141000"
"06097150601","Census Tract 1506.01, Sonoma County, California",4413,90114,2526,84,0,238,10,1340,57.2,1.9,0,5.4,0.2,30.4,42.8,1411,1079,332,76.47,23.53,134,945,91,241,225,1186,12.4,27.4,15.9,"25% - 50% P.O.C.","$80000 - $108000"
"06097150602","Census Tract 1506.02, Sonoma County, California",4271,90556,3009,0,0,210,0,872,70.5,0,0,4.9,0,20.4,29.5,1550,1342,208,86.58,13.42,77,1265,6,202,83,1467,5.7,2.9,5.4,"25% - 50% P.O.C.","$80000 - $108000"
"06097150603","Census Tract 1506.03, Sonoma County, California",7691,77690,4931,40,4,190,0,2308,64.1,0.5,0.1,2.5,0,30,35.9,2866,1575,1291,54.95,45.05,230,1345,80,1211,310,2556,14.6,6.2,10.8,"25% - 50% P.O.C.","Less than $80000"
"06097150607","Census Tract 1506.07, Sonoma County, California",5145,124643,3563,81,1,436,16,736,69.3,1.6,0,8.5,0.3,14.3,30.7,1738,1349,389,77.62,22.38,139,1210,46,343,185,1553,10.3,11.8,10.6,"25% - 50% P.O.C.","$108000 - $141000"
"06097150609","Census Tract 1506.09, Sonoma County, California",5033,78160,3267,112,0,264,5,1193,64.9,2.2,0,5.2,0.1,23.7,35.1,2008,1377,631,68.58,31.42,73,1304,101,530,174,1834,5.3,16,8.7,"25% - 50% P.O.C.","Less than $80000"
"06097150610","Census Tract 1506.10, Sonoma County, California",3983,111429,2568,18,24,264,0,828,64.5,0.5,0.6,6.6,0,20.8,35.5,1346,1087,259,80.76,19.24,30,1057,54,205,84,1262,2.8,20.8,6.2,"25% - 50% P.O.C.","$108000 - $141000"
"06097150611","Census Tract 1506.11, Sonoma County, California",4147,99722,2677,88,0,224,0,1007,64.6,2.1,0,5.4,0,24.3,35.4,1430,795,635,55.59,44.41,44,751,75,560,119,1311,5.5,11.8,8.3,"25% - 50% P.O.C.","$80000 - $108000"
"06097150612","Census Tract 1506.12, Sonoma County, California",4676,109028,3773,22,17,171,0,520,80.7,0.5,0.4,3.7,0,11.1,19.3,1666,1042,624,62.55,37.45,137,905,56,568,193,1473,13.1,9,11.6,"Less than 25% P.O.C.","$108000 - $141000"
"06097150701","Census Tract 1507.01, Sonoma County, California",4939,87025,3383,46,6,45,0,1297,68.5,0.9,0.1,0.9,0,26.3,31.5,2059,994,1065,48.28,51.72,31,963,157,908,188,1871,3.1,14.7,9.1,"25% - 50% P.O.C.","$80000 - $108000"
"06097150702","Census Tract 1507.02, Sonoma County, California",4915,108281,4046,58,8,229,0,375,82.3,1.2,0.2,4.7,0,7.6,17.7,1939,1498,441,77.26,22.74,88,1410,70,371,158,1781,5.9,15.9,8.1,"Less than 25% P.O.C.","$108000 - $141000"
"06097150800","Census Tract 1508, Sonoma County, California",5401,84744,3631,3,13,255,11,1158,67.2,0.1,0.2,4.7,0.2,21.4,32.8,2012,1128,884,56.06,43.94,62,1066,69,815,131,1881,5.5,7.8,6.5,"25% - 50% P.O.C.","$80000 - $108000"
"06097150901","Census Tract 1509.01, Sonoma County, California",5053,64772,2886,65,0,165,0,1604,57.1,1.3,0,3.3,0,31.7,42.9,2041,1056,985,51.74,48.26,1,1055,154,831,155,1886,0.1,15.6,7.6,"25% - 50% P.O.C.","Less than $80000"
"06097150902","Census Tract 1509.02, Sonoma County, California",3423,107740,2849,30,0,55,0,344,83.2,0.9,0,1.6,0,10,16.8,1409,1000,409,70.97,29.03,58,942,23,386,81,1328,5.8,5.6,5.7,"Less than 25% P.O.C.","$80000 - $108000"
"06097151000","Census Tract 1510, Sonoma County, California",3968,89792,3234,0,0,109,0,580,81.5,0,0,2.7,0,14.6,18.5,1495,910,585,60.87,39.13,56,854,72,513,128,1367,6.2,12.3,8.6,"Less than 25% P.O.C.","$80000 - $108000"
"06097151100","Census Tract 1511, Sonoma County, California",5619,89708,4429,88,24,47,17,858,78.8,1.6,0.4,0.8,0.3,15.3,21.2,1901,1185,716,62.34,37.66,111,1074,95,621,206,1695,9.4,13.3,10.8,"Less than 25% P.O.C.","$80000 - $108000"
"06097151201","Census Tract 1512.01, Sonoma County, California",7069,72985,4801,27,4,279,0,1806,67.9,0.4,0.1,3.9,0,25.5,32.1,2920,1955,965,66.95,33.05,309,1646,10,955,319,2601,15.8,1,10.9,"25% - 50% P.O.C.","Less than $80000"
"06097151203","Census Tract 1512.03, Sonoma County, California",4460,82931,3564,12,0,93,7,646,79.9,0.3,0,2.1,0.2,14.5,20.1,1776,1118,658,62.95,37.05,54,1064,52,606,106,1670,4.8,7.9,6,"Less than 25% P.O.C.","$80000 - $108000"
"06097151204","Census Tract 1512.04, Sonoma County, California",2987,70438,2157,12,0,67,11,639,72.2,0.4,0,2.2,0.4,21.4,27.8,1179,585,594,49.62,50.38,57,528,103,491,160,1019,9.7,17.3,13.6,"25% - 50% P.O.C.","Less than $80000"
"06097151301","Census Tract 1513.01, Sonoma County, California",4970,62809,1982,34,0,363,8,2306,39.9,0.7,0,7.3,0.2,46.4,60.1,1659,840,819,50.63,49.37,83,757,189,630,272,1387,9.9,23.1,16.4,"50% - 75% P.O.C.","Less than $80000"
"06097151305","Census Tract 1513.05, Sonoma County, California",6038,52375,3120,76,0,116,0,2653,51.7,1.3,0,1.9,0,43.9,48.3,2548,695,1853,27.28,72.72,116,579,208,1645,324,2224,16.7,11.2,12.7,"25% - 50% P.O.C.","Less than $80000"
"06097151306","Census Tract 1513.06, Sonoma County, California",3841,63125,2466,65,0,255,0,892,64.2,1.7,0,6.6,0,23.2,35.8,1735,1123,612,64.73,35.27,32,1091,65,547,97,1638,2.8,10.6,5.6,"25% - 50% P.O.C.","Less than $80000"
"06097151307","Census Tract 1513.07, Sonoma County, California",5783,95161,3644,35,0,317,0,1514,63,0.6,0,5.5,0,26.2,37,2018,1496,522,74.13,25.87,165,1331,97,425,262,1756,11,18.6,13,"25% - 50% P.O.C.","$80000 - $108000"
"06097151308","Census Tract 1513.08, Sonoma County, California",5119,65119,3696,113,0,116,0,852,72.2,2.2,0,2.3,0,16.6,27.8,1964,1021,943,51.99,48.01,40,981,44,899,84,1880,3.9,4.7,4.3,"25% - 50% P.O.C.","Less than $80000"
"06097151309","Census Tract 1513.09, Sonoma County, California",5737,108370,4118,76,0,444,0,921,71.8,1.3,0,7.7,0,16.1,28.2,2146,1524,622,71.02,28.98,57,1467,35,587,92,2054,3.7,5.6,4.3,"25% - 50% P.O.C.","$108000 - $141000"
"06097151310","Census Tract 1513.10, Sonoma County, California",5716,75025,3342,307,0,616,7,1346,58.5,5.4,0,10.8,0.1,23.5,41.5,1507,802,705,53.22,46.78,60,742,70,635,130,1377,7.5,9.9,8.6,"25% - 50% P.O.C.","Less than $80000"
"06097151311","Census Tract 1513.11, Sonoma County, California",6575,89038,4169,313,0,676,0,1319,63.4,4.8,0,10.3,0,20.1,36.6,2402,1458,944,60.7,39.3,93,1365,67,877,160,2242,6.4,7.1,6.7,"25% - 50% P.O.C.","$80000 - $108000"
"06097151401","Census Tract 1514.01, Sonoma County, California",8050,71539,3123,145,127,854,106,3368,38.8,1.8,1.6,10.6,1.3,41.8,61.2,2607,1312,1295,50.33,49.67,109,1203,242,1053,351,2256,8.3,18.7,13.5,"50% - 75% P.O.C.","Less than $80000"
"06097151402","Census Tract 1514.02, Sonoma County, California",9853,50059,3531,328,150,583,0,5156,35.8,3.3,1.5,5.9,0,52.3,64.2,3510,1486,2024,42.34,57.66,283,1203,163,1861,446,3064,19,8.1,12.7,"50% - 75% P.O.C.","Less than $80000"
"06097151502","Census Tract 1515.02, Sonoma County, California",7069,82026,5706,208,41,258,22,702,80.7,2.9,0.6,3.6,0.3,9.9,19.3,2890,1519,1371,52.56,47.44,51,1468,146,1225,197,2693,3.4,10.6,6.8,"Less than 25% P.O.C.","$80000 - $108000"
"06097151503","Census Tract 1515.03, Sonoma County, California",3448,145147,2973,49,10,170,0,173,86.2,1.4,0.3,4.9,0,5,13.8,1362,1262,100,92.66,7.34,25,1237,13,87,38,1324,2,13,2.8,"Less than 25% P.O.C.","$141000 or more"
"06097151504","Census Tract 1515.04, Sonoma County, California",3554,104063,2944,8,0,183,0,353,82.8,0.2,0,5.1,0,9.9,17.2,1287,1018,269,79.1,20.9,53,965,68,201,121,1166,5.2,25.3,9.4,"Less than 25% P.O.C.","$80000 - $108000"
"06097151601","Census Tract 1516.01, Sonoma County, California",3013,77306,2600,7,10,121,6,230,86.3,0.2,0.3,4,0.2,7.6,13.7,1751,1318,433,75.27,24.73,0,1318,0,433,0,1751,0,0,0,"Less than 25% P.O.C.","Less than $80000"
"06097151602","Census Tract 1516.02, Sonoma County, California",2985,69537,2769,0,0,119,0,83,92.8,0,0,4,0,2.8,7.2,1810,1425,385,78.73,21.27,19,1406,0,385,19,1791,1.3,0,1,"Less than 25% P.O.C.","Less than $80000"
"06097151700","Census Tract 1517, Sonoma County, California",7457,76691,5109,4,42,441,480,1178,68.5,0.1,0.6,5.9,6.4,15.8,31.5,2915,1077,1838,36.95,63.05,67,1010,76,1762,143,2772,6.2,4.1,4.9,"25% - 50% P.O.C.","Less than $80000"
"06097151800","Census Tract 1518, Sonoma County, California",4848,81948,3732,306,0,48,11,470,77,6.3,0,1,0.2,9.7,23,2041,1283,758,62.86,37.14,15,1268,51,707,66,1975,1.2,6.7,3.2,"Less than 25% P.O.C.","$80000 - $108000"
"06097151900","Census Tract 1519, Sonoma County, California",3286,50282,1994,65,37,152,0,898,60.7,2,1.1,4.6,0,27.3,39.3,1449,441,1008,30.43,69.57,36,405,53,955,89,1360,8.2,5.3,6.1,"25% - 50% P.O.C.","Less than $80000"
"06097152000","Census Tract 1520, Sonoma County, California",1980,49856,1155,79,4,71,0,558,58.3,4,0.2,3.6,0,28.2,41.7,987,83,904,8.41,91.59,0,83,36,868,36,951,0,4,3.6,"25% - 50% P.O.C.","Less than $80000"
"06097152100","Census Tract 1521, Sonoma County, California",3136,69074,2085,167,21,139,11,629,66.5,5.3,0.7,4.4,0.4,20.1,33.5,1018,557,461,54.72,45.28,54,503,19,442,73,945,9.7,4.1,7.2,"25% - 50% P.O.C.","Less than $80000"
"06097152201","Census Tract 1522.01, Sonoma County, California",3937,58333,2375,187,126,59,4,1006,60.3,4.7,3.2,1.5,0.1,25.6,39.7,1742,564,1178,32.38,67.62,10,554,118,1060,128,1614,1.8,10,7.3,"25% - 50% P.O.C.","Less than $80000"
"06097152202","Census Tract 1522.02, Sonoma County, California",6510,67887,4326,29,0,335,0,1558,66.5,0.4,0,5.1,0,23.9,33.5,2844,1695,1149,59.6,40.4,89,1606,49,1100,138,2706,5.3,4.3,4.9,"25% - 50% P.O.C.","Less than $80000"
"06097152203","Census Tract 1522.03, Sonoma County, California",3535,57679,2607,96,109,66,0,430,73.7,2.7,3.1,1.9,0,12.2,26.3,1800,603,1197,33.5,66.5,14,589,23,1174,37,1763,2.3,1.9,2.1,"25% - 50% P.O.C.","Less than $80000"
"06097152300","Census Tract 1523, Sonoma County, California",4115,108947,3413,2,24,82,0,506,82.9,0,0.6,2,0,12.3,17.1,1764,1351,413,76.59,23.41,90,1261,33,380,123,1641,6.7,8,7,"Less than 25% P.O.C.","$108000 - $141000"
"06097152400","Census Tract 1524, Sonoma County, California",8367,130845,6573,175,44,692,35,563,78.6,2.1,0.5,8.3,0.4,6.7,21.4,3645,2809,836,77.06,22.94,114,2695,0,836,114,3531,4.1,0,3.1,"Less than 25% P.O.C.","$108000 - $141000"
"06097152501","Census Tract 1525.01, Sonoma County, California",4352,69933,2912,101,12,343,0,855,66.9,2.3,0.3,7.9,0,19.6,33.1,1707,795,912,46.57,53.43,11,784,76,836,87,1620,1.4,8.3,5.1,"25% - 50% P.O.C.","Less than $80000"
"06097152502","Census Tract 1525.02, Sonoma County, California",3782,58125,2169,12,39,285,0,1098,57.4,0.3,1,7.5,0,29,42.6,1476,920,556,62.33,37.67,39,881,86,470,125,1351,4.2,15.5,8.5,"25% - 50% P.O.C.","Less than $80000"
"06097152600","Census Tract 1526, Sonoma County, California",8131,119722,6655,139,0,366,2,683,81.8,1.7,0,4.5,0,8.4,18.2,3078,2451,627,79.63,20.37,192,2259,76,551,268,2810,7.8,12.1,8.7,"Less than 25% P.O.C.","$108000 - $141000"
"06097152701","Census Tract 1527.01, Sonoma County, California",4804,76341,3208,0,0,148,0,1214,66.8,0,0,3.1,0,25.3,33.2,1989,1348,641,67.77,32.23,34,1314,76,565,110,1879,2.5,11.9,5.5,"25% - 50% P.O.C.","Less than $80000"
"06097152702","Census Tract 1527.02, Sonoma County, California",5342,85321,3156,74,16,161,0,1600,59.1,1.4,0.3,3,0,30,40.9,1838,863,975,46.95,53.05,69,794,60,915,129,1709,8,6.2,7,"25% - 50% P.O.C.","$80000 - $108000"
"06097152801","Census Tract 1528.01, Sonoma County, California",4631,109167,2572,0,39,176,0,1690,55.5,0,0.8,3.8,0,36.5,44.5,1490,1077,413,72.28,27.72,57,1020,188,225,245,1245,5.3,45.5,16.4,"25% - 50% P.O.C.","$108000 - $141000"
"06097152802","Census Tract 1528.02, Sonoma County, California",7564,50691,2786,207,0,207,0,4178,36.8,2.7,0,2.7,0,55.2,63.2,2805,804,2001,28.66,71.34,151,653,314,1687,465,2340,18.8,15.7,16.6,"50% - 75% P.O.C.","Less than $80000"
"06097152903","Census Tract 1529.03, Sonoma County, California",5488,70136,1729,148,0,234,0,3121,31.5,2.7,0,4.3,0,56.9,68.5,1562,723,839,46.29,53.71,142,581,237,602,379,1183,19.6,28.2,24.3,"50% - 75% P.O.C.","Less than $80000"
"06097152904","Census Tract 1529.04, Sonoma County, California",5459,89510,3173,112,3,149,139,1604,58.1,2.1,0.1,2.7,2.5,29.4,41.9,1892,1268,624,67.02,32.98,110,1158,130,494,240,1652,8.7,20.8,12.7,"25% - 50% P.O.C.","$80000 - $108000"
"06097152905","Census Tract 1529.05, Sonoma County, California",4458,86852,2710,152,55,195,16,1256,60.8,3.4,1.2,4.4,0.4,28.2,39.2,1530,927,603,60.59,39.41,81,846,141,462,222,1308,8.7,23.4,14.5,"25% - 50% P.O.C.","$80000 - $108000"
"06097152906","Census Tract 1529.06, Sonoma County, California",5576,108365,3931,147,0,196,0,1171,70.5,2.6,0,3.5,0,21,29.5,2025,1460,565,72.1,27.9,46,1414,84,481,130,1895,3.2,14.9,6.4,"25% - 50% P.O.C.","$108000 - $141000"
"06097153001","Census Tract 1530.01, Sonoma County, California",7147,54106,3128,39,39,478,0,3159,43.8,0.5,0.5,6.7,0,44.2,56.2,2687,778,1909,28.95,71.05,98,680,235,1674,333,2354,12.6,12.3,12.4,"50% - 75% P.O.C.","Less than $80000"
"06097153002","Census Tract 1530.02, Sonoma County, California",6864,81911,2496,227,28,217,87,3504,36.4,3.3,0.4,3.2,1.3,51,63.6,1903,921,982,48.4,51.6,193,728,235,747,428,1475,21,23.9,22.5,"50% - 75% P.O.C.","$80000 - $108000"
"06097153003","Census Tract 1530.03, Sonoma County, California",5669,65701,2777,45,77,248,64,2264,49,0.8,1.4,4.4,1.1,39.9,51,1958,1069,889,54.6,45.4,197,872,87,802,284,1674,18.4,9.8,14.5,"50% - 75% P.O.C.","Less than $80000"
"06097153005","Census Tract 1530.05, Sonoma County, California",7207,104951,4472,17,0,467,0,1995,62.1,0.2,0,6.5,0,27.7,37.9,2495,1903,592,76.27,23.73,177,1726,73,519,250,2245,9.3,12.3,10,"25% - 50% P.O.C.","$80000 - $108000"
"06097153006","Census Tract 1530.06, Sonoma County, California",8199,69722,4416,279,1,239,20,2850,53.9,3.4,0,2.9,0.2,34.8,46.1,2920,1915,1005,65.58,34.42,79,1836,198,807,277,2643,4.1,19.7,9.5,"25% - 50% P.O.C.","Less than $80000"
"06097153102","Census Tract 1531.02, Sonoma County, California",5976,81189,1058,325,75,307,0,4147,17.7,5.4,1.3,5.1,0,69.4,82.3,1499,722,777,48.17,51.83,190,532,156,621,346,1153,26.3,20.1,23.1,"75% or more P.O.C.","$80000 - $108000"
"06097153103","Census Tract 1531.03, Sonoma County, California",4507,60640,1272,53,81,351,0,2652,28.2,1.2,1.8,7.8,0,58.8,71.8,1399,736,663,52.61,47.39,126,610,161,502,287,1112,17.1,24.3,20.5,"50% - 75% P.O.C.","Less than $80000"
"06097153104","Census Tract 1531.04, Sonoma County, California",3949,52132,956,81,55,39,0,2620,24.2,2.1,1.4,1,0,66.3,75.8,1218,395,823,32.43,67.57,77,318,169,654,246,972,19.5,20.5,20.2,"75% or more P.O.C.","Less than $80000"
"06097153200","Census Tract 1532, Sonoma County, California",8327,69280,2687,302,0,456,55,4559,32.3,3.6,0,5.5,0.7,54.7,67.7,2550,1240,1310,48.63,51.37,148,1092,370,940,518,2032,11.9,28.2,20.3,"50% - 75% P.O.C.","Less than $80000"
"06097153300","Census Tract 1533, Sonoma County, California",12385,79528,4899,386,72,994,50,5357,39.6,3.1,0.6,8,0.4,43.3,60.4,3834,2391,1443,62.36,37.64,434,1957,301,1142,735,3099,18.2,20.9,19.2,"50% - 75% P.O.C.","Less than $80000"
"06097153401","Census Tract 1534.01, Sonoma County, California",6373,85750,5130,42,0,155,16,531,80.5,0.7,0,2.4,0.3,8.3,19.5,2675,1428,1247,53.38,46.62,37,1391,65,1182,102,2573,2.6,5.2,3.8,"Less than 25% P.O.C.","$80000 - $108000"
"06097153403","Census Tract 1534.03, Sonoma County, California",3910,85778,3074,117,0,138,3,498,78.6,3,0,3.5,0.1,12.7,21.4,1586,1076,510,67.84,32.16,28,1048,21,489,49,1537,2.6,4.1,3.1,"Less than 25% P.O.C.","$80000 - $108000"
"06097153404","Census Tract 1534.04, Sonoma County, California",4382,92198,3800,12,5,38,0,322,86.7,0.3,0.1,0.9,0,7.3,13.3,1739,1198,541,68.89,31.11,117,1081,0,541,117,1622,9.8,0,6.7,"Less than 25% P.O.C.","$80000 - $108000"
"06097153501","Census Tract 1535.01, Sonoma County, California",4816,98598,4136,57,3,74,0,496,85.9,1.2,0.1,1.5,0,10.3,14.1,1901,1379,522,72.54,27.46,101,1278,37,485,138,1763,7.3,7.1,7.3,"Less than 25% P.O.C.","$80000 - $108000"
"06097153502","Census Tract 1535.02, Sonoma County, California",4266,94023,3511,0,0,80,0,515,82.3,0,0,1.9,0,12.1,17.7,1741,1367,374,78.52,21.48,62,1305,46,328,108,1633,4.5,12.3,6.2,"Less than 25% P.O.C.","$80000 - $108000"
"06097153600","Census Tract 1536, Sonoma County, California",6265,102647,4866,7,21,21,11,1066,77.7,0.1,0.3,0.3,0.2,17,22.3,2280,1615,665,70.83,29.17,119,1496,67,598,186,2094,7.4,10.1,8.2,"Less than 25% P.O.C.","$80000 - $108000"
"06097153703","Census Tract 1537.03, Sonoma County, California",3506,59761,2975,55,13,63,10,245,84.9,1.6,0.4,1.8,0.3,7,15.1,1729,1110,619,64.2,35.8,61,1049,18,601,79,1650,5.5,2.9,4.6,"Less than 25% P.O.C.","Less than $80000"
"06097153704","Census Tract 1537.04, Sonoma County, California",4071,60901,3407,4,0,53,8,469,83.7,0.1,0,1.3,0.2,11.5,16.3,1891,1112,779,58.8,41.2,40,1072,25,754,65,1826,3.6,3.2,3.4,"Less than 25% P.O.C.","Less than $80000"
"06097153705","Census Tract 1537.05, Sonoma County, California",3936,69081,3140,9,8,120,0,488,79.8,0.2,0.2,3,0,12.4,20.2,1829,1293,536,70.69,29.31,38,1255,64,472,102,1727,2.9,11.9,5.6,"Less than 25% P.O.C.","Less than $80000"
"06097153706","Census Tract 1537.06, Sonoma County, California",4440,64746,3689,0,77,41,0,369,83.1,0,1.7,0.9,0,8.3,16.9,1997,1437,560,71.96,28.04,88,1349,26,534,114,1883,6.1,4.6,5.7,"Less than 25% P.O.C.","Less than $80000"
"06097153801","Census Tract 1538.01, Sonoma County, California",10263,117070,5613,110,103,363,0,3877,54.7,1.1,1,3.5,0,37.8,45.3,3019,2116,903,70.09,29.91,353,1763,207,696,560,2459,16.7,22.9,18.5,"25% - 50% P.O.C.","$108000 - $141000"
"06097153804","Census Tract 1538.04, Sonoma County, California",3534,120605,1955,0,15,40,0,1229,55.3,0,0.4,1.1,0,34.8,44.7,1147,955,192,83.26,16.74,186,769,8,184,194,953,19.5,4.2,16.9,"25% - 50% P.O.C.","$108000 - $141000"
"06097153806","Census Tract 1538.06, Sonoma County, California",3244,94018,2142,0,48,19,6,953,66,0,1.5,0.6,0.2,29.4,34,1186,866,320,73.02,26.98,90,776,68,252,158,1028,10.4,21.2,13.3,"25% - 50% P.O.C.","$80000 - $108000"
"06097153807","Census Tract 1538.07, Sonoma County, California",3459,123684,2471,66,153,115,0,522,71.4,1.9,4.4,3.3,0,15.1,28.6,1364,1259,105,92.3,7.7,50,1209,0,105,50,1314,4,0,3.7,"25% - 50% P.O.C.","$108000 - $141000"
"06097153808","Census Tract 1538.08, Sonoma County, California",4393,72841,2127,28,57,113,0,1925,48.4,0.6,1.3,2.6,0,43.8,51.6,1535,1070,465,69.71,30.29,221,849,39,426,260,1275,20.7,8.4,16.9,"50% - 75% P.O.C.","Less than $80000"
"06097153809","Census Tract 1538.09, Sonoma County, California",4388,94735,2581,0,0,65,141,1310,58.8,0,0,1.5,3.2,29.9,41.2,1564,1119,445,71.55,28.45,44,1075,54,391,98,1466,3.9,12.1,6.3,"25% - 50% P.O.C.","$80000 - $108000"
"06097153901","Census Tract 1539.01, Sonoma County, California",4966,83375,3566,17,0,131,0,864,71.8,0.3,0,2.6,0,17.4,28.2,2081,1386,695,66.6,33.4,62,1324,57,638,119,1962,4.5,8.2,5.7,"25% - 50% P.O.C.","$80000 - $108000"
"06097153902","Census Tract 1539.02, Sonoma County, California",4617,76250,2542,0,0,41,8,1994,55.1,0,0,0.9,0.2,43.2,44.9,1713,795,918,46.41,53.59,41,754,46,872,87,1626,5.2,5,5.1,"25% - 50% P.O.C.","Less than $80000"
"06097153903","Census Tract 1539.03, Sonoma County, California",3876,105909,2753,0,30,28,0,998,71,0,0.8,0.7,0,25.7,29,1522,1069,453,70.24,29.76,74,995,38,415,112,1410,6.9,8.4,7.4,"25% - 50% P.O.C.","$80000 - $108000"
"06097154000","Census Tract 1540, Sonoma County, California",2606,96324,1827,0,31,47,0,655,70.1,0,1.2,1.8,0,25.1,29.9,1052,793,259,75.38,24.62,73,720,15,244,88,964,9.2,5.8,8.4,"25% - 50% P.O.C.","$80000 - $108000"
"06097154100","Census Tract 1541, Sonoma County, California",3644,104792,2426,0,0,55,11,992,66.6,0,0,1.5,0.3,27.2,33.4,1353,825,528,60.98,39.02,48,777,67,461,115,1238,5.8,12.7,8.5,"25% - 50% P.O.C.","$80000 - $108000"
"06097154201","Census Tract 1542.01, Sonoma County, California",3959,64309,1868,3,84,75,6,1915,47.2,0.1,2.1,1.9,0.2,48.4,52.8,1387,696,691,50.18,49.82,49,647,188,503,237,1150,7,27.2,17.1,"50% - 75% P.O.C.","Less than $80000"
"06097154202","Census Tract 1542.02, Sonoma County, California",6050,72317,4324,66,48,322,0,1122,71.5,1.1,0.8,5.3,0,18.5,28.5,2302,1769,533,76.85,23.15,76,1693,116,417,192,2110,4.3,21.8,8.3,"25% - 50% P.O.C.","Less than $80000"
"06097154302","Census Tract 1543.02, Sonoma County, California",3848,80341,3176,63,50,28,22,154,82.5,1.6,1.3,0.7,0.6,4,17.5,1797,1349,448,75.07,24.93,33,1316,12,436,45,1752,2.4,2.7,2.5,"Less than 25% P.O.C.","$80000 - $108000"
"06097154303","Census Tract 1543.03, Sonoma County, California",1528,78882,1256,0,0,43,2,218,82.2,0,0,2.8,0.1,14.3,17.8,777,624,153,80.31,19.69,0,624,12,141,12,765,0,7.8,1.5,"Less than 25% P.O.C.","Less than $80000"
"06097154304","Census Tract 1543.04, Sonoma County, California",2455,62153,1932,0,111,76,3,234,78.7,0,4.5,3.1,0.1,9.5,21.3,1088,697,391,64.06,35.94,20,677,17,374,37,1051,2.9,4.3,3.4,"Less than 25% P.O.C.","Less than $80000"
"06097990100","Census Tract 9901, Sonoma County, California",0,NA,0,0,0,0,0,0,NA,NA,NA,NA,NA,NA,NA,0,0,0,NA,NA,0,0,0,0,0,0,NA,NA,NA,"N/A","N/A"
