"GEOID","NAME","total_pop","median_hh_income","white","black","ai_an","asian","hi_pi","hisp_lat","pct_white","pct_black","pct_ai_an","pct_asian","pct_hi_pi","pct_hisp_lat","pct_poc","total_hh","total_hh_owner","total_hh_renter","pct_owners","pct_renters","total_owner_more_than_4","total_owner_less_than_4","total_renter_more_than_4","total_renter_less_than_4","total_hh_more_than_4","total_hh_less_than_4","pct_owner_more_than_4","pct_renter_more_than_4","pct_total_hh_more_than_4","poc_bin","income_bin"
"48015760100","Census Tract 7601, Austin County, Texas",2781,49705,1235,323,0,0,0,1116,44.4,11.6,0,0,0,40.1,55.6,983,661,322,67.24,32.76,128,533,56,266,184,799,19.4,17.4,18.7,"50% - 75% P.O.C.","$44000 - $59000"
"48015760200","Census Tract 7602, Austin County, Texas",5876,62128,3205,616,0,16,0,2008,54.5,10.5,0,0.3,0,34.2,45.5,2131,1775,356,83.29,16.71,251,1524,4,352,255,1876,14.1,1.1,12,"25% - 50% P.O.C.","$59000 - $86000"
"48015760300","Census Tract 7603, Austin County, Texas",6777,71550,3752,310,0,0,0,2500,55.4,4.6,0,0,0,36.9,44.6,2551,1732,819,67.89,32.11,241,1491,182,637,423,2128,13.9,22.2,16.6,"25% - 50% P.O.C.","$59000 - $86000"
"48015760400","Census Tract 7604, Austin County, Texas",4009,78263,2851,323,0,95,0,719,71.1,8.1,0,2.4,0,17.9,28.9,1558,1386,172,88.96,11.04,117,1269,52,120,169,1389,8.4,30.2,10.8,"25% - 50% P.O.C.","$59000 - $86000"
"48015760501","Census Tract 7605.01, Austin County, Texas",4894,89479,4122,154,0,0,0,473,84.2,3.1,0,0,0,9.7,15.8,1767,1596,171,90.32,9.68,143,1453,10,161,153,1614,9,5.8,8.7,"Less than 25% P.O.C.","$86000 or more"
"48015760502","Census Tract 7605.02, Austin County, Texas",5427,48226,3350,874,30,0,0,1173,61.7,16.1,0.6,0,0,21.6,38.3,2311,1463,848,63.31,36.69,46,1417,75,773,121,2190,3.1,8.8,5.2,"25% - 50% P.O.C.","$44000 - $59000"
"48039660100","Census Tract 6601, Brazoria County, Texas",5037,110179,2899,488,24,370,0,1033,57.6,9.7,0.5,7.3,0,20.5,42.4,1733,1505,228,86.84,13.16,230,1275,11,217,241,1492,15.3,4.8,13.9,"25% - 50% P.O.C.","$86000 or more"
"48039660200","Census Tract 6602, Brazoria County, Texas",6704,98819,3934,580,0,360,0,1808,58.7,8.7,0,5.4,0,27,41.3,2129,1713,416,80.46,19.54,168,1545,59,357,227,1902,9.8,14.2,10.7,"25% - 50% P.O.C.","$86000 or more"
"48039660300","Census Tract 6603, Brazoria County, Texas",11643,103323,7527,1148,36,340,0,2361,64.6,9.9,0.3,2.9,0,20.3,35.4,4002,2853,1149,71.29,28.71,313,2540,0,1149,313,3689,11,0,7.8,"25% - 50% P.O.C.","$86000 or more"
"48039660400","Census Tract 6604, Brazoria County, Texas",11429,98963,5962,1090,0,1150,0,3033,52.2,9.5,0,10.1,0,26.5,47.8,3988,2883,1105,72.29,27.71,534,2349,113,992,647,3341,18.5,10.2,16.2,"25% - 50% P.O.C.","$86000 or more"
"48039660500","Census Tract 6605, Brazoria County, Texas",9163,82588,4064,860,96,536,0,3542,44.4,9.4,1,5.8,0,38.7,55.6,3478,3009,469,86.52,13.48,373,2636,28,441,401,3077,12.4,6,11.5,"50% - 75% P.O.C.","$59000 - $86000"
"48039660601","Census Tract 6606.01, Brazoria County, Texas",13005,107012,5279,2615,367,2259,0,2104,40.6,20.1,2.8,17.4,0,16.2,59.4,4704,4195,509,89.18,10.82,462,3733,0,509,462,4242,11,0,9.8,"50% - 75% P.O.C.","$86000 or more"
"48039660602","Census Tract 6606.02, Brazoria County, Texas",49119,102239,10609,15968,0,10554,0,11114,21.6,32.5,0,21.5,0,22.6,78.4,15682,10361,5321,66.07,33.93,1866,8495,463,4858,2329,13353,18,8.7,14.9,"75% or more P.O.C.","$86000 or more"
"48039660701","Census Tract 6607.01, Brazoria County, Texas",15574,104840,5866,3426,41,2602,0,3134,37.7,22,0.3,16.7,0,20.1,62.3,5633,3456,2177,61.35,38.65,415,3041,54,2123,469,5164,12,2.5,8.3,"50% - 75% P.O.C.","$86000 or more"
"48039660702","Census Tract 6607.02, Brazoria County, Texas",15351,105083,7424,3619,0,1722,0,2458,48.4,23.6,0,11.2,0,16,51.6,5321,4023,1298,75.61,24.39,611,3412,0,1298,611,4710,15.2,0,11.5,"50% - 75% P.O.C.","$86000 or more"
"48039660801","Census Tract 6608.01, Brazoria County, Texas",9590,106415,4615,1674,113,138,0,3032,48.1,17.5,1.2,1.4,0,31.6,51.9,3260,2413,847,74.02,25.98,262,2151,106,741,368,2892,10.9,12.5,11.3,"50% - 75% P.O.C.","$86000 or more"
"48039660802","Census Tract 6608.02, Brazoria County, Texas",9038,112525,4073,1043,0,439,0,3348,45.1,11.5,0,4.9,0,37,54.9,2459,2242,217,91.18,8.82,577,1665,81,136,658,1801,25.7,37.3,26.8,"50% - 75% P.O.C.","$86000 or more"
"48039660900","Census Tract 6609, Brazoria County, Texas",7845,63315,3250,234,0,343,0,3903,41.4,3,0,4.4,0,49.8,58.6,2215,1818,397,82.08,17.92,519,1299,88,309,607,1608,28.5,22.2,27.4,"50% - 75% P.O.C.","$59000 - $86000"
"48039661000","Census Tract 6610, Brazoria County, Texas",7896,91659,4126,439,0,171,0,3107,52.3,5.6,0,2.2,0,39.3,47.7,2445,2252,193,92.11,7.89,464,1788,0,193,464,1981,20.6,0,19,"25% - 50% P.O.C.","$86000 or more"
"48039661100","Census Tract 6611, Brazoria County, Texas",3763,56920,1739,234,0,20,0,1770,46.2,6.2,0,0.5,0,47,53.8,1263,769,494,60.89,39.11,123,646,76,418,199,1064,16,15.4,15.8,"50% - 75% P.O.C.","$44000 - $59000"
"48039661200","Census Tract 6612, Brazoria County, Texas",4283,50424,2250,135,22,42,0,1788,52.5,3.2,0.5,1,0,41.7,47.5,1576,588,988,37.31,62.69,113,475,56,932,169,1407,19.2,5.7,10.7,"25% - 50% P.O.C.","$44000 - $59000"
"48039661300","Census Tract 6613, Brazoria County, Texas",2432,43866,1006,25,0,0,0,1384,41.4,1,0,0,0,56.9,58.6,845,384,461,45.44,54.56,24,360,55,406,79,766,6.2,11.9,9.3,"50% - 75% P.O.C.","Less than $44000"
"48039661400","Census Tract 6614, Brazoria County, Texas",7030,54051,4656,108,0,146,0,2090,66.2,1.5,0,2.1,0,29.7,33.8,2461,1770,691,71.92,28.08,351,1419,113,578,464,1997,19.8,16.4,18.9,"25% - 50% P.O.C.","$44000 - $59000"
"48039661501","Census Tract 6615.01, Brazoria County, Texas",5223,62149,2792,72,16,0,0,2203,53.5,1.4,0.3,0,0,42.2,46.5,1682,1438,244,85.49,14.51,241,1197,78,166,319,1363,16.8,32,19,"25% - 50% P.O.C.","$59000 - $86000"
"48039661502","Census Tract 6615.02, Brazoria County, Texas",4647,73811,2981,155,16,31,0,1337,64.1,3.3,0.3,0.7,0,28.8,35.9,1500,1242,258,82.8,17.2,218,1024,43,215,261,1239,17.6,16.7,17.4,"25% - 50% P.O.C.","$59000 - $86000"
"48039661601","Census Tract 6616.01, Brazoria County, Texas",6143,72625,3934,109,8,24,0,2021,64,1.8,0.1,0.4,0,32.9,36,2442,1510,932,61.83,38.17,97,1413,96,836,193,2249,6.4,10.3,7.9,"25% - 50% P.O.C.","$59000 - $86000"
"48039661602","Census Tract 6616.02, Brazoria County, Texas",3031,66934,1187,39,20,41,0,1744,39.2,1.3,0.7,1.4,0,57.5,60.8,994,732,262,73.64,26.36,144,588,39,223,183,811,19.7,14.9,18.4,"50% - 75% P.O.C.","$59000 - $86000"
"48039661700","Census Tract 6617, Brazoria County, Texas",2796,79231,1718,101,0,7,0,950,61.4,3.6,0,0.3,0,34,38.6,1056,1000,56,94.7,5.3,118,882,0,56,118,938,11.8,0,11.2,"25% - 50% P.O.C.","$59000 - $86000"
"48039661800","Census Tract 6618, Brazoria County, Texas",6980,88463,3663,609,0,604,0,1810,52.5,8.7,0,8.7,0,25.9,47.5,2153,2016,137,93.64,6.36,293,1723,31,106,324,1829,14.5,22.6,15,"25% - 50% P.O.C.","$86000 or more"
"48039661900","Census Tract 6619, Brazoria County, Texas",15144,82636,4831,3596,36,237,0,6320,31.9,23.7,0.2,1.6,0,41.7,68.1,2829,2435,394,86.07,13.93,345,2090,131,263,476,2353,14.2,33.2,16.8,"50% - 75% P.O.C.","$59000 - $86000"
"48039662000","Census Tract 6620, Brazoria County, Texas",6191,75959,4283,224,0,16,0,1542,69.2,3.6,0,0.3,0,24.9,30.8,2193,1787,406,81.49,18.51,157,1630,135,271,292,1901,8.8,33.3,13.3,"25% - 50% P.O.C.","$59000 - $86000"
"48039662100","Census Tract 6621, Brazoria County, Texas",5367,80152,2817,686,57,33,0,1671,52.5,12.8,1.1,0.6,0,31.1,47.5,1940,1550,390,79.9,20.1,206,1344,6,384,212,1728,13.3,1.5,10.9,"25% - 50% P.O.C.","$59000 - $86000"
"48039662200","Census Tract 6622, Brazoria County, Texas",7339,56956,4523,648,0,334,0,1599,61.6,8.8,0,4.6,0,21.8,38.4,2437,1508,929,61.88,38.12,345,1163,0,929,345,2092,22.9,0,14.2,"25% - 50% P.O.C.","$44000 - $59000"
"48039662300","Census Tract 6623, Brazoria County, Texas",5038,54917,2904,588,0,117,0,1269,57.6,11.7,0,2.3,0,25.2,42.4,1907,1036,871,54.33,45.67,133,903,67,804,200,1707,12.8,7.7,10.5,"25% - 50% P.O.C.","$44000 - $59000"
"48039662400","Census Tract 6624, Brazoria County, Texas",5110,55526,3254,269,0,18,0,1491,63.7,5.3,0,0.4,0,29.2,36.3,1988,1374,614,69.11,30.89,126,1248,46,568,172,1816,9.2,7.5,8.7,"25% - 50% P.O.C.","$44000 - $59000"
"48039662500","Census Tract 6625, Brazoria County, Texas",2944,98333,1989,241,0,0,0,688,67.6,8.2,0,0,0,23.4,32.4,1000,792,208,79.2,20.8,73,719,0,208,73,927,9.2,0,7.3,"25% - 50% P.O.C.","$86000 or more"
"48039662600","Census Tract 6626, Brazoria County, Texas",3119,75865,2123,292,0,0,0,667,68.1,9.4,0,0,0,21.4,31.9,1165,884,281,75.88,24.12,59,825,65,216,124,1041,6.7,23.1,10.6,"25% - 50% P.O.C.","$59000 - $86000"
"48039662700","Census Tract 6627, Brazoria County, Texas",2344,61188,1790,178,0,0,0,348,76.4,7.6,0,0,0,14.8,23.6,839,796,43,94.87,5.13,62,734,11,32,73,766,7.8,25.6,8.7,"Less than 25% P.O.C.","$59000 - $86000"
"48039662800","Census Tract 6628, Brazoria County, Texas",6196,65888,3990,684,0,0,0,1522,64.4,11,0,0,0,24.6,35.6,2353,1744,609,74.12,25.88,132,1612,49,560,181,2172,7.6,8,7.7,"25% - 50% P.O.C.","$59000 - $86000"
"48039662900","Census Tract 6629, Brazoria County, Texas",4824,54474,3423,396,24,8,0,929,71,8.2,0.5,0.2,0,19.3,29,1710,1287,423,75.26,24.74,234,1053,36,387,270,1440,18.2,8.5,15.8,"25% - 50% P.O.C.","$44000 - $59000"
"48039663000","Census Tract 6630, Brazoria County, Texas",4244,65601,2516,773,9,39,0,870,59.3,18.2,0.2,0.9,0,20.5,40.7,1203,1057,146,87.86,12.14,18,1039,13,133,31,1172,1.7,8.9,2.6,"25% - 50% P.O.C.","$59000 - $86000"
"48039663100","Census Tract 6631, Brazoria County, Texas",7575,107232,4235,1117,27,144,0,1989,55.9,14.7,0.4,1.9,0,26.3,44.1,2095,1917,178,91.5,8.5,118,1799,16,162,134,1961,6.2,9,6.4,"25% - 50% P.O.C.","$86000 or more"
"48039663200","Census Tract 6632, Brazoria County, Texas",4960,75000,3272,81,25,103,0,1461,66,1.6,0.5,2.1,0,29.5,34,2032,1168,864,57.48,42.52,45,1123,28,836,73,1959,3.9,3.2,3.6,"25% - 50% P.O.C.","$59000 - $86000"
"48039663300","Census Tract 6633, Brazoria County, Texas",2340,63281,1236,198,0,143,0,678,52.8,8.5,0,6.1,0,29,47.2,769,526,243,68.4,31.6,34,492,43,200,77,692,6.5,17.7,10,"25% - 50% P.O.C.","$59000 - $86000"
"48039663400","Census Tract 6634, Brazoria County, Texas",7720,67775,4750,594,0,276,0,2100,61.5,7.7,0,3.6,0,27.2,38.5,3141,1807,1334,57.53,42.47,80,1727,63,1271,143,2998,4.4,4.7,4.6,"25% - 50% P.O.C.","$59000 - $86000"
"48039663500","Census Tract 6635, Brazoria County, Texas",5624,72074,2974,53,0,46,0,2406,52.9,0.9,0,0.8,0,42.8,47.1,2161,1084,1077,50.16,49.84,79,1005,280,797,359,1802,7.3,26,16.6,"25% - 50% P.O.C.","$59000 - $86000"
"48039663600","Census Tract 6636, Brazoria County, Texas",5249,124234,3753,26,0,152,0,1244,71.5,0.5,0,2.9,0,23.7,28.5,1840,1686,154,91.63,8.37,209,1477,34,120,243,1597,12.4,22.1,13.2,"25% - 50% P.O.C.","$86000 or more"
"48039663700","Census Tract 6637, Brazoria County, Texas",3631,90000,1576,61,21,18,0,1928,43.4,1.7,0.6,0.5,0,53.1,56.6,1306,897,409,68.68,31.32,195,702,34,375,229,1077,21.7,8.3,17.5,"50% - 75% P.O.C.","$86000 or more"
"48039663800","Census Tract 6638, Brazoria County, Texas",6383,60862,2529,569,0,0,21,3186,39.6,8.9,0,0,0.3,49.9,60.4,2444,1276,1168,52.21,47.79,194,1082,62,1106,256,2188,15.2,5.3,10.5,"50% - 75% P.O.C.","$59000 - $86000"
"48039663900","Census Tract 6639, Brazoria County, Texas",2581,46765,687,118,0,0,0,1670,26.6,4.6,0,0,0,64.7,73.4,842,454,388,53.92,46.08,105,349,32,356,137,705,23.1,8.2,16.3,"50% - 75% P.O.C.","$44000 - $59000"
"48039664000","Census Tract 6640, Brazoria County, Texas",3602,63063,734,711,0,0,0,2157,20.4,19.7,0,0,0,59.9,79.6,1355,808,547,59.63,40.37,120,688,55,492,175,1180,14.9,10.1,12.9,"75% or more P.O.C.","$59000 - $86000"
"48039664100","Census Tract 6641, Brazoria County, Texas",5878,67664,3400,20,0,98,0,2327,57.8,0.3,0,1.7,0,39.6,42.2,2134,1646,488,77.13,22.87,220,1426,27,461,247,1887,13.4,5.5,11.6,"25% - 50% P.O.C.","$59000 - $86000"
"48039664200","Census Tract 6642, Brazoria County, Texas",2149,48625,1468,130,0,14,0,457,68.3,6,0,0.7,0,21.3,31.7,971,640,331,65.91,34.09,40,600,48,283,88,883,6.2,14.5,9.1,"25% - 50% P.O.C.","$44000 - $59000"
"48039664300","Census Tract 6643, Brazoria County, Texas",5691,41488,736,596,330,7,0,3904,12.9,10.5,5.8,0.1,0,68.6,87.1,1756,721,1035,41.06,58.94,168,553,189,846,357,1399,23.3,18.3,20.3,"75% or more P.O.C.","Less than $44000"
"48039664400","Census Tract 6644, Brazoria County, Texas",6205,37701,1240,1051,0,101,0,3750,20,16.9,0,1.6,0,60.4,80,2169,1027,1142,47.35,52.65,38,989,322,820,360,1809,3.7,28.2,16.6,"75% or more P.O.C.","Less than $44000"
"48039664501","Census Tract 6645.01, Brazoria County, Texas",5507,47725,3685,555,0,0,0,1216,66.9,10.1,0,0,0,22.1,33.1,1923,1566,357,81.44,18.56,220,1346,88,269,308,1615,14,24.6,16,"25% - 50% P.O.C.","$44000 - $59000"
"48039990000","Census Tract 9900, Brazoria County, Texas",0,NA,0,0,0,0,0,0,NA,NA,NA,NA,NA,NA,NA,0,0,0,NA,NA,0,0,0,0,0,0,NA,NA,NA,"N/A","N/A"
"48057000100","Census Tract 1, Calhoun County, Texas",5451,65833,1918,105,0,591,0,2837,35.2,1.9,0,10.8,0,52,64.8,1898,1516,382,79.87,20.13,258,1258,7,375,265,1633,17,1.8,14,"50% - 75% P.O.C.","$59000 - $86000"
"48057000200","Census Tract 2, Calhoun County, Texas",4343,45804,884,204,0,104,7,3132,20.4,4.7,0,2.4,0.2,72.1,79.6,1475,860,615,58.31,41.69,117,743,20,595,137,1338,13.6,3.3,9.3,"75% or more P.O.C.","$44000 - $59000"
"48057000300","Census Tract 3, Calhoun County, Texas",1657,59063,1207,90,0,10,0,307,72.8,5.4,0,0.6,0,18.5,27.2,608,421,187,69.24,30.76,44,377,10,177,54,554,10.5,5.3,8.9,"25% - 50% P.O.C.","$59000 - $86000"
"48057000400","Census Tract 4, Calhoun County, Texas",6875,62455,2851,106,0,366,0,3466,41.5,1.5,0,5.3,0,50.4,58.5,2411,1777,634,73.7,26.3,200,1577,148,486,348,2063,11.3,23.3,14.4,"50% - 75% P.O.C.","$59000 - $86000"
"48057000500","Census Tract 5, Calhoun County, Texas",3342,58563,2303,0,0,69,0,847,68.9,0,0,2.1,0,25.3,31.1,1190,944,246,79.33,20.67,76,868,50,196,126,1064,8.1,20.3,10.6,"25% - 50% P.O.C.","$44000 - $59000"
"48057990000","Census Tract 9900, Calhoun County, Texas",0,NA,0,0,0,0,0,0,NA,NA,NA,NA,NA,NA,NA,0,0,0,NA,NA,0,0,0,0,0,0,NA,NA,NA,"N/A","N/A"
"48071710100","Census Tract 7101, Chambers County, Texas",9246,91102,7001,621,26,0,0,1266,75.7,6.7,0.3,0,0,13.7,24.3,3335,2589,746,77.63,22.37,360,2229,10,736,370,2965,13.9,1.3,11.1,"Less than 25% P.O.C.","$86000 or more"
"48071710200","Census Tract 7102, Chambers County, Texas",20191,116539,12599,1256,25,157,0,5851,62.4,6.2,0.1,0.8,0,29,37.6,6495,5866,629,90.32,9.68,778,5088,372,257,1150,5345,13.3,59.1,17.7,"25% - 50% P.O.C.","$86000 or more"
"48071710300","Census Tract 7103, Chambers County, Texas",2715,77371,1716,493,2,7,0,412,63.2,18.2,0.1,0.3,0,15.2,36.8,947,837,110,88.38,11.62,128,709,19,91,147,800,15.3,17.3,15.5,"25% - 50% P.O.C.","$59000 - $86000"
"48071710401","Census Tract 7104.01, Chambers County, Texas",5399,48902,4622,323,10,39,0,275,85.6,6,0.2,0.7,0,5.1,14.4,1880,1276,604,67.87,32.13,197,1079,115,489,312,1568,15.4,19,16.6,"Less than 25% P.O.C.","$44000 - $59000"
"48071710500","Census Tract 7105, Chambers County, Texas",3754,40987,1723,304,0,262,0,1463,45.9,8.1,0,7,0,39,54.1,1412,1101,311,77.97,22.03,93,1008,14,297,107,1305,8.4,4.5,7.6,"50% - 75% P.O.C.","Less than $44000"
"48071710600","Census Tract 7106, Chambers County, Texas",0,NA,0,0,0,0,0,0,NA,NA,NA,NA,NA,NA,NA,0,0,0,NA,NA,0,0,0,0,0,0,NA,NA,NA,"N/A","N/A"
"48071990000","Census Tract 9900, Chambers County, Texas",0,NA,0,0,0,0,0,0,NA,NA,NA,NA,NA,NA,NA,0,0,0,NA,NA,0,0,0,0,0,0,NA,NA,NA,"N/A","N/A"
"48089750100","Census Tract 7501, Colorado County, Texas",4648,39821,1240,797,4,0,0,2443,26.7,17.1,0.1,0,0,52.6,73.3,1502,1201,301,79.96,20.04,224,977,41,260,265,1237,18.7,13.6,17.6,"50% - 75% P.O.C.","Less than $44000"
"48089750200","Census Tract 7502, Colorado County, Texas",1983,48750,1083,286,0,0,0,585,54.6,14.4,0,0,0,29.5,45.4,694,586,108,84.44,15.56,44,542,9,99,53,641,7.5,8.3,7.6,"25% - 50% P.O.C.","$44000 - $59000"
"48089750300","Census Tract 7503, Colorado County, Texas",5310,62076,3364,755,16,3,0,1169,63.4,14.2,0.3,0.1,0,22,36.6,1873,1587,286,84.73,15.27,172,1415,46,240,218,1655,10.8,16.1,11.6,"25% - 50% P.O.C.","$59000 - $86000"
"48089750400","Census Tract 7504, Colorado County, Texas",5502,46250,3731,434,0,0,0,1198,67.8,7.9,0,0,0,21.8,32.2,1983,1564,419,78.87,21.13,84,1480,59,360,143,1840,5.4,14.1,7.2,"25% - 50% P.O.C.","$44000 - $59000"
"48089750500","Census Tract 7505, Colorado County, Texas",3781,58750,2453,411,0,2,0,915,64.9,10.9,0,0.1,0,24.2,35.1,1398,1204,194,86.12,13.88,121,1083,0,194,121,1277,10,0,8.7,"25% - 50% P.O.C.","$44000 - $59000"
"48157670101","Census Tract 6701.01, Fort Bend County, Texas",6633,47945,169,2036,0,11,0,4376,2.5,30.7,0,0.2,0,66,97.5,1792,1227,565,68.47,31.53,262,965,170,395,432,1360,21.4,30.1,24.1,"75% or more P.O.C.","$44000 - $59000"
"48157670102","Census Tract 6701.02, Fort Bend County, Texas",3320,58750,29,1837,0,54,0,1400,0.9,55.3,0,1.6,0,42.2,99.1,958,620,338,64.72,35.28,96,524,91,247,187,771,15.5,26.9,19.5,"75% or more P.O.C.","$44000 - $59000"
"48157670200","Census Tract 6702, Fort Bend County, Texas",7801,60394,151,4262,0,134,0,3254,1.9,54.6,0,1.7,0,41.7,98.1,2315,1637,678,70.71,29.29,256,1381,213,465,469,1846,15.6,31.4,20.3,"75% or more P.O.C.","$59000 - $86000"
"48157670300","Census Tract 6703, Fort Bend County, Texas",3319,54417,89,2123,18,137,0,896,2.7,64,0.5,4.1,0,27,97.3,1130,732,398,64.78,35.22,36,696,112,286,148,982,4.9,28.1,13.1,"75% or more P.O.C.","$44000 - $59000"
"48157670400","Census Tract 6704, Fort Bend County, Texas",5242,51843,103,3845,0,3,0,1010,2,73.3,0,0.1,0,19.3,98,1619,1013,606,62.57,37.43,264,749,99,507,363,1256,26.1,16.3,22.4,"75% or more P.O.C.","$44000 - $59000"
"48157670500","Census Tract 6705, Fort Bend County, Texas",4745,59221,256,3043,10,244,0,1087,5.4,64.1,0.2,5.1,0,22.9,94.6,1673,1353,320,80.87,19.13,97,1256,27,293,124,1549,7.2,8.4,7.4,"75% or more P.O.C.","$59000 - $86000"
"48157670601","Census Tract 6706.01, Fort Bend County, Texas",9711,77697,247,7565,0,10,0,1714,2.5,77.9,0,0.1,0,17.7,97.5,3113,2503,610,80.4,19.6,312,2191,186,424,498,2615,12.5,30.5,16,"75% or more P.O.C.","$59000 - $86000"
"48157670602","Census Tract 6706.02, Fort Bend County, Texas",2027,55125,50,1260,0,7,0,710,2.5,62.2,0,0.3,0,35,97.5,587,343,244,58.43,41.57,57,286,39,205,96,491,16.6,16,16.4,"75% or more P.O.C.","$44000 - $59000"
"48157670700","Census Tract 6707, Fort Bend County, Texas",7283,107532,1493,3122,31,1383,0,971,20.5,42.9,0.4,19,0,13.3,79.5,2400,2142,258,89.25,10.75,278,1864,88,170,366,2034,13,34.1,15.2,"75% or more P.O.C.","$86000 or more"
"48157670800","Census Tract 6708, Fort Bend County, Texas",17725,74869,501,8557,0,363,0,8170,2.8,48.3,0,2,0,46.1,97.2,4775,3773,1002,79.02,20.98,923,2850,355,647,1278,3497,24.5,35.4,26.8,"75% or more P.O.C.","$59000 - $86000"
"48157670901","Census Tract 6709.01, Fort Bend County, Texas",13016,109741,3045,4595,0,4109,81,958,23.4,35.3,0,31.6,0.6,7.4,76.6,3957,3754,203,94.87,5.13,568,3186,30,173,598,3359,15.1,14.8,15.1,"75% or more P.O.C.","$86000 or more"
"48157670902","Census Tract 6709.02, Fort Bend County, Texas",9045,91635,386,5623,0,117,0,2824,4.3,62.2,0,1.3,0,31.2,95.7,2549,2248,301,88.19,11.81,480,1768,35,266,515,2034,21.4,11.6,20.2,"75% or more P.O.C.","$86000 or more"
"48157671001","Census Tract 6710.01, Fort Bend County, Texas",5395,91205,2654,1277,33,352,0,904,49.2,23.7,0.6,6.5,0,16.8,50.8,2224,2107,117,94.74,5.26,151,1956,0,117,151,2073,7.2,0,6.8,"50% - 75% P.O.C.","$86000 or more"
"48157671002","Census Tract 6710.02, Fort Bend County, Texas",6290,72841,1844,2598,0,12,0,1584,29.3,41.3,0,0.2,0,25.2,70.7,2405,1746,659,72.6,27.4,153,1593,68,591,221,2184,8.8,10.3,9.2,"50% - 75% P.O.C.","$59000 - $86000"
"48157671100","Census Tract 6711, Fort Bend County, Texas",8405,67149,1216,2899,0,650,0,3627,14.5,34.5,0,7.7,0,43.2,85.5,2763,2200,563,79.62,20.38,332,1868,91,472,423,2340,15.1,16.2,15.3,"75% or more P.O.C.","$59000 - $86000"
"48157671200","Census Tract 6712, Fort Bend County, Texas",6300,68047,433,3823,0,395,0,1541,6.9,60.7,0,6.3,0,24.5,93.1,2097,1477,620,70.43,29.57,204,1273,222,398,426,1671,13.8,35.8,20.3,"75% or more P.O.C.","$59000 - $86000"
"48157671300","Census Tract 6713, Fort Bend County, Texas",4234,61555,604,1591,0,391,0,1581,14.3,37.6,0,9.2,0,37.3,85.7,1271,535,736,42.09,57.91,125,410,115,621,240,1031,23.4,15.6,18.9,"75% or more P.O.C.","$59000 - $86000"
"48157671400","Census Tract 6714, Fort Bend County, Texas",8448,58217,1017,2250,0,3337,0,1657,12,26.6,0,39.5,0,19.6,88,3224,1101,2123,34.15,65.85,189,912,131,1992,320,2904,17.2,6.2,9.9,"75% or more P.O.C.","$44000 - $59000"
"48157671501","Census Tract 6715.01, Fort Bend County, Texas",8197,111364,2116,2084,0,2969,0,846,25.8,25.4,0,36.2,0,10.3,74.2,2608,2027,581,77.72,22.28,257,1770,55,526,312,2296,12.7,9.5,12,"50% - 75% P.O.C.","$86000 or more"
"48157671502","Census Tract 6715.02, Fort Bend County, Texas",1608,115000,373,563,0,615,0,16,23.2,35,0,38.2,0,1,76.8,492,416,76,84.55,15.45,51,365,4,72,55,437,12.3,5.3,11.2,"75% or more P.O.C.","$86000 or more"
"48157671601","Census Tract 6716.01, Fort Bend County, Texas",6480,72981,3244,392,72,1866,0,699,50.1,6,1.1,28.8,0,10.8,49.9,2802,1360,1442,48.54,51.46,66,1294,29,1413,95,2707,4.9,2,3.4,"25% - 50% P.O.C.","$59000 - $86000"
"48157671602","Census Tract 6716.02, Fort Bend County, Texas",3393,104389,1498,201,0,1160,0,526,44.1,5.9,0,34.2,0,15.5,55.9,1184,1014,170,85.64,14.36,79,935,14,156,93,1091,7.8,8.2,7.9,"50% - 75% P.O.C.","$86000 or more"
"48157671700","Census Tract 6717, Fort Bend County, Texas",5668,137176,3958,161,0,904,0,516,69.8,2.8,0,15.9,0,9.1,30.2,2171,1870,301,86.14,13.86,124,1746,40,261,164,2007,6.6,13.3,7.6,"25% - 50% P.O.C.","$86000 or more"
"48157671800","Census Tract 6718, Fort Bend County, Texas",3696,62247,752,1134,0,477,0,1241,20.3,30.7,0,12.9,0,33.6,79.7,1253,605,648,48.28,51.72,136,469,11,637,147,1106,22.5,1.7,11.7,"75% or more P.O.C.","$59000 - $86000"
"48157671900","Census Tract 6719, Fort Bend County, Texas",4164,69130,2350,324,0,655,0,661,56.4,7.8,0,15.7,0,15.9,43.6,1418,1346,72,94.92,5.08,186,1160,20,52,206,1212,13.8,27.8,14.5,"25% - 50% P.O.C.","$59000 - $86000"
"48157672001","Census Tract 6720.01, Fort Bend County, Texas",8512,69177,1625,1351,18,3948,0,1467,19.1,15.9,0.2,46.4,0,17.2,80.9,2591,1705,886,65.8,34.2,318,1387,17,869,335,2256,18.7,1.9,12.9,"75% or more P.O.C.","$59000 - $86000"
"48157672002","Census Tract 6720.02, Fort Bend County, Texas",6915,63505,1549,1982,0,1937,0,1138,22.4,28.7,0,28,0,16.5,77.6,2815,735,2080,26.11,73.89,32,703,109,1971,141,2674,4.4,5.2,5,"75% or more P.O.C.","$59000 - $86000"
"48157672100","Census Tract 6721, Fort Bend County, Texas",4407,114875,2762,99,0,1091,9,352,62.7,2.2,0,24.8,0.2,8,37.3,1853,1579,274,85.21,14.79,60,1519,0,274,60,1793,3.8,0,3.2,"25% - 50% P.O.C.","$86000 or more"
"48157672200","Census Tract 6722, Fort Bend County, Texas",4084,100104,1952,393,8,573,0,980,47.8,9.6,0.2,14,0,24,52.2,1636,1199,437,73.29,26.71,116,1083,5,432,121,1515,9.7,1.1,7.4,"50% - 75% P.O.C.","$86000 or more"
"48157672301","Census Tract 6723.01, Fort Bend County, Texas",7435,70540,1145,1338,0,3118,0,1754,15.4,18,0,41.9,0,23.6,84.6,2354,1474,880,62.62,37.38,300,1174,66,814,366,1988,20.4,7.5,15.5,"75% or more P.O.C.","$59000 - $86000"
"48157672302","Census Tract 6723.02, Fort Bend County, Texas",9462,84767,4588,427,26,2506,0,1638,48.5,4.5,0.3,26.5,0,17.3,51.5,3140,2454,686,78.15,21.85,244,2210,79,607,323,2817,9.9,11.5,10.3,"50% - 75% P.O.C.","$59000 - $86000"
"48157672400","Census Tract 6724, Fort Bend County, Texas",8911,71438,1636,2746,0,1348,0,2962,18.4,30.8,0,15.1,0,33.2,81.6,2625,1956,669,74.51,25.49,343,1613,223,446,566,2059,17.5,33.3,21.6,"75% or more P.O.C.","$59000 - $86000"
"48157672500","Census Tract 6725, Fort Bend County, Texas",7459,66000,966,1603,0,1021,0,3821,13,21.5,0,13.7,0,51.2,87,2340,1969,371,84.15,15.85,384,1585,20,351,404,1936,19.5,5.4,17.3,"75% or more P.O.C.","$59000 - $86000"
"48157672601","Census Tract 6726.01, Fort Bend County, Texas",10962,51583,1287,2402,0,674,0,6357,11.7,21.9,0,6.1,0,58,88.3,3047,2058,989,67.54,32.46,445,1613,199,790,644,2403,21.6,20.1,21.1,"75% or more P.O.C.","$44000 - $59000"
"48157672602","Census Tract 6726.02, Fort Bend County, Texas",7280,90568,435,3893,0,1121,0,1831,6,53.5,0,15.4,0,25.2,94,1784,1443,341,80.89,19.11,521,922,98,243,619,1165,36.1,28.7,34.7,"75% or more P.O.C.","$86000 or more"
"48157672701","Census Tract 6727.01, Fort Bend County, Texas",12817,67252,1315,3071,0,4507,0,3760,10.3,24,0,35.2,0,29.3,89.7,3439,2539,900,73.83,26.17,587,1952,277,623,864,2575,23.1,30.8,25.1,"75% or more P.O.C.","$59000 - $86000"
"48157672702","Census Tract 6727.02, Fort Bend County, Texas",7929,76716,2469,1907,145,1022,0,2018,31.1,24.1,1.8,12.9,0,25.5,68.9,2156,1509,647,69.99,30.01,270,1239,170,477,440,1716,17.9,26.3,20.4,"50% - 75% P.O.C.","$59000 - $86000"
"48157672800","Census Tract 6728, Fort Bend County, Texas",8248,85398,1831,1492,12,3574,0,1262,22.2,18.1,0.1,43.3,0,15.3,77.8,2323,1473,850,63.41,36.59,410,1063,118,732,528,1795,27.8,13.9,22.7,"75% or more P.O.C.","$59000 - $86000"
"48157672900","Census Tract 6729, Fort Bend County, Texas",59947,103399,15038,15277,0,19898,0,8957,25.1,25.5,0,33.2,0,14.9,74.9,16932,14192,2740,83.82,16.18,3153,11039,837,1903,3990,12942,22.2,30.5,23.6,"50% - 75% P.O.C.","$86000 or more"
"48157673001","Census Tract 6730.01, Fort Bend County, Texas",7564,140455,5383,473,0,795,13,838,71.2,6.3,0,10.5,0.2,11.1,28.8,2498,2176,322,87.11,12.89,269,1907,72,250,341,2157,12.4,22.4,13.7,"25% - 50% P.O.C.","$86000 or more"
"48157673002","Census Tract 6730.02, Fort Bend County, Texas",9393,85703,4360,1369,0,1101,0,2516,46.4,14.6,0,11.7,0,26.8,53.6,3019,1541,1478,51.04,48.96,257,1284,155,1323,412,2607,16.7,10.5,13.6,"50% - 75% P.O.C.","$59000 - $86000"
"48157673003","Census Tract 6730.03, Fort Bend County, Texas",11883,163302,6257,696,58,3113,0,1525,52.7,5.9,0.5,26.2,0,12.8,47.3,3754,3270,484,87.11,12.89,440,2830,127,357,567,3187,13.5,26.2,15.1,"25% - 50% P.O.C.","$86000 or more"
"48157673101","Census Tract 6731.01, Fort Bend County, Texas",72041,148776,30315,5299,805,15891,0,17523,42.1,7.4,1.1,22.1,0,24.3,57.9,20705,17542,3163,84.72,15.28,2877,14665,538,2625,3415,17290,16.4,17,16.5,"50% - 75% P.O.C.","$86000 or more"
"48157673102","Census Tract 6731.02, Fort Bend County, Texas",17783,126132,7997,1387,0,4587,0,3521,45,7.8,0,25.8,0,19.8,55,6057,4505,1552,74.38,25.62,377,4128,94,1458,471,5586,8.4,6.1,7.8,"50% - 75% P.O.C.","$86000 or more"
"48157673200","Census Tract 6732, Fort Bend County, Texas",19362,155824,12515,1070,122,1696,0,3453,64.6,5.5,0.6,8.8,0,17.8,35.4,5793,5424,369,93.63,6.37,876,4548,34,335,910,4883,16.2,9.2,15.7,"25% - 50% P.O.C.","$86000 or more"
"48157673300","Census Tract 6733, Fort Bend County, Texas",7825,139722,6199,337,0,298,0,848,79.2,4.3,0,3.8,0,10.8,20.8,2686,2607,79,97.06,2.94,321,2286,8,71,329,2357,12.3,10.1,12.2,"Less than 25% P.O.C.","$86000 or more"
"48157673400","Census Tract 6734, Fort Bend County, Texas",28707,129772,15485,4023,0,2753,0,5790,53.9,14,0,9.6,0,20.2,46.1,8969,8102,867,90.33,9.67,1167,6935,89,778,1256,7713,14.4,10.3,14,"25% - 50% P.O.C.","$86000 or more"
"48157673500","Census Tract 6735, Fort Bend County, Texas",9366,119632,5169,1131,0,611,0,2337,55.2,12.1,0,6.5,0,25,44.8,3198,2481,717,77.58,22.42,295,2186,0,717,295,2903,11.9,0,9.2,"25% - 50% P.O.C.","$86000 or more"
"48157673600","Census Tract 6736, Fort Bend County, Texas",6782,97331,5200,40,0,61,0,1334,76.7,0.6,0,0.9,0,19.7,23.3,2479,2367,112,95.48,4.52,293,2074,0,112,293,2186,12.4,0,11.8,"Less than 25% P.O.C.","$86000 or more"
"48157673700","Census Tract 6737, Fort Bend County, Texas",2819,NA,1047,791,24,0,0,939,37.1,28.1,0.9,0,0,33.3,62.9,4,0,4,0,100,0,0,0,4,0,4,NA,0,0,"50% - 75% P.O.C.","N/A"
"48157673800","Census Tract 6738, Fort Bend County, Texas",9524,115568,2208,942,0,4293,0,1982,23.2,9.9,0,45.1,0,20.8,76.8,2629,2112,517,80.33,19.67,543,1569,72,445,615,2014,25.7,13.9,23.4,"75% or more P.O.C.","$86000 or more"
"48157673901","Census Tract 6739.01, Fort Bend County, Texas",8960,157941,3419,464,37,3275,0,1400,38.2,5.2,0.4,36.6,0,15.6,61.8,2752,2621,131,95.24,4.76,398,2223,32,99,430,2322,15.2,24.4,15.6,"50% - 75% P.O.C.","$86000 or more"
"48157673902","Census Tract 6739.02, Fort Bend County, Texas",12026,157917,1922,351,0,9113,0,496,16,2.9,0,75.8,0,4.1,84,3391,2628,763,77.5,22.5,636,1992,11,752,647,2744,24.2,1.4,19.1,"75% or more P.O.C.","$86000 or more"
"48157674000","Census Tract 6740, Fort Bend County, Texas",8145,90398,3431,498,27,3468,0,646,42.1,6.1,0.3,42.6,0,7.9,57.9,3208,1957,1251,61,39,162,1795,42,1209,204,3004,8.3,3.4,6.4,"50% - 75% P.O.C.","$86000 or more"
"48157674100","Census Tract 6741, Fort Bend County, Texas",7669,114325,4133,643,2,1623,247,891,53.9,8.4,0,21.2,3.2,11.6,46.1,2659,2061,598,77.51,22.49,138,1923,143,455,281,2378,6.7,23.9,10.6,"25% - 50% P.O.C.","$86000 or more"
"48157674200","Census Tract 6742, Fort Bend County, Texas",5256,220694,2878,152,0,1832,0,368,54.8,2.9,0,34.9,0,7,45.2,1782,1663,119,93.32,6.68,154,1509,0,119,154,1628,9.3,0,8.6,"25% - 50% P.O.C.","$86000 or more"
"48157674300","Census Tract 6743, Fort Bend County, Texas",9551,130341,3346,1156,0,4098,0,781,35,12.1,0,42.9,0,8.2,65,2801,2474,327,88.33,11.67,300,2174,134,193,434,2367,12.1,41,15.5,"50% - 75% P.O.C.","$86000 or more"
"48157674400","Census Tract 6744, Fort Bend County, Texas",21369,174787,4831,1284,0,13075,0,1545,22.6,6,0,61.2,0,7.2,77.4,6130,5395,735,88.01,11.99,849,4546,0,735,849,5281,15.7,0,13.8,"75% or more P.O.C.","$86000 or more"
"48157674501","Census Tract 6745.01, Fort Bend County, Texas",13281,116548,3697,3000,0,4098,27,1852,27.8,22.6,0,30.9,0.2,13.9,72.2,4188,2987,1201,71.32,28.68,606,2381,101,1100,707,3481,20.3,8.4,16.9,"50% - 75% P.O.C.","$86000 or more"
"48157674502","Census Tract 6745.02, Fort Bend County, Texas",23361,133873,10339,5832,136,1451,0,5046,44.3,25,0.6,6.2,0,21.6,55.7,6467,5860,607,90.61,9.39,1186,4674,242,365,1428,5039,20.2,39.9,22.1,"50% - 75% P.O.C.","$86000 or more"
"48157674601","Census Tract 6746.01, Fort Bend County, Texas",3737,141927,2766,483,0,137,0,316,74,12.9,0,3.7,0,8.5,26,1409,1285,124,91.2,8.8,133,1152,0,124,133,1276,10.4,0,9.4,"25% - 50% P.O.C.","$86000 or more"
"48157674602","Census Tract 6746.02, Fort Bend County, Texas",8865,146813,5614,977,0,812,0,1376,63.3,11,0,9.2,0,15.5,36.7,2749,2493,256,90.69,9.31,436,2057,4,252,440,2309,17.5,1.6,16,"25% - 50% P.O.C.","$86000 or more"
"48157674603","Census Tract 6746.03, Fort Bend County, Texas",5798,81250,2989,483,0,194,0,2044,51.6,8.3,0,3.3,0,35.3,48.4,1982,1505,477,75.93,24.07,149,1356,67,410,216,1766,9.9,14,10.9,"25% - 50% P.O.C.","$59000 - $86000"
"48157674604","Census Tract 6746.04, Fort Bend County, Texas",5021,141756,1133,2021,0,1150,0,668,22.6,40.3,0,22.9,0,13.3,77.4,1393,1281,112,91.96,8.04,232,1049,35,77,267,1126,18.1,31.2,19.2,"75% or more P.O.C.","$86000 or more"
"48157674700","Census Tract 6747, Fort Bend County, Texas",15585,92338,5780,2757,51,3341,0,3225,37.1,17.7,0.3,21.4,0,20.7,62.9,5239,3891,1348,74.27,25.73,703,3188,49,1299,752,4487,18.1,3.6,14.4,"50% - 75% P.O.C.","$86000 or more"
"48157674800","Census Tract 6748, Fort Bend County, Texas",5629,37057,1229,1182,0,40,0,3178,21.8,21,0,0.7,0,56.5,78.2,2046,618,1428,30.21,69.79,78,540,184,1244,262,1784,12.6,12.9,12.8,"75% or more P.O.C.","Less than $44000"
"48157674900","Census Tract 6749, Fort Bend County, Texas",6203,36727,648,877,0,26,12,4606,10.4,14.1,0,0.4,0.2,74.3,89.6,1634,705,929,43.15,56.85,237,468,138,791,375,1259,33.6,14.9,22.9,"75% or more P.O.C.","Less than $44000"
"48157675000","Census Tract 6750, Fort Bend County, Texas",3207,31583,308,506,0,19,0,2374,9.6,15.8,0,0.6,0,74,90.4,960,417,543,43.44,56.56,96,321,103,440,199,761,23,19,20.7,"75% or more P.O.C.","Less than $44000"
"48157675100","Census Tract 6751, Fort Bend County, Texas",11143,52583,3229,1571,0,395,0,5685,29,14.1,0,3.5,0,51,71,3936,2052,1884,52.13,47.87,224,1828,391,1493,615,3321,10.9,20.8,15.6,"50% - 75% P.O.C.","$44000 - $59000"
"48157675200","Census Tract 6752, Fort Bend County, Texas",5762,47206,986,255,0,0,0,4487,17.1,4.4,0,0,0,77.9,82.9,1866,808,1058,43.3,56.7,132,676,259,799,391,1475,16.3,24.5,21,"75% or more P.O.C.","$44000 - $59000"
"48157675300","Census Tract 6753, Fort Bend County, Texas",6949,46659,1140,594,58,3,0,5154,16.4,8.5,0.8,0,0,74.2,83.6,2204,1039,1165,47.14,52.86,180,859,257,908,437,1767,17.3,22.1,19.8,"75% or more P.O.C.","$44000 - $59000"
"48157675400","Census Tract 6754, Fort Bend County, Texas",9186,59019,2754,802,0,189,7,5355,30,8.7,0,2.1,0.1,58.3,70,2719,2047,672,75.29,24.71,398,1649,210,462,608,2111,19.4,31.2,22.4,"50% - 75% P.O.C.","$59000 - $86000"
"48157675500","Census Tract 6755, Fort Bend County, Texas",22116,85215,8351,4126,0,2800,0,6065,37.8,18.7,0,12.7,0,27.4,62.2,6963,5853,1110,84.06,15.94,1225,4628,30,1080,1255,5708,20.9,2.7,18,"50% - 75% P.O.C.","$59000 - $86000"
"48157675600","Census Tract 6756, Fort Bend County, Texas",7111,84327,4467,16,0,159,0,2307,62.8,0.2,0,2.2,0,32.4,37.2,2331,2117,214,90.82,9.18,326,1791,24,190,350,1981,15.4,11.2,15,"25% - 50% P.O.C.","$59000 - $86000"
"48157675700","Census Tract 6757, Fort Bend County, Texas",6586,63291,3371,450,17,42,0,2647,51.2,6.8,0.3,0.6,0,40.2,48.8,2308,1628,680,70.54,29.46,201,1427,124,556,325,1983,12.3,18.2,14.1,"25% - 50% P.O.C.","$59000 - $86000"
"48157675800","Census Tract 6758, Fort Bend County, Texas",3316,47368,1191,788,3,13,0,1316,35.9,23.8,0.1,0.4,0,39.7,64.1,1160,637,523,54.91,45.09,45,592,69,454,114,1046,7.1,13.2,9.8,"50% - 75% P.O.C.","$44000 - $59000"
"48167720100","Census Tract 7201, Galveston County, Texas",5372,99861,4013,87,0,326,0,885,74.7,1.6,0,6.1,0,16.5,25.3,1944,1718,226,88.37,11.63,163,1555,13,213,176,1768,9.5,5.8,9.1,"25% - 50% P.O.C.","$86000 or more"
"48167720200","Census Tract 7202, Galveston County, Texas",4597,114196,3562,44,24,240,0,633,77.5,1,0.5,5.2,0,13.8,22.5,1737,1284,453,73.92,26.08,136,1148,14,439,150,1587,10.6,3.1,8.6,"Less than 25% P.O.C.","$86000 or more"
"48167720301","Census Tract 7203.01, Galveston County, Texas",2240,107283,1675,27,0,81,0,434,74.8,1.2,0,3.6,0,19.4,25.2,788,625,163,79.31,20.69,35,590,19,144,54,734,5.6,11.7,6.9,"25% - 50% P.O.C.","$86000 or more"
"48167720302","Census Tract 7203.02, Galveston County, Texas",7227,131827,5104,267,25,407,0,1226,70.6,3.7,0.3,5.6,0,17,29.4,2173,1866,307,85.87,14.13,334,1532,68,239,402,1771,17.9,22.1,18.5,"25% - 50% P.O.C.","$86000 or more"
"48167720400","Census Tract 7204, Galveston County, Texas",8815,194934,6595,313,0,964,0,848,74.8,3.6,0,10.9,0,9.6,25.2,2622,2583,39,98.51,1.49,395,2188,0,39,395,2227,15.3,0,15.1,"25% - 50% P.O.C.","$86000 or more"
"48167720501","Census Tract 7205.01, Galveston County, Texas",4611,104180,3198,222,15,178,0,859,69.4,4.8,0.3,3.9,0,18.6,30.6,1431,1255,176,87.7,12.3,198,1057,9,167,207,1224,15.8,5.1,14.5,"25% - 50% P.O.C.","$86000 or more"
"48167720502","Census Tract 7205.02, Galveston County, Texas",11370,109341,7748,434,23,510,0,2347,68.1,3.8,0.2,4.5,0,20.6,31.9,3629,3151,478,86.83,13.17,470,2681,34,444,504,3125,14.9,7.1,13.9,"25% - 50% P.O.C.","$86000 or more"
"48167720503","Census Tract 7205.03, Galveston County, Texas",16616,124579,10636,1693,0,1025,0,2690,64,10.2,0,6.2,0,16.2,36,5255,4828,427,91.87,8.13,705,4123,41,386,746,4509,14.6,9.6,14.2,"25% - 50% P.O.C.","$86000 or more"
"48167720600","Census Tract 7206, Galveston County, Texas",14555,112172,9224,1332,0,663,0,2708,63.4,9.2,0,4.6,0,18.6,36.6,5573,4743,830,85.11,14.89,464,4279,0,830,464,5109,9.8,0,8.3,"25% - 50% P.O.C.","$86000 or more"
"48167720700","Census Tract 7207, Galveston County, Texas",11993,106694,6527,1046,2,1264,0,3014,54.4,8.7,0,10.5,0,25.1,45.6,4140,2633,1507,63.6,36.4,382,2251,32,1475,414,3726,14.5,2.1,10,"25% - 50% P.O.C.","$86000 or more"
"48167720800","Census Tract 7208, Galveston County, Texas",3852,84806,2052,785,0,112,0,903,53.3,20.4,0,2.9,0,23.4,46.7,1477,1191,286,80.64,19.36,162,1029,70,216,232,1245,13.6,24.5,15.7,"25% - 50% P.O.C.","$59000 - $86000"
"48167720900","Census Tract 7209, Galveston County, Texas",5173,49236,3079,337,0,0,9,1574,59.5,6.5,0,0,0.2,30.4,40.5,1942,1385,557,71.32,28.68,160,1225,24,533,184,1758,11.6,4.3,9.5,"25% - 50% P.O.C.","$44000 - $59000"
"48167721000","Census Tract 7210, Galveston County, Texas",2212,71875,1465,0,118,31,0,570,66.2,0,5.3,1.4,0,25.8,33.8,806,644,162,79.9,20.1,86,558,34,128,120,686,13.4,21,14.9,"25% - 50% P.O.C.","$59000 - $86000"
"48167721100","Census Tract 7211, Galveston County, Texas",12618,59818,4836,945,19,246,0,6485,38.3,7.5,0.2,1.9,0,51.4,61.7,4218,2676,1542,63.44,36.56,461,2215,195,1347,656,3562,17.2,12.6,15.6,"50% - 75% P.O.C.","$59000 - $86000"
"48167721201","Census Tract 7212.01, Galveston County, Texas",22489,107276,14688,2663,86,424,0,4219,65.3,11.8,0.4,1.9,0,18.8,34.7,7915,5192,2723,65.6,34.4,572,4620,157,2566,729,7186,11,5.8,9.2,"25% - 50% P.O.C.","$86000 or more"
"48167721202","Census Tract 7212.02, Galveston County, Texas",7818,129461,4914,684,0,593,0,1530,62.9,8.7,0,7.6,0,19.6,37.1,2460,2205,255,89.63,10.37,294,1911,95,160,389,2071,13.3,37.3,15.8,"25% - 50% P.O.C.","$86000 or more"
"48167721300","Census Tract 7213, Galveston County, Texas",4910,67972,3573,19,105,213,0,933,72.8,0.4,2.1,4.3,0,19,27.2,2001,1474,527,73.66,26.34,115,1359,17,510,132,1869,7.8,3.2,6.6,"25% - 50% P.O.C.","$59000 - $86000"
"48167721400","Census Tract 7214, Galveston County, Texas",8109,103218,5877,206,43,452,0,1241,72.5,2.5,0.5,5.6,0,15.3,27.5,3259,2097,1162,64.34,35.66,104,1993,28,1134,132,3127,5,2.4,4.1,"25% - 50% P.O.C.","$86000 or more"
"48167721500","Census Tract 7215, Galveston County, Texas",7688,89368,5614,541,0,133,0,1252,73,7,0,1.7,0,16.3,27,3553,2022,1531,56.91,43.09,103,1919,79,1452,182,3371,5.1,5.2,5.1,"25% - 50% P.O.C.","$86000 or more"
"48167721600","Census Tract 7216, Galveston County, Texas",2419,62917,1431,0,0,7,0,974,59.2,0,0,0.3,0,40.3,40.8,825,501,324,60.73,39.27,102,399,25,299,127,698,20.4,7.7,15.4,"25% - 50% P.O.C.","$59000 - $86000"
"48167721700","Census Tract 7217, Galveston County, Texas",9993,47390,4977,268,0,266,0,4279,49.8,2.7,0,2.7,0,42.8,50.2,3289,2090,1199,63.55,36.45,337,1753,210,989,547,2742,16.1,17.5,16.6,"50% - 75% P.O.C.","$44000 - $59000"
"48167721800","Census Tract 7218, Galveston County, Texas",4795,39243,2767,11,0,274,0,1669,57.7,0.2,0,5.7,0,34.8,42.3,1851,1335,516,72.12,27.88,80,1255,76,440,156,1695,6,14.7,8.4,"25% - 50% P.O.C.","Less than $44000"
"48167721900","Census Tract 7219, Galveston County, Texas",11251,46531,4343,2641,0,218,47,3610,38.6,23.5,0,1.9,0.4,32.1,61.4,3890,1560,2330,40.1,59.9,227,1333,275,2055,502,3388,14.6,11.8,12.9,"50% - 75% P.O.C.","$44000 - $59000"
"48167722001","Census Tract 7220.01, Galveston County, Texas",5290,80357,2869,507,0,61,0,1740,54.2,9.6,0,1.2,0,32.9,45.8,2070,1790,280,86.47,13.53,13,1777,0,280,13,2057,0.7,0,0.6,"25% - 50% P.O.C.","$59000 - $86000"
"48167722002","Census Tract 7220.02, Galveston County, Texas",3246,54063,1567,571,64,0,0,1022,48.3,17.6,2,0,0,31.5,51.7,1354,719,635,53.1,46.9,31,688,27,608,58,1296,4.3,4.3,4.3,"50% - 75% P.O.C.","$44000 - $59000"
"48167722100","Census Tract 7221, Galveston County, Texas",6967,56719,3765,913,0,26,0,2234,54,13.1,0,0.4,0,32.1,46,2431,1890,541,77.75,22.25,232,1658,83,458,315,2116,12.3,15.3,13,"25% - 50% P.O.C.","$44000 - $59000"
"48167722200","Census Tract 7222, Galveston County, Texas",3127,30578,980,1262,0,0,3,840,31.3,40.4,0,0,0.1,26.9,68.7,1197,372,825,31.08,68.92,73,299,61,764,134,1063,19.6,7.4,11.2,"50% - 75% P.O.C.","Less than $44000"
"48167722300","Census Tract 7223, Galveston County, Texas",7258,41188,2394,1775,0,0,45,2276,33,24.5,0,0,0.6,31.4,67,2067,1213,854,58.68,41.32,249,964,259,595,508,1559,20.5,30.3,24.6,"50% - 75% P.O.C.","Less than $44000"
"48167722600","Census Tract 7226, Galveston County, Texas",2583,45700,573,1316,0,0,0,640,22.2,50.9,0,0,0,24.8,77.8,926,365,561,39.42,60.58,46,319,40,521,86,840,12.6,7.1,9.3,"75% or more P.O.C.","$44000 - $59000"
"48167722700","Census Tract 7227, Galveston County, Texas",4984,46136,459,3634,26,85,0,508,9.2,72.9,0.5,1.7,0,10.2,90.8,1796,1117,679,62.19,37.81,27,1090,67,612,94,1702,2.4,9.9,5.2,"75% or more P.O.C.","$44000 - $59000"
"48167722800","Census Tract 7228, Galveston County, Texas",2547,39063,729,820,0,29,0,949,28.6,32.2,0,1.1,0,37.3,71.4,881,486,395,55.16,44.84,53,433,84,311,137,744,10.9,21.3,15.6,"50% - 75% P.O.C.","Less than $44000"
"48167722900","Census Tract 7229, Galveston County, Texas",2630,41979,852,555,0,9,0,1207,32.4,21.1,0,0.3,0,45.9,67.6,1045,819,226,78.37,21.63,86,733,20,206,106,939,10.5,8.8,10.1,"50% - 75% P.O.C.","Less than $44000"
"48167723000","Census Tract 7230, Galveston County, Texas",3183,36475,588,1785,0,0,0,779,18.5,56.1,0,0,0,24.5,81.5,1375,904,471,65.75,34.25,83,821,19,452,102,1273,9.2,4,7.4,"75% or more P.O.C.","Less than $44000"
"48167723100","Census Tract 7231, Galveston County, Texas",3324,42247,1360,1187,0,24,0,712,40.9,35.7,0,0.7,0,21.4,59.1,1461,556,905,38.06,61.94,35,521,0,905,35,1426,6.3,0,2.4,"50% - 75% P.O.C.","Less than $44000"
"48167723200","Census Tract 7232, Galveston County, Texas",5060,81283,2239,809,0,177,0,1747,44.2,16,0,3.5,0,34.5,55.8,1683,1319,364,78.37,21.63,166,1153,31,333,197,1486,12.6,8.5,11.7,"50% - 75% P.O.C.","$59000 - $86000"
"48167723300","Census Tract 7233, Galveston County, Texas",7126,81042,4832,474,0,253,0,1406,67.8,6.7,0,3.6,0,19.7,32.2,2384,1877,507,78.73,21.27,229,1648,52,455,281,2103,12.2,10.3,11.8,"25% - 50% P.O.C.","$59000 - $86000"
"48167723400","Census Tract 7234, Galveston County, Texas",7092,77697,6200,0,0,0,0,839,87.4,0,0,0,0,11.8,12.6,2536,1868,668,73.66,26.34,218,1650,140,528,358,2178,11.7,21,14.1,"Less than 25% P.O.C.","$59000 - $86000"
"48167723501","Census Tract 7235.01, Galveston County, Texas",1226,76125,1001,72,0,0,0,153,81.6,5.9,0,0,0,12.5,18.4,423,352,71,83.22,16.78,46,306,6,65,52,371,13.1,8.5,12.3,"Less than 25% P.O.C.","$59000 - $86000"
"48167723502","Census Tract 7235.02, Galveston County, Texas",8903,75104,7590,0,22,0,0,1038,85.3,0,0.2,0,0,11.7,14.7,3214,2835,379,88.21,11.79,236,2599,31,348,267,2947,8.3,8.2,8.3,"Less than 25% P.O.C.","$59000 - $86000"
"48167723600","Census Tract 7236, Galveston County, Texas",4628,77485,2977,592,0,0,0,1026,64.3,12.8,0,0,0,22.2,35.7,1717,1470,247,85.61,14.39,181,1289,0,247,181,1536,12.3,0,10.5,"25% - 50% P.O.C.","$59000 - $86000"
"48167723700","Census Tract 7237, Galveston County, Texas",2467,30663,712,1200,27,0,0,521,28.9,48.6,1.1,0,0,21.1,71.1,962,438,524,45.53,54.47,27,411,63,461,90,872,6.2,12,9.4,"50% - 75% P.O.C.","Less than $44000"
"48167723800","Census Tract 7238, Galveston County, Texas",4277,96314,3418,278,9,25,0,542,79.9,6.5,0.2,0.6,0,12.7,20.1,2027,1696,331,83.67,16.33,58,1638,2,329,60,1967,3.4,0.6,3,"Less than 25% P.O.C.","$86000 or more"
"48167723900","Census Tract 7239, Galveston County, Texas",2549,52804,1932,11,5,0,0,601,75.8,0.4,0.2,0,0,23.6,24.2,1027,755,272,73.52,26.48,49,706,29,243,78,949,6.5,10.7,7.6,"Less than 25% P.O.C.","$44000 - $59000"
"48167724000","Census Tract 7240, Galveston County, Texas",3428,35057,1599,792,0,91,0,911,46.6,23.1,0,2.7,0,26.6,53.4,213,81,132,38.03,61.97,11,70,0,132,11,202,13.6,0,5.2,"50% - 75% P.O.C.","Less than $44000"
"48167724101","Census Tract 7241.01, Galveston County, Texas",1023,44583,705,148,14,0,0,127,68.9,14.5,1.4,0,0,12.4,31.1,585,271,314,46.32,53.68,0,271,5,309,5,580,0,1.6,0.9,"25% - 50% P.O.C.","$44000 - $59000"
"48167724200","Census Tract 7242, Galveston County, Texas",2762,38906,1239,549,0,471,0,468,44.9,19.9,0,17.1,0,16.9,55.1,1285,398,887,30.97,69.03,14,384,0,887,14,1271,3.5,0,1.1,"50% - 75% P.O.C.","Less than $44000"
"48167724300","Census Tract 7243, Galveston County, Texas",3043,42708,1881,370,16,252,0,457,61.8,12.2,0.5,8.3,0,15,38.2,1371,498,873,36.32,63.68,53,445,25,848,78,1293,10.6,2.9,5.7,"25% - 50% P.O.C.","Less than $44000"
"48167724400","Census Tract 7244, Galveston County, Texas",3051,48750,1539,447,0,17,0,1017,50.4,14.7,0,0.6,0,33.3,49.6,1463,765,698,52.29,47.71,76,689,22,676,98,1365,9.9,3.2,6.7,"25% - 50% P.O.C.","$44000 - $59000"
"48167724500","Census Tract 7245, Galveston County, Texas",904,42619,539,150,2,16,0,181,59.6,16.6,0.2,1.8,0,20,40.4,532,113,419,21.24,78.76,0,113,8,411,8,524,0,1.9,1.5,"25% - 50% P.O.C.","Less than $44000"
"48167724600","Census Tract 7246, Galveston County, Texas",1926,20862,634,865,0,16,0,406,32.9,44.9,0,0.8,0,21.1,67.1,720,245,475,34.03,65.97,52,193,70,405,122,598,21.2,14.7,16.9,"50% - 75% P.O.C.","Less than $44000"
"48167724700","Census Tract 7247, Galveston County, Texas",1772,28203,445,760,7,7,0,444,25.1,42.9,0.4,0.4,0,25.1,74.9,707,283,424,40.03,59.97,33,250,53,371,86,621,11.7,12.5,12.2,"50% - 75% P.O.C.","Less than $44000"
"48167724800","Census Tract 7248, Galveston County, Texas",1308,44632,552,287,4,2,0,408,42.2,21.9,0.3,0.2,0,31.2,57.8,585,313,272,53.5,46.5,19,294,17,255,36,549,6.1,6.2,6.2,"50% - 75% P.O.C.","$44000 - $59000"
"48167724900","Census Tract 7249, Galveston County, Texas",1653,50216,885,110,0,24,0,613,53.5,6.7,0,1.5,0,37.1,46.5,683,388,295,56.81,43.19,16,372,26,269,42,641,4.1,8.8,6.1,"25% - 50% P.O.C.","$44000 - $59000"
"48167725000","Census Tract 7250, Galveston County, Texas",1796,45221,757,226,0,14,0,758,42.1,12.6,0,0.8,0,42.2,57.9,819,369,450,45.05,54.95,18,351,34,416,52,767,4.9,7.6,6.3,"50% - 75% P.O.C.","$44000 - $59000"
"48167725100","Census Tract 7251, Galveston County, Texas",2073,43567,438,833,0,0,0,756,21.1,40.2,0,0,0,36.5,78.9,753,357,396,47.41,52.59,11,346,69,327,80,673,3.1,17.4,10.6,"75% or more P.O.C.","Less than $44000"
"48167725200","Census Tract 7252, Galveston County, Texas",2149,28412,308,436,0,6,0,1355,14.3,20.3,0,0.3,0,63.1,85.7,795,239,556,30.06,69.94,14,225,85,471,99,696,5.9,15.3,12.5,"75% or more P.O.C.","Less than $44000"
"48167725300","Census Tract 7253, Galveston County, Texas",2110,55167,1229,165,0,0,0,632,58.2,7.8,0,0,0,30,41.8,814,572,242,70.27,29.73,21,551,17,225,38,776,3.7,7,4.7,"25% - 50% P.O.C.","$44000 - $59000"
"48167725400","Census Tract 7254, Galveston County, Texas",3796,41448,1456,302,37,9,0,1976,38.4,8,1,0.2,0,52.1,61.6,1537,818,719,53.22,46.78,77,741,94,625,171,1366,9.4,13.1,11.1,"50% - 75% P.O.C.","Less than $44000"
"48167725500","Census Tract 7255, Galveston County, Texas",1034,78700,809,63,0,25,0,123,78.2,6.1,0,2.4,0,11.9,21.8,504,382,122,75.79,24.21,0,382,21,101,21,483,0,17.2,4.2,"Less than 25% P.O.C.","$59000 - $86000"
"48167725600","Census Tract 7256, Galveston County, Texas",4649,46678,2166,624,89,95,0,1545,46.6,13.4,1.9,2,0,33.2,53.4,2207,323,1884,14.64,85.36,0,323,68,1816,68,2139,0,3.6,3.1,"50% - 75% P.O.C.","$44000 - $59000"
"48167725700","Census Tract 7257, Galveston County, Texas",2210,100897,1543,82,0,107,0,469,69.8,3.7,0,4.8,0,21.2,30.2,908,757,151,83.37,16.63,24,733,8,143,32,876,3.2,5.3,3.5,"25% - 50% P.O.C.","$86000 or more"
"48167725800","Census Tract 7258, Galveston County, Texas",4236,48833,1519,1043,0,125,0,1508,35.9,24.6,0,3,0,35.6,64.1,1674,505,1169,30.17,69.83,78,427,53,1116,131,1543,15.4,4.5,7.8,"50% - 75% P.O.C.","$44000 - $59000"
"48167725900","Census Tract 7259, Galveston County, Texas",2491,53516,1674,27,0,106,0,665,67.2,1.1,0,4.3,0,26.7,32.8,1351,266,1085,19.69,80.31,16,250,44,1041,60,1291,6,4.1,4.4,"25% - 50% P.O.C.","$44000 - $59000"
"48167726000","Census Tract 7260, Galveston County, Texas",1339,72228,1004,13,0,11,0,297,75,1,0,0.8,0,22.2,25,565,511,54,90.44,9.56,23,488,0,54,23,542,4.5,0,4.1,"25% - 50% P.O.C.","$59000 - $86000"
"48167726100","Census Tract 7261, Galveston County, Texas",2605,79839,2419,0,0,46,0,140,92.9,0,0,1.8,0,5.4,7.1,1236,1096,140,88.67,11.33,38,1058,10,130,48,1188,3.5,7.1,3.9,"Less than 25% P.O.C.","$59000 - $86000"
"48167726200","Census Tract 7262, Galveston County, Texas",2337,47417,673,487,3,84,6,1084,28.8,20.8,0.1,3.6,0.3,46.4,71.2,777,546,231,70.27,29.73,36,510,75,156,111,666,6.6,32.5,14.3,"50% - 75% P.O.C.","$44000 - $59000"
"48167990000","Census Tract 9900, Galveston County, Texas",0,NA,0,0,0,0,0,0,NA,NA,NA,NA,NA,NA,NA,0,0,0,NA,NA,0,0,0,0,0,0,NA,NA,NA,"N/A","N/A"
"48185180101","Census Tract 1801.01, Grimes County, Texas",5569,48854,1643,1414,0,14,0,2458,29.5,25.4,0,0.3,0,44.1,70.5,1575,999,576,63.43,36.57,169,830,49,527,218,1357,16.9,8.5,13.8,"50% - 75% P.O.C.","$44000 - $59000"
"48185180102","Census Tract 1801.02, Grimes County, Texas",4380,43882,3256,121,26,8,0,907,74.3,2.8,0.6,0.2,0,20.7,25.7,1717,1380,337,80.37,19.63,140,1240,51,286,191,1526,10.1,15.1,11.1,"25% - 50% P.O.C.","Less than $44000"
"48185180200","Census Tract 1802, Grimes County, Texas",7375,56199,4219,1310,0,0,0,1662,57.2,17.8,0,0,0,22.5,42.8,2479,1858,621,74.95,25.05,279,1579,171,450,450,2029,15,27.5,18.2,"25% - 50% P.O.C.","$44000 - $59000"
"48185180301","Census Tract 1803.01, Grimes County, Texas",4997,63301,4057,385,6,6,0,450,81.2,7.7,0.1,0.1,0,9,18.8,1921,1673,248,87.09,12.91,95,1578,35,213,130,1791,5.7,14.1,6.8,"Less than 25% P.O.C.","$59000 - $86000"
"48185180302","Census Tract 1803.02, Grimes County, Texas",3371,43454,2351,208,31,0,0,637,69.7,6.2,0.9,0,0,18.9,30.3,1259,967,292,76.81,23.19,67,900,53,239,120,1139,6.9,18.2,9.5,"25% - 50% P.O.C.","Less than $44000"
"48185180400","Census Tract 1804, Grimes County, Texas",2292,NA,845,726,8,27,0,647,36.9,31.7,0.3,1.2,0,28.2,63.1,60,15,45,25,75,0,15,5,40,5,55,0,11.1,8.3,"50% - 75% P.O.C.","N/A"
"48201100000","Census Tract 1000, Harris County, Texas",6011,89239,3152,1264,0,452,0,980,52.4,21,0,7.5,0,16.3,47.6,3124,434,2690,13.89,86.11,0,434,17,2673,17,3107,0,0.6,0.5,"25% - 50% P.O.C.","$86000 or more"
"48201210100","Census Tract 2101, Harris County, Texas",7363,NA,1282,4043,0,8,0,1962,17.4,54.9,0,0.1,0,26.6,82.6,46,4,42,8.7,91.3,0,4,0,42,0,46,0,0,0,"75% or more P.O.C.","N/A"
"48201210400","Census Tract 2104, Harris County, Texas",4422,36217,318,784,0,0,0,3236,7.2,17.7,0,0,0,73.2,92.8,1563,648,915,41.46,58.54,85,563,84,831,169,1394,13.1,9.2,10.8,"75% or more P.O.C.","Less than $44000"
"48201210500","Census Tract 2105, Harris County, Texas",5548,37323,225,585,0,0,66,4619,4.1,10.5,0,0,1.2,83.3,95.9,1784,720,1064,40.36,59.64,87,633,114,950,201,1583,12.1,10.7,11.3,"75% or more P.O.C.","Less than $44000"
"48201210600","Census Tract 2106, Harris County, Texas",5327,57750,904,89,0,0,0,4303,17,1.7,0,0,0,80.8,83,2103,1492,611,70.95,29.05,144,1348,18,593,162,1941,9.7,2.9,7.7,"75% or more P.O.C.","$44000 - $59000"
"48201210700","Census Tract 2107, Harris County, Texas",2459,39047,115,335,0,8,0,2001,4.7,13.6,0,0.3,0,81.4,95.3,749,446,303,59.55,40.45,65,381,64,239,129,620,14.6,21.1,17.2,"75% or more P.O.C.","Less than $44000"
"48201210800","Census Tract 2108, Harris County, Texas",2466,32639,132,792,0,0,0,1542,5.4,32.1,0,0,0,62.5,94.6,847,337,510,39.79,60.21,70,267,75,435,145,702,20.8,14.7,17.1,"75% or more P.O.C.","Less than $44000"
"48201210900","Census Tract 2109, Harris County, Texas",1320,33548,47,911,0,0,36,313,3.6,69,0,0,2.7,23.7,96.4,564,312,252,55.32,44.68,18,294,3,249,21,543,5.8,1.2,3.7,"75% or more P.O.C.","Less than $44000"
"48201211000","Census Tract 2110, Harris County, Texas",1989,36736,16,1058,0,26,0,877,0.8,53.2,0,1.3,0,44.1,99.2,707,350,357,49.5,50.5,73,277,48,309,121,586,20.9,13.4,17.1,"75% or more P.O.C.","Less than $44000"
"48201211100","Census Tract 2111, Harris County, Texas",5322,26166,107,2048,0,42,0,3125,2,38.5,0,0.8,0,58.7,98,1903,659,1244,34.63,65.37,30,629,201,1043,231,1672,4.6,16.2,12.1,"75% or more P.O.C.","Less than $44000"
"48201211200","Census Tract 2112, Harris County, Texas",2211,21143,2,1511,0,0,0,643,0.1,68.3,0,0,0,29.1,99.9,1012,382,630,37.75,62.25,11,371,36,594,47,965,2.9,5.7,4.6,"75% or more P.O.C.","Less than $44000"
"48201211300","Census Tract 2113, Harris County, Texas",5319,27014,106,3106,0,0,0,2040,2,58.4,0,0,0,38.4,98,2105,656,1449,31.16,68.84,148,508,108,1341,256,1849,22.6,7.5,12.2,"75% or more P.O.C.","Less than $44000"
"48201211400","Census Tract 2114, Harris County, Texas",3890,30368,365,1747,0,41,0,1676,9.4,44.9,0,1.1,0,43.1,90.6,1453,456,997,31.38,68.62,94,362,89,908,183,1270,20.6,8.9,12.6,"75% or more P.O.C.","Less than $44000"
"48201211500","Census Tract 2115, Harris County, Texas",6547,32285,184,199,0,0,0,6164,2.8,3,0,0,0,94.1,97.2,1905,954,951,50.08,49.92,192,762,224,727,416,1489,20.1,23.6,21.8,"75% or more P.O.C.","Less than $44000"
"48201211600","Census Tract 2116, Harris County, Texas",3068,31809,141,610,0,0,0,2298,4.6,19.9,0,0,0,74.9,95.4,1160,487,673,41.98,58.02,25,462,133,540,158,1002,5.1,19.8,13.6,"75% or more P.O.C.","Less than $44000"
"48201211700","Census Tract 2117, Harris County, Texas",4142,31367,121,2099,0,120,0,1799,2.9,50.7,0,2.9,0,43.4,97.1,1458,595,863,40.81,59.19,182,413,53,810,235,1223,30.6,6.1,16.1,"75% or more P.O.C.","Less than $44000"
"48201211900","Census Tract 2119, Harris County, Texas",5398,35487,88,6,35,0,0,5269,1.6,0.1,0.6,0,0,97.6,98.4,1446,869,577,60.1,39.9,121,748,267,310,388,1058,13.9,46.3,26.8,"75% or more P.O.C.","Less than $44000"
"48201212300","Census Tract 2123, Harris County, Texas",4387,25392,367,169,0,7,0,3803,8.4,3.9,0,0.2,0,86.7,91.6,1598,748,850,46.81,53.19,74,674,100,750,174,1424,9.9,11.8,10.9,"75% or more P.O.C.","Less than $44000"
"48201212400","Census Tract 2124, Harris County, Texas",3037,38194,111,142,7,0,0,2777,3.7,4.7,0.2,0,0,91.4,96.3,909,617,292,67.88,32.12,131,486,74,218,205,704,21.2,25.3,22.6,"75% or more P.O.C.","Less than $44000"
"48201212500","Census Tract 2125, Harris County, Texas",4005,40735,177,2099,0,0,0,1693,4.4,52.4,0,0,0,42.3,95.6,1348,734,614,54.45,45.55,83,651,165,449,248,1100,11.3,26.9,18.4,"75% or more P.O.C.","Less than $44000"
"48201220100","Census Tract 2201, Harris County, Texas",2117,32310,8,1001,0,0,0,1108,0.4,47.3,0,0,0,52.3,99.6,677,355,322,52.44,47.56,59,296,57,265,116,561,16.6,17.7,17.1,"75% or more P.O.C.","Less than $44000"
"48201220200","Census Tract 2202, Harris County, Texas",2646,41750,190,76,0,0,0,2380,7.2,2.9,0,0,0,89.9,92.8,862,485,377,56.26,43.74,92,393,83,294,175,687,19,22,20.3,"75% or more P.O.C.","Less than $44000"
"48201220300","Census Tract 2203, Harris County, Texas",4437,47035,279,64,0,66,0,4028,6.3,1.4,0,1.5,0,90.8,93.7,1237,588,649,47.53,52.47,135,453,187,462,322,915,23,28.8,26,"75% or more P.O.C.","$44000 - $59000"
"48201220400","Census Tract 2204, Harris County, Texas",4253,36530,211,245,13,0,0,3761,5,5.8,0.3,0,0,88.4,95,1267,614,653,48.46,51.54,105,509,129,524,234,1033,17.1,19.8,18.5,"75% or more P.O.C.","Less than $44000"
"48201220500","Census Tract 2205, Harris County, Texas",3377,15906,311,571,21,82,0,2384,9.2,16.9,0.6,2.4,0,70.6,90.8,1742,328,1414,18.83,81.17,26,302,101,1313,127,1615,7.9,7.1,7.3,"75% or more P.O.C.","Less than $44000"
"48201220600","Census Tract 2206, Harris County, Texas",4083,38958,119,671,0,0,0,3293,2.9,16.4,0,0,0,80.7,97.1,1068,544,524,50.94,49.06,185,359,169,355,354,714,34,32.3,33.1,"75% or more P.O.C.","Less than $44000"
"48201220700","Census Tract 2207, Harris County, Texas",6419,25688,338,969,0,0,0,5112,5.3,15.1,0,0,0,79.6,94.7,1914,971,943,50.73,49.27,249,722,209,734,458,1456,25.6,22.2,23.9,"75% or more P.O.C.","Less than $44000"
"48201220800","Census Tract 2208, Harris County, Texas",4089,24894,73,1835,0,0,0,2181,1.8,44.9,0,0,0,53.3,98.2,1078,325,753,30.15,69.85,119,206,160,593,279,799,36.6,21.2,25.9,"75% or more P.O.C.","Less than $44000"
"48201220900","Census Tract 2209, Harris County, Texas",1755,39891,179,306,0,0,0,1252,10.2,17.4,0,0,0,71.3,89.8,492,224,268,45.53,54.47,62,162,43,225,105,387,27.7,16,21.3,"75% or more P.O.C.","Less than $44000"
"48201221000","Census Tract 2210, Harris County, Texas",4214,31464,339,386,0,0,0,3476,8,9.2,0,0,0,82.5,92,1105,573,532,51.86,48.14,159,414,194,338,353,752,27.7,36.5,31.9,"75% or more P.O.C.","Less than $44000"
"48201221100","Census Tract 2211, Harris County, Texas",3694,29175,300,26,0,0,0,3340,8.1,0.7,0,0,0,90.4,91.9,981,614,367,62.59,37.41,148,466,104,263,252,729,24.1,28.3,25.7,"75% or more P.O.C.","Less than $44000"
"48201221200","Census Tract 2212, Harris County, Texas",6473,43706,282,248,0,0,0,5943,4.4,3.8,0,0,0,91.8,95.6,1674,990,684,59.14,40.86,348,642,306,378,654,1020,35.2,44.7,39.1,"75% or more P.O.C.","Less than $44000"
"48201221300","Census Tract 2213, Harris County, Texas",9917,46532,329,68,0,118,0,9367,3.3,0.7,0,1.2,0,94.5,96.7,2521,1679,842,66.6,33.4,578,1101,146,696,724,1797,34.4,17.3,28.7,"75% or more P.O.C.","$44000 - $59000"
"48201221400","Census Tract 2214, Harris County, Texas",5991,34639,355,130,17,0,0,5489,5.9,2.2,0.3,0,0,91.6,94.1,1801,719,1082,39.92,60.08,208,511,245,837,453,1348,28.9,22.6,25.2,"75% or more P.O.C.","Less than $44000"
"48201221500","Census Tract 2215, Harris County, Texas",8398,30556,405,1123,0,51,0,6819,4.8,13.4,0,0.6,0,81.2,95.2,2701,821,1880,30.4,69.6,95,726,316,1564,411,2290,11.6,16.8,15.2,"75% or more P.O.C.","Less than $44000"
"48201221600","Census Tract 2216, Harris County, Texas",9403,49071,486,125,17,14,0,8761,5.2,1.3,0.2,0.1,0,93.2,94.8,2443,1848,595,75.64,24.36,440,1408,168,427,608,1835,23.8,28.2,24.9,"75% or more P.O.C.","$44000 - $59000"
"48201221700","Census Tract 2217, Harris County, Texas",7898,43096,377,0,0,0,0,7521,4.8,0,0,0,0,95.2,95.2,2277,1562,715,68.6,31.4,240,1322,209,506,449,1828,15.4,29.2,19.7,"75% or more P.O.C.","Less than $44000"
"48201221800","Census Tract 2218, Harris County, Texas",4091,30469,241,0,0,24,0,3826,5.9,0,0,0.6,0,93.5,94.1,1080,648,432,60,40,215,433,82,350,297,783,33.2,19,27.5,"75% or more P.O.C.","Less than $44000"
"48201221900","Census Tract 2219, Harris County, Texas",5151,43438,170,0,0,0,0,4980,3.3,0,0,0,0,96.7,96.7,1308,718,590,54.89,45.11,179,539,187,403,366,942,24.9,31.7,28,"75% or more P.O.C.","Less than $44000"
"48201222000","Census Tract 2220, Harris County, Texas",2327,37467,185,177,0,0,0,1950,8,7.6,0,0,0,83.8,92,560,392,168,70,30,87,305,77,91,164,396,22.2,45.8,29.3,"75% or more P.O.C.","Less than $44000"
"48201222100","Census Tract 2221, Harris County, Texas",5527,29983,306,5,0,0,0,5216,5.5,0.1,0,0,0,94.4,94.5,1407,936,471,66.52,33.48,366,570,155,316,521,886,39.1,32.9,37,"75% or more P.O.C.","Less than $44000"
"48201222200","Census Tract 2222, Harris County, Texas",3609,34917,307,213,0,9,0,2956,8.5,5.9,0,0.2,0,81.9,91.5,1007,515,492,51.14,48.86,126,389,112,380,238,769,24.5,22.8,23.6,"75% or more P.O.C.","Less than $44000"
"48201222300","Census Tract 2223, Harris County, Texas",5036,43281,222,43,0,42,0,4721,4.4,0.9,0,0.8,0,93.7,95.6,1219,820,399,67.27,32.73,248,572,165,234,413,806,30.2,41.4,33.9,"75% or more P.O.C.","Less than $44000"
"48201222401","Census Tract 2224.01, Harris County, Texas",3423,37266,228,4,5,36,0,3141,6.7,0.1,0.1,1.1,0,91.8,93.3,914,527,387,57.66,42.34,110,417,147,240,257,657,20.9,38,28.1,"75% or more P.O.C.","Less than $44000"
"48201222402","Census Tract 2224.02, Harris County, Texas",6061,47904,591,129,0,16,0,5325,9.8,2.1,0,0.3,0,87.9,90.2,1371,864,507,63.02,36.98,332,532,237,270,569,802,38.4,46.7,41.5,"75% or more P.O.C.","$44000 - $59000"
"48201222501","Census Tract 2225.01, Harris County, Texas",3834,25057,71,101,3,96,0,3558,1.9,2.6,0.1,2.5,0,92.8,98.1,1056,287,769,27.18,72.82,97,190,119,650,216,840,33.8,15.5,20.5,"75% or more P.O.C.","Less than $44000"
"48201222502","Census Tract 2225.02, Harris County, Texas",4041,48068,417,97,0,118,0,3409,10.3,2.4,0,2.9,0,84.4,89.7,1083,826,257,76.27,23.73,210,616,55,202,265,818,25.4,21.4,24.5,"75% or more P.O.C.","$44000 - $59000"
"48201222503","Census Tract 2225.03, Harris County, Texas",7729,32813,254,381,0,37,0,7016,3.3,4.9,0,0.5,0,90.8,96.7,1934,673,1261,34.8,65.2,298,375,389,872,687,1247,44.3,30.8,35.5,"75% or more P.O.C.","Less than $44000"
"48201222600","Census Tract 2226, Harris County, Texas",5062,26790,108,893,0,187,0,3790,2.1,17.6,0,3.7,0,74.9,97.9,1970,9,1961,0.46,99.54,0,9,242,1719,242,1728,0,12.3,12.3,"75% or more P.O.C.","Less than $44000"
"48201222700","Census Tract 2227, Harris County, Texas",6011,21371,229,4262,0,69,0,1451,3.8,70.9,0,1.1,0,24.1,96.2,2253,257,1996,11.41,88.59,58,199,111,1885,169,2084,22.6,5.6,7.5,"75% or more P.O.C.","Less than $44000"
"48201222800","Census Tract 2228, Harris County, Texas",3134,31990,237,11,0,92,0,2794,7.6,0.4,0,2.9,0,89.2,92.4,818,496,322,60.64,39.36,121,375,128,194,249,569,24.4,39.8,30.4,"75% or more P.O.C.","Less than $44000"
"48201222900","Census Tract 2229, Harris County, Texas",8011,52758,271,763,79,14,0,6846,3.4,9.5,1,0.2,0,85.5,96.6,2005,1563,442,77.96,22.04,485,1078,83,359,568,1437,31,18.8,28.3,"75% or more P.O.C.","$44000 - $59000"
"48201223001","Census Tract 2230.01, Harris County, Texas",4217,50670,164,479,4,7,0,3563,3.9,11.4,0.1,0.2,0,84.5,96.1,1049,589,460,56.15,43.85,206,383,111,349,317,732,35,24.1,30.2,"75% or more P.O.C.","$44000 - $59000"
"48201223002","Census Tract 2230.02, Harris County, Texas",3868,26093,124,379,0,39,0,3326,3.2,9.8,0,1,0,86,96.8,1253,527,726,42.06,57.94,132,395,127,599,259,994,25,17.5,20.7,"75% or more P.O.C.","Less than $44000"
"48201223100","Census Tract 2231, Harris County, Texas",2313,59342,381,66,0,12,13,1823,16.5,2.9,0,0.5,0.6,78.8,83.5,610,483,127,79.18,20.82,169,314,41,86,210,400,35,32.3,34.4,"75% or more P.O.C.","$59000 - $86000"
"48201230100","Census Tract 2301, Harris County, Texas",1229,35234,36,846,0,2,0,345,2.9,68.8,0,0.2,0,28.1,97.1,511,159,352,31.12,68.88,18,141,12,340,30,481,11.3,3.4,5.9,"75% or more P.O.C.","Less than $44000"
"48201230200","Census Tract 2302, Harris County, Texas",5347,31368,172,3999,42,0,0,1120,3.2,74.8,0.8,0,0,20.9,96.8,1773,1006,767,56.74,43.26,185,821,79,688,264,1509,18.4,10.3,14.9,"75% or more P.O.C.","Less than $44000"
"48201230300","Census Tract 2303, Harris County, Texas",2460,32431,10,1619,0,17,0,765,0.4,65.8,0,0.7,0,31.1,99.6,835,517,318,61.92,38.08,61,456,37,281,98,737,11.8,11.6,11.7,"75% or more P.O.C.","Less than $44000"
"48201230400","Census Tract 2304, Harris County, Texas",3319,29120,106,1525,0,98,0,1590,3.2,45.9,0,3,0,47.9,96.8,1101,416,685,37.78,62.22,84,332,117,568,201,900,20.2,17.1,18.3,"75% or more P.O.C.","Less than $44000"
"48201230500","Census Tract 2305, Harris County, Texas",3640,35750,158,332,0,99,0,3038,4.3,9.1,0,2.7,0,83.5,95.7,1114,709,405,63.64,36.36,138,571,107,298,245,869,19.5,26.4,22,"75% or more P.O.C.","Less than $44000"
"48201230600","Census Tract 2306, Harris County, Texas",2728,31081,28,1510,0,0,0,1190,1,55.4,0,0,0,43.6,99,916,551,365,60.15,39.85,95,456,63,302,158,758,17.2,17.3,17.2,"75% or more P.O.C.","Less than $44000"
"48201230700","Census Tract 2307, Harris County, Texas",2763,25313,54,1771,0,7,0,931,2,64.1,0,0.3,0,33.7,98,983,406,577,41.3,58.7,87,319,54,523,141,842,21.4,9.4,14.3,"75% or more P.O.C.","Less than $44000"
"48201230800","Census Tract 2308, Harris County, Texas",2317,31250,0,1340,0,0,0,951,0,57.8,0,0,0,41,100,756,480,276,63.49,36.51,131,349,22,254,153,603,27.3,8,20.2,"75% or more P.O.C.","Less than $44000"
"48201230900","Census Tract 2309, Harris County, Texas",4107,22227,54,3034,0,0,0,1019,1.3,73.9,0,0,0,24.8,98.7,1598,617,981,38.61,61.39,34,583,87,894,121,1477,5.5,8.9,7.6,"75% or more P.O.C.","Less than $44000"
"48201231000","Census Tract 2310, Harris County, Texas",4677,43193,157,2424,0,0,0,1901,3.4,51.8,0,0,0,40.6,96.6,1399,1025,374,73.27,26.73,206,819,67,307,273,1126,20.1,17.9,19.5,"75% or more P.O.C.","Less than $44000"
"48201231100","Census Tract 2311, Harris County, Texas",5010,40389,253,1330,75,0,0,3314,5,26.5,1.5,0,0,66.1,95,1464,971,493,66.33,33.67,341,630,102,391,443,1021,35.1,20.7,30.3,"75% or more P.O.C.","Less than $44000"
"48201231200","Census Tract 2312, Harris County, Texas",7450,36646,401,5263,0,0,0,1784,5.4,70.6,0,0,0,23.9,94.6,2192,1073,1119,48.95,51.05,133,940,260,859,393,1799,12.4,23.2,17.9,"75% or more P.O.C.","Less than $44000"
"48201231300","Census Tract 2313, Harris County, Texas",4496,37792,23,2928,0,0,0,1545,0.5,65.1,0,0,0,34.4,99.5,1495,919,576,61.47,38.53,145,774,99,477,244,1251,15.8,17.2,16.3,"75% or more P.O.C.","Less than $44000"
"48201231400","Census Tract 2314, Harris County, Texas",2837,40641,35,2357,0,0,0,445,1.2,83.1,0,0,0,15.7,98.8,964,616,348,63.9,36.1,104,512,20,328,124,840,16.9,5.7,12.9,"75% or more P.O.C.","Less than $44000"
"48201231500","Census Tract 2315, Harris County, Texas",3000,30658,8,2570,0,0,0,422,0.3,85.7,0,0,0,14.1,99.7,938,550,388,58.64,41.36,72,478,66,322,138,800,13.1,17,14.7,"75% or more P.O.C.","Less than $44000"
"48201231600","Census Tract 2316, Harris County, Texas",3350,46024,31,2230,0,0,0,1089,0.9,66.6,0,0,0,32.5,99.1,1021,842,179,82.47,17.53,115,727,42,137,157,864,13.7,23.5,15.4,"75% or more P.O.C.","$44000 - $59000"
"48201231700","Census Tract 2317, Harris County, Texas",3640,30393,115,217,0,15,0,3293,3.2,6,0,0.4,0,90.5,96.8,1072,729,343,68,32,171,558,29,314,200,872,23.5,8.5,18.7,"75% or more P.O.C.","Less than $44000"
"48201231800","Census Tract 2318, Harris County, Texas",3091,42321,98,902,0,0,0,2091,3.2,29.2,0,0,0,67.6,96.8,856,580,276,67.76,32.24,187,393,77,199,264,592,32.2,27.9,30.8,"75% or more P.O.C.","Less than $44000"
"48201231900","Census Tract 2319, Harris County, Texas",7696,41458,126,4920,0,0,0,2650,1.6,63.9,0,0,0,34.4,98.4,2243,1458,785,65,35,355,1103,108,677,463,1780,24.3,13.8,20.6,"75% or more P.O.C.","Less than $44000"
"48201232000","Census Tract 2320, Harris County, Texas",4420,48531,33,1778,0,0,0,2609,0.7,40.2,0,0,0,59,99.3,1326,1000,326,75.41,24.59,211,789,68,258,279,1047,21.1,20.9,21,"75% or more P.O.C.","$44000 - $59000"
"48201232100","Census Tract 2321, Harris County, Texas",3590,35824,230,758,0,0,0,2602,6.4,21.1,0,0,0,72.5,93.6,976,494,482,50.61,49.39,129,365,122,360,251,725,26.1,25.3,25.7,"75% or more P.O.C.","Less than $44000"
"48201232200","Census Tract 2322, Harris County, Texas",16474,66498,4529,4503,0,834,0,6031,27.5,27.3,0,5.1,0,36.6,72.5,6226,3321,2905,53.34,46.66,458,2863,129,2776,587,5639,13.8,4.4,9.4,"50% - 75% P.O.C.","$59000 - $86000"
"48201232301","Census Tract 2323.01, Harris County, Texas",12938,47302,1364,4249,0,27,61,7068,10.5,32.8,0,0.2,0.5,54.6,89.5,3600,1902,1698,52.83,47.17,496,1406,323,1375,819,2781,26.1,19,22.8,"75% or more P.O.C.","$44000 - $59000"
"48201232302","Census Tract 2323.02, Harris County, Texas",12014,69185,714,3842,0,80,0,7323,5.9,32,0,0.7,0,61,94.1,3141,2382,759,75.84,24.16,608,1774,166,593,774,2367,25.5,21.9,24.6,"75% or more P.O.C.","$59000 - $86000"
"48201232401","Census Tract 2324.01, Harris County, Texas",9255,62730,1039,2053,0,355,0,5761,11.2,22.2,0,3.8,0,62.2,88.8,2552,1971,581,77.23,22.77,655,1316,86,495,741,1811,33.2,14.8,29,"75% or more P.O.C.","$59000 - $86000"
"48201232402","Census Tract 2324.02, Harris County, Texas",4121,54051,418,1093,0,121,0,2385,10.1,26.5,0,2.9,0,57.9,89.9,1308,713,595,54.51,45.49,139,574,92,503,231,1077,19.5,15.5,17.7,"75% or more P.O.C.","$44000 - $59000"
"48201232403","Census Tract 2324.03, Harris County, Texas",4674,46346,175,1069,9,94,0,3313,3.7,22.9,0.2,2,0,70.9,96.3,1474,680,794,46.13,53.87,111,569,127,667,238,1236,16.3,16,16.1,"75% or more P.O.C.","$44000 - $59000"
"48201232500","Census Tract 2325, Harris County, Texas",4060,39316,586,1023,0,0,0,2451,14.4,25.2,0,0,0,60.4,85.6,927,478,449,51.56,48.44,66,412,89,360,155,772,13.8,19.8,16.7,"75% or more P.O.C.","Less than $44000"
"48201232600","Census Tract 2326, Harris County, Texas",3138,60650,470,179,0,4,0,2471,15,5.7,0,0.1,0,78.7,85,897,722,175,80.49,19.51,190,532,5,170,195,702,26.3,2.9,21.7,"75% or more P.O.C.","$59000 - $86000"
"48201232701","Census Tract 2327.01, Harris County, Texas",7825,32226,279,1772,0,17,0,5728,3.6,22.6,0,0.2,0,73.2,96.4,2479,827,1652,33.36,66.64,163,664,196,1456,359,2120,19.7,11.9,14.5,"75% or more P.O.C.","Less than $44000"
"48201232702","Census Tract 2327.02, Harris County, Texas",5334,37920,367,1605,0,0,20,3251,6.9,30.1,0,0,0.4,60.9,93.1,1878,312,1566,16.61,83.39,51,261,226,1340,277,1601,16.3,14.4,14.7,"75% or more P.O.C.","Less than $44000"
"48201232800","Census Tract 2328, Harris County, Texas",5464,45000,374,1666,0,70,0,3354,6.8,30.5,0,1.3,0,61.4,93.2,2090,706,1384,33.78,66.22,156,550,80,1304,236,1854,22.1,5.8,11.3,"75% or more P.O.C.","$44000 - $59000"
"48201232900","Census Tract 2329, Harris County, Texas",7278,46875,488,3215,0,420,0,3129,6.7,44.2,0,5.8,0,43,93.3,2937,1001,1936,34.08,65.92,151,850,66,1870,217,2720,15.1,3.4,7.4,"75% or more P.O.C.","$44000 - $59000"
"48201233001","Census Tract 2330.01, Harris County, Texas",4161,44542,724,1506,0,0,0,1877,17.4,36.2,0,0,0,45.1,82.6,1318,465,853,35.28,64.72,68,397,134,719,202,1116,14.6,15.7,15.3,"75% or more P.O.C.","$44000 - $59000"
"48201233002","Census Tract 2330.02, Harris County, Texas",4992,83767,516,1605,0,432,0,2384,10.3,32.2,0,8.7,0,47.8,89.7,1309,1104,205,84.34,15.66,284,820,42,163,326,983,25.7,20.5,24.9,"75% or more P.O.C.","$59000 - $86000"
"48201233003","Census Tract 2330.03, Harris County, Texas",2555,77616,737,182,0,11,9,1585,28.8,7.1,0,0.4,0.4,62,71.2,800,732,68,91.5,8.5,156,576,29,39,185,615,21.3,42.6,23.1,"50% - 75% P.O.C.","$59000 - $86000"
"48201233101","Census Tract 2331.01, Harris County, Texas",4458,35246,588,232,38,0,0,3543,13.2,5.2,0.9,0,0,79.5,86.8,1217,520,697,42.73,57.27,174,346,97,600,271,946,33.5,13.9,22.3,"75% or more P.O.C.","Less than $44000"
"48201233102","Census Tract 2331.02, Harris County, Texas",7115,35486,732,0,0,0,0,6340,10.3,0,0,0,0,89.1,89.7,1806,923,883,51.11,48.89,325,598,264,619,589,1217,35.2,29.9,32.6,"75% or more P.O.C.","Less than $44000"
"48201233103","Census Tract 2331.03, Harris County, Texas",5550,38025,501,67,0,11,0,4960,9,1.2,0,0.2,0,89.4,91,1548,666,882,43.02,56.98,206,460,210,672,416,1132,30.9,23.8,26.9,"75% or more P.O.C.","Less than $44000"
"48201233200","Census Tract 2332, Harris County, Texas",6590,53611,969,145,0,68,0,5408,14.7,2.2,0,1,0,82.1,85.3,1766,1309,457,74.12,25.88,329,980,226,231,555,1211,25.1,49.5,31.4,"75% or more P.O.C.","$44000 - $59000"
"48201233300","Census Tract 2333, Harris County, Texas",4263,47031,280,0,0,0,0,3983,6.6,0,0,0,0,93.4,93.4,1261,663,598,52.58,47.42,150,513,100,498,250,1011,22.6,16.7,19.8,"75% or more P.O.C.","$44000 - $59000"
"48201233400","Census Tract 2334, Harris County, Texas",2554,34412,260,269,0,0,0,2019,10.2,10.5,0,0,0,79.1,89.8,958,366,592,38.2,61.8,78,288,55,537,133,825,21.3,9.3,13.9,"75% or more P.O.C.","Less than $44000"
"48201233500","Census Tract 2335, Harris County, Texas",8113,48280,729,109,20,0,0,7255,9,1.3,0.2,0,0,89.4,91,2253,1723,530,76.48,23.52,436,1287,112,418,548,1705,25.3,21.1,24.3,"75% or more P.O.C.","$44000 - $59000"
"48201233600","Census Tract 2336, Harris County, Texas",2207,27450,43,1015,0,0,0,1131,1.9,46,0,0,0,51.2,98.1,780,514,266,65.9,34.1,81,433,51,215,132,648,15.8,19.2,16.9,"75% or more P.O.C.","Less than $44000"
"48201233701","Census Tract 2337.01, Harris County, Texas",5414,39492,602,903,8,0,0,3901,11.1,16.7,0.1,0,0,72.1,88.9,1423,913,510,64.16,35.84,224,689,83,427,307,1116,24.5,16.3,21.6,"75% or more P.O.C.","Less than $44000"
"48201233702","Census Tract 2337.02, Harris County, Texas",3036,49013,76,39,26,0,0,2895,2.5,1.3,0.9,0,0,95.4,97.5,751,414,337,55.13,44.87,136,278,115,222,251,500,32.9,34.1,33.4,"75% or more P.O.C.","$44000 - $59000"
"48201233703","Census Tract 2337.03, Harris County, Texas",2510,58243,318,77,0,0,0,2115,12.7,3.1,0,0,0,84.3,87.3,674,480,194,71.22,28.78,109,371,71,123,180,494,22.7,36.6,26.7,"75% or more P.O.C.","$44000 - $59000"
"48201240100","Census Tract 2401, Harris County, Texas",3959,30945,442,823,33,52,134,2357,11.2,20.8,0.8,1.3,3.4,59.5,88.8,1483,78,1405,5.26,94.74,27,51,187,1218,214,1269,34.6,13.3,14.4,"75% or more P.O.C.","Less than $44000"
"48201240400","Census Tract 2404, Harris County, Texas",8300,46136,1409,1642,0,82,0,5097,17,19.8,0,1,0,61.4,83,2378,1687,691,70.94,29.06,403,1284,115,576,518,1860,23.9,16.6,21.8,"75% or more P.O.C.","$44000 - $59000"
"48201240501","Census Tract 2405.01, Harris County, Texas",6668,31743,149,2071,0,108,0,4152,2.2,31.1,0,1.6,0,62.3,97.8,2342,334,2008,14.26,85.74,94,240,215,1793,309,2033,28.1,10.7,13.2,"75% or more P.O.C.","Less than $44000"
"48201240502","Census Tract 2405.02, Harris County, Texas",5979,24930,127,1730,0,51,0,4071,2.1,28.9,0,0.9,0,68.1,97.9,2096,94,2002,4.48,95.52,38,56,236,1766,274,1822,40.4,11.8,13.1,"75% or more P.O.C.","Less than $44000"
"48201240600","Census Tract 2406, Harris County, Texas",2790,26169,56,848,13,0,0,1841,2,30.4,0.5,0,0,66,98,1027,6,1021,0.58,99.42,0,6,158,863,158,869,0,15.5,15.4,"75% or more P.O.C.","Less than $44000"
"48201240701","Census Tract 2407.01, Harris County, Texas",14085,49885,1074,4722,0,361,0,7831,7.6,33.5,0,2.6,0,55.6,92.4,4842,2831,2011,58.47,41.53,495,2336,70,1941,565,4277,17.5,3.5,11.7,"75% or more P.O.C.","$44000 - $59000"
"48201240702","Census Tract 2407.02, Harris County, Texas",14051,60166,1779,4308,0,308,0,7412,12.7,30.7,0,2.2,0,52.8,87.3,4014,2729,1285,67.99,32.01,687,2042,294,991,981,3033,25.2,22.9,24.4,"75% or more P.O.C.","$59000 - $86000"
"48201240801","Census Tract 2408.01, Harris County, Texas",5448,35431,1130,1820,0,0,0,2451,20.7,33.4,0,0,0,45,79.3,2650,496,2154,18.72,81.28,25,471,167,1987,192,2458,5,7.8,7.2,"75% or more P.O.C.","Less than $44000"
"48201240802","Census Tract 2408.02, Harris County, Texas",6859,55103,1057,2926,0,113,0,2608,15.4,42.7,0,1.6,0,38,84.6,2296,1090,1206,47.47,52.53,204,886,158,1048,362,1934,18.7,13.1,15.8,"75% or more P.O.C.","$44000 - $59000"
"48201240901","Census Tract 2409.01, Harris County, Texas",11399,75213,1326,3934,80,67,94,5420,11.6,34.5,0.7,0.6,0.8,47.5,88.4,3386,2415,971,71.32,28.68,475,1940,152,819,627,2759,19.7,15.7,18.5,"75% or more P.O.C.","$59000 - $86000"
"48201240902","Census Tract 2409.02, Harris County, Texas",16658,67007,2920,5945,0,912,0,6623,17.5,35.7,0,5.5,0,39.8,82.5,5120,4169,951,81.43,18.57,715,3454,188,763,903,4217,17.2,19.8,17.6,"75% or more P.O.C.","$59000 - $86000"
"48201241000","Census Tract 2410, Harris County, Texas",9370,52891,3613,2146,15,201,279,2935,38.6,22.9,0.2,2.1,3,31.3,61.4,3029,2153,876,71.08,28.92,317,1836,123,753,440,2589,14.7,14,14.5,"50% - 75% P.O.C.","$44000 - $59000"
"48201241101","Census Tract 2411.01, Harris County, Texas",5019,71533,2024,842,0,66,0,1974,40.3,16.8,0,1.3,0,39.3,59.7,1611,1340,271,83.18,16.82,217,1123,87,184,304,1307,16.2,32.1,18.9,"50% - 75% P.O.C.","$59000 - $86000"
"48201241102","Census Tract 2411.02, Harris County, Texas",12773,72135,3814,3529,22,131,0,4854,29.9,27.6,0.2,1,0,38,70.1,4251,2670,1581,62.81,37.19,246,2424,289,1292,535,3716,9.2,18.3,12.6,"50% - 75% P.O.C.","$59000 - $86000"
"48201241103","Census Tract 2411.03, Harris County, Texas",4328,48410,1600,866,5,10,0,1823,37,20,0.1,0.2,0,42.1,63,1587,778,809,49.02,50.98,90,688,120,689,210,1377,11.6,14.8,13.2,"50% - 75% P.O.C.","$44000 - $59000"
"48201241200","Census Tract 2412, Harris County, Texas",8151,55727,2409,2352,17,375,0,2922,29.6,28.9,0.2,4.6,0,35.8,70.4,2766,1834,932,66.31,33.69,262,1572,123,809,385,2381,14.3,13.2,13.9,"50% - 75% P.O.C.","$44000 - $59000"
"48201241300","Census Tract 2413, Harris County, Texas",12064,96747,5736,2354,16,814,0,2784,47.5,19.5,0.1,6.7,0,23.1,52.5,4058,3314,744,81.67,18.33,553,2761,103,641,656,3402,16.7,13.8,16.2,"50% - 75% P.O.C.","$86000 or more"
"48201241400","Census Tract 2414, Harris County, Texas",9796,80605,5643,1440,0,177,0,2314,57.6,14.7,0,1.8,0,23.6,42.4,3286,2191,1095,66.68,33.32,241,1950,93,1002,334,2952,11,8.5,10.2,"25% - 50% P.O.C.","$59000 - $86000"
"48201241500","Census Tract 2415, Harris County, Texas",7911,44014,1070,3148,0,109,0,3457,13.5,39.8,0,1.4,0,43.7,86.5,3164,776,2388,24.53,75.47,112,664,186,2202,298,2866,14.4,7.8,9.4,"75% or more P.O.C.","$44000 - $59000"
"48201250100","Census Tract 2501, Harris County, Texas",9412,80191,1569,2977,0,241,106,4477,16.7,31.6,0,2.6,1.1,47.6,83.3,2691,2358,333,87.63,12.37,380,1978,70,263,450,2241,16.1,21,16.7,"75% or more P.O.C.","$59000 - $86000"
"48201250200","Census Tract 2502, Harris County, Texas",11011,64856,1368,4275,24,169,0,5119,12.4,38.8,0.2,1.5,0,46.5,87.6,3069,1889,1180,61.55,38.45,473,1416,220,960,693,2376,25,18.6,22.6,"75% or more P.O.C.","$59000 - $86000"
"48201250301","Census Tract 2503.01, Harris County, Texas",11976,64966,1950,5929,53,270,0,3709,16.3,49.5,0.4,2.3,0,31,83.7,3170,1694,1476,53.44,46.56,322,1372,231,1245,553,2617,19,15.7,17.4,"75% or more P.O.C.","$59000 - $86000"
"48201250302","Census Tract 2503.02, Harris County, Texas",11641,82250,3747,3007,0,447,0,4290,32.2,25.8,0,3.8,0,36.9,67.8,3723,2948,775,79.18,20.82,465,2483,66,709,531,3192,15.8,8.5,14.3,"50% - 75% P.O.C.","$59000 - $86000"
"48201250401","Census Tract 2504.01, Harris County, Texas",12679,98721,5392,2253,0,260,87,4456,42.5,17.8,0,2.1,0.7,35.1,57.5,3846,3382,464,87.94,12.06,607,2775,68,396,675,3171,17.9,14.7,17.6,"50% - 75% P.O.C.","$86000 or more"
"48201250402","Census Tract 2504.02, Harris County, Texas",22829,120197,11759,4931,94,402,0,5420,51.5,21.6,0.4,1.8,0,23.7,48.5,7489,6191,1298,82.67,17.33,991,5200,119,1179,1110,6379,16,9.2,14.8,"25% - 50% P.O.C.","$86000 or more"
"48201250500","Census Tract 2505, Harris County, Texas",6410,71651,2960,1268,0,252,0,1782,46.2,19.8,0,3.9,0,27.8,53.8,2176,1242,934,57.08,42.92,135,1107,44,890,179,1997,10.9,4.7,8.2,"50% - 75% P.O.C.","$59000 - $86000"
"48201250600","Census Tract 2506, Harris County, Texas",7799,31224,1846,2597,0,33,52,3247,23.7,33.3,0,0.4,0.7,41.6,76.3,3340,771,2569,23.08,76.92,53,718,276,2293,329,3011,6.9,10.7,9.9,"75% or more P.O.C.","Less than $44000"
"48201250701","Census Tract 2507.01, Harris County, Texas",5777,81296,3090,704,12,151,0,1746,53.5,12.2,0.2,2.6,0,30.2,46.5,1946,1659,287,85.25,14.75,108,1551,69,218,177,1769,6.5,24,9.1,"25% - 50% P.O.C.","$59000 - $86000"
"48201250702","Census Tract 2507.02, Harris County, Texas",4759,110769,2498,458,0,249,0,1276,52.5,9.6,0,5.2,0,26.8,47.5,1626,1473,153,90.59,9.41,225,1248,0,153,225,1401,15.3,0,13.8,"25% - 50% P.O.C.","$86000 or more"
"48201250800","Census Tract 2508, Harris County, Texas",8912,108583,6698,569,0,287,0,930,75.2,6.4,0,3.2,0,10.4,24.8,3014,2470,544,81.95,18.05,370,2100,51,493,421,2593,15,9.4,14,"Less than 25% P.O.C.","$86000 or more"
"48201250900","Census Tract 2509, Harris County, Texas",9617,143825,7953,160,0,248,0,1031,82.7,1.7,0,2.6,0,10.7,17.3,3387,2648,739,78.18,21.82,187,2461,12,727,199,3188,7.1,1.6,5.9,"Less than 25% P.O.C.","$86000 or more"
"48201251000","Census Tract 2510, Harris County, Texas",2693,95956,1663,185,0,205,0,539,61.8,6.9,0,7.6,0,20,38.2,1141,649,492,56.88,43.12,53,596,0,492,53,1088,8.2,0,4.6,"25% - 50% P.O.C.","$86000 or more"
"48201251100","Census Tract 2511, Harris County, Texas",7077,82965,5064,284,41,47,0,1588,71.6,4,0.6,0.7,0,22.4,28.4,2779,2480,299,89.24,10.76,149,2331,87,212,236,2543,6,29.1,8.5,"25% - 50% P.O.C.","$59000 - $86000"
"48201251200","Census Tract 2512, Harris County, Texas",6889,67399,4106,368,0,367,0,1692,59.6,5.3,0,5.3,0,24.6,40.4,2275,1853,422,81.45,18.55,354,1499,42,380,396,1879,19.1,10,17.4,"25% - 50% P.O.C.","$59000 - $86000"
"48201251300","Census Tract 2513, Harris County, Texas",7054,95580,5615,131,45,34,0,971,79.6,1.9,0.6,0.5,0,13.8,20.4,2517,2215,302,88,12,146,2069,52,250,198,2319,6.6,17.2,7.9,"Less than 25% P.O.C.","$86000 or more"
"48201251401","Census Tract 2514.01, Harris County, Texas",2987,111111,2054,235,0,73,0,552,68.8,7.9,0,2.4,0,18.5,31.2,906,701,205,77.37,22.63,86,615,40,165,126,780,12.3,19.5,13.9,"25% - 50% P.O.C.","$86000 or more"
"48201251402","Census Tract 2514.02, Harris County, Texas",6266,66553,4239,20,0,249,0,1593,67.7,0.3,0,4,0,25.4,32.3,2213,1574,639,71.13,28.87,223,1351,75,564,298,1915,14.2,11.7,13.5,"25% - 50% P.O.C.","$59000 - $86000"
"48201251501","Census Tract 2515.01, Harris County, Texas",6002,134283,4354,96,0,773,0,631,72.5,1.6,0,12.9,0,10.5,27.5,1759,1717,42,97.61,2.39,302,1415,0,42,302,1457,17.6,0,17.2,"25% - 50% P.O.C.","$86000 or more"
"48201251502","Census Tract 2515.02, Harris County, Texas",9303,143169,7664,148,0,199,0,1209,82.4,1.6,0,2.1,0,13,17.6,3177,2990,187,94.11,5.89,320,2670,77,110,397,2780,10.7,41.2,12.5,"Less than 25% P.O.C.","$86000 or more"
"48201251503","Census Tract 2515.03, Harris County, Texas",2402,117708,1808,183,0,97,0,245,75.3,7.6,0,4,0,10.2,24.7,787,730,57,92.76,7.24,82,648,0,57,82,705,11.2,0,10.4,"Less than 25% P.O.C.","$86000 or more"
"48201251600","Census Tract 2516, Harris County, Texas",6605,92029,4942,70,0,0,0,1560,74.8,1.1,0,0,0,23.6,25.2,2087,1821,266,87.25,12.75,285,1536,107,159,392,1695,15.7,40.2,18.8,"25% - 50% P.O.C.","$86000 or more"
"48201251700","Census Tract 2517, Harris County, Texas",8501,45585,6379,212,0,25,0,1716,75,2.5,0,0.3,0,20.2,25,3029,2119,910,69.96,30.04,201,1918,119,791,320,2709,9.5,13.1,10.6,"25% - 50% P.O.C.","$44000 - $59000"
"48201251800","Census Tract 2518, Harris County, Texas",2047,84750,1370,22,0,7,0,648,66.9,1.1,0,0.3,0,31.7,33.1,680,590,90,86.76,13.24,66,524,56,34,122,558,11.2,62.2,17.9,"25% - 50% P.O.C.","$59000 - $86000"
"48201251901","Census Tract 2519.01, Harris County, Texas",10887,79382,7144,413,116,37,0,2942,65.6,3.8,1.1,0.3,0,27,34.4,3780,3275,505,86.64,13.36,390,2885,130,375,520,3260,11.9,25.7,13.8,"25% - 50% P.O.C.","$59000 - $86000"
"48201251902","Census Tract 2519.02, Harris County, Texas",6233,98445,4235,550,171,104,0,1107,67.9,8.8,2.7,1.7,0,17.8,32.1,2265,1881,384,83.05,16.95,211,1670,8,376,219,2046,11.2,2.1,9.7,"25% - 50% P.O.C.","$86000 or more"
"48201252000","Census Tract 2520, Harris County, Texas",21439,128209,8798,5999,70,596,0,5560,41,28,0.3,2.8,0,25.9,59,6793,5780,1013,85.09,14.91,696,5084,0,1013,696,6097,12,0,10.2,"50% - 75% P.O.C.","$86000 or more"
"48201252100","Census Tract 2521, Harris County, Texas",2392,72955,785,272,0,23,0,1305,32.8,11.4,0,1,0,54.6,67.2,760,684,76,90,10,70,614,0,76,70,690,10.2,0,9.2,"50% - 75% P.O.C.","$59000 - $86000"
"48201252200","Census Tract 2522, Harris County, Texas",9953,62810,1365,2037,243,404,0,5787,13.7,20.5,2.4,4.1,0,58.1,86.3,3103,2027,1076,65.32,34.68,385,1642,84,992,469,2634,19,7.8,15.1,"75% or more P.O.C.","$59000 - $86000"
"48201252301","Census Tract 2523.01, Harris County, Texas",9270,64914,838,3345,0,33,0,4941,9,36.1,0,0.4,0,53.3,91,2554,2001,553,78.35,21.65,544,1457,10,543,554,2000,27.2,1.8,21.7,"75% or more P.O.C.","$59000 - $86000"
"48201252302","Census Tract 2523.02, Harris County, Texas",14935,76070,1106,2702,0,166,0,10621,7.4,18.1,0,1.1,0,71.1,92.6,4209,3340,869,79.35,20.65,904,2436,99,770,1003,3206,27.1,11.4,23.8,"75% or more P.O.C.","$59000 - $86000"
"48201252400","Census Tract 2524, Harris County, Texas",6461,61875,2178,145,0,0,0,4124,33.7,2.2,0,0,0,63.8,66.3,2014,1331,683,66.09,33.91,108,1223,283,400,391,1623,8.1,41.4,19.4,"50% - 75% P.O.C.","$59000 - $86000"
"48201252500","Census Tract 2525, Harris County, Texas",4208,49559,1133,36,0,0,0,3018,26.9,0.9,0,0,0,71.7,73.1,1374,799,575,58.15,41.85,144,655,91,484,235,1139,18,15.8,17.1,"50% - 75% P.O.C.","$44000 - $59000"
"48201252600","Census Tract 2526, Harris County, Texas",8851,50075,2201,0,0,0,0,6570,24.9,0,0,0,0,74.2,75.1,2342,1435,907,61.27,38.73,441,994,287,620,728,1614,30.7,31.6,31.1,"75% or more P.O.C.","$44000 - $59000"
"48201252700","Census Tract 2527, Harris County, Texas",4101,40530,2306,363,0,47,0,1319,56.2,8.9,0,1.1,0,32.2,43.8,1580,909,671,57.53,42.47,46,863,144,527,190,1390,5.1,21.5,12,"25% - 50% P.O.C.","Less than $44000"
"48201252800","Census Tract 2528, Harris County, Texas",7056,61058,1899,2629,0,177,0,2230,26.9,37.3,0,2.5,0,31.6,73.1,2379,1741,638,73.18,26.82,128,1613,200,438,328,2051,7.4,31.3,13.8,"50% - 75% P.O.C.","$59000 - $86000"
"48201252900","Census Tract 2529, Harris County, Texas",8908,63229,4503,710,0,80,0,3323,50.6,8,0,0.9,0,37.3,49.4,3149,2505,644,79.55,20.45,308,2197,134,510,442,2707,12.3,20.8,14,"25% - 50% P.O.C.","$59000 - $86000"
"48201253000","Census Tract 2530, Harris County, Texas",4466,46250,1207,1343,0,0,0,1867,27,30.1,0,0,0,41.8,73,1516,915,601,60.36,39.64,153,762,152,449,305,1211,16.7,25.3,20.1,"50% - 75% P.O.C.","$44000 - $59000"
"48201253100","Census Tract 2531, Harris County, Texas",12358,113791,3614,2342,0,363,0,5925,29.2,19,0,2.9,0,47.9,70.8,3626,3229,397,89.05,10.95,822,2407,0,397,822,2804,25.5,0,22.7,"50% - 75% P.O.C.","$86000 or more"
"48201253200","Census Tract 2532, Harris County, Texas",10019,83355,5001,1313,17,17,0,3278,49.9,13.1,0.2,0.2,0,32.7,50.1,3362,2398,964,71.33,28.67,221,2177,169,795,390,2972,9.2,17.5,11.6,"50% - 75% P.O.C.","$59000 - $86000"
"48201253300","Census Tract 2533, Harris County, Texas",3513,85657,1739,263,0,79,0,1419,49.5,7.5,0,2.2,0,40.4,50.5,1181,1098,83,92.97,7.03,138,960,0,83,138,1043,12.6,0,11.7,"50% - 75% P.O.C.","$59000 - $86000"
"48201253400","Census Tract 2534, Harris County, Texas",623,44083,403,16,0,10,0,194,64.7,2.6,0,1.6,0,31.1,35.3,201,106,95,52.74,47.26,12,94,6,89,18,183,11.3,6.3,9,"25% - 50% P.O.C.","$44000 - $59000"
"48201253500","Census Tract 2535, Harris County, Texas",9816,56155,2533,3024,0,446,14,3538,25.8,30.8,0,4.5,0.1,36,74.2,3221,1419,1802,44.05,55.95,351,1068,168,1634,519,2702,24.7,9.3,16.1,"50% - 75% P.O.C.","$44000 - $59000"
"48201253600","Census Tract 2536, Harris County, Texas",6647,45658,2000,1216,21,240,0,3170,30.1,18.3,0.3,3.6,0,47.7,69.9,2702,617,2085,22.83,77.17,76,541,163,1922,239,2463,12.3,7.8,8.8,"50% - 75% P.O.C.","$44000 - $59000"
"48201253700","Census Tract 2537, Harris County, Texas",5813,58105,1497,1236,0,242,0,2595,25.8,21.3,0,4.2,0,44.6,74.2,1957,765,1192,39.09,60.91,260,505,116,1076,376,1581,34,9.7,19.2,"50% - 75% P.O.C.","$44000 - $59000"
"48201253800","Census Tract 2538, Harris County, Texas",8037,62255,3098,631,0,86,0,4143,38.5,7.9,0,1.1,0,51.5,61.5,2632,1848,784,70.21,29.79,329,1519,95,689,424,2208,17.8,12.1,16.1,"50% - 75% P.O.C.","$59000 - $86000"
"48201253900","Census Tract 2539, Harris County, Texas",3854,53178,2106,333,6,42,0,1248,54.6,8.6,0.2,1.1,0,32.4,45.4,1566,744,822,47.51,52.49,81,663,86,736,167,1399,10.9,10.5,10.7,"25% - 50% P.O.C.","$44000 - $59000"
"48201254000","Census Tract 2540, Harris County, Texas",4032,52962,1696,1107,0,43,0,1152,42.1,27.5,0,1.1,0,28.6,57.9,1415,570,845,40.28,59.72,78,492,184,661,262,1153,13.7,21.8,18.5,"50% - 75% P.O.C.","$44000 - $59000"
"48201254100","Census Tract 2541, Harris County, Texas",5184,43026,1178,881,0,0,0,2984,22.7,17,0,0,0,57.6,77.3,1652,805,847,48.73,51.27,210,595,107,740,317,1335,26.1,12.6,19.2,"75% or more P.O.C.","Less than $44000"
"48201254200","Census Tract 2542, Harris County, Texas",2620,52292,448,71,0,0,0,2013,17.1,2.7,0,0,0,76.8,82.9,796,500,296,62.81,37.19,89,411,46,250,135,661,17.8,15.5,17,"75% or more P.O.C.","$44000 - $59000"
"48201254300","Census Tract 2543, Harris County, Texas",5138,48602,1131,740,0,0,0,3185,22,14.4,0,0,0,62,78,1808,954,854,52.77,47.23,196,758,79,775,275,1533,20.5,9.3,15.2,"75% or more P.O.C.","$44000 - $59000"
"48201254400","Census Tract 2544, Harris County, Texas",2971,38043,337,215,0,15,0,2381,11.3,7.2,0,0.5,0,80.1,88.7,950,669,281,70.42,29.58,112,557,66,215,178,772,16.7,23.5,18.7,"75% or more P.O.C.","Less than $44000"
"48201254500","Census Tract 2545, Harris County, Texas",1887,48207,139,391,0,10,0,1331,7.4,20.7,0,0.5,0,70.5,92.6,595,376,219,63.19,36.81,70,306,7,212,77,518,18.6,3.2,12.9,"75% or more P.O.C.","$44000 - $59000"
"48201254600","Census Tract 2546, Harris County, Texas",3678,56509,391,319,0,7,0,2726,10.6,8.7,0,0.2,0,74.1,89.4,1153,861,292,74.67,25.33,171,690,50,242,221,932,19.9,17.1,19.2,"75% or more P.O.C.","$44000 - $59000"
"48201254700","Census Tract 2547, Harris County, Texas",2397,59565,1122,313,0,52,0,871,46.8,13.1,0,2.2,0,36.3,53.2,882,508,374,57.6,42.4,29,479,54,320,83,799,5.7,14.4,9.4,"50% - 75% P.O.C.","$59000 - $86000"
"48201310100","Census Tract 3101, Harris County, Texas",5346,70510,1201,1860,3,208,0,1958,22.5,34.8,0.1,3.9,0,36.6,77.5,2656,887,1769,33.4,66.6,34,853,136,1633,170,2486,3.8,7.7,6.4,"75% or more P.O.C.","$59000 - $86000"
"48201310200","Census Tract 3102, Harris County, Texas",1912,134464,829,315,7,183,0,466,43.4,16.5,0.4,9.6,0,24.4,56.6,949,699,250,73.66,26.34,30,669,0,250,30,919,4.3,0,3.2,"50% - 75% P.O.C.","$86000 or more"
"48201310300","Census Tract 3103, Harris County, Texas",4840,44943,1066,227,0,28,0,3510,22,4.7,0,0.6,0,72.5,78,1925,844,1081,43.84,56.16,158,686,68,1013,226,1699,18.7,6.3,11.7,"75% or more P.O.C.","$44000 - $59000"
"48201310400","Census Tract 3104, Harris County, Texas",3430,31853,148,56,0,0,10,3216,4.3,1.6,0,0,0.3,93.8,95.7,1268,613,655,48.34,51.66,118,495,109,546,227,1041,19.2,16.6,17.9,"75% or more P.O.C.","Less than $44000"
"48201310500","Census Tract 3105, Harris County, Texas",4439,39928,181,158,7,82,0,4005,4.1,3.6,0.2,1.8,0,90.2,95.9,1375,583,792,42.4,57.6,81,502,106,686,187,1188,13.9,13.4,13.6,"75% or more P.O.C.","Less than $44000"
"48201310600","Census Tract 3106, Harris County, Texas",5407,35122,638,347,7,96,0,4307,11.8,6.4,0.1,1.8,0,79.7,88.2,2022,1086,936,53.71,46.29,155,931,51,885,206,1816,14.3,5.4,10.2,"75% or more P.O.C.","Less than $44000"
"48201310700","Census Tract 3107, Harris County, Texas",4582,51071,660,35,0,0,0,3864,14.4,0.8,0,0,0,84.3,85.6,1348,585,763,43.4,56.6,128,457,104,659,232,1116,21.9,13.6,17.2,"75% or more P.O.C.","$44000 - $59000"
"48201310800","Census Tract 3108, Harris County, Texas",2643,38856,233,76,0,37,0,2285,8.8,2.9,0,1.4,0,86.5,91.2,996,257,739,25.8,74.2,38,219,38,701,76,920,14.8,5.1,7.6,"75% or more P.O.C.","Less than $44000"
"48201310900","Census Tract 3109, Harris County, Texas",5442,30421,245,28,0,93,0,5065,4.5,0.5,0,1.7,0,93.1,95.5,1829,685,1144,37.45,62.55,111,574,176,968,287,1542,16.2,15.4,15.7,"75% or more P.O.C.","Less than $44000"
"48201311000","Census Tract 3110, Harris County, Texas",5754,29981,254,0,0,0,0,5500,4.4,0,0,0,0,95.6,95.6,2070,1052,1018,50.82,49.18,151,901,83,935,234,1836,14.4,8.2,11.3,"75% or more P.O.C.","Less than $44000"
"48201311100","Census Tract 3111, Harris County, Texas",5304,38619,116,15,0,0,0,5173,2.2,0.3,0,0,0,97.5,97.8,1620,853,767,52.65,47.35,177,676,192,575,369,1251,20.8,25,22.8,"75% or more P.O.C.","Less than $44000"
"48201311200","Census Tract 3112, Harris County, Texas",4922,39148,408,117,0,9,0,4388,8.3,2.4,0,0.2,0,89.2,91.7,1758,924,834,52.56,47.44,93,831,112,722,205,1553,10.1,13.4,11.7,"75% or more P.O.C.","Less than $44000"
"48201311300","Census Tract 3113, Harris County, Texas",4915,48237,91,0,0,128,0,4685,1.9,0,0,2.6,0,95.3,98.1,1431,971,460,67.85,32.15,177,794,190,270,367,1064,18.2,41.3,25.6,"75% or more P.O.C.","$44000 - $59000"
"48201311400","Census Tract 3114, Harris County, Texas",1667,40179,13,260,0,0,0,1394,0.8,15.6,0,0,0,83.6,99.2,485,259,226,53.4,46.6,72,187,38,188,110,375,27.8,16.8,22.7,"75% or more P.O.C.","Less than $44000"
"48201311500","Census Tract 3115, Harris County, Texas",7543,52513,149,109,0,96,0,7189,2,1.4,0,1.3,0,95.3,98,2145,1262,883,58.83,41.17,303,959,187,696,490,1655,24,21.2,22.8,"75% or more P.O.C.","$44000 - $59000"
"48201311600","Census Tract 3116, Harris County, Texas",3923,31542,117,236,0,90,0,3480,3,6,0,2.3,0,88.7,97,1407,11,1396,0.78,99.22,0,11,181,1215,181,1226,0,13,12.9,"75% or more P.O.C.","Less than $44000"
"48201311700","Census Tract 3117, Harris County, Texas",5741,32159,130,537,0,50,0,5024,2.3,9.4,0,0.9,0,87.5,97.7,1784,609,1175,34.14,65.86,148,461,179,996,327,1457,24.3,15.2,18.3,"75% or more P.O.C.","Less than $44000"
"48201311800","Census Tract 3118, Harris County, Texas",4585,39776,176,31,0,172,0,4181,3.8,0.7,0,3.8,0,91.2,96.2,1233,518,715,42.01,57.99,143,375,209,506,352,881,27.6,29.2,28.5,"75% or more P.O.C.","Less than $44000"
"48201311900","Census Tract 3119, Harris County, Texas",2454,52059,237,61,0,73,0,2083,9.7,2.5,0,3,0,84.9,90.3,698,347,351,49.71,50.29,47,300,86,265,133,565,13.5,24.5,19.1,"75% or more P.O.C.","$44000 - $59000"
"48201312000","Census Tract 3120, Harris County, Texas",4570,66250,1572,1472,0,679,11,647,34.4,32.2,0,14.9,0.2,14.2,65.6,596,392,204,65.77,34.23,47,345,9,195,56,540,12,4.4,9.4,"50% - 75% P.O.C.","$59000 - $86000"
"48201312100","Census Tract 3121, Harris County, Texas",4030,NA,1600,902,0,755,0,705,39.7,22.4,0,18.7,0,17.5,60.3,0,0,0,NA,NA,0,0,0,0,0,0,NA,NA,NA,"50% - 75% P.O.C.","N/A"
"48201312200","Census Tract 3122, Harris County, Texas",1939,26293,47,1785,0,5,0,92,2.4,92.1,0,0.3,0,4.7,97.6,756,159,597,21.03,78.97,2,157,58,539,60,696,1.3,9.7,7.9,"75% or more P.O.C.","Less than $44000"
"48201312300","Census Tract 3123, Harris County, Texas",1965,39583,254,1232,0,47,0,382,12.9,62.7,0,2.4,0,19.4,87.1,881,329,552,37.34,62.66,12,317,47,505,59,822,3.6,8.5,6.7,"75% or more P.O.C.","Less than $44000"
"48201312400","Census Tract 3124, Harris County, Texas",2056,21500,92,1721,0,0,0,236,4.5,83.7,0,0,0,11.5,95.5,980,195,785,19.9,80.1,11,184,35,750,46,934,5.6,4.5,4.7,"75% or more P.O.C.","Less than $44000"
"48201312500","Census Tract 3125, Harris County, Texas",3470,99489,1620,680,10,435,0,643,46.7,19.6,0.3,12.5,0,18.5,53.3,1683,848,835,50.39,49.61,0,848,37,798,37,1646,0,4.4,2.2,"50% - 75% P.O.C.","$86000 or more"
"48201312600","Census Tract 3126, Harris County, Texas",8023,71023,3920,948,0,1159,0,1542,48.9,11.8,0,14.4,0,19.2,51.1,4063,1083,2980,26.66,73.34,0,1083,23,2957,23,4040,0,0.8,0.6,"50% - 75% P.O.C.","$59000 - $86000"
"48201312700","Census Tract 3127, Harris County, Texas",2069,59531,284,1580,0,46,0,98,13.7,76.4,0,2.2,0,4.7,86.3,1054,329,725,31.21,68.79,0,329,42,683,42,1012,0,5.8,4,"75% or more P.O.C.","$59000 - $86000"
"48201312800","Census Tract 3128, Harris County, Texas",2813,15538,236,2051,0,130,0,326,8.4,72.9,0,4.6,0,11.6,91.6,742,119,623,16.04,83.96,8,111,55,568,63,679,6.7,8.8,8.5,"75% or more P.O.C.","Less than $44000"
"48201312900","Census Tract 3129, Harris County, Texas",4361,39797,490,3520,0,159,0,128,11.2,80.7,0,3.6,0,2.9,88.8,1724,706,1018,40.95,59.05,11,695,66,952,77,1647,1.6,6.5,4.5,"75% or more P.O.C.","Less than $44000"
"48201313000","Census Tract 3130, Harris County, Texas",2736,45237,402,2003,0,24,0,293,14.7,73.2,0,0.9,0,10.7,85.3,1237,438,799,35.41,64.59,27,411,32,767,59,1178,6.2,4,4.8,"75% or more P.O.C.","$44000 - $59000"
"48201313100","Census Tract 3131, Harris County, Texas",4049,88575,2248,550,0,718,0,483,55.5,13.6,0,17.7,0,11.9,44.5,1981,527,1454,26.6,73.4,0,527,0,1454,0,1981,0,0,0,"25% - 50% P.O.C.","$86000 or more"
"48201313200","Census Tract 3132, Harris County, Texas",3998,65213,570,2946,0,213,0,261,14.3,73.7,0,5.3,0,6.5,85.7,1768,925,843,52.32,47.68,28,897,25,818,53,1715,3,3,3,"75% or more P.O.C.","$59000 - $86000"
"48201313300","Census Tract 3133, Harris County, Texas",2491,34297,173,1909,12,18,0,360,6.9,76.6,0.5,0.7,0,14.5,93.1,1047,588,459,56.16,43.84,33,555,45,414,78,969,5.6,9.8,7.4,"75% or more P.O.C.","Less than $44000"
"48201313400","Census Tract 3134, Harris County, Texas",2972,24024,183,2348,54,39,0,325,6.2,79,1.8,1.3,0,10.9,93.8,1383,542,841,39.19,60.81,63,479,11,830,74,1309,11.6,1.3,5.4,"75% or more P.O.C.","Less than $44000"
"48201313500","Census Tract 3135, Harris County, Texas",2792,43047,81,2062,0,0,0,618,2.9,73.9,0,0,0,22.1,97.1,823,387,436,47.02,52.98,40,347,75,361,115,708,10.3,17.2,14,"75% or more P.O.C.","Less than $44000"
"48201313600","Census Tract 3136, Harris County, Texas",4650,24448,273,3292,0,91,0,972,5.9,70.8,0,2,0,20.9,94.1,1827,708,1119,38.75,61.25,56,652,213,906,269,1558,7.9,19,14.7,"75% or more P.O.C.","Less than $44000"
"48201313700","Census Tract 3137, Harris County, Texas",2210,50750,159,1806,0,15,0,217,7.2,81.7,0,0.7,0,9.8,92.8,943,486,457,51.54,48.46,40,446,45,412,85,858,8.2,9.8,9,"75% or more P.O.C.","$44000 - $59000"
"48201313800","Census Tract 3138, Harris County, Texas",4427,28885,60,3740,10,19,0,598,1.4,84.5,0.2,0.4,0,13.5,98.6,1798,351,1447,19.52,80.48,32,319,133,1314,165,1633,9.1,9.2,9.2,"75% or more P.O.C.","Less than $44000"
"48201313900","Census Tract 3139, Harris County, Texas",4623,52392,1543,1399,0,963,0,563,33.4,30.3,0,20.8,0,12.2,66.6,2527,381,2146,15.08,84.92,0,381,0,2146,0,2527,0,0,0,"50% - 75% P.O.C.","$44000 - $59000"
"48201314001","Census Tract 3140.01, Harris County, Texas",2716,63333,801,378,0,1069,0,361,29.5,13.9,0,39.4,0,13.3,70.5,1564,489,1075,31.27,68.73,0,489,9,1066,9,1555,0,0.8,0.6,"50% - 75% P.O.C.","$59000 - $86000"
"48201314002","Census Tract 3140.02, Harris County, Texas",6911,50589,2426,1259,0,2724,0,378,35.1,18.2,0,39.4,0,5.5,64.9,3892,371,3521,9.53,90.47,37,334,0,3521,37,3855,10,0,1,"50% - 75% P.O.C.","$44000 - $59000"
"48201314300","Census Tract 3143, Harris County, Texas",3890,34516,248,3155,0,151,0,281,6.4,81.1,0,3.9,0,7.2,93.6,2168,279,1889,12.87,87.13,0,279,59,1830,59,2109,0,3.1,2.7,"75% or more P.O.C.","Less than $44000"
"48201314400","Census Tract 3144, Harris County, Texas",3527,56482,1240,103,14,1700,0,350,35.2,2.9,0.4,48.2,0,9.9,64.8,1879,448,1431,23.84,76.16,0,448,0,1431,0,1879,0,0,0,"50% - 75% P.O.C.","$44000 - $59000"
"48201320100","Census Tract 3201, Harris County, Texas",2811,40545,68,131,0,77,0,2535,2.4,4.7,0,2.7,0,90.2,97.6,975,275,700,28.21,71.79,56,219,112,588,168,807,20.4,16,17.2,"75% or more P.O.C.","Less than $44000"
"48201320200","Census Tract 3202, Harris County, Texas",5437,44726,266,39,53,543,0,4535,4.9,0.7,1,10,0,83.4,95.1,1761,791,970,44.92,55.08,192,599,117,853,309,1452,24.3,12.1,17.5,"75% or more P.O.C.","$44000 - $59000"
"48201320500","Census Tract 3205, Harris County, Texas",4583,62431,280,12,0,81,0,4104,6.1,0.3,0,1.8,0,89.5,93.9,1223,976,247,79.8,20.2,254,722,31,216,285,938,26,12.6,23.3,"75% or more P.O.C.","$59000 - $86000"
"48201320601","Census Tract 3206.01, Harris County, Texas",2512,45125,184,25,0,10,0,2293,7.3,1,0,0.4,0,91.3,92.7,802,460,342,57.36,42.64,96,364,21,321,117,685,20.9,6.1,14.6,"75% or more P.O.C.","$44000 - $59000"
"48201320602","Census Tract 3206.02, Harris County, Texas",4960,32346,302,169,0,0,0,4489,6.1,3.4,0,0,0,90.5,93.9,1483,562,921,37.9,62.1,192,370,116,805,308,1175,34.2,12.6,20.8,"75% or more P.O.C.","Less than $44000"
"48201320700","Census Tract 3207, Harris County, Texas",4830,57385,344,686,0,291,0,3499,7.1,14.2,0,6,0,72.4,92.9,1622,544,1078,33.54,66.46,133,411,78,1000,211,1411,24.4,7.2,13,"75% or more P.O.C.","$44000 - $59000"
"48201320800","Census Tract 3208, Harris County, Texas",5157,41793,302,27,0,0,0,4797,5.9,0.5,0,0,0,93,94.1,1493,811,682,54.32,45.68,228,583,168,514,396,1097,28.1,24.6,26.5,"75% or more P.O.C.","Less than $44000"
"48201320900","Census Tract 3209, Harris County, Texas",7291,51848,693,318,0,25,0,6243,9.5,4.4,0,0.3,0,85.6,90.5,2242,1346,896,60.04,39.96,364,982,79,817,443,1799,27,8.8,19.8,"75% or more P.O.C.","$44000 - $59000"
"48201321000","Census Tract 3210, Harris County, Texas",9550,52909,839,674,0,53,0,7838,8.8,7.1,0,0.6,0,82.1,91.2,2562,1314,1248,51.29,48.71,358,956,332,916,690,1872,27.2,26.6,26.9,"75% or more P.O.C.","$44000 - $59000"
"48201321100","Census Tract 3211, Harris County, Texas",8469,64911,1222,1191,0,676,0,5268,14.4,14.1,0,8,0,62.2,85.6,2669,1309,1360,49.04,50.96,353,956,155,1205,508,2161,27,11.4,19,"75% or more P.O.C.","$59000 - $86000"
"48201321200","Census Tract 3212, Harris County, Texas",4030,37063,381,396,17,79,0,3157,9.5,9.8,0.4,2,0,78.3,90.5,1213,417,796,34.38,65.62,133,284,134,662,267,946,31.9,16.8,22,"75% or more P.O.C.","Less than $44000"
"48201321300","Census Tract 3213, Harris County, Texas",6765,42083,506,602,0,40,0,5543,7.5,8.9,0,0.6,0,81.9,92.5,1984,324,1660,16.33,83.67,160,164,314,1346,474,1510,49.4,18.9,23.9,"75% or more P.O.C.","Less than $44000"
"48201321401","Census Tract 3214.01, Harris County, Texas",4719,43281,314,8,0,21,0,4376,6.7,0.2,0,0.4,0,92.7,93.3,1195,877,318,73.39,26.61,241,636,96,222,337,858,27.5,30.2,28.2,"75% or more P.O.C.","Less than $44000"
"48201321402","Census Tract 3214.02, Harris County, Texas",4412,66176,540,0,0,0,0,3872,12.2,0,0,0,0,87.8,87.8,1212,837,375,69.06,30.94,301,536,50,325,351,861,36,13.3,29,"75% or more P.O.C.","$59000 - $86000"
"48201321500","Census Tract 3215, Harris County, Texas",3299,33000,120,122,10,0,0,3004,3.6,3.7,0.3,0,0,91.1,96.4,950,208,742,21.89,78.11,52,156,171,571,223,727,25,23,23.5,"75% or more P.O.C.","Less than $44000"
"48201321600","Census Tract 3216, Harris County, Texas",6913,66653,822,99,0,21,0,5869,11.9,1.4,0,0.3,0,84.9,88.1,1874,1402,472,74.81,25.19,380,1022,93,379,473,1401,27.1,19.7,25.2,"75% or more P.O.C.","$59000 - $86000"
"48201321700","Census Tract 3217, Harris County, Texas",3440,71042,567,15,0,19,0,2822,16.5,0.4,0,0.6,0,82,83.5,1002,831,171,82.93,17.07,172,659,28,143,200,802,20.7,16.4,20,"75% or more P.O.C.","$59000 - $86000"
"48201321800","Census Tract 3218, Harris County, Texas",4155,65184,195,27,0,0,0,3914,4.7,0.6,0,0,0,94.2,95.3,1091,760,331,69.66,30.34,234,526,74,257,308,783,30.8,22.4,28.2,"75% or more P.O.C.","$59000 - $86000"
"48201321900","Census Tract 3219, Harris County, Texas",6006,50379,580,12,0,16,0,5398,9.7,0.2,0,0.3,0,89.9,90.3,1496,852,644,56.95,43.05,255,597,235,409,490,1006,29.9,36.5,32.8,"75% or more P.O.C.","$44000 - $59000"
"48201322000","Census Tract 3220, Harris County, Texas",4912,39286,409,193,0,0,0,4186,8.3,3.9,0,0,0,85.2,91.7,1480,56,1424,3.78,96.22,16,40,315,1109,331,1149,28.6,22.1,22.4,"75% or more P.O.C.","Less than $44000"
"48201322100","Census Tract 3221, Harris County, Texas",4246,43179,478,26,0,0,0,3742,11.3,0.6,0,0,0,88.1,88.7,1187,596,591,50.21,49.79,81,515,194,397,275,912,13.6,32.8,23.2,"75% or more P.O.C.","Less than $44000"
"48201322200","Census Tract 3222, Harris County, Texas",1633,32232,160,4,0,5,0,1447,9.8,0.2,0,0.3,0,88.6,90.2,491,206,285,41.96,58.04,52,154,25,260,77,414,25.2,8.8,15.7,"75% or more P.O.C.","Less than $44000"
"48201322600","Census Tract 3226, Harris County, Texas",5516,53277,1478,55,7,6,0,3956,26.8,1,0.1,0.1,0,71.7,73.2,1621,1043,578,64.34,35.66,335,708,50,528,385,1236,32.1,8.7,23.8,"50% - 75% P.O.C.","$44000 - $59000"
"48201322700","Census Tract 3227, Harris County, Texas",7002,54295,1440,102,33,0,0,5418,20.6,1.5,0.5,0,0,77.4,79.4,2001,1163,838,58.12,41.88,141,1022,226,612,367,1634,12.1,27,18.3,"75% or more P.O.C.","$44000 - $59000"
"48201322800","Census Tract 3228, Harris County, Texas",6996,53616,704,0,24,62,0,6206,10.1,0,0.3,0.9,0,88.7,89.9,1691,1170,521,69.19,30.81,365,805,220,301,585,1106,31.2,42.2,34.6,"75% or more P.O.C.","$44000 - $59000"
"48201322900","Census Tract 3229, Harris County, Texas",4094,52090,308,0,0,0,0,3786,7.5,0,0,0,0,92.5,92.5,1079,692,387,64.13,35.87,163,529,168,219,331,748,23.6,43.4,30.7,"75% or more P.O.C.","$44000 - $59000"
"48201323000","Census Tract 3230, Harris County, Texas",6870,31343,377,48,0,1,0,6444,5.5,0.7,0,0,0,93.8,94.5,2035,295,1740,14.5,85.5,56,239,412,1328,468,1567,19,23.7,23,"75% or more P.O.C.","Less than $44000"
"48201323100","Census Tract 3231, Harris County, Texas",4066,37373,231,299,0,0,19,3517,5.7,7.4,0,0,0.5,86.5,94.3,1169,223,946,19.08,80.92,65,158,160,786,225,944,29.1,16.9,19.2,"75% or more P.O.C.","Less than $44000"
"48201323200","Census Tract 3232, Harris County, Texas",5727,60921,1121,134,0,22,0,4423,19.6,2.3,0,0.4,0,77.2,80.4,1584,1027,557,64.84,35.16,321,706,52,505,373,1211,31.3,9.3,23.5,"75% or more P.O.C.","$59000 - $86000"
"48201323300","Census Tract 3233, Harris County, Texas",3310,36154,483,203,0,22,0,2570,14.6,6.1,0,0.7,0,77.6,85.4,1106,338,768,30.56,69.44,36,302,79,689,115,991,10.7,10.3,10.4,"75% or more P.O.C.","Less than $44000"
"48201323400","Census Tract 3234, Harris County, Texas",8636,47818,719,119,0,106,0,7690,8.3,1.4,0,1.2,0,89,91.7,2237,1191,1046,53.24,46.76,467,724,320,726,787,1450,39.2,30.6,35.2,"75% or more P.O.C.","$44000 - $59000"
"48201323500","Census Tract 3235, Harris County, Texas",5671,31159,584,677,9,0,0,4401,10.3,11.9,0.2,0,0,77.6,89.7,1864,396,1468,21.24,78.76,109,287,135,1333,244,1620,27.5,9.2,13.1,"75% or more P.O.C.","Less than $44000"
"48201323600","Census Tract 3236, Harris County, Texas",8547,50638,2763,304,0,314,0,5045,32.3,3.6,0,3.7,0,59,67.7,3319,1803,1516,54.32,45.68,147,1656,142,1374,289,3030,8.2,9.4,8.7,"50% - 75% P.O.C.","$44000 - $59000"
"48201323701","Census Tract 3237.01, Harris County, Texas",4934,54837,1635,141,0,65,6,2934,33.1,2.9,0,1.3,0.1,59.5,66.9,1854,620,1234,33.44,66.56,28,592,92,1142,120,1734,4.5,7.5,6.5,"50% - 75% P.O.C.","$44000 - $59000"
"48201323702","Census Tract 3237.02, Harris County, Texas",3183,50980,1173,2,6,226,0,1776,36.9,0.1,0.2,7.1,0,55.8,63.1,1103,601,502,54.49,45.51,126,475,0,502,126,977,21,0,11.4,"50% - 75% P.O.C.","$44000 - $59000"
"48201323801","Census Tract 3238.01, Harris County, Texas",3820,62331,824,0,0,0,0,2961,21.6,0,0,0,0,77.5,78.4,1174,979,195,83.39,16.61,173,806,0,195,173,1001,17.7,0,14.7,"75% or more P.O.C.","$59000 - $86000"
"48201323802","Census Tract 3238.02, Harris County, Texas",5018,50250,890,99,66,59,0,3871,17.7,2,1.3,1.2,0,77.1,82.3,1593,1054,539,66.16,33.84,258,796,79,460,337,1256,24.5,14.7,21.2,"75% or more P.O.C.","$44000 - $59000"
"48201323900","Census Tract 3239, Harris County, Texas",3952,32500,1294,190,0,33,0,2378,32.7,4.8,0,0.8,0,60.2,67.3,1458,457,1001,31.34,68.66,25,432,149,852,174,1284,5.5,14.9,11.9,"50% - 75% P.O.C.","Less than $44000"
"48201324000","Census Tract 3240, Harris County, Texas",5453,74960,2283,69,0,354,0,2658,41.9,1.3,0,6.5,0,48.7,58.1,1843,1247,596,67.66,32.34,128,1119,201,395,329,1514,10.3,33.7,17.9,"50% - 75% P.O.C.","$59000 - $86000"
"48201324100","Census Tract 3241, Harris County, Texas",5463,41950,351,121,0,0,0,4919,6.4,2.2,0,0,0,90,93.6,1542,651,891,42.22,57.78,108,543,262,629,370,1172,16.6,29.4,24,"75% or more P.O.C.","Less than $44000"
"48201324200","Census Tract 3242, Harris County, Texas",1087,24880,42,16,0,0,0,1029,3.9,1.5,0,0,0,94.7,96.1,381,212,169,55.64,44.36,25,187,28,141,53,328,11.8,16.6,13.9,"75% or more P.O.C.","Less than $44000"
"48201330100","Census Tract 3301, Harris County, Texas",9589,59547,137,5468,0,26,0,3889,1.4,57,0,0.3,0,40.6,98.6,2477,1532,945,61.85,38.15,513,1019,235,710,748,1729,33.5,24.9,30.2,"75% or more P.O.C.","$59000 - $86000"
"48201330200","Census Tract 3302, Harris County, Texas",4438,50448,119,1711,0,0,0,2587,2.7,38.6,0,0,0,58.3,97.3,1301,680,621,52.27,47.73,136,544,121,500,257,1044,20,19.5,19.8,"75% or more P.O.C.","$44000 - $59000"
"48201330301","Census Tract 3303.01, Harris County, Texas",8737,62889,143,1950,0,236,30,6281,1.6,22.3,0,2.7,0.3,71.9,98.4,2244,1950,294,86.9,13.1,519,1431,0,294,519,1725,26.6,0,23.1,"75% or more P.O.C.","$59000 - $86000"
"48201330302","Census Tract 3303.02, Harris County, Texas",6540,54671,248,2456,0,48,0,3775,3.8,37.6,0,0.7,0,57.7,96.2,1755,1191,564,67.86,32.14,265,926,136,428,401,1354,22.3,24.1,22.8,"75% or more P.O.C.","$44000 - $59000"
"48201330303","Census Tract 3303.03, Harris County, Texas",4231,46825,640,1543,0,24,0,1931,15.1,36.5,0,0.6,0,45.6,84.9,1630,620,1010,38.04,61.96,92,528,64,946,156,1474,14.8,6.3,9.6,"75% or more P.O.C.","$44000 - $59000"
"48201330400","Census Tract 3304, Harris County, Texas",4863,43096,267,1735,0,0,0,2835,5.5,35.7,0,0,0,58.3,94.5,1519,804,715,52.93,47.07,142,662,128,587,270,1249,17.7,17.9,17.8,"75% or more P.O.C.","Less than $44000"
"48201330500","Census Tract 3305, Harris County, Texas",4982,51437,107,1713,0,148,0,3006,2.1,34.4,0,3,0,60.3,97.9,1337,825,512,61.71,38.29,212,613,163,349,375,962,25.7,31.8,28,"75% or more P.O.C.","$44000 - $59000"
"48201330600","Census Tract 3306, Harris County, Texas",7239,55208,228,3514,29,0,0,3468,3.1,48.5,0.4,0,0,47.9,96.9,2177,1597,580,73.36,26.64,274,1323,137,443,411,1766,17.2,23.6,18.9,"75% or more P.O.C.","$44000 - $59000"
"48201330700","Census Tract 3307, Harris County, Texas",9966,48750,295,3308,0,229,0,6009,3,33.2,0,2.3,0,60.3,97,2504,1591,913,63.54,36.46,456,1135,335,578,791,1713,28.7,36.7,31.6,"75% or more P.O.C.","$44000 - $59000"
"48201330800","Census Tract 3308, Harris County, Texas",13816,79807,829,8092,0,304,0,4528,6,58.6,0,2.2,0,32.8,94,4637,3537,1100,76.28,23.72,427,3110,104,996,531,4106,12.1,9.5,11.5,"75% or more P.O.C.","$59000 - $86000"
"48201330900","Census Tract 3309, Harris County, Texas",13284,60634,985,6334,0,315,0,5426,7.4,47.7,0,2.4,0,40.8,92.6,4310,2542,1768,58.98,41.02,460,2082,409,1359,869,3441,18.1,23.1,20.2,"75% or more P.O.C.","$59000 - $86000"
"48201331100","Census Tract 3311, Harris County, Texas",4295,26903,109,2444,23,0,0,1719,2.5,56.9,0.5,0,0,40,97.5,1534,656,878,42.76,57.24,124,532,108,770,232,1302,18.9,12.3,15.1,"75% or more P.O.C.","Less than $44000"
"48201331200","Census Tract 3312, Harris County, Texas",3637,26130,35,3345,0,26,0,170,1,92,0,0.7,0,4.7,99,1428,438,990,30.67,69.33,30,408,201,789,231,1197,6.8,20.3,16.2,"75% or more P.O.C.","Less than $44000"
"48201331300","Census Tract 3313, Harris County, Texas",5220,42250,97,4073,0,15,0,1035,1.9,78,0,0.3,0,19.8,98.1,1701,1132,569,66.55,33.45,157,975,137,432,294,1407,13.9,24.1,17.3,"75% or more P.O.C.","Less than $44000"
"48201331400","Census Tract 3314, Harris County, Texas",2414,13886,0,2107,0,76,0,0,0,87.3,0,3.1,0,0,100,1147,38,1109,3.31,96.69,0,38,75,1034,75,1072,0,6.8,6.5,"75% or more P.O.C.","Less than $44000"
"48201331500","Census Tract 3315, Harris County, Texas",10258,57721,318,8284,68,20,0,1382,3.1,80.8,0.7,0.2,0,13.5,96.9,3003,2130,873,70.93,29.07,187,1943,242,631,429,2574,8.8,27.7,14.3,"75% or more P.O.C.","$44000 - $59000"
"48201331601","Census Tract 3316.01, Harris County, Texas",6762,35962,61,5864,0,52,0,650,0.9,86.7,0,0.8,0,9.6,99.1,2480,1677,803,67.62,32.38,94,1583,84,719,178,2302,5.6,10.5,7.2,"75% or more P.O.C.","Less than $44000"
"48201331602","Census Tract 3316.02, Harris County, Texas",1946,37347,107,1324,0,30,0,417,5.5,68,0,1.5,0,21.4,94.5,664,184,480,27.71,72.29,3,181,86,394,89,575,1.6,17.9,13.4,"75% or more P.O.C.","Less than $44000"
"48201331700","Census Tract 3317, Harris County, Texas",4933,31169,77,3470,10,40,0,1336,1.6,70.3,0.2,0.8,0,27.1,98.4,1480,827,653,55.88,44.12,121,706,150,503,271,1209,14.6,23,18.3,"75% or more P.O.C.","Less than $44000"
"48201331800","Census Tract 3318, Harris County, Texas",3985,36250,101,3139,0,20,0,672,2.5,78.8,0,0.5,0,16.9,97.5,1172,537,635,45.82,54.18,121,416,153,482,274,898,22.5,24.1,23.4,"75% or more P.O.C.","Less than $44000"
"48201331900","Census Tract 3319, Harris County, Texas",3899,51021,46,2852,0,0,0,1001,1.2,73.1,0,0,0,25.7,98.8,1199,944,255,78.73,21.27,168,776,44,211,212,987,17.8,17.3,17.7,"75% or more P.O.C.","$44000 - $59000"
"48201332000","Census Tract 3320, Harris County, Texas",6785,29441,164,4490,0,60,0,2023,2.4,66.2,0,0.9,0,29.8,97.6,2010,849,1161,42.24,57.76,139,710,355,806,494,1516,16.4,30.6,24.6,"75% or more P.O.C.","Less than $44000"
"48201332100","Census Tract 3321, Harris County, Texas",3588,39053,0,1359,0,0,0,2229,0,37.9,0,0,0,62.1,100,949,534,415,56.27,43.73,120,414,179,236,299,650,22.5,43.1,31.5,"75% or more P.O.C.","Less than $44000"
"48201332200","Census Tract 3322, Harris County, Texas",4892,45786,30,2846,0,0,0,2002,0.6,58.2,0,0,0,40.9,99.4,1375,933,442,67.85,32.15,312,621,103,339,415,960,33.4,23.3,30.2,"75% or more P.O.C.","$44000 - $59000"
"48201332300","Census Tract 3323, Harris County, Texas",3165,36188,29,2151,0,0,0,985,0.9,68,0,0,0,31.1,99.1,967,579,388,59.88,40.12,91,488,82,306,173,794,15.7,21.1,17.9,"75% or more P.O.C.","Less than $44000"
"48201332400","Census Tract 3324, Harris County, Texas",4115,35875,0,3119,0,0,45,750,0,75.8,0,0,1.1,18.2,100,1419,906,513,63.85,36.15,96,810,101,412,197,1222,10.6,19.7,13.9,"75% or more P.O.C.","Less than $44000"
"48201332500","Census Tract 3325, Harris County, Texas",2949,42146,164,1238,6,0,0,1541,5.6,42,0.2,0,0,52.3,94.4,1041,870,171,83.57,16.43,110,760,32,139,142,899,12.6,18.7,13.6,"75% or more P.O.C.","Less than $44000"
"48201332600","Census Tract 3326, Harris County, Texas",7359,39761,172,2266,0,13,0,4740,2.3,30.8,0,0.2,0,64.4,97.7,2136,1125,1011,52.67,47.33,209,916,249,762,458,1678,18.6,24.6,21.4,"75% or more P.O.C.","Less than $44000"
"48201332700","Census Tract 3327, Harris County, Texas",2555,48750,59,11,0,23,0,2462,2.3,0.4,0,0.9,0,96.4,97.7,750,444,306,59.2,40.8,100,344,66,240,166,584,22.5,21.6,22.1,"75% or more P.O.C.","$44000 - $59000"
"48201332800","Census Tract 3328, Harris County, Texas",5011,33326,228,651,0,0,0,4132,4.5,13,0,0,0,82.5,95.5,1473,384,1089,26.07,73.93,127,257,224,865,351,1122,33.1,20.6,23.8,"75% or more P.O.C.","Less than $44000"
"48201332900","Census Tract 3329, Harris County, Texas",5422,43327,244,243,21,36,0,4878,4.5,4.5,0.4,0.7,0,90,95.5,1417,596,821,42.06,57.94,126,470,282,539,408,1009,21.1,34.3,28.8,"75% or more P.O.C.","Less than $44000"
"48201333000","Census Tract 3330, Harris County, Texas",4027,59057,302,154,0,0,0,3553,7.5,3.8,0,0,0,88.2,92.5,1040,827,213,79.52,20.48,269,558,52,161,321,719,32.5,24.4,30.9,"75% or more P.O.C.","$59000 - $86000"
"48201333100","Census Tract 3331, Harris County, Texas",4374,46494,308,637,0,1100,0,2329,7,14.6,0,25.1,0,53.2,93,1339,615,724,45.93,54.07,55,560,151,573,206,1133,8.9,20.9,15.4,"75% or more P.O.C.","$44000 - $59000"
"48201333201","Census Tract 3332.01, Harris County, Texas",4691,43189,275,1102,0,144,0,3170,5.9,23.5,0,3.1,0,67.6,94.1,1833,514,1319,28.04,71.96,100,414,100,1219,200,1633,19.5,7.6,10.9,"75% or more P.O.C.","Less than $44000"
"48201333202","Census Tract 3332.02, Harris County, Texas",5949,33591,451,2332,0,149,0,2998,7.6,39.2,0,2.5,0,50.4,92.4,2158,373,1785,17.28,82.72,72,301,251,1534,323,1835,19.3,14.1,15,"75% or more P.O.C.","Less than $44000"
"48201333300","Census Tract 3333, Harris County, Texas",10222,38836,572,1186,0,221,0,8126,5.6,11.6,0,2.2,0,79.5,94.4,3042,782,2260,25.71,74.29,291,491,201,2059,492,2550,37.2,8.9,16.2,"75% or more P.O.C.","Less than $44000"
"48201333500","Census Tract 3335, Harris County, Texas",6236,39436,384,1577,20,0,0,4255,6.2,25.3,0.3,0,0,68.2,93.8,2059,630,1429,30.6,69.4,138,492,195,1234,333,1726,21.9,13.6,16.2,"75% or more P.O.C.","Less than $44000"
"48201333600","Census Tract 3336, Harris County, Texas",4452,70609,684,243,0,38,0,3431,15.4,5.5,0,0.9,0,77.1,84.6,1183,907,276,76.67,23.33,273,634,39,237,312,871,30.1,14.1,26.4,"75% or more P.O.C.","$59000 - $86000"
"48201333700","Census Tract 3337, Harris County, Texas",3565,48375,222,137,7,175,0,2956,6.2,3.8,0.2,4.9,0,82.9,93.8,990,717,273,72.42,27.58,128,589,118,155,246,744,17.9,43.2,24.8,"75% or more P.O.C.","$44000 - $59000"
"48201333800","Census Tract 3338, Harris County, Texas",11520,55572,648,1642,0,235,0,8962,5.6,14.3,0,2,0,77.8,94.4,3165,1799,1366,56.84,43.16,370,1429,399,967,769,2396,20.6,29.2,24.3,"75% or more P.O.C.","$44000 - $59000"
"48201333901","Census Tract 3339.01, Harris County, Texas",10209,80987,689,1261,0,1794,19,5926,6.7,12.4,0,17.6,0.2,58,93.3,2610,2348,262,89.96,10.04,779,1569,96,166,875,1735,33.2,36.6,33.5,"75% or more P.O.C.","$59000 - $86000"
"48201333902","Census Tract 3339.02, Harris County, Texas",9431,53442,1339,1203,0,542,0,6208,14.2,12.8,0,5.7,0,65.8,85.8,3157,1449,1708,45.9,54.1,222,1227,178,1530,400,2757,15.3,10.4,12.7,"75% or more P.O.C.","$44000 - $59000"
"48201334001","Census Tract 3340.01, Harris County, Texas",3746,43856,469,1328,0,677,0,1272,12.5,35.5,0,18.1,0,34,87.5,1296,384,912,29.63,70.37,58,326,63,849,121,1175,15.1,6.9,9.3,"75% or more P.O.C.","Less than $44000"
"48201334002","Census Tract 3340.02, Harris County, Texas",2338,58935,472,890,0,113,7,856,20.2,38.1,0,4.8,0.3,36.6,79.8,1114,69,1045,6.19,93.81,4,65,15,1030,19,1095,5.8,1.4,1.7,"75% or more P.O.C.","$44000 - $59000"
"48201334003","Census Tract 3340.03, Harris County, Texas",6478,57049,1158,1366,14,523,0,3337,17.9,21.1,0.2,8.1,0,51.5,82.1,2372,1223,1149,51.56,48.44,234,989,77,1072,311,2061,19.1,6.7,13.1,"75% or more P.O.C.","$44000 - $59000"
"48201334100","Census Tract 3341, Harris County, Texas",14703,58527,1585,8093,105,799,0,3708,10.8,55,0.7,5.4,0,25.2,89.2,5761,2510,3251,43.57,56.43,446,2064,45,3206,491,5270,17.8,1.4,8.5,"75% or more P.O.C.","$44000 - $59000"
"48201340100","Census Tract 3401, Harris County, Texas",6957,47311,1723,1245,22,1079,0,2823,24.8,17.9,0.3,15.5,0,40.6,75.2,2608,902,1706,34.59,65.41,255,647,65,1641,320,2288,28.3,3.8,12.3,"75% or more P.O.C.","$44000 - $59000"
"48201340201","Census Tract 3402.01, Harris County, Texas",1546,113333,732,89,0,384,0,314,47.3,5.8,0,24.8,0,20.3,52.7,606,519,87,85.64,14.36,50,469,0,87,50,556,9.6,0,8.3,"50% - 75% P.O.C.","$86000 or more"
"48201340202","Census Tract 3402.02, Harris County, Texas",5356,147700,2976,97,0,1342,0,871,55.6,1.8,0,25.1,0,16.3,44.4,1740,1491,249,85.69,14.31,187,1304,10,239,197,1543,12.5,4,11.3,"25% - 50% P.O.C.","$86000 or more"
"48201340203","Census Tract 3402.03, Harris County, Texas",3989,126392,2757,109,60,716,0,284,69.1,2.7,1.5,17.9,0,7.1,30.9,1609,1084,525,67.37,32.63,78,1006,0,525,78,1531,7.2,0,4.8,"25% - 50% P.O.C.","$86000 or more"
"48201340301","Census Tract 3403.01, Harris County, Texas",3878,189491,2526,127,0,819,0,347,65.1,3.3,0,21.1,0,8.9,34.9,1393,1339,54,96.12,3.88,170,1169,0,54,170,1223,12.7,0,12.2,"25% - 50% P.O.C.","$86000 or more"
"48201340302","Census Tract 3403.02, Harris County, Texas",6728,113737,4482,138,17,746,0,1274,66.6,2.1,0.3,11.1,0,18.9,33.4,2379,2267,112,95.29,4.71,282,1985,0,112,282,2097,12.4,0,11.9,"25% - 50% P.O.C.","$86000 or more"
"48201340400","Census Tract 3404, Harris County, Texas",1319,166579,1020,36,11,82,0,99,77.3,2.7,0.8,6.2,0,7.5,22.7,522,519,3,99.43,0.57,36,483,0,3,36,486,6.9,0,6.9,"Less than 25% P.O.C.","$86000 or more"
"48201340500","Census Tract 3405, Harris County, Texas",6899,45948,3208,680,0,481,0,2176,46.5,9.9,0,7,0,31.5,53.5,2781,1230,1551,44.23,55.77,106,1124,141,1410,247,2534,8.6,9.1,8.9,"50% - 75% P.O.C.","$44000 - $59000"
"48201340600","Census Tract 3406, Harris County, Texas",2508,91250,1832,65,7,122,14,447,73,2.6,0.3,4.9,0.6,17.8,27,959,921,38,96.04,3.96,90,831,0,38,90,869,9.8,0,9.4,"25% - 50% P.O.C.","$86000 or more"
"48201340700","Census Tract 3407, Harris County, Texas",8000,76073,3230,807,0,554,0,2601,40.4,10.1,0,6.9,0,32.5,59.6,2649,1944,705,73.39,26.61,291,1653,137,568,428,2221,15,19.4,16.2,"50% - 75% P.O.C.","$59000 - $86000"
"48201340800","Census Tract 3408, Harris County, Texas",5955,127583,3449,394,4,912,0,1085,57.9,6.6,0.1,15.3,0,18.2,42.1,2053,1864,189,90.79,9.21,107,1757,15,174,122,1931,5.7,7.9,5.9,"25% - 50% P.O.C.","$86000 or more"
"48201340900","Census Tract 3409, Harris County, Texas",4522,53056,1647,483,50,515,0,1768,36.4,10.7,1.1,11.4,0,39.1,63.6,1966,296,1670,15.06,84.94,51,245,126,1544,177,1789,17.2,7.5,9,"50% - 75% P.O.C.","$44000 - $59000"
"48201341000","Census Tract 3410, Harris County, Texas",8759,59191,4001,1326,0,536,0,2577,45.7,15.1,0,6.1,0,29.4,54.3,3984,1185,2799,29.74,70.26,17,1168,48,2751,65,3919,1.4,1.7,1.6,"50% - 75% P.O.C.","$59000 - $86000"
"48201341100","Census Tract 3411, Harris County, Texas",4268,62008,1695,685,0,248,0,1488,39.7,16,0,5.8,0,34.9,60.3,1806,219,1587,12.13,87.87,0,219,79,1508,79,1727,0,5,4.4,"50% - 75% P.O.C.","$59000 - $86000"
"48201341201","Census Tract 3412.01, Harris County, Texas",3977,41705,1485,1115,0,60,0,1266,37.3,28,0,1.5,0,31.8,62.7,1613,167,1446,10.35,89.65,13,154,57,1389,70,1543,7.8,3.9,4.3,"50% - 75% P.O.C.","Less than $44000"
"48201341202","Census Tract 3412.02, Harris County, Texas",4643,84922,2957,90,0,237,0,1359,63.7,1.9,0,5.1,0,29.3,36.3,2009,1002,1007,49.88,50.12,111,891,25,982,136,1873,11.1,2.5,6.8,"25% - 50% P.O.C.","$59000 - $86000"
"48201341301","Census Tract 3413.01, Harris County, Texas",5214,50563,3070,519,0,526,0,775,58.9,10,0,10.1,0,14.9,41.1,2483,862,1621,34.72,65.28,0,862,0,1621,0,2483,0,0,0,"25% - 50% P.O.C.","$44000 - $59000"
"48201341302","Census Tract 3413.02, Harris County, Texas",2896,51309,1310,415,12,197,0,724,45.2,14.3,0.4,6.8,0,25,54.8,1521,130,1391,8.55,91.45,0,130,71,1320,71,1450,0,5.1,4.7,"50% - 75% P.O.C.","$44000 - $59000"
"48201341400","Census Tract 3414, Harris County, Texas",4900,116852,3917,207,0,129,0,561,79.9,4.2,0,2.6,0,11.4,20.1,1858,1453,405,78.2,21.8,107,1346,0,405,107,1751,7.4,0,5.8,"Less than 25% P.O.C.","$86000 or more"
"48201341501","Census Tract 3415.01, Harris County, Texas",6467,86204,4532,276,32,55,0,1462,70.1,4.3,0.5,0.9,0,22.6,29.9,2450,1555,895,63.47,36.53,124,1431,36,859,160,2290,8,4,6.5,"25% - 50% P.O.C.","$86000 or more"
"48201341502","Census Tract 3415.02, Harris County, Texas",4376,84968,3383,268,0,11,0,682,77.3,6.1,0,0.3,0,15.6,22.7,1911,981,930,51.33,48.67,120,861,16,914,136,1775,12.2,1.7,7.1,"Less than 25% P.O.C.","$59000 - $86000"
"48201341600","Census Tract 3416, Harris County, Texas",6805,97288,4772,138,19,270,0,1445,70.1,2,0.3,4,0,21.2,29.9,2533,1659,874,65.5,34.5,94,1565,127,747,221,2312,5.7,14.5,8.7,"25% - 50% P.O.C.","$86000 or more"
"48201341700","Census Tract 3417, Harris County, Texas",3076,89188,2402,29,14,13,0,610,78.1,0.9,0.5,0.4,0,19.8,21.9,1095,940,155,85.84,14.16,133,807,19,136,152,943,14.1,12.3,13.9,"Less than 25% P.O.C.","$86000 or more"
"48201341800","Census Tract 3418, Harris County, Texas",2358,86757,1512,178,0,74,0,516,64.1,7.5,0,3.1,0,21.9,35.9,832,623,209,74.88,25.12,30,593,69,140,99,733,4.8,33,11.9,"25% - 50% P.O.C.","$86000 or more"
"48201342001","Census Tract 3420.01, Harris County, Texas",7044,112778,4257,86,0,356,0,2082,60.4,1.2,0,5.1,0,29.6,39.6,2318,2106,212,90.85,9.15,328,1778,44,168,372,1946,15.6,20.8,16,"25% - 50% P.O.C.","$86000 or more"
"48201342002","Census Tract 3420.02, Harris County, Texas",3352,98261,1626,36,0,343,0,1330,48.5,1.1,0,10.2,0,39.7,51.5,1347,852,495,63.25,36.75,57,795,0,495,57,1290,6.7,0,4.2,"50% - 75% P.O.C.","$86000 or more"
"48201342100","Census Tract 3421, Harris County, Texas",4323,75453,1570,49,0,144,0,2460,36.3,1.1,0,3.3,0,56.9,63.7,1449,1257,192,86.75,13.25,207,1050,19,173,226,1223,16.5,9.9,15.6,"50% - 75% P.O.C.","$59000 - $86000"
"48201342200","Census Tract 3422, Harris County, Texas",3883,60822,1374,167,17,10,0,2264,35.4,4.3,0.4,0.3,0,58.3,64.6,1271,728,543,57.28,42.72,127,601,89,454,216,1055,17.4,16.4,17,"50% - 75% P.O.C.","$59000 - $86000"
"48201342300","Census Tract 3423, Harris County, Texas",8278,64702,2505,304,0,47,0,5231,30.3,3.7,0,0.6,0,63.2,69.7,2338,1215,1123,51.97,48.03,219,996,340,783,559,1779,18,30.3,23.9,"50% - 75% P.O.C.","$59000 - $86000"
"48201342400","Census Tract 3424, Harris County, Texas",3436,62386,1192,96,11,0,0,2039,34.7,2.8,0.3,0,0,59.3,65.3,1178,669,509,56.79,43.21,85,584,85,424,170,1008,12.7,16.7,14.4,"50% - 75% P.O.C.","$59000 - $86000"
"48201342500","Census Tract 3425, Harris County, Texas",5653,72966,3849,23,22,0,0,1698,68.1,0.4,0.4,0,0,30,31.9,2125,1397,728,65.74,34.26,46,1351,107,621,153,1972,3.3,14.7,7.2,"25% - 50% P.O.C.","$59000 - $86000"
"48201342700","Census Tract 3427, Harris County, Texas",4891,68550,3565,61,52,64,0,1119,72.9,1.2,1.1,1.3,0,22.9,27.1,1709,1263,446,73.9,26.1,159,1104,54,392,213,1496,12.6,12.1,12.5,"25% - 50% P.O.C.","$59000 - $86000"
"48201342800","Census Tract 3428, Harris County, Texas",8650,117500,5645,0,0,380,0,2571,65.3,0,0,4.4,0,29.7,34.7,2720,2670,50,98.16,1.84,483,2187,17,33,500,2220,18.1,34,18.4,"25% - 50% P.O.C.","$86000 or more"
"48201342900","Census Tract 3429, Harris County, Texas",6383,85096,3915,16,0,23,0,2180,61.3,0.3,0,0.4,0,34.2,38.7,2238,1853,385,82.8,17.2,168,1685,64,321,232,2006,9.1,16.6,10.4,"25% - 50% P.O.C.","$59000 - $86000"
"48201343000","Census Tract 3430, Harris County, Texas",7043,65100,3718,375,0,69,0,2840,52.8,5.3,0,1,0,40.3,47.2,2588,1475,1113,56.99,43.01,196,1279,91,1022,287,2301,13.3,8.2,11.1,"25% - 50% P.O.C.","$59000 - $86000"
"48201343100","Census Tract 3431, Harris County, Texas",4590,89856,2860,75,85,23,0,1412,62.3,1.6,1.9,0.5,0,30.8,37.7,1665,1426,239,85.65,14.35,130,1296,0,239,130,1535,9.1,0,7.8,"25% - 50% P.O.C.","$86000 or more"
"48201343200","Census Tract 3432, Harris County, Texas",5037,109050,2682,173,0,14,0,1874,53.2,3.4,0,0.3,0,37.2,46.8,1658,1469,189,88.6,11.4,181,1288,44,145,225,1433,12.3,23.3,13.6,"25% - 50% P.O.C.","$86000 or more"
"48201343301","Census Tract 3433.01, Harris County, Texas",4951,86522,2675,87,0,120,0,1943,54,1.8,0,2.4,0,39.2,46,1502,1366,136,90.95,9.05,256,1110,13,123,269,1233,18.7,9.6,17.9,"25% - 50% P.O.C.","$86000 or more"
"48201343302","Census Tract 3433.02, Harris County, Texas",4815,76831,2763,495,0,43,0,1325,57.4,10.3,0,0.9,0,27.5,42.6,1741,1386,355,79.61,20.39,184,1202,0,355,184,1557,13.3,0,10.6,"25% - 50% P.O.C.","$59000 - $86000"
"48201343600","Census Tract 3436, Harris County, Texas",2907,65516,1804,65,0,28,0,948,62.1,2.2,0,1,0,32.6,37.9,1197,856,341,71.51,28.49,82,774,5,336,87,1110,9.6,1.5,7.3,"25% - 50% P.O.C.","$59000 - $86000"
"48201343700","Census Tract 3437, Harris County, Texas",3946,57973,1637,643,2,0,0,1597,41.5,16.3,0.1,0,0,40.5,58.5,1426,611,815,42.85,57.15,43,568,125,690,168,1258,7,15.3,11.8,"50% - 75% P.O.C.","$44000 - $59000"
"48201350100","Census Tract 3501, Harris County, Texas",17635,94017,4453,2573,0,4493,0,5477,25.3,14.6,0,25.5,0,31.1,74.7,5297,4664,633,88.05,11.95,814,3850,139,494,953,4344,17.5,22,18,"50% - 75% P.O.C.","$86000 or more"
"48201350200","Census Tract 3502, Harris County, Texas",8612,69118,1513,1133,15,913,0,4983,17.6,13.2,0.2,10.6,0,57.9,82.4,2684,2202,482,82.04,17.96,382,1820,46,436,428,2256,17.3,9.5,15.9,"75% or more P.O.C.","$59000 - $86000"
"48201350300","Census Tract 3503, Harris County, Texas",6731,105741,1987,764,0,365,0,3521,29.5,11.4,0,5.4,0,52.3,70.5,2064,1918,146,92.93,7.07,333,1585,91,55,424,1640,17.4,62.3,20.5,"50% - 75% P.O.C.","$86000 or more"
"48201350400","Census Tract 3504, Harris County, Texas",6756,61071,921,919,0,627,13,4207,13.6,13.6,0,9.3,0.2,62.3,86.4,1980,1222,758,61.72,38.28,246,976,140,618,386,1594,20.1,18.5,19.5,"75% or more P.O.C.","$59000 - $86000"
"48201350500","Census Tract 3505, Harris County, Texas",7851,45707,831,1303,0,1357,0,4224,10.6,16.6,0,17.3,0,53.8,89.4,2415,1436,979,59.46,40.54,384,1052,187,792,571,1844,26.7,19.1,23.6,"75% or more P.O.C.","$44000 - $59000"
"48201350601","Census Tract 3506.01, Harris County, Texas",4979,73707,2555,527,0,250,0,1373,51.3,10.6,0,5,0,27.6,48.7,1832,1015,817,55.4,44.6,93,922,91,726,184,1648,9.2,11.1,10,"25% - 50% P.O.C.","$59000 - $86000"
"48201350602","Census Tract 3506.02, Harris County, Texas",9329,101569,4643,944,0,971,0,2261,49.8,10.1,0,10.4,0,24.2,50.2,2962,2318,644,78.26,21.74,239,2079,64,580,303,2659,10.3,9.9,10.2,"50% - 75% P.O.C.","$86000 or more"
"48201350700","Census Tract 3507, Harris County, Texas",2216,93266,1470,138,10,17,0,522,66.3,6.2,0.5,0.8,0,23.6,33.7,749,630,119,84.11,15.89,57,573,46,73,103,646,9,38.7,13.8,"25% - 50% P.O.C.","$86000 or more"
"48201350801","Census Tract 3508.01, Harris County, Texas",5391,63964,2875,430,37,166,0,1593,53.3,8,0.7,3.1,0,29.5,46.7,1940,932,1008,48.04,51.96,118,814,68,940,186,1754,12.7,6.7,9.6,"25% - 50% P.O.C.","$59000 - $86000"
"48201350802","Census Tract 3508.02, Harris County, Texas",8737,74893,4012,772,17,1556,0,2045,45.9,8.8,0.2,17.8,0,23.4,54.1,2848,1581,1267,55.51,44.49,370,1211,265,1002,635,2213,23.4,20.9,22.3,"50% - 75% P.O.C.","$59000 - $86000"
"48201410100","Census Tract 4101, Harris County, Texas",4811,58778,1947,1261,21,285,0,1138,40.5,26.2,0.4,5.9,0,23.7,59.5,2710,753,1957,27.79,72.21,0,753,11,1946,11,2699,0,0.6,0.4,"50% - 75% P.O.C.","$44000 - $59000"
"48201410200","Census Tract 4102, Harris County, Texas",5576,133355,3708,74,0,553,0,1059,66.5,1.3,0,9.9,0,19,33.5,3072,979,2093,31.87,68.13,0,979,0,2093,0,3072,0,0,0,"25% - 50% P.O.C.","$86000 or more"
"48201410300","Census Tract 4103, Harris County, Texas",3030,106705,2071,104,14,280,0,499,68.3,3.4,0.5,9.2,0,16.5,31.7,1822,890,932,48.85,51.15,0,890,0,932,0,1822,0,0,0,"25% - 50% P.O.C.","$86000 or more"
"48201410401","Census Tract 4104.01, Harris County, Texas",4019,149750,3103,0,0,344,0,341,77.2,0,0,8.6,0,8.5,22.8,2064,1430,634,69.28,30.72,21,1409,0,634,21,2043,1.5,0,1,"Less than 25% P.O.C.","$86000 or more"
"48201410402","Census Tract 4104.02, Harris County, Texas",2433,109620,1705,69,0,321,0,312,70.1,2.8,0,13.2,0,12.8,29.9,1439,758,681,52.68,47.32,9,749,0,681,9,1430,1.2,0,0.6,"25% - 50% P.O.C.","$86000 or more"
"48201410500","Census Tract 4105, Harris County, Texas",4560,93214,3192,89,26,283,19,831,70,2,0.6,6.2,0.4,18.2,30,2554,1221,1333,47.81,52.19,16,1205,40,1293,56,2498,1.3,3,2.2,"25% - 50% P.O.C.","$86000 or more"
"48201410600","Census Tract 4106, Harris County, Texas",4899,79347,3038,716,17,310,0,728,62,14.6,0.3,6.3,0,14.9,38,3212,392,2820,12.2,87.8,17,375,0,2820,17,3195,4.3,0,0.5,"25% - 50% P.O.C.","$59000 - $86000"
"48201410701","Census Tract 4107.01, Harris County, Texas",4001,81979,2615,249,0,406,0,550,65.4,6.2,0,10.1,0,13.7,34.6,2481,1028,1453,41.43,58.57,0,1028,0,1453,0,2481,0,0,0,"25% - 50% P.O.C.","$59000 - $86000"
"48201410702","Census Tract 4107.02, Harris County, Texas",2768,60167,1655,401,0,246,7,409,59.8,14.5,0,8.9,0.3,14.8,40.2,1552,251,1301,16.17,83.83,0,251,0,1301,0,1552,0,0,0,"25% - 50% P.O.C.","$59000 - $86000"
"48201410800","Census Tract 4108, Harris County, Texas",4226,70404,2861,116,46,271,0,671,67.7,2.7,1.1,6.4,0,15.9,32.3,2515,713,1802,28.35,71.65,55,658,19,1783,74,2441,7.7,1.1,2.9,"25% - 50% P.O.C.","$59000 - $86000"
"48201410900","Census Tract 4109, Harris County, Texas",3198,100514,2120,80,40,518,0,427,66.3,2.5,1.3,16.2,0,13.4,33.7,1746,582,1164,33.33,66.67,47,535,15,1149,62,1684,8.1,1.3,3.6,"25% - 50% P.O.C.","$86000 or more"
"48201411000","Census Tract 4110, Harris County, Texas",5175,95833,3652,84,0,673,14,455,70.6,1.6,0,13,0.3,8.8,29.4,3366,763,2603,22.67,77.33,0,763,0,2603,0,3366,0,0,0,"25% - 50% P.O.C.","$86000 or more"
"48201411100","Census Tract 4111, Harris County, Texas",3741,174583,2210,288,55,636,0,552,59.1,7.7,1.5,17,0,14.8,40.9,1469,1131,338,76.99,23.01,111,1020,27,311,138,1331,9.8,8,9.4,"25% - 50% P.O.C.","$86000 or more"
"48201411200","Census Tract 4112, Harris County, Texas",1871,222031,1577,0,0,125,0,148,84.3,0,0,6.7,0,7.9,15.7,679,612,67,90.13,9.87,74,538,16,51,90,589,12.1,23.9,13.3,"Less than 25% P.O.C.","$86000 or more"
"48201411300","Census Tract 4113, Harris County, Texas",4618,97953,2793,207,18,702,0,671,60.5,4.5,0.4,15.2,0,14.5,39.5,2689,601,2088,22.35,77.65,0,601,21,2067,21,2668,0,1,0.8,"25% - 50% P.O.C.","$86000 or more"
"48201411400","Census Tract 4114, Harris County, Texas",2810,250001,2572,17,0,12,0,201,91.5,0.6,0,0.4,0,7.2,8.5,1177,1023,154,86.92,13.08,96,927,0,154,96,1081,9.4,0,8.2,"Less than 25% P.O.C.","$86000 or more"
"48201411501","Census Tract 4115.01, Harris County, Texas",7519,89430,4596,441,0,1392,0,1009,61.1,5.9,0,18.5,0,13.4,38.9,4388,876,3512,19.96,80.04,94,782,0,3512,94,4294,10.7,0,2.1,"25% - 50% P.O.C.","$86000 or more"
"48201411502","Census Tract 4115.02, Harris County, Texas",4146,87274,2673,128,0,567,0,722,64.5,3.1,0,13.7,0,17.4,35.5,2345,471,1874,20.09,79.91,0,471,0,1874,0,2345,0,0,0,"25% - 50% P.O.C.","$86000 or more"
"48201411600","Census Tract 4116, Harris County, Texas",2425,171111,1993,136,0,97,0,148,82.2,5.6,0,4,0,6.1,17.8,1084,822,262,75.83,24.17,49,773,0,262,49,1035,6,0,4.5,"Less than 25% P.O.C.","$86000 or more"
"48201411700","Census Tract 4117, Harris County, Texas",3476,76000,1714,634,0,352,0,648,49.3,18.2,0,10.1,0,18.6,50.7,1914,89,1825,4.65,95.35,0,89,18,1807,18,1896,0,1,0.9,"50% - 75% P.O.C.","$59000 - $86000"
"48201411800","Census Tract 4118, Harris County, Texas",5447,81515,3533,231,0,682,0,899,64.9,4.2,0,12.5,0,16.5,35.1,3089,1111,1978,35.97,64.03,17,1094,0,1978,17,3072,1.5,0,0.6,"25% - 50% P.O.C.","$59000 - $86000"
"48201411900","Census Tract 4119, Harris County, Texas",3298,84539,2708,6,0,220,0,220,82.1,0.2,0,6.7,0,6.7,17.9,1681,808,873,48.07,51.93,22,786,14,859,36,1645,2.7,1.6,2.1,"Less than 25% P.O.C.","$59000 - $86000"
"48201412000","Census Tract 4120, Harris County, Texas",3967,184667,3006,98,0,332,0,400,75.8,2.5,0,8.4,0,10.1,24.2,1628,1058,570,64.99,35.01,102,956,32,538,134,1494,9.6,5.6,8.2,"Less than 25% P.O.C.","$86000 or more"
"48201412100","Census Tract 4121, Harris County, Texas",2836,NA,1103,424,0,698,0,459,38.9,15,0,24.6,0,16.2,61.1,0,0,0,NA,NA,0,0,0,0,0,0,NA,NA,NA,"50% - 75% P.O.C.","N/A"
"48201412200","Census Tract 4122, Harris County, Texas",5953,135625,3930,163,0,1028,0,527,66,2.7,0,17.3,0,8.9,34,2179,1294,885,59.39,40.61,185,1109,32,853,217,1962,14.3,3.6,10,"25% - 50% P.O.C.","$86000 or more"
"48201412300","Census Tract 4123, Harris County, Texas",7063,250001,5423,0,87,850,0,389,76.8,0,1.2,12,0,5.5,23.2,2527,2305,222,91.21,8.79,225,2080,15,207,240,2287,9.8,6.8,9.5,"Less than 25% P.O.C.","$86000 or more"
"48201412400","Census Tract 4124, Harris County, Texas",4759,250001,3705,71,0,575,0,285,77.9,1.5,0,12.1,0,6,22.1,1672,1503,169,89.89,10.11,206,1297,0,169,206,1466,13.7,0,12.3,"Less than 25% P.O.C.","$86000 or more"
"48201412500","Census Tract 4125, Harris County, Texas",1652,250001,1155,34,0,249,0,148,69.9,2.1,0,15.1,0,9,30.1,556,408,148,73.38,26.62,80,328,14,134,94,462,19.6,9.5,16.9,"25% - 50% P.O.C.","$86000 or more"
"48201412600","Census Tract 4126, Harris County, Texas",3913,250001,2938,0,0,565,0,296,75.1,0,0,14.4,0,7.6,24.9,1272,1162,110,91.35,8.65,179,983,0,110,179,1093,15.4,0,14.1,"Less than 25% P.O.C.","$86000 or more"
"48201412700","Census Tract 4127, Harris County, Texas",3540,137283,2279,45,0,788,0,391,64.4,1.3,0,22.3,0,11,35.6,1426,1140,286,79.94,20.06,84,1056,13,273,97,1329,7.4,4.5,6.8,"25% - 50% P.O.C.","$86000 or more"
"48201412800","Census Tract 4128, Harris County, Texas",5179,233500,3459,189,0,1151,0,330,66.8,3.6,0,22.2,0,6.4,33.2,1720,1607,113,93.43,6.57,128,1479,21,92,149,1571,8,18.6,8.7,"25% - 50% P.O.C.","$86000 or more"
"48201412900","Census Tract 4129, Harris County, Texas",4155,64796,1797,483,0,980,0,791,43.2,11.6,0,23.6,0,19,56.8,1951,555,1396,28.45,71.55,25,530,92,1304,117,1834,4.5,6.6,6,"50% - 75% P.O.C.","$59000 - $86000"
"48201413000","Census Tract 4130, Harris County, Texas",3728,161111,2334,34,0,633,0,540,62.6,0.9,0,17,0,14.5,37.4,1410,784,626,55.6,44.4,42,742,42,584,84,1326,5.4,6.7,6,"25% - 50% P.O.C.","$86000 or more"
"48201413100","Census Tract 4131, Harris County, Texas",2827,250001,1920,72,39,243,0,433,67.9,2.5,1.4,8.6,0,15.3,32.1,983,887,96,90.23,9.77,72,815,3,93,75,908,8.1,3.1,7.6,"25% - 50% P.O.C.","$86000 or more"
"48201413201","Census Tract 4132.01, Harris County, Texas",2742,56250,1413,114,0,642,0,518,51.5,4.2,0,23.4,0,18.9,48.5,1540,50,1490,3.25,96.75,10,40,0,1490,10,1530,20,0,0.6,"25% - 50% P.O.C.","$44000 - $59000"
"48201413202","Census Tract 4132.02, Harris County, Texas",3980,67924,1947,247,14,1137,0,541,48.9,6.2,0.4,28.6,0,13.6,51.1,2315,656,1659,28.34,71.66,9,647,0,1659,9,2306,1.4,0,0.4,"50% - 75% P.O.C.","$59000 - $86000"
"48201413300","Census Tract 4133, Harris County, Texas",7833,94719,4480,1290,40,1120,0,704,57.2,16.5,0.5,14.3,0,9,42.8,3317,1718,1599,51.79,48.21,180,1538,55,1544,235,3082,10.5,3.4,7.1,"25% - 50% P.O.C.","$86000 or more"
"48201420100","Census Tract 4201, Harris County, Texas",2912,46634,329,994,0,399,54,1117,11.3,34.1,0,13.7,1.9,38.4,88.7,1442,216,1226,14.98,85.02,0,216,49,1177,49,1393,0,4,3.4,"75% or more P.O.C.","$44000 - $59000"
"48201420200","Census Tract 4202, Harris County, Texas",2660,70182,738,64,0,178,0,1466,27.7,2.4,0,6.7,0,55.1,72.3,942,528,414,56.05,43.95,35,493,116,298,151,791,6.6,28,16,"50% - 75% P.O.C.","$59000 - $86000"
"48201420300","Census Tract 4203, Harris County, Texas",3575,98222,2359,566,0,147,0,417,66,15.8,0,4.1,0,11.7,34,1528,825,703,53.99,46.01,34,791,10,693,44,1484,4.1,1.4,2.9,"25% - 50% P.O.C.","$86000 or more"
"48201420400","Census Tract 4204, Harris County, Texas",3608,95586,2499,312,0,290,19,463,69.3,8.6,0,8,0.5,12.8,30.7,1485,1184,301,79.73,20.27,26,1158,59,242,85,1400,2.2,19.6,5.7,"25% - 50% P.O.C.","$86000 or more"
"48201420500","Census Tract 4205, Harris County, Texas",3926,36349,352,529,0,42,0,2945,9,13.5,0,1.1,0,75,91,1182,114,1068,9.64,90.36,6,108,202,866,208,974,5.3,18.9,17.6,"75% or more P.O.C.","Less than $44000"
"48201420600","Census Tract 4206, Harris County, Texas",2385,79828,1395,234,0,164,0,450,58.5,9.8,0,6.9,0,18.9,41.5,959,666,293,69.45,30.55,54,612,0,293,54,905,8.1,0,5.6,"25% - 50% P.O.C.","$59000 - $86000"
"48201420700","Census Tract 4207, Harris County, Texas",2805,150096,2022,166,0,269,0,329,72.1,5.9,0,9.6,0,11.7,27.9,1000,952,48,95.2,4.8,80,872,0,48,80,920,8.4,0,8,"25% - 50% P.O.C.","$86000 or more"
"48201420800","Census Tract 4208, Harris County, Texas",2183,186875,1464,64,0,396,9,198,67.1,2.9,0,18.1,0.4,9.1,32.9,769,713,56,92.72,7.28,79,634,0,56,79,690,11.1,0,10.3,"25% - 50% P.O.C.","$86000 or more"
"48201420900","Census Tract 4209, Harris County, Texas",7126,221579,4642,198,28,1561,0,605,65.1,2.8,0.4,21.9,0,8.5,34.9,2518,2378,140,94.44,5.56,161,2217,0,140,161,2357,6.8,0,6.4,"25% - 50% P.O.C.","$86000 or more"
"48201421000","Census Tract 4210, Harris County, Texas",3113,160671,2038,65,0,694,0,221,65.5,2.1,0,22.3,0,7.1,34.5,1124,945,179,84.07,15.93,68,877,14,165,82,1042,7.2,7.8,7.3,"25% - 50% P.O.C.","$86000 or more"
"48201421101","Census Tract 4211.01, Harris County, Texas",3060,41338,524,425,0,508,0,1574,17.1,13.9,0,16.6,0,51.4,82.9,1447,57,1390,3.94,96.06,0,57,49,1341,49,1398,0,3.5,3.4,"75% or more P.O.C.","Less than $44000"
"48201421102","Census Tract 4211.02, Harris County, Texas",5456,30267,287,1031,11,62,0,4032,5.3,18.9,0.2,1.1,0,73.9,94.7,2065,0,2065,0,100,0,0,231,1834,231,1834,NA,11.2,11.2,"75% or more P.O.C.","Less than $44000"
"48201421201","Census Tract 4212.01, Harris County, Texas",5652,39020,207,1056,0,231,0,4047,3.7,18.7,0,4.1,0,71.6,96.3,2163,0,2163,0,100,0,0,270,1893,270,1893,NA,12.5,12.5,"75% or more P.O.C.","Less than $44000"
"48201421202","Census Tract 4212.02, Harris County, Texas",5450,28064,151,319,0,27,0,4953,2.8,5.9,0,0.5,0,90.9,97.2,1609,0,1609,0,100,0,0,315,1294,315,1294,NA,19.6,19.6,"75% or more P.O.C.","Less than $44000"
"48201421300","Census Tract 4213, Harris County, Texas",8107,32415,839,1797,0,1478,0,3421,10.3,22.2,0,18.2,0,42.2,89.7,2414,291,2123,12.05,87.95,64,227,396,1727,460,1954,22,18.7,19.1,"75% or more P.O.C.","Less than $44000"
"48201421401","Census Tract 4214.01, Harris County, Texas",3969,28217,400,706,0,168,0,2458,10.1,17.8,0,4.2,0,61.9,89.9,1347,32,1315,2.38,97.62,4,28,228,1087,232,1115,12.5,17.3,17.2,"75% or more P.O.C.","Less than $44000"
"48201421402","Census Tract 4214.02, Harris County, Texas",3825,26624,125,203,0,75,0,3422,3.3,5.3,0,2,0,89.5,96.7,1250,0,1250,0,100,0,0,193,1057,193,1057,NA,15.4,15.4,"75% or more P.O.C.","Less than $44000"
"48201421403","Census Tract 4214.03, Harris County, Texas",4521,28314,145,458,0,90,0,3828,3.2,10.1,0,2,0,84.7,96.8,1387,210,1177,15.14,84.86,43,167,173,1004,216,1171,20.5,14.7,15.6,"75% or more P.O.C.","Less than $44000"
"48201421500","Census Tract 4215, Harris County, Texas",7897,31517,439,2099,11,856,0,4236,5.6,26.6,0.1,10.8,0,53.6,94.4,2910,134,2776,4.6,95.4,5,129,362,2414,367,2543,3.7,13,12.6,"75% or more P.O.C.","Less than $44000"
"48201421600","Census Tract 4216, Harris County, Texas",7173,31175,539,828,15,315,0,5476,7.5,11.5,0.2,4.4,0,76.3,92.5,2175,169,2006,7.77,92.23,42,127,357,1649,399,1776,24.9,17.8,18.3,"75% or more P.O.C.","Less than $44000"
"48201421700","Census Tract 4217, Harris County, Texas",4715,69053,1801,255,47,506,0,1942,38.2,5.4,1,10.7,0,41.2,61.8,1748,1022,726,58.47,41.53,61,961,87,639,148,1600,6,12,8.5,"50% - 75% P.O.C.","$59000 - $86000"
"48201421800","Census Tract 4218, Harris County, Texas",4474,48571,1687,1251,0,535,0,825,37.7,28,0,12,0,18.4,62.3,2034,643,1391,31.61,68.39,35,608,70,1321,105,1929,5.4,5,5.2,"50% - 75% P.O.C.","$44000 - $59000"
"48201421900","Census Tract 4219, Harris County, Texas",2701,162716,2096,40,0,267,0,241,77.6,1.5,0,9.9,0,8.9,22.4,1033,1002,31,97,3,27,975,0,31,27,1006,2.7,0,2.6,"Less than 25% P.O.C.","$86000 or more"
"48201422000","Census Tract 4220, Harris County, Texas",2556,110871,1709,150,0,390,0,261,66.9,5.9,0,15.3,0,10.2,33.1,945,763,182,80.74,19.26,62,701,11,171,73,872,8.1,6,7.7,"25% - 50% P.O.C.","$86000 or more"
"48201422100","Census Tract 4221, Harris County, Texas",5294,60833,1812,739,14,239,0,2393,34.2,14,0.3,4.5,0,45.2,65.8,1824,1438,386,78.84,21.16,177,1261,134,252,311,1513,12.3,34.7,17.1,"50% - 75% P.O.C.","$59000 - $86000"
"48201422200","Census Tract 4222, Harris County, Texas",5433,23712,260,3252,0,8,0,1844,4.8,59.9,0,0.1,0,33.9,95.2,2138,174,1964,8.14,91.86,23,151,233,1731,256,1882,13.2,11.9,12,"75% or more P.O.C.","Less than $44000"
"48201422301","Census Tract 4223.01, Harris County, Texas",6886,28588,446,3550,0,967,0,1923,6.5,51.6,0,14,0,27.9,93.5,2719,682,2037,25.08,74.92,84,598,252,1785,336,2383,12.3,12.4,12.4,"75% or more P.O.C.","Less than $44000"
"48201422302","Census Tract 4223.02, Harris County, Texas",1741,58894,437,816,0,23,0,431,25.1,46.9,0,1.3,0,24.8,74.9,821,504,317,61.39,38.61,22,482,17,300,39,782,4.4,5.4,4.8,"50% - 75% P.O.C.","$44000 - $59000"
"48201422401","Census Tract 4224.01, Harris County, Texas",3686,26327,354,1692,0,406,0,1058,9.6,45.9,0,11,0,28.7,90.4,1897,300,1597,15.81,84.19,33,267,78,1519,111,1786,11,4.9,5.9,"75% or more P.O.C.","Less than $44000"
"48201422402","Census Tract 4224.02, Harris County, Texas",6395,46769,1162,591,0,166,0,4456,18.2,9.2,0,2.6,0,69.7,81.8,2057,842,1215,40.93,59.07,91,751,173,1042,264,1793,10.8,14.2,12.8,"75% or more P.O.C.","$44000 - $59000"
"48201422500","Census Tract 4225, Harris County, Texas",7283,42309,1671,1811,32,175,0,3471,22.9,24.9,0.4,2.4,0,47.7,77.1,2404,718,1686,29.87,70.13,0,718,357,1329,357,2047,0,21.2,14.9,"75% or more P.O.C.","Less than $44000"
"48201422600","Census Tract 4226, Harris County, Texas",6816,55625,2066,433,0,291,0,3980,30.3,6.4,0,4.3,0,58.4,69.7,2204,982,1222,44.56,55.44,22,960,165,1057,187,2017,2.2,13.5,8.5,"50% - 75% P.O.C.","$44000 - $59000"
"48201422701","Census Tract 4227.01, Harris County, Texas",5917,52696,541,127,0,208,0,5029,9.1,2.1,0,3.5,0,85,90.9,1588,791,797,49.81,50.19,159,632,367,430,526,1062,20.1,46,33.1,"75% or more P.O.C.","$44000 - $59000"
"48201422702","Census Tract 4227.02, Harris County, Texas",3332,64500,923,5,0,226,0,2160,27.7,0.2,0,6.8,0,64.8,72.3,1094,794,300,72.58,27.42,108,686,32,268,140,954,13.6,10.7,12.8,"50% - 75% P.O.C.","$59000 - $86000"
"48201422800","Census Tract 4228, Harris County, Texas",5415,38264,1212,1062,0,273,0,2847,22.4,19.6,0,5,0,52.6,77.6,1624,536,1088,33,67,27,509,275,813,302,1322,5,25.3,18.6,"75% or more P.O.C.","Less than $44000"
"48201422900","Census Tract 4229, Harris County, Texas",3974,38164,507,611,9,205,0,2536,12.8,15.4,0.2,5.2,0,63.8,87.2,1524,497,1027,32.61,67.39,85,412,74,953,159,1365,17.1,7.2,10.4,"75% or more P.O.C.","Less than $44000"
"48201423000","Census Tract 4230, Harris County, Texas",6004,33645,685,759,16,200,0,4067,11.4,12.6,0.3,3.3,0,67.7,88.6,1919,307,1612,16,84,85,222,309,1303,394,1525,27.7,19.2,20.5,"75% or more P.O.C.","Less than $44000"
"48201423100","Census Tract 4231, Harris County, Texas",2711,35114,29,584,0,0,0,2098,1.1,21.5,0,0,0,77.4,98.9,924,0,924,0,100,0,0,132,792,132,792,NA,14.3,14.3,"75% or more P.O.C.","Less than $44000"
"48201423201","Census Tract 4232.01, Harris County, Texas",3683,75500,905,803,0,394,0,1548,24.6,21.8,0,10.7,0,42,75.4,1074,830,244,77.28,22.72,124,706,71,173,195,879,14.9,29.1,18.2,"75% or more P.O.C.","$59000 - $86000"
"48201423202","Census Tract 4232.02, Harris County, Texas",7948,32098,733,3016,0,43,0,4110,9.2,37.9,0,0.5,0,51.7,90.8,2912,323,2589,11.09,88.91,41,282,129,2460,170,2742,12.7,5,5.8,"75% or more P.O.C.","Less than $44000"
"48201423301","Census Tract 4233.01, Harris County, Texas",4472,50227,1322,1471,0,300,0,1301,29.6,32.9,0,6.7,0,29.1,70.4,1846,915,931,49.57,50.43,51,864,28,903,79,1767,5.6,3,4.3,"50% - 75% P.O.C.","$44000 - $59000"
"48201423302","Census Tract 4233.02, Harris County, Texas",5455,43137,1090,2672,0,160,0,1516,20,49,0,2.9,0,27.8,80,2343,874,1469,37.3,62.7,83,791,94,1375,177,2166,9.5,6.4,7.6,"75% or more P.O.C.","Less than $44000"
"48201423401","Census Tract 4234.01, Harris County, Texas",6255,59318,1235,2691,23,382,0,1924,19.7,43,0.4,6.1,0,30.8,80.3,1862,998,864,53.6,46.4,350,648,145,719,495,1367,35.1,16.8,26.6,"75% or more P.O.C.","$59000 - $86000"
"48201423402","Census Tract 4234.02, Harris County, Texas",4743,57424,36,2610,0,927,0,1095,0.8,55,0,19.5,0,23.1,99.2,1452,1057,395,72.8,27.2,193,864,54,341,247,1205,18.3,13.7,17,"75% or more P.O.C.","$44000 - $59000"
"48201423500","Census Tract 4235, Harris County, Texas",2001,88208,771,452,0,195,0,543,38.5,22.6,0,9.7,0,27.1,61.5,707,644,63,91.09,8.91,44,600,18,45,62,645,6.8,28.6,8.8,"50% - 75% P.O.C.","$86000 or more"
"48201423600","Census Tract 4236, Harris County, Texas",7790,45858,735,3938,0,350,0,2746,9.4,50.6,0,4.5,0,35.3,90.6,2491,1803,688,72.38,27.62,213,1590,137,551,350,2141,11.8,19.9,14.1,"75% or more P.O.C.","$44000 - $59000"
"48201430100","Census Tract 4301, Harris County, Texas",5928,76786,3783,355,20,299,0,1122,63.8,6,0.3,5,0,18.9,36.2,2890,1297,1593,44.88,55.12,84,1213,71,1522,155,2735,6.5,4.5,5.4,"25% - 50% P.O.C.","$59000 - $86000"
"48201430200","Census Tract 4302, Harris County, Texas",1489,82375,925,88,0,113,0,340,62.1,5.9,0,7.6,0,22.8,37.9,678,232,446,34.22,65.78,25,207,27,419,52,626,10.8,6.1,7.7,"25% - 50% P.O.C.","$59000 - $86000"
"48201430300","Census Tract 4303, Harris County, Texas",4825,250001,4262,0,11,316,0,207,88.3,0,0.2,6.5,0,4.3,11.7,1540,1528,12,99.22,0.78,245,1283,0,12,245,1295,16,0,15.9,"Less than 25% P.O.C.","$86000 or more"
"48201430400","Census Tract 4304, Harris County, Texas",3398,250001,2611,21,0,369,0,301,76.8,0.6,0,10.9,0,8.9,23.2,1207,1195,12,99.01,0.99,127,1068,5,7,132,1075,10.6,41.7,10.9,"Less than 25% P.O.C.","$86000 or more"
"48201430500","Census Tract 4305, Harris County, Texas",2698,112935,1711,45,0,385,0,445,63.4,1.7,0,14.3,0,16.5,36.6,978,627,351,64.11,35.89,87,540,23,328,110,868,13.9,6.6,11.2,"25% - 50% P.O.C.","$86000 or more"
"48201430600","Census Tract 4306, Harris County, Texas",3952,246250,2783,5,15,525,0,573,70.4,0.1,0.4,13.3,0,14.5,29.6,1230,1182,48,96.1,3.9,214,968,13,35,227,1003,18.1,27.1,18.5,"25% - 50% P.O.C.","$86000 or more"
"48201430700","Census Tract 4307, Harris County, Texas",3802,77917,2252,110,0,1050,0,219,59.2,2.9,0,27.6,0,5.8,40.8,1716,589,1127,34.32,65.68,32,557,21,1106,53,1663,5.4,1.9,3.1,"25% - 50% P.O.C.","$59000 - $86000"
"48201430800","Census Tract 4308, Harris County, Texas",6209,133196,3728,71,0,1398,0,973,60,1.1,0,22.5,0,15.7,40,2468,1192,1276,48.3,51.7,144,1048,14,1262,158,2310,12.1,1.1,6.4,"25% - 50% P.O.C.","$86000 or more"
"48201430900","Census Tract 4309, Harris County, Texas",5587,103773,3475,19,0,1270,0,715,62.2,0.3,0,22.7,0,12.8,37.8,2352,2007,345,85.33,14.67,75,1932,37,308,112,2240,3.7,10.7,4.8,"25% - 50% P.O.C.","$86000 or more"
"48201431000","Census Tract 4310, Harris County, Texas",6124,90600,4886,127,0,290,0,763,79.8,2.1,0,4.7,0,12.5,20.2,2584,1770,814,68.5,31.5,139,1631,63,751,202,2382,7.9,7.7,7.8,"Less than 25% P.O.C.","$86000 or more"
"48201431101","Census Tract 4311.01, Harris County, Texas",3868,46977,1506,1266,0,428,0,577,38.9,32.7,0,11.1,0,14.9,61.1,2556,717,1839,28.05,71.95,0,717,0,1839,0,2556,0,0,0,"50% - 75% P.O.C.","$44000 - $59000"
"48201431102","Census Tract 4311.02, Harris County, Texas",4297,55331,1530,1254,0,378,0,1135,35.6,29.2,0,8.8,0,26.4,64.4,2104,350,1754,16.63,83.37,0,350,53,1701,53,2051,0,3,2.5,"50% - 75% P.O.C.","$44000 - $59000"
"48201431201","Census Tract 4312.01, Harris County, Texas",3788,36307,1232,1242,0,287,0,979,32.5,32.8,0,7.6,0,25.8,67.5,2226,16,2210,0.72,99.28,0,16,35,2175,35,2191,0,1.6,1.6,"50% - 75% P.O.C.","Less than $44000"
"48201431202","Census Tract 4312.02, Harris County, Texas",6031,57923,2876,617,43,1344,0,995,47.7,10.2,0.7,22.3,0,16.5,52.3,2629,704,1925,26.78,73.22,48,656,140,1785,188,2441,6.8,7.3,7.2,"50% - 75% P.O.C.","$44000 - $59000"
"48201431301","Census Tract 4313.01, Harris County, Texas",5711,55313,2339,779,24,557,0,1959,41,13.6,0.4,9.8,0,34.3,59,2768,502,2266,18.14,81.86,0,502,71,2195,71,2697,0,3.1,2.6,"50% - 75% P.O.C.","$44000 - $59000"
"48201431302","Census Tract 4313.02, Harris County, Texas",4503,102398,3383,163,0,205,0,621,75.1,3.6,0,4.6,0,13.8,24.9,2005,1221,784,60.9,39.1,145,1076,0,784,145,1860,11.9,0,7.2,"Less than 25% P.O.C.","$86000 or more"
"48201431401","Census Tract 4314.01, Harris County, Texas",1937,71129,1177,110,0,238,0,412,60.8,5.7,0,12.3,0,21.3,39.2,1060,332,728,31.32,68.68,0,332,24,704,24,1036,0,3.3,2.3,"25% - 50% P.O.C.","$59000 - $86000"
"48201431402","Census Tract 4314.02, Harris County, Texas",3329,83730,1869,152,0,698,0,558,56.1,4.6,0,21,0,16.8,43.9,2069,783,1286,37.84,62.16,0,783,0,1286,0,2069,0,0,0,"25% - 50% P.O.C.","$59000 - $86000"
"48201431501","Census Tract 4315.01, Harris County, Texas",4718,79026,3344,227,0,514,0,514,70.9,4.8,0,10.9,0,10.9,29.1,2839,1447,1392,50.97,49.03,38,1409,22,1370,60,2779,2.6,1.6,2.1,"25% - 50% P.O.C.","$59000 - $86000"
"48201431502","Census Tract 4315.02, Harris County, Texas",3635,120556,2575,166,0,442,0,199,70.8,4.6,0,12.2,0,5.5,29.2,1662,982,680,59.09,40.91,92,890,17,663,109,1553,9.4,2.5,6.6,"25% - 50% P.O.C.","$86000 or more"
"48201431600","Census Tract 4316, Harris County, Texas",2954,150625,2617,25,0,55,0,246,88.6,0.8,0,1.9,0,8.3,11.4,1387,1194,193,86.09,13.91,34,1160,0,193,34,1353,2.8,0,2.5,"Less than 25% P.O.C.","$86000 or more"
"48201431700","Census Tract 4317, Harris County, Texas",4642,166862,3724,306,0,146,0,428,80.2,6.6,0,3.1,0,9.2,19.8,2134,1569,565,73.52,26.48,68,1501,0,565,68,2066,4.3,0,3.2,"Less than 25% P.O.C.","$86000 or more"
"48201431801","Census Tract 4318.01, Harris County, Texas",3611,99375,2075,208,0,884,0,398,57.5,5.8,0,24.5,0,11,42.5,1712,611,1101,35.69,64.31,75,536,3,1098,78,1634,12.3,0.3,4.6,"25% - 50% P.O.C.","$86000 or more"
"48201431802","Census Tract 4318.02, Harris County, Texas",4700,119125,2448,219,0,888,0,1119,52.1,4.7,0,18.9,0,23.8,47.9,2664,552,2112,20.72,79.28,0,552,0,2112,0,2664,0,0,0,"25% - 50% P.O.C.","$86000 or more"
"48201431900","Census Tract 4319, Harris County, Texas",4779,95718,2122,321,0,1357,0,586,44.4,6.7,0,28.4,0,12.3,55.6,2892,649,2243,22.44,77.56,0,649,27,2216,27,2865,0,1.2,0.9,"50% - 75% P.O.C.","$86000 or more"
"48201432001","Census Tract 4320.01, Harris County, Texas",4265,60435,1747,533,0,421,0,1339,41,12.5,0,9.9,0,31.4,59,1938,654,1284,33.75,66.25,22,632,46,1238,68,1870,3.4,3.6,3.5,"50% - 75% P.O.C.","$59000 - $86000"
"48201432002","Census Tract 4320.02, Harris County, Texas",4753,33478,786,861,0,332,0,2699,16.5,18.1,0,7,0,56.8,83.5,2300,150,2150,6.52,93.48,0,150,159,1991,159,2141,0,7.4,6.9,"75% or more P.O.C.","Less than $44000"
"48201432100","Census Tract 4321, Harris County, Texas",6053,46122,1768,1209,19,986,0,1899,29.2,20,0.3,16.3,0,31.4,70.8,2788,373,2415,13.38,86.62,0,373,0,2415,0,2788,0,0,0,"50% - 75% P.O.C.","$44000 - $59000"
"48201432200","Census Tract 4322, Harris County, Texas",4494,46167,1541,755,0,129,0,1917,34.3,16.8,0,2.9,0,42.7,65.7,2063,769,1294,37.28,62.72,46,723,88,1206,134,1929,6,6.8,6.5,"50% - 75% P.O.C.","$44000 - $59000"
"48201432300","Census Tract 4323, Harris County, Texas",7339,43177,1400,2125,0,522,0,3024,19.1,29,0,7.1,0,41.2,80.9,3423,116,3307,3.39,96.61,0,116,229,3078,229,3194,0,6.9,6.7,"75% or more P.O.C.","Less than $44000"
"48201432400","Census Tract 4324, Harris County, Texas",6174,36284,1330,1829,0,694,0,2122,21.5,29.6,0,11.2,0,34.4,78.5,3120,852,2268,27.31,72.69,0,852,145,2123,145,2975,0,6.4,4.6,"75% or more P.O.C.","Less than $44000"
"48201432500","Census Tract 4325, Harris County, Texas",5289,31466,1307,575,0,343,0,2954,24.7,10.9,0,6.5,0,55.9,75.3,2306,710,1596,30.79,69.21,18,692,153,1443,171,2135,2.5,9.6,7.4,"75% or more P.O.C.","Less than $44000"
"48201432600","Census Tract 4326, Harris County, Texas",2026,45661,650,350,5,95,0,856,32.1,17.3,0.2,4.7,0,42.3,67.9,909,234,675,25.74,74.26,24,210,38,637,62,847,10.3,5.6,6.8,"50% - 75% P.O.C.","$44000 - $59000"
"48201432701","Census Tract 4327.01, Harris County, Texas",5984,24107,381,247,21,21,0,5301,6.4,4.1,0.4,0.4,0,88.6,93.6,2130,99,2031,4.65,95.35,0,99,186,1845,186,1944,0,9.2,8.7,"75% or more P.O.C.","Less than $44000"
"48201432702","Census Tract 4327.02, Harris County, Texas",4036,62878,1358,542,0,317,0,1745,33.6,13.4,0,7.9,0,43.2,66.4,1809,419,1390,23.16,76.84,10,409,77,1313,87,1722,2.4,5.5,4.8,"50% - 75% P.O.C.","$59000 - $86000"
"48201432801","Census Tract 4328.01, Harris County, Texas",4890,35156,481,855,65,607,0,2816,9.8,17.5,1.3,12.4,0,57.6,90.2,2065,506,1559,24.5,75.5,33,473,104,1455,137,1928,6.5,6.7,6.6,"75% or more P.O.C.","Less than $44000"
"48201432802","Census Tract 4328.02, Harris County, Texas",6464,23609,379,1143,20,516,0,4207,5.9,17.7,0.3,8,0,65.1,94.1,2351,158,2193,6.72,93.28,8,150,290,1903,298,2053,5.1,13.2,12.7,"75% or more P.O.C.","Less than $44000"
"48201432901","Census Tract 4329.01, Harris County, Texas",3042,28534,460,294,0,12,0,2276,15.1,9.7,0,0.4,0,74.8,84.9,1122,206,916,18.36,81.64,6,200,44,872,50,1072,2.9,4.8,4.5,"75% or more P.O.C.","Less than $44000"
"48201432902","Census Tract 4329.02, Harris County, Texas",6203,34542,583,508,0,1115,0,3938,9.4,8.2,0,18,0,63.5,90.6,2330,492,1838,21.12,78.88,55,437,111,1727,166,2164,11.2,6,7.1,"75% or more P.O.C.","Less than $44000"
"48201433001","Census Tract 4330.01, Harris County, Texas",5722,25844,195,369,0,919,42,4197,3.4,6.4,0,16.1,0.7,73.3,96.6,1878,0,1878,0,100,0,0,386,1492,386,1492,NA,20.6,20.6,"75% or more P.O.C.","Less than $44000"
"48201433002","Census Tract 4330.02, Harris County, Texas",3385,28077,176,232,15,867,0,2071,5.2,6.9,0.4,25.6,0,61.2,94.8,1438,38,1400,2.64,97.36,0,38,96,1304,96,1342,0,6.9,6.7,"75% or more P.O.C.","Less than $44000"
"48201433003","Census Tract 4330.03, Harris County, Texas",5787,23621,22,513,0,1685,0,3434,0.4,8.9,0,29.1,0,59.3,99.6,1897,96,1801,5.06,94.94,0,96,402,1399,402,1495,0,22.3,21.2,"75% or more P.O.C.","Less than $44000"
"48201433100","Census Tract 4331, Harris County, Texas",4022,29342,36,636,0,59,0,3211,0.9,15.8,0,1.5,0,79.8,99.1,1204,30,1174,2.49,97.51,10,20,178,996,188,1016,33.3,15.2,15.6,"75% or more P.O.C.","Less than $44000"
"48201433201","Census Tract 4332.01, Harris County, Texas",4940,35598,643,1014,0,2072,0,1147,13,20.5,0,41.9,0,23.2,87,1870,674,1196,36.04,63.96,61,613,169,1027,230,1640,9.1,14.1,12.3,"75% or more P.O.C.","Less than $44000"
"48201433202","Census Tract 4332.02, Harris County, Texas",4269,46677,517,366,0,909,13,2410,12.1,8.6,0,21.3,0.3,56.5,87.9,1296,586,710,45.22,54.78,86,500,204,506,290,1006,14.7,28.7,22.4,"75% or more P.O.C.","$44000 - $59000"
"48201433300","Census Tract 4333, Harris County, Texas",5121,65400,1418,201,0,979,0,2423,27.7,3.9,0,19.1,0,47.3,72.3,1548,1154,394,74.55,25.45,133,1021,147,247,280,1268,11.5,37.3,18.1,"50% - 75% P.O.C.","$59000 - $86000"
"48201433400","Census Tract 4334, Harris County, Texas",4295,32526,484,671,0,376,0,2700,11.3,15.6,0,8.8,0,62.9,88.7,1673,424,1249,25.34,74.66,47,377,66,1183,113,1560,11.1,5.3,6.8,"75% or more P.O.C.","Less than $44000"
"48201433501","Census Tract 4335.01, Harris County, Texas",5593,27353,189,714,0,60,0,4609,3.4,12.8,0,1.1,0,82.4,96.6,1909,136,1773,7.12,92.88,15,121,277,1496,292,1617,11,15.6,15.3,"75% or more P.O.C.","Less than $44000"
"48201433502","Census Tract 4335.02, Harris County, Texas",8242,25766,411,1258,98,577,0,5898,5,15.3,1.2,7,0,71.6,95,2900,267,2633,9.21,90.79,76,191,369,2264,445,2455,28.5,14,15.3,"75% or more P.O.C.","Less than $44000"
"48201433600","Census Tract 4336, Harris County, Texas",6571,38862,180,2326,0,277,0,3613,2.7,35.4,0,4.2,0,55,97.3,2485,151,2334,6.08,93.92,0,151,205,2129,205,2280,0,8.8,8.2,"75% or more P.O.C.","Less than $44000"
"48201440100","Census Tract 4401, Harris County, Texas",7513,53929,1020,2438,24,716,0,3272,13.6,32.5,0.3,9.5,0,43.6,86.4,2920,1394,1526,47.74,52.26,120,1274,154,1372,274,2646,8.6,10.1,9.4,"75% or more P.O.C.","$44000 - $59000"
"48201450100","Census Tract 4501, Harris County, Texas",2023,127188,1353,15,0,218,0,437,66.9,0.7,0,10.8,0,21.6,33.1,711,602,109,84.67,15.33,75,527,26,83,101,610,12.5,23.9,14.2,"25% - 50% P.O.C.","$86000 or more"
"48201450200","Census Tract 4502, Harris County, Texas",5450,117760,3903,162,0,607,0,584,71.6,3,0,11.1,0,10.7,28.4,1913,1419,494,74.18,25.82,213,1206,18,476,231,1682,15,3.6,12.1,"25% - 50% P.O.C.","$86000 or more"
"48201450300","Census Tract 4503, Harris County, Texas",8570,69265,3123,1227,0,887,0,3075,36.4,14.3,0,10.4,0,35.9,63.6,2866,1234,1632,43.06,56.94,66,1168,273,1359,339,2527,5.3,16.7,11.8,"50% - 75% P.O.C.","$59000 - $86000"
"48201450400","Census Tract 4504, Harris County, Texas",4612,70614,1432,1610,0,208,0,1234,31,34.9,0,4.5,0,26.8,69,1775,595,1180,33.52,66.48,22,573,224,956,246,1529,3.7,19,13.9,"50% - 75% P.O.C.","$59000 - $86000"
"48201450500","Census Tract 4505, Harris County, Texas",2915,149375,1883,122,30,283,0,543,64.6,4.2,1,9.7,0,18.6,35.4,1124,907,217,80.69,19.31,115,792,0,217,115,1009,12.7,0,10.2,"25% - 50% P.O.C.","$86000 or more"
"48201450600","Census Tract 4506, Harris County, Texas",4124,82639,2730,588,0,307,0,302,66.2,14.3,0,7.4,0,7.3,33.8,1769,785,984,44.38,55.62,77,708,83,901,160,1609,9.8,8.4,9,"25% - 50% P.O.C.","$59000 - $86000"
"48201450700","Census Tract 4507, Harris County, Texas",6205,226602,5563,24,26,165,0,305,89.7,0.4,0.4,2.7,0,4.9,10.3,2033,1862,171,91.59,8.41,222,1640,55,116,277,1756,11.9,32.2,13.6,"Less than 25% P.O.C.","$86000 or more"
"48201450801","Census Tract 4508.01, Harris County, Texas",1656,53841,913,422,0,38,0,269,55.1,25.5,0,2.3,0,16.2,44.9,914,169,745,18.49,81.51,0,169,0,745,0,914,0,0,0,"25% - 50% P.O.C.","$44000 - $59000"
"48201450802","Census Tract 4508.02, Harris County, Texas",8058,53158,2542,2920,0,379,0,1777,31.5,36.2,0,4.7,0,22.1,68.5,3036,612,2424,20.16,79.84,38,574,405,2019,443,2593,6.2,16.7,14.6,"50% - 75% P.O.C.","$44000 - $59000"
"48201450900","Census Tract 4509, Harris County, Texas",3091,92115,1797,641,0,272,0,295,58.1,20.7,0,8.8,0,9.5,41.9,1256,716,540,57.01,42.99,87,629,42,498,129,1127,12.2,7.8,10.3,"25% - 50% P.O.C.","$86000 or more"
"48201451001","Census Tract 4510.01, Harris County, Texas",5349,45864,1782,1437,0,289,0,1619,33.3,26.9,0,5.4,0,30.3,66.7,2238,707,1531,31.59,68.41,47,660,76,1455,123,2115,6.6,5,5.5,"50% - 75% P.O.C.","$44000 - $59000"
"48201451002","Census Tract 4510.02, Harris County, Texas",5365,57500,868,2662,0,237,0,1578,16.2,49.6,0,4.4,0,29.4,83.8,2304,333,1971,14.45,85.55,0,333,167,1804,167,2137,0,8.5,7.2,"75% or more P.O.C.","$44000 - $59000"
"48201451100","Census Tract 4511, Harris County, Texas",3911,88412,2072,893,0,218,0,662,53,22.8,0,5.6,0,16.9,47,1960,1178,782,60.1,39.9,0,1178,14,768,14,1946,0,1.8,0.7,"25% - 50% P.O.C.","$86000 or more"
"48201451200","Census Tract 4512, Harris County, Texas",2635,152419,2058,42,0,107,0,384,78.1,1.6,0,4.1,0,14.6,21.9,1008,909,99,90.18,9.82,4,905,50,49,54,954,0.4,50.5,5.4,"Less than 25% P.O.C.","$86000 or more"
"48201451300","Census Tract 4513, Harris County, Texas",7329,82094,3584,1270,15,719,0,1561,48.9,17.3,0.2,9.8,0,21.3,51.1,3051,1977,1074,64.8,35.2,139,1838,37,1037,176,2875,7,3.4,5.8,"50% - 75% P.O.C.","$59000 - $86000"
"48201451401","Census Tract 4514.01, Harris County, Texas",3392,46495,1689,558,0,281,0,761,49.8,16.5,0,8.3,0,22.4,50.2,1745,591,1154,33.87,66.13,15,576,50,1104,65,1680,2.5,4.3,3.7,"50% - 75% P.O.C.","$44000 - $59000"
"48201451402","Census Tract 4514.02, Harris County, Texas",4919,52632,1549,1015,0,118,22,2044,31.5,20.6,0,2.4,0.4,41.6,68.5,2537,369,2168,14.54,85.46,0,369,100,2068,100,2437,0,4.6,3.9,"50% - 75% P.O.C.","$44000 - $59000"
"48201451403","Census Tract 4514.03, Harris County, Texas",5696,54578,1396,1979,0,943,48,1108,24.5,34.7,0,16.6,0.8,19.5,75.5,3049,342,2707,11.22,88.78,53,289,42,2665,95,2954,15.5,1.6,3.1,"75% or more P.O.C.","$44000 - $59000"
"48201451500","Census Tract 4515, Harris County, Texas",5340,61135,2273,723,99,637,0,1463,42.6,13.5,1.9,11.9,0,27.4,57.4,2834,431,2403,15.21,84.79,0,431,17,2386,17,2817,0,0.7,0.6,"50% - 75% P.O.C.","$59000 - $86000"
"48201451601","Census Tract 4516.01, Harris County, Texas",7435,94917,3253,942,21,1792,0,1118,43.8,12.7,0.3,24.1,0,15,56.2,3093,1743,1350,56.35,43.65,207,1536,85,1265,292,2801,11.9,6.3,9.4,"50% - 75% P.O.C.","$86000 or more"
"48201451602","Census Tract 4516.02, Harris County, Texas",9604,87732,4034,930,0,2458,0,1896,42,9.7,0,25.6,0,19.7,58,3764,1307,2457,34.72,65.28,204,1103,21,2436,225,3539,15.6,0.9,6,"50% - 75% P.O.C.","$86000 or more"
"48201451700","Census Tract 4517, Harris County, Texas",3862,56006,703,1706,85,598,0,694,18.2,44.2,2.2,15.5,0,18,81.8,1696,739,957,43.57,56.43,8,731,57,900,65,1631,1.1,6,3.8,"75% or more P.O.C.","$44000 - $59000"
"48201451800","Census Tract 4518, Harris County, Texas",5399,59730,1053,1814,34,585,12,1790,19.5,33.6,0.6,10.8,0.2,33.2,80.5,1985,1140,845,57.43,42.57,115,1025,59,786,174,1811,10.1,7,8.8,"75% or more P.O.C.","$59000 - $86000"
"48201451901","Census Tract 4519.01, Harris County, Texas",7288,38581,986,3053,0,1074,0,1974,13.5,41.9,0,14.7,0,27.1,86.5,3442,884,2558,25.68,74.32,73,811,45,2513,118,3324,8.3,1.8,3.4,"75% or more P.O.C.","Less than $44000"
"48201451902","Census Tract 4519.02, Harris County, Texas",2420,98542,898,185,6,1051,0,239,37.1,7.6,0.2,43.4,0,9.9,62.9,893,790,103,88.47,11.53,45,745,0,103,45,848,5.7,0,5,"50% - 75% P.O.C.","$86000 or more"
"48201452000","Census Tract 4520, Harris County, Texas",8259,46146,1588,2461,0,1053,0,2920,19.2,29.8,0,12.7,0,35.4,80.8,3672,669,3003,18.22,81.78,88,581,105,2898,193,3479,13.2,3.5,5.3,"75% or more P.O.C.","$44000 - $59000"
"48201452100","Census Tract 4521, Harris County, Texas",11307,51483,2769,4614,110,1419,0,2078,24.5,40.8,1,12.5,0,18.4,75.5,4972,632,4340,12.71,87.29,109,523,190,4150,299,4673,17.2,4.4,6,"75% or more P.O.C.","$44000 - $59000"
"48201452201","Census Tract 4522.01, Harris County, Texas",5402,38420,816,2651,0,575,0,1360,15.1,49.1,0,10.6,0,25.2,84.9,2906,257,2649,8.84,91.16,0,257,90,2559,90,2816,0,3.4,3.1,"75% or more P.O.C.","Less than $44000"
"48201452202","Census Tract 4522.02, Harris County, Texas",3781,41590,504,2135,0,312,0,814,13.3,56.5,0,8.3,0,21.5,86.7,1725,204,1521,11.83,88.17,0,204,115,1406,115,1610,0,7.6,6.7,"75% or more P.O.C.","Less than $44000"
"48201452300","Census Tract 4523, Harris County, Texas",2467,47778,178,340,0,862,0,1086,7.2,13.8,0,34.9,0,44,92.8,738,530,208,71.82,28.18,67,463,67,141,134,604,12.6,32.2,18.2,"75% or more P.O.C.","$44000 - $59000"
"48201452400","Census Tract 4524, Harris County, Texas",7546,34788,407,155,0,2723,0,4189,5.4,2.1,0,36.1,0,55.5,94.6,2496,1326,1170,53.12,46.88,134,1192,125,1045,259,2237,10.1,10.7,10.4,"75% or more P.O.C.","Less than $44000"
"48201452500","Census Tract 4525, Harris County, Texas",7684,38311,475,1509,0,2056,0,3531,6.2,19.6,0,26.8,0,46,93.8,2412,938,1474,38.89,61.11,81,857,281,1193,362,2050,8.6,19.1,15,"75% or more P.O.C.","Less than $44000"
"48201452600","Census Tract 4526, Harris County, Texas",9195,38941,520,2608,39,3026,0,2622,5.7,28.4,0.4,32.9,0,28.5,94.3,2649,690,1959,26.05,73.95,210,480,308,1651,518,2131,30.4,15.7,19.6,"75% or more P.O.C.","Less than $44000"
"48201452700","Census Tract 4527, Harris County, Texas",13362,41028,353,4354,72,5798,0,2652,2.6,32.6,0.5,43.4,0,19.8,97.4,3846,1920,1926,49.92,50.08,392,1528,404,1522,796,3050,20.4,21,20.7,"75% or more P.O.C.","Less than $44000"
"48201452801","Census Tract 4528.01, Harris County, Texas",5817,44219,383,1942,0,1903,0,1557,6.6,33.4,0,32.7,0,26.8,93.4,1900,1110,790,58.42,41.58,227,883,127,663,354,1546,20.5,16.1,18.6,"75% or more P.O.C.","$44000 - $59000"
"48201452802","Census Tract 4528.02, Harris County, Texas",7237,41923,248,1439,0,1804,0,3694,3.4,19.9,0,24.9,0,51,96.6,1874,732,1142,39.06,60.94,253,479,282,860,535,1339,34.6,24.7,28.5,"75% or more P.O.C.","Less than $44000"
"48201452900","Census Tract 4529, Harris County, Texas",4755,49089,378,506,0,769,0,3102,7.9,10.6,0,16.2,0,65.2,92.1,1103,607,496,55.03,44.97,192,415,253,243,445,658,31.6,51,40.3,"75% or more P.O.C.","$44000 - $59000"
"48201453000","Census Tract 4530, Harris County, Texas",8159,46431,293,266,0,1414,0,6122,3.6,3.3,0,17.3,0,75,96.4,2166,1420,746,65.56,34.44,182,1238,229,517,411,1755,12.8,30.7,19,"75% or more P.O.C.","$44000 - $59000"
"48201453100","Census Tract 4531, Harris County, Texas",4216,27247,290,879,0,550,0,2468,6.9,20.8,0,13,0,58.5,93.1,1491,438,1053,29.38,70.62,50,388,177,876,227,1264,11.4,16.8,15.2,"75% or more P.O.C.","Less than $44000"
"48201453200","Census Tract 4532, Harris County, Texas",8861,36496,352,2856,0,913,0,4734,4,32.2,0,10.3,0,53.4,96,2781,490,2291,17.62,82.38,222,268,214,2077,436,2345,45.3,9.3,15.7,"75% or more P.O.C.","Less than $44000"
"48201453300","Census Tract 4533, Harris County, Texas",3676,26860,188,1606,0,225,0,1615,5.1,43.7,0,6.1,0,43.9,94.9,1248,40,1208,3.21,96.79,0,40,246,962,246,1002,0,20.4,19.7,"75% or more P.O.C.","Less than $44000"
"48201453401","Census Tract 4534.01, Harris County, Texas",3143,44500,386,623,0,326,0,1757,12.3,19.8,0,10.4,0,55.9,87.7,1018,478,540,46.95,53.05,86,392,48,492,134,884,18,8.9,13.2,"75% or more P.O.C.","$44000 - $59000"
"48201453402","Census Tract 4534.02, Harris County, Texas",7644,49119,620,1908,0,1307,0,3613,8.1,25,0,17.1,0,47.3,91.9,2713,1130,1583,41.65,58.35,226,904,105,1478,331,2382,20,6.6,12.2,"75% or more P.O.C.","$44000 - $59000"
"48201453403","Census Tract 4534.03, Harris County, Texas",4589,30827,228,1647,26,664,0,1998,5,35.9,0.6,14.5,0,43.5,95,1684,312,1372,18.53,81.47,71,241,82,1290,153,1531,22.8,6,9.1,"75% or more P.O.C.","Less than $44000"
"48201453501","Census Tract 4535.01, Harris County, Texas",6824,46937,485,1522,0,1518,0,3202,7.1,22.3,0,22.2,0,46.9,92.9,2124,1053,1071,49.58,50.42,201,852,205,866,406,1718,19.1,19.1,19.1,"75% or more P.O.C.","$44000 - $59000"
"48201453502","Census Tract 4535.02, Harris County, Texas",3768,44455,336,887,0,213,33,2269,8.9,23.5,0,5.7,0.9,60.2,91.1,1088,572,516,52.57,47.43,53,519,167,349,220,868,9.3,32.4,20.2,"75% or more P.O.C.","$44000 - $59000"
"48201453601","Census Tract 4536.01, Harris County, Texas",2308,31281,122,604,0,339,0,1243,5.3,26.2,0,14.7,0,53.9,94.7,671,277,394,41.28,58.72,22,255,74,320,96,575,7.9,18.8,14.3,"75% or more P.O.C.","Less than $44000"
"48201453602","Census Tract 4536.02, Harris County, Texas",8321,38666,781,1811,0,1139,0,4590,9.4,21.8,0,13.7,0,55.2,90.6,2499,1155,1344,46.22,53.78,290,865,262,1082,552,1947,25.1,19.5,22.1,"75% or more P.O.C.","Less than $44000"
"48201453700","Census Tract 4537, Harris County, Texas",9123,50647,850,3505,0,1024,0,3744,9.3,38.4,0,11.2,0,41,90.7,2663,1322,1341,49.64,50.36,271,1051,279,1062,550,2113,20.5,20.8,20.7,"75% or more P.O.C.","$44000 - $59000"
"48201453800","Census Tract 4538, Harris County, Texas",4293,54549,146,1163,8,446,0,2530,3.4,27.1,0.2,10.4,0,58.9,96.6,1096,655,441,59.76,40.24,245,410,109,332,354,742,37.4,24.7,32.3,"75% or more P.O.C.","$44000 - $59000"
"48201453900","Census Tract 4539, Harris County, Texas",10803,50470,410,2528,47,4500,0,3235,3.8,23.4,0.4,41.7,0,29.9,96.2,3100,1926,1174,62.13,37.87,457,1469,240,934,697,2403,23.7,20.4,22.5,"75% or more P.O.C.","$44000 - $59000"
"48201454000","Census Tract 4540, Harris County, Texas",5201,62639,535,1503,0,1252,10,1733,10.3,28.9,0,24.1,0.2,33.3,89.7,1523,1289,234,84.64,15.36,281,1008,6,228,287,1236,21.8,2.6,18.8,"75% or more P.O.C.","$59000 - $86000"
"48201454100","Census Tract 4541, Harris County, Texas",3784,59089,566,1132,0,786,0,1254,15,29.9,0,20.8,0,33.1,85,1118,623,495,55.72,44.28,77,546,87,408,164,954,12.4,17.6,14.7,"75% or more P.O.C.","$59000 - $86000"
"48201454200","Census Tract 4542, Harris County, Texas",4453,74009,694,1188,0,153,0,2418,15.6,26.7,0,3.4,0,54.3,84.4,1173,1003,170,85.51,14.49,237,766,0,170,237,936,23.6,0,20.2,"75% or more P.O.C.","$59000 - $86000"
"48201454301","Census Tract 4543.01, Harris County, Texas",11974,53178,1301,6041,18,1466,0,2907,10.9,50.5,0.2,12.2,0,24.3,89.1,4344,1372,2972,31.58,68.42,158,1214,307,2665,465,3879,11.5,10.3,10.7,"75% or more P.O.C.","$44000 - $59000"
"48201454302","Census Tract 4543.02, Harris County, Texas",6375,56717,1391,1421,0,782,0,2739,21.8,22.3,0,12.3,0,43,78.2,2283,1650,633,72.27,27.73,134,1516,88,545,222,2061,8.1,13.9,9.7,"75% or more P.O.C.","$44000 - $59000"
"48201454400","Census Tract 4544, Harris County, Texas",1186,44526,196,623,11,194,0,162,16.5,52.5,0.9,16.4,0,13.7,83.5,461,0,461,0,100,0,0,116,345,116,345,NA,25.2,25.2,"75% or more P.O.C.","$44000 - $59000"
"48201454501","Census Tract 4545.01, Harris County, Texas",9778,181544,6114,260,0,2244,0,953,62.5,2.7,0,22.9,0,9.7,37.5,3182,2761,421,86.77,13.23,343,2418,47,374,390,2792,12.4,11.2,12.3,"25% - 50% P.O.C.","$86000 or more"
"48201454502","Census Tract 4545.02, Harris County, Texas",2540,204250,1468,159,0,666,0,209,57.8,6.3,0,26.2,0,8.2,42.2,805,720,85,89.44,10.56,80,640,0,85,80,725,11.1,0,9.9,"25% - 50% P.O.C.","$86000 or more"
"48201454600","Census Tract 4546, Harris County, Texas",5031,73088,3029,308,0,278,0,1328,60.2,6.1,0,5.5,0,26.4,39.8,2204,660,1544,29.95,70.05,0,660,126,1418,126,2078,0,8.2,5.7,"25% - 50% P.O.C.","$59000 - $86000"
"48201454700","Census Tract 4547, Harris County, Texas",6949,124272,4961,57,323,259,0,1248,71.4,0.8,4.6,3.7,0,18,28.6,2341,1983,358,84.71,15.29,240,1743,0,358,240,2101,12.1,0,10.3,"25% - 50% P.O.C.","$86000 or more"
"48201454800","Census Tract 4548, Harris County, Texas",8434,59490,4316,189,191,433,0,3128,51.2,2.2,2.3,5.1,0,37.1,48.8,3083,1795,1288,58.22,41.78,102,1693,202,1086,304,2779,5.7,15.7,9.9,"25% - 50% P.O.C.","$59000 - $86000"
"48201454900","Census Tract 4549, Harris County, Texas",12205,97065,5526,722,0,2673,0,2984,45.3,5.9,0,21.9,0,24.4,54.7,3715,2718,997,73.16,26.84,542,2176,121,876,663,3052,19.9,12.1,17.8,"50% - 75% P.O.C.","$86000 or more"
"48201455000","Census Tract 4550, Harris County, Texas",2838,121250,1848,32,0,229,0,663,65.1,1.1,0,8.1,0,23.4,34.9,977,645,332,66.02,33.98,82,563,53,279,135,842,12.7,16,13.8,"25% - 50% P.O.C.","$86000 or more"
"48201455101","Census Tract 4551.01, Harris County, Texas",7134,75346,3726,479,0,273,0,2310,52.2,6.7,0,3.8,0,32.4,47.8,2420,1753,667,72.44,27.56,215,1538,79,588,294,2126,12.3,11.8,12.1,"25% - 50% P.O.C.","$59000 - $86000"
"48201455102","Census Tract 4551.02, Harris County, Texas",2920,110114,1660,103,0,433,0,572,56.8,3.5,0,14.8,0,19.6,43.2,1021,849,172,83.15,16.85,54,795,0,172,54,967,6.4,0,5.3,"25% - 50% P.O.C.","$86000 or more"
"48201455200","Census Tract 4552, Harris County, Texas",4332,85319,2490,374,94,103,0,1171,57.5,8.6,2.2,2.4,0,27,42.5,1488,1230,258,82.66,17.34,72,1158,58,200,130,1358,5.9,22.5,8.7,"25% - 50% P.O.C.","$59000 - $86000"
"48201455300","Census Tract 4553, Harris County, Texas",10991,65777,4326,1586,0,1215,0,3467,39.4,14.4,0,11.1,0,31.5,60.6,4534,797,3737,17.58,82.42,224,573,245,3492,469,4065,28.1,6.6,10.3,"50% - 75% P.O.C.","$59000 - $86000"
"48201510100","Census Tract 5101, Harris County, Texas",2344,133854,1218,231,0,258,0,619,52,9.9,0,11,0,26.4,48,1185,650,535,54.85,45.15,12,638,24,511,36,1149,1.8,4.5,3,"25% - 50% P.O.C.","$86000 or more"
"48201510200","Census Tract 5102, Harris County, Texas",6627,95523,2761,358,0,1008,0,2329,41.7,5.4,0,15.2,0,35.1,58.3,3406,862,2544,25.31,74.69,26,836,0,2544,26,3380,3,0,0.8,"50% - 75% P.O.C.","$86000 or more"
"48201510300","Census Tract 5103, Harris County, Texas",5123,116959,4330,41,0,96,0,595,84.5,0.8,0,1.9,0,11.6,15.5,2430,1748,682,71.93,28.07,155,1593,0,682,155,2275,8.9,0,6.4,"Less than 25% P.O.C.","$86000 or more"
"48201510400","Census Tract 5104, Harris County, Texas",3870,90052,2856,142,0,123,1,611,73.8,3.7,0,3.2,0,15.8,26.2,2003,947,1056,47.28,52.72,60,887,13,1043,73,1930,6.3,1.2,3.6,"25% - 50% P.O.C.","$86000 or more"
"48201510500","Census Tract 5105, Harris County, Texas",3733,142778,2621,98,0,273,0,582,70.2,2.6,0,7.3,0,15.6,29.8,1898,1047,851,55.16,44.84,8,1039,0,851,8,1890,0.8,0,0.4,"25% - 50% P.O.C.","$86000 or more"
"48201510600","Census Tract 5106, Harris County, Texas",7004,134071,4254,564,14,618,0,1351,60.7,8.1,0.2,8.8,0,19.3,39.3,3606,2075,1531,57.54,42.46,47,2028,0,1531,47,3559,2.3,0,1.3,"25% - 50% P.O.C.","$86000 or more"
"48201510700","Census Tract 5107, Harris County, Texas",4905,123719,2958,290,0,809,0,682,60.3,5.9,0,16.5,0,13.9,39.7,2681,1090,1591,40.66,59.34,0,1090,0,1591,0,2681,0,0,0,"25% - 50% P.O.C.","$86000 or more"
"48201510800","Census Tract 5108, Harris County, Texas",8400,141742,5716,459,30,275,0,1506,68,5.5,0.4,3.3,0,17.9,32,4266,2818,1448,66.06,33.94,0,2818,0,1448,0,4266,0,0,0,"25% - 50% P.O.C.","$86000 or more"
"48201510900","Census Tract 5109, Harris County, Texas",7568,131659,4436,525,40,749,0,1692,58.6,6.9,0.5,9.9,0,22.4,41.4,3593,2298,1295,63.96,36.04,70,2228,0,1295,70,3523,3,0,1.9,"25% - 50% P.O.C.","$86000 or more"
"48201511001","Census Tract 5110.01, Harris County, Texas",3108,73043,2159,92,0,188,0,627,69.5,3,0,6,0,20.2,30.5,1366,819,547,59.96,40.04,0,819,30,517,30,1336,0,5.5,2.2,"25% - 50% P.O.C.","$59000 - $86000"
"48201511002","Census Tract 5110.02, Harris County, Texas",4400,80913,2603,273,28,228,0,1161,59.2,6.2,0.6,5.2,0,26.4,40.8,2225,839,1386,37.71,62.29,20,819,9,1377,29,2196,2.4,0.6,1.3,"25% - 50% P.O.C.","$59000 - $86000"
"48201511100","Census Tract 5111, Harris County, Texas",3514,122917,1921,134,0,465,0,913,54.7,3.8,0,13.2,0,26,45.3,1638,955,683,58.3,41.7,27,928,42,641,69,1569,2.8,6.1,4.2,"25% - 50% P.O.C.","$86000 or more"
"48201511200","Census Tract 5112, Harris County, Texas",5998,147619,3791,205,0,370,0,1525,63.2,3.4,0,6.2,0,25.4,36.8,2734,2108,626,77.1,22.9,30,2078,72,554,102,2632,1.4,11.5,3.7,"25% - 50% P.O.C.","$86000 or more"
"48201511301","Census Tract 5113.01, Harris County, Texas",4124,115050,3009,274,0,97,0,736,73,6.6,0,2.4,0,17.8,27,1905,1250,655,65.62,34.38,51,1199,0,655,51,1854,4.1,0,2.7,"25% - 50% P.O.C.","$86000 or more"
"48201511302","Census Tract 5113.02, Harris County, Texas",3716,109778,3193,1,0,68,0,453,85.9,0,0,1.8,0,12.2,14.1,1878,1044,834,55.59,44.41,22,1022,14,820,36,1842,2.1,1.7,1.9,"Less than 25% P.O.C.","$86000 or more"
"48201511400","Census Tract 5114, Harris County, Texas",3113,111897,1826,14,9,79,0,1072,58.7,0.4,0.3,2.5,0,34.4,41.3,1468,898,570,61.17,38.83,5,893,29,541,34,1434,0.6,5.1,2.3,"25% - 50% P.O.C.","$86000 or more"
"48201511500","Census Tract 5115, Harris County, Texas",8052,124879,4400,39,0,392,0,3100,54.6,0.5,0,4.9,0,38.5,45.4,3408,2124,1284,62.32,37.68,108,2016,151,1133,259,3149,5.1,11.8,7.6,"25% - 50% P.O.C.","$86000 or more"
"48201511600","Census Tract 5116, Harris County, Texas",3542,59038,1116,106,0,78,0,2166,31.5,3,0,2.2,0,61.2,68.5,1496,909,587,60.76,39.24,95,814,41,546,136,1360,10.5,7,9.1,"50% - 75% P.O.C.","$59000 - $86000"
"48201520100","Census Tract 5201, Harris County, Texas",2088,118684,1031,70,0,190,0,694,49.4,3.4,0,9.1,0,33.2,50.6,896,373,523,41.63,58.37,35,338,18,505,53,843,9.4,3.4,5.9,"50% - 75% P.O.C.","$86000 or more"
"48201520200","Census Tract 5202, Harris County, Texas",3363,90125,2016,426,47,179,0,673,59.9,12.7,1.4,5.3,0,20,40.1,1400,767,633,54.79,45.21,62,705,39,594,101,1299,8.1,6.2,7.2,"25% - 50% P.O.C.","$86000 or more"
"48201520300","Census Tract 5203, Harris County, Texas",5355,44643,1505,391,10,112,0,3149,28.1,7.3,0.2,2.1,0,58.8,71.9,1900,558,1342,29.37,70.63,50,508,166,1176,216,1684,9,12.4,11.4,"50% - 75% P.O.C.","$44000 - $59000"
"48201520400","Census Tract 5204, Harris County, Texas",3303,31471,615,237,0,2,0,2412,18.6,7.2,0,0.1,0,73,81.4,1153,208,945,18.04,81.96,13,195,97,848,110,1043,6.2,10.3,9.5,"75% or more P.O.C.","Less than $44000"
"48201520500","Census Tract 5205, Harris County, Texas",9579,40463,890,477,0,0,0,8017,9.3,5,0,0,0,83.7,90.7,2685,1065,1620,39.66,60.34,276,789,598,1022,874,1811,25.9,36.9,32.6,"75% or more P.O.C.","Less than $44000"
"48201520601","Census Tract 5206.01, Harris County, Texas",2726,36250,341,120,0,198,0,2062,12.5,4.4,0,7.3,0,75.6,87.5,807,218,589,27.01,72.99,80,138,61,528,141,666,36.7,10.4,17.5,"75% or more P.O.C.","Less than $44000"
"48201520602","Census Tract 5206.02, Harris County, Texas",5681,40955,937,268,13,48,0,4404,16.5,4.7,0.2,0.8,0,77.5,83.5,1909,839,1070,43.95,56.05,86,753,204,866,290,1619,10.3,19.1,15.2,"75% or more P.O.C.","Less than $44000"
"48201520700","Census Tract 5207, Harris County, Texas",4334,126500,2362,150,0,296,0,1320,54.5,3.5,0,6.8,0,30.5,45.5,1374,1040,334,75.69,24.31,74,966,32,302,106,1268,7.1,9.6,7.7,"25% - 50% P.O.C.","$86000 or more"
"48201521000","Census Tract 5210, Harris County, Texas",2620,38807,593,154,0,95,0,1768,22.6,5.9,0,3.6,0,67.5,77.4,770,281,489,36.49,63.51,23,258,126,363,149,621,8.2,25.8,19.4,"75% or more P.O.C.","Less than $44000"
"48201521100","Census Tract 5211, Harris County, Texas",2304,37375,327,0,0,0,0,1956,14.2,0,0,0,0,84.9,85.8,656,125,531,19.05,80.95,10,115,104,427,114,542,8,19.6,17.4,"75% or more P.O.C.","Less than $44000"
"48201521200","Census Tract 5212, Harris County, Texas",5804,39534,652,310,0,181,0,4553,11.2,5.3,0,3.1,0,78.4,88.8,2117,716,1401,33.82,66.18,80,636,139,1262,219,1898,11.2,9.9,10.3,"75% or more P.O.C.","Less than $44000"
"48201521300","Census Tract 5213, Harris County, Texas",5461,44574,1146,342,0,462,0,3393,21,6.3,0,8.5,0,62.1,79,1926,1182,744,61.37,38.63,126,1056,164,580,290,1636,10.7,22,15.1,"75% or more P.O.C.","$44000 - $59000"
"48201521400","Census Tract 5214, Harris County, Texas",7766,37500,285,22,0,91,0,7368,3.7,0.3,0,1.2,0,94.9,96.3,2118,501,1617,23.65,76.35,94,407,452,1165,546,1572,18.8,28,25.8,"75% or more P.O.C.","Less than $44000"
"48201521500","Census Tract 5215, Harris County, Texas",5621,69542,1591,96,0,100,0,3773,28.3,1.7,0,1.8,0,67.1,71.7,1857,1161,696,62.52,37.48,126,1035,158,538,284,1573,10.9,22.7,15.3,"50% - 75% P.O.C.","$59000 - $86000"
"48201521600","Census Tract 5216, Harris County, Texas",3544,53194,361,534,0,22,0,2616,10.2,15.1,0,0.6,0,73.8,89.8,996,761,235,76.41,23.59,184,577,69,166,253,743,24.2,29.4,25.4,"75% or more P.O.C.","$44000 - $59000"
"48201521700","Census Tract 5217, Harris County, Texas",6773,32002,569,1995,0,93,68,4048,8.4,29.5,0,1.4,1,59.8,91.6,2997,286,2711,9.54,90.46,0,286,100,2611,100,2897,0,3.7,3.3,"75% or more P.O.C.","Less than $44000"
"48201521800","Census Tract 5218, Harris County, Texas",5866,58462,987,540,60,1418,0,2827,16.8,9.2,1,24.2,0,48.2,83.2,1858,1399,459,75.3,24.7,338,1061,25,434,363,1495,24.2,5.4,19.5,"75% or more P.O.C.","$44000 - $59000"
"48201521900","Census Tract 5219, Harris County, Texas",6034,80125,2859,186,0,768,0,2199,47.4,3.1,0,12.7,0,36.4,52.6,2355,1607,748,68.24,31.76,84,1523,92,656,176,2179,5.2,12.3,7.5,"50% - 75% P.O.C.","$59000 - $86000"
"48201522000","Census Tract 5220, Harris County, Texas",4718,51204,1670,247,0,97,0,2659,35.4,5.2,0,2.1,0,56.4,64.6,1848,763,1085,41.29,58.71,106,657,147,938,253,1595,13.9,13.5,13.7,"50% - 75% P.O.C.","$44000 - $59000"
"48201522100","Census Tract 5221, Harris County, Texas",7734,52484,2493,536,24,438,0,4227,32.2,6.9,0.3,5.7,0,54.7,67.8,2693,1140,1553,42.33,57.67,63,1077,341,1212,404,2289,5.5,22,15,"50% - 75% P.O.C.","$44000 - $59000"
"48201522201","Census Tract 5222.01, Harris County, Texas",3960,49750,1069,164,0,96,0,2589,27,4.1,0,2.4,0,65.4,73,1263,609,654,48.22,51.78,54,555,114,540,168,1095,8.9,17.4,13.3,"50% - 75% P.O.C.","$44000 - $59000"
"48201522202","Census Tract 5222.02, Harris County, Texas",4449,44853,880,162,0,229,0,3178,19.8,3.6,0,5.1,0,71.4,80.2,1278,470,808,36.78,63.22,35,435,243,565,278,1000,7.4,30.1,21.8,"75% or more P.O.C.","$44000 - $59000"
"48201522301","Census Tract 5223.01, Harris County, Texas",3979,46000,988,145,0,168,0,2678,24.8,3.6,0,4.2,0,67.3,75.2,1560,426,1134,27.31,72.69,25,401,37,1097,62,1498,5.9,3.3,4,"75% or more P.O.C.","$44000 - $59000"
"48201522302","Census Tract 5223.02, Harris County, Texas",3675,59979,681,9,0,165,0,2697,18.5,0.2,0,4.5,0,73.4,81.5,1381,283,1098,20.49,79.51,0,283,129,969,129,1252,0,11.7,9.3,"75% or more P.O.C.","$59000 - $86000"
"48201522401","Census Tract 5224.01, Harris County, Texas",5479,64427,2739,276,0,305,0,2108,50,5,0,5.6,0,38.5,50,2089,1140,949,54.57,45.43,125,1015,151,798,276,1813,11,15.9,13.2,"50% - 75% P.O.C.","$59000 - $86000"
"48201522402","Census Tract 5224.02, Harris County, Texas",3980,54969,1333,21,0,174,0,2402,33.5,0.5,0,4.4,0,60.4,66.5,1292,781,511,60.45,39.55,77,704,131,380,208,1084,9.9,25.6,16.1,"50% - 75% P.O.C.","$44000 - $59000"
"48201522500","Census Tract 5225, Harris County, Texas",5157,205184,4041,0,0,421,0,530,78.4,0,0,8.2,0,10.3,21.6,1745,1689,56,96.79,3.21,170,1519,11,45,181,1564,10.1,19.6,10.4,"Less than 25% P.O.C.","$86000 or more"
"48201530100","Census Tract 5301, Harris County, Texas",6389,30081,798,742,17,31,0,4763,12.5,11.6,0.3,0.5,0,74.6,87.5,2393,290,2103,12.12,87.88,24,266,317,1786,341,2052,8.3,15.1,14.2,"75% or more P.O.C.","Less than $44000"
"48201530200","Census Tract 5302, Harris County, Texas",3679,96745,2102,60,0,169,0,1194,57.1,1.6,0,4.6,0,32.5,42.9,1590,1102,488,69.31,30.69,83,1019,0,488,83,1507,7.5,0,5.2,"25% - 50% P.O.C.","$86000 or more"
"48201530300","Census Tract 5303, Harris County, Texas",2382,25350,159,1270,0,9,0,944,6.7,53.3,0,0.4,0,39.6,93.3,947,433,514,45.72,54.28,38,395,97,417,135,812,8.8,18.9,14.3,"75% or more P.O.C.","Less than $44000"
"48201530400","Census Tract 5304, Harris County, Texas",2932,31923,58,1230,0,0,0,1644,2,42,0,0,0,56.1,98,974,572,402,58.73,41.27,65,507,104,298,169,805,11.4,25.9,17.4,"75% or more P.O.C.","Less than $44000"
"48201530500","Census Tract 5305, Harris County, Texas",5423,31555,371,1694,0,0,8,3348,6.8,31.2,0,0,0.1,61.7,93.2,1733,641,1092,36.99,63.01,113,528,235,857,348,1385,17.6,21.5,20.1,"75% or more P.O.C.","Less than $44000"
"48201530600","Census Tract 5306, Harris County, Texas",3627,34604,480,576,0,66,0,2479,13.2,15.9,0,1.8,0,68.3,86.8,1223,550,673,44.97,55.03,166,384,80,593,246,977,30.2,11.9,20.1,"75% or more P.O.C.","Less than $44000"
"48201530700","Census Tract 5307, Harris County, Texas",5929,28910,391,1454,21,11,0,3978,6.6,24.5,0.4,0.2,0,67.1,93.4,2029,666,1363,32.82,67.18,137,529,202,1161,339,1690,20.6,14.8,16.7,"75% or more P.O.C.","Less than $44000"
"48201530800","Census Tract 5308, Harris County, Texas",4397,56525,476,3053,0,1,0,856,10.8,69.4,0,0,0,19.5,89.2,1575,1190,385,75.56,24.44,175,1015,0,385,175,1400,14.7,0,11.1,"75% or more P.O.C.","$44000 - $59000"
"48201530900","Census Tract 5309, Harris County, Texas",4132,86458,2123,182,0,47,0,1690,51.4,4.4,0,1.1,0,40.9,48.6,1498,1025,473,68.42,31.58,63,962,43,430,106,1392,6.1,9.1,7.1,"25% - 50% P.O.C.","$86000 or more"
"48201531000","Census Tract 5310, Harris County, Texas",3949,140179,2771,40,0,129,0,979,70.2,1,0,3.3,0,24.8,29.8,1551,1247,304,80.4,19.6,128,1119,0,304,128,1423,10.3,0,8.3,"25% - 50% P.O.C.","$86000 or more"
"48201531100","Census Tract 5311, Harris County, Texas",3347,139338,2496,0,0,64,0,787,74.6,0,0,1.9,0,23.5,25.4,1302,1128,174,86.64,13.36,105,1023,0,174,105,1197,9.3,0,8.1,"25% - 50% P.O.C.","$86000 or more"
"48201531200","Census Tract 5312, Harris County, Texas",3471,65388,1642,261,0,85,0,1483,47.3,7.5,0,2.4,0,42.7,52.7,1445,742,703,51.35,48.65,39,703,53,650,92,1353,5.3,7.5,6.4,"50% - 75% P.O.C.","$59000 - $86000"
"48201531300","Census Tract 5313, Harris County, Texas",5967,32053,1561,713,0,0,0,3550,26.2,11.9,0,0,0,59.5,73.8,2383,534,1849,22.41,77.59,0,534,189,1660,189,2194,0,10.2,7.9,"50% - 75% P.O.C.","Less than $44000"
"48201531400","Census Tract 5314, Harris County, Texas",2194,75272,1123,132,0,68,0,834,51.2,6,0,3.1,0,38,48.8,963,676,287,70.2,29.8,41,635,6,281,47,916,6.1,2.1,4.9,"25% - 50% P.O.C.","$59000 - $86000"
"48201531500","Census Tract 5315, Harris County, Texas",2856,53214,1203,141,0,68,0,1386,42.1,4.9,0,2.4,0,48.5,57.9,1240,760,480,61.29,38.71,0,760,37,443,37,1203,0,7.7,3,"50% - 75% P.O.C.","$44000 - $59000"
"48201531600","Census Tract 5316, Harris County, Texas",3246,78906,1708,65,0,28,0,1424,52.6,2,0,0.9,0,43.9,47.4,1203,970,233,80.63,19.37,45,925,0,233,45,1158,4.6,0,3.7,"25% - 50% P.O.C.","$59000 - $86000"
"48201531700","Census Tract 5317, Harris County, Texas",3515,133409,2335,102,0,205,0,650,66.4,2.9,0,5.8,0,18.5,33.6,1292,1166,126,90.25,9.75,114,1052,0,126,114,1178,9.8,0,8.8,"25% - 50% P.O.C.","$86000 or more"
"48201531800","Census Tract 5318, Harris County, Texas",2548,32674,60,1299,0,78,0,1069,2.4,51,0,3.1,0,42,97.6,927,577,350,62.24,37.76,99,478,30,320,129,798,17.2,8.6,13.9,"75% or more P.O.C.","Less than $44000"
"48201531900","Census Tract 5319, Harris County, Texas",4974,45144,355,2852,0,36,0,1582,7.1,57.3,0,0.7,0,31.8,92.9,1511,1129,382,74.72,25.28,176,953,93,289,269,1242,15.6,24.3,17.8,"75% or more P.O.C.","$44000 - $59000"
"48201532001","Census Tract 5320.01, Harris County, Texas",6619,36682,745,2072,0,69,7,3660,11.3,31.3,0,1,0.1,55.3,88.7,2760,297,2463,10.76,89.24,53,244,89,2374,142,2618,17.8,3.6,5.1,"75% or more P.O.C.","Less than $44000"
"48201532002","Census Tract 5320.02, Harris County, Texas",1139,76250,477,155,0,0,0,416,41.9,13.6,0,0,0,36.5,58.1,414,371,43,89.61,10.39,45,326,11,32,56,358,12.1,25.6,13.5,"50% - 75% P.O.C.","$59000 - $86000"
"48201532100","Census Tract 5321, Harris County, Texas",7369,31717,841,1815,0,328,0,4373,11.4,24.6,0,4.5,0,59.3,88.6,2707,703,2004,25.97,74.03,50,653,348,1656,398,2309,7.1,17.4,14.7,"75% or more P.O.C.","Less than $44000"
"48201532200","Census Tract 5322, Harris County, Texas",3883,38972,438,690,0,25,0,2693,11.3,17.8,0,0.6,0,69.4,88.7,1371,294,1077,21.44,78.56,6,288,150,927,156,1215,2,13.9,11.4,"75% or more P.O.C.","Less than $44000"
"48201532300","Census Tract 5323, Harris County, Texas",6993,45133,1265,1988,74,194,0,3472,18.1,28.4,1.1,2.8,0,49.6,81.9,3073,671,2402,21.84,78.16,28,643,190,2212,218,2855,4.2,7.9,7.1,"75% or more P.O.C.","$44000 - $59000"
"48201532400","Census Tract 5324, Harris County, Texas",6348,66066,1168,756,0,177,0,4194,18.4,11.9,0,2.8,0,66.1,81.6,2028,1324,704,65.29,34.71,229,1095,88,616,317,1711,17.3,12.5,15.6,"75% or more P.O.C.","$59000 - $86000"
"48201532501","Census Tract 5325.01, Harris County, Texas",9319,64819,1865,517,0,1989,0,4836,20,5.5,0,21.3,0,51.9,80,2841,2410,431,84.83,15.17,299,2111,96,335,395,2446,12.4,22.3,13.9,"75% or more P.O.C.","$59000 - $86000"
"48201532502","Census Tract 5325.02, Harris County, Texas",5127,41310,735,296,0,234,0,3862,14.3,5.8,0,4.6,0,75.3,85.7,1532,1257,275,82.05,17.95,293,964,63,212,356,1176,23.3,22.9,23.2,"75% or more P.O.C.","Less than $44000"
"48201532600","Census Tract 5326, Harris County, Texas",7408,37482,300,2318,0,790,0,3974,4,31.3,0,10.7,0,53.6,96,2215,1063,1152,47.99,52.01,267,796,169,983,436,1779,25.1,14.7,19.7,"75% or more P.O.C.","Less than $44000"
"48201532700","Census Tract 5327, Harris County, Texas",5169,44728,629,2103,0,63,0,2292,12.2,40.7,0,1.2,0,44.3,87.8,1781,1108,673,62.21,37.79,178,930,121,552,299,1482,16.1,18,16.8,"75% or more P.O.C.","$44000 - $59000"
"48201532800","Census Tract 5328, Harris County, Texas",1893,67672,397,330,0,72,0,1081,21,17.4,0,3.8,0,57.1,79,656,419,237,63.87,36.13,51,368,60,177,111,545,12.2,25.3,16.9,"75% or more P.O.C.","$59000 - $86000"
"48201532900","Census Tract 5329, Harris County, Texas",5662,43926,142,2073,28,239,8,3145,2.5,36.6,0.5,4.2,0.1,55.5,97.5,1785,1012,773,56.69,43.31,173,839,128,645,301,1484,17.1,16.6,16.9,"75% or more P.O.C.","Less than $44000"
"48201533000","Census Tract 5330, Harris County, Texas",2433,29611,23,1473,0,66,0,871,0.9,60.5,0,2.7,0,35.8,99.1,829,117,712,14.11,85.89,14,103,38,674,52,777,12,5.3,6.3,"75% or more P.O.C.","Less than $44000"
"48201533100","Census Tract 5331, Harris County, Texas",6879,53955,353,3832,0,213,0,2415,5.1,55.7,0,3.1,0,35.1,94.9,2251,1570,681,69.75,30.25,132,1438,151,530,283,1968,8.4,22.2,12.6,"75% or more P.O.C.","$44000 - $59000"
"48201533200","Census Tract 5332, Harris County, Texas",3983,36285,304,1651,0,126,0,1760,7.6,41.5,0,3.2,0,44.2,92.4,1451,545,906,37.56,62.44,56,489,138,768,194,1257,10.3,15.2,13.4,"75% or more P.O.C.","Less than $44000"
"48201533300","Census Tract 5333, Harris County, Texas",6049,20633,79,4035,21,0,0,1740,1.3,66.7,0.3,0,0,28.8,98.7,2174,1062,1112,48.85,51.15,106,956,94,1018,200,1974,10,8.5,9.2,"75% or more P.O.C.","Less than $44000"
"48201533400","Census Tract 5334, Harris County, Texas",11864,40739,158,3940,0,371,0,7362,1.3,33.2,0,3.1,0,62.1,98.7,3207,2475,732,77.17,22.83,706,1769,162,570,868,2339,28.5,22.1,27.1,"75% or more P.O.C.","Less than $44000"
"48201533500","Census Tract 5335, Harris County, Texas",4245,56782,474,437,0,371,0,2963,11.2,10.3,0,8.7,0,69.8,88.8,1233,1080,153,87.59,12.41,264,816,18,135,282,951,24.4,11.8,22.9,"75% or more P.O.C.","$44000 - $59000"
"48201533600","Census Tract 5336, Harris County, Texas",5399,32406,111,1140,13,275,0,3860,2.1,21.1,0.2,5.1,0,71.5,97.9,1907,358,1549,18.77,81.23,60,298,84,1465,144,1763,16.8,5.4,7.6,"75% or more P.O.C.","Less than $44000"
"48201533701","Census Tract 5337.01, Harris County, Texas",5558,28821,172,770,0,59,0,4557,3.1,13.9,0,1.1,0,82,96.9,1719,509,1210,29.61,70.39,121,388,196,1014,317,1402,23.8,16.2,18.4,"75% or more P.O.C.","Less than $44000"
"48201533702","Census Tract 5337.02, Harris County, Texas",3815,40853,233,431,0,77,0,3064,6.1,11.3,0,2,0,80.3,93.9,947,686,261,72.44,27.56,210,476,119,142,329,618,30.6,45.6,34.7,"75% or more P.O.C.","Less than $44000"
"48201533801","Census Tract 5338.01, Harris County, Texas",11239,52429,631,2084,79,1464,0,6981,5.6,18.5,0.7,13,0,62.1,94.4,2919,2285,634,78.28,21.72,522,1763,175,459,697,2222,22.8,27.6,23.9,"75% or more P.O.C.","$44000 - $59000"
"48201533802","Census Tract 5338.02, Harris County, Texas",7851,53581,419,944,0,1148,0,5251,5.3,12,0,14.6,0,66.9,94.7,2080,1630,450,78.37,21.63,457,1173,106,344,563,1517,28,23.6,27.1,"75% or more P.O.C.","$44000 - $59000"
"48201533901","Census Tract 5339.01, Harris County, Texas",9472,57583,546,2157,0,493,0,6259,5.8,22.8,0,5.2,0,66.1,94.2,2693,2133,560,79.21,20.79,381,1752,141,419,522,2171,17.9,25.2,19.4,"75% or more P.O.C.","$44000 - $59000"
"48201533902","Census Tract 5339.02, Harris County, Texas",4629,28500,297,1215,0,207,0,2910,6.4,26.2,0,4.5,0,62.9,93.6,1482,316,1166,21.32,78.68,36,280,89,1077,125,1357,11.4,7.6,8.4,"75% or more P.O.C.","Less than $44000"
"48201534001","Census Tract 5340.01, Harris County, Texas",3237,35990,305,233,0,620,0,2079,9.4,7.2,0,19.2,0,64.2,90.6,964,316,648,32.78,67.22,82,234,108,540,190,774,25.9,16.7,19.7,"75% or more P.O.C.","Less than $44000"
"48201534002","Census Tract 5340.02, Harris County, Texas",6438,50859,863,615,37,371,0,4552,13.4,9.6,0.6,5.8,0,70.7,86.6,1553,1025,528,66,34,353,672,194,334,547,1006,34.4,36.7,35.2,"75% or more P.O.C.","$44000 - $59000"
"48201534003","Census Tract 5340.03, Harris County, Texas",2777,64574,193,589,0,325,0,1630,6.9,21.2,0,11.7,0,58.7,93.1,689,501,188,72.71,27.29,128,373,39,149,167,522,25.5,20.7,24.2,"75% or more P.O.C.","$59000 - $86000"
"48201534100","Census Tract 5341, Harris County, Texas",7952,75303,1046,879,0,1380,0,4567,13.2,11.1,0,17.4,0,57.4,86.8,2120,1577,543,74.39,25.61,346,1231,158,385,504,1616,21.9,29.1,23.8,"75% or more P.O.C.","$59000 - $86000"
"48201534201","Census Tract 5342.01, Harris County, Texas",3289,59804,351,299,0,587,0,1977,10.7,9.1,0,17.8,0,60.1,89.3,904,445,459,49.23,50.77,127,318,125,334,252,652,28.5,27.2,27.9,"75% or more P.O.C.","$59000 - $86000"
"48201534202","Census Tract 5342.02, Harris County, Texas",9583,86298,4300,1167,0,988,19,3014,44.9,12.2,0,10.3,0.2,31.5,55.1,3781,2277,1504,60.22,39.78,271,2006,118,1386,389,3392,11.9,7.8,10.3,"50% - 75% P.O.C.","$86000 or more"
"48201534203","Census Tract 5342.03, Harris County, Texas",2279,50464,590,50,9,128,0,1502,25.9,2.2,0.4,5.6,0,65.9,74.1,589,372,217,63.16,36.84,117,255,111,106,228,361,31.5,51.2,38.7,"50% - 75% P.O.C.","$44000 - $59000"
"48201540100","Census Tract 5401, Harris County, Texas",10485,147756,4787,737,0,2100,0,2702,45.7,7,0,20,0,25.8,54.3,3885,3121,764,80.33,19.67,168,2953,168,596,336,3549,5.4,22,8.6,"50% - 75% P.O.C.","$86000 or more"
"48201540200","Census Tract 5402, Harris County, Texas",2522,53567,524,338,0,148,0,1485,20.8,13.4,0,5.9,0,58.9,79.2,925,471,454,50.92,49.08,82,389,21,433,103,822,17.4,4.6,11.1,"75% or more P.O.C.","$44000 - $59000"
"48201540501","Census Tract 5405.01, Harris County, Texas",6755,35589,872,517,0,188,0,4963,12.9,7.7,0,2.8,0,73.5,87.1,2345,268,2077,11.43,88.57,0,268,102,1975,102,2243,0,4.9,4.3,"75% or more P.O.C.","Less than $44000"
"48201540502","Census Tract 5405.02, Harris County, Texas",4790,76641,2747,471,0,142,0,1386,57.3,9.8,0,3,0,28.9,42.7,1735,1366,369,78.73,21.27,116,1250,80,289,196,1539,8.5,21.7,11.3,"25% - 50% P.O.C.","$59000 - $86000"
"48201540601","Census Tract 5406.01, Harris County, Texas",4076,70385,1156,530,0,529,0,1780,28.4,13,0,13,0,43.7,71.6,1408,1115,293,79.19,20.81,166,949,33,260,199,1209,14.9,11.3,14.1,"50% - 75% P.O.C.","$59000 - $86000"
"48201540602","Census Tract 5406.02, Harris County, Texas",7085,58586,1757,1753,0,615,0,2873,24.8,24.7,0,8.7,0,40.6,75.2,2511,1488,1023,59.26,40.74,163,1325,52,971,215,2296,11,5.1,8.6,"75% or more P.O.C.","$44000 - $59000"
"48201540700","Census Tract 5407, Harris County, Texas",6924,89728,2564,399,28,814,31,2894,37,5.8,0.4,11.8,0.4,41.8,63,2261,1849,412,81.78,18.22,354,1495,28,384,382,1879,19.1,6.8,16.9,"50% - 75% P.O.C.","$86000 or more"
"48201540800","Census Tract 5408, Harris County, Texas",7122,58214,932,1110,0,574,0,4381,13.1,15.6,0,8.1,0,61.5,86.9,2350,1353,997,57.57,42.43,173,1180,65,932,238,2112,12.8,6.5,10.1,"75% or more P.O.C.","$44000 - $59000"
"48201540901","Census Tract 5409.01, Harris County, Texas",2607,134048,1641,293,0,258,0,389,62.9,11.2,0,9.9,0,14.9,37.1,1100,946,154,86,14,34,912,13,141,47,1053,3.6,8.4,4.3,"25% - 50% P.O.C.","$86000 or more"
"48201540902","Census Tract 5409.02, Harris County, Texas",7058,59788,2472,1828,20,680,0,1973,35,25.9,0.3,9.6,0,28,65,3019,1296,1723,42.93,57.07,39,1257,34,1689,73,2946,3,2,2.4,"50% - 75% P.O.C.","$59000 - $86000"
"48201541001","Census Tract 5410.01, Harris County, Texas",11346,71525,3246,1907,0,2771,0,3007,28.6,16.8,0,24.4,0,26.5,71.4,3893,1970,1923,50.6,49.4,339,1631,10,1913,349,3544,17.2,0.5,9,"50% - 75% P.O.C.","$59000 - $86000"
"48201541002","Census Tract 5410.02, Harris County, Texas",8858,104741,3255,1855,0,1741,0,1783,36.7,20.9,0,19.7,0,20.1,63.3,2740,2296,444,83.8,16.2,510,1786,38,406,548,2192,22.2,8.6,20,"50% - 75% P.O.C.","$86000 or more"
"48201541003","Census Tract 5410.03, Harris County, Texas",13814,102327,6654,1939,0,1706,0,3046,48.2,14,0,12.3,0,22.1,51.8,4411,3705,706,83.99,16.01,675,3030,119,587,794,3617,18.2,16.9,18,"50% - 75% P.O.C.","$86000 or more"
"48201541100","Census Tract 5411, Harris County, Texas",7423,100989,3900,696,39,691,0,1917,52.5,9.4,0.5,9.3,0,25.8,47.5,2343,2148,195,91.68,8.32,367,1781,78,117,445,1898,17.1,40,19,"25% - 50% P.O.C.","$86000 or more"
"48201541201","Census Tract 5412.01, Harris County, Texas",8854,102500,4778,833,87,779,0,2089,54,9.4,1,8.8,0,23.6,46,2984,2645,339,88.64,11.36,265,2380,19,320,284,2700,10,5.6,9.5,"25% - 50% P.O.C.","$86000 or more"
"48201541202","Census Tract 5412.02, Harris County, Texas",8698,87788,4116,920,0,268,0,3138,47.3,10.6,0,3.1,0,36.1,52.7,2862,2217,645,77.46,22.54,298,1919,32,613,330,2532,13.4,5,11.5,"50% - 75% P.O.C.","$86000 or more"
"48201541203","Census Tract 5412.03, Harris County, Texas",2688,113125,2118,0,0,163,0,407,78.8,0,0,6.1,0,15.1,21.2,999,915,84,91.59,8.41,26,889,26,58,52,947,2.8,31,5.2,"Less than 25% P.O.C.","$86000 or more"
"48201541300","Census Tract 5413, Harris County, Texas",12999,61853,2190,2025,0,1686,0,6976,16.8,15.6,0,13,0,53.7,83.2,3834,2211,1623,57.67,42.33,301,1910,372,1251,673,3161,13.6,22.9,17.6,"75% or more P.O.C.","$59000 - $86000"
"48201541400","Census Tract 5414, Harris County, Texas",15920,74078,2517,2632,0,3321,0,7182,15.8,16.5,0,20.9,0,45.1,84.2,4815,3589,1226,74.54,25.46,838,2751,192,1034,1030,3785,23.3,15.7,21.4,"75% or more P.O.C.","$59000 - $86000"
"48201541500","Census Tract 5415, Harris County, Texas",5493,71910,1430,402,0,817,13,2505,26,7.3,0,14.9,0.2,45.6,74,1629,1431,198,87.85,12.15,329,1102,81,117,410,1219,23,40.9,25.2,"50% - 75% P.O.C.","$59000 - $86000"
"48201541601","Census Tract 5416.01, Harris County, Texas",6137,94286,2817,816,0,818,0,1504,45.9,13.3,0,13.3,0,24.5,54.1,2106,1937,169,91.98,8.02,162,1775,0,169,162,1944,8.4,0,7.7,"50% - 75% P.O.C.","$86000 or more"
"48201541602","Census Tract 5416.02, Harris County, Texas",10628,63500,2467,716,170,447,0,6474,23.2,6.7,1.6,4.2,0,60.9,76.8,3122,2310,812,73.99,26.01,451,1859,249,563,700,2422,19.5,30.7,22.4,"75% or more P.O.C.","$59000 - $86000"
"48201541700","Census Tract 5417, Harris County, Texas",11084,62524,3011,2693,186,1153,0,3835,27.2,24.3,1.7,10.4,0,34.6,72.8,4168,1494,2674,35.84,64.16,279,1215,28,2646,307,3861,18.7,1,7.4,"50% - 75% P.O.C.","$59000 - $86000"
"48201541800","Census Tract 5418, Harris County, Texas",6731,55608,1662,1059,0,594,0,3122,24.7,15.7,0,8.8,0,46.4,75.3,2460,896,1564,36.42,63.58,211,685,169,1395,380,2080,23.5,10.8,15.4,"75% or more P.O.C.","$44000 - $59000"
"48201541900","Census Tract 5419, Harris County, Texas",8020,76510,2820,1133,0,469,0,3081,35.2,14.1,0,5.8,0,38.4,64.8,2468,1801,667,72.97,27.03,314,1487,71,596,385,2083,17.4,10.6,15.6,"50% - 75% P.O.C.","$59000 - $86000"
"48201542000","Census Tract 5420, Harris County, Texas",15630,80850,7214,2233,0,854,146,4610,46.2,14.3,0,5.5,0.9,29.5,53.8,4580,3436,1144,75.02,24.98,767,2669,98,1046,865,3715,22.3,8.6,18.9,"50% - 75% P.O.C.","$59000 - $86000"
"48201542101","Census Tract 5421.01, Harris County, Texas",25740,66587,4632,7585,41,1476,0,11679,18,29.5,0.2,5.7,0,45.4,82,7446,4353,3093,58.46,41.54,1303,3050,631,2462,1934,5512,29.9,20.4,26,"75% or more P.O.C.","$59000 - $86000"
"48201542102","Census Tract 5421.02, Harris County, Texas",16690,79424,2894,4302,0,390,0,8503,17.3,25.8,0,2.3,0,50.9,82.7,4597,3665,932,79.73,20.27,667,2998,408,524,1075,3522,18.2,43.8,23.4,"75% or more P.O.C.","$59000 - $86000"
"48201542200","Census Tract 5422, Harris County, Texas",24521,78750,3605,5939,85,1269,0,13155,14.7,24.2,0.3,5.2,0,53.6,85.3,6679,5081,1598,76.07,23.93,1398,3683,174,1424,1572,5107,27.5,10.9,23.5,"75% or more P.O.C.","$59000 - $86000"
"48201542301","Census Tract 5423.01, Harris County, Texas",14366,76268,3389,1897,0,849,0,8036,23.6,13.2,0,5.9,0,55.9,76.4,4081,3286,795,80.52,19.48,831,2455,244,551,1075,3006,25.3,30.7,26.3,"75% or more P.O.C.","$59000 - $86000"
"48201542302","Census Tract 5423.02, Harris County, Texas",7768,83477,2084,1562,46,421,0,3585,26.8,20.1,0.6,5.4,0,46.2,73.2,2360,1701,659,72.08,27.92,387,1314,146,513,533,1827,22.8,22.2,22.6,"50% - 75% P.O.C.","$59000 - $86000"
"48201542400","Census Tract 5424, Harris County, Texas",12600,67166,2744,1626,0,563,0,7396,21.8,12.9,0,4.5,0,58.7,78.2,3780,1858,1922,49.15,50.85,418,1440,288,1634,706,3074,22.5,15,18.7,"75% or more P.O.C.","$59000 - $86000"
"48201542500","Census Tract 5425, Harris County, Texas",2927,76285,2223,134,0,60,0,456,75.9,4.6,0,2,0,15.6,24.1,1315,696,619,52.93,47.07,30,666,0,619,30,1285,4.3,0,2.3,"Less than 25% P.O.C.","$59000 - $86000"
"48201542600","Census Tract 5426, Harris County, Texas",5841,98207,2645,630,0,258,0,2056,45.3,10.8,0,4.4,0,35.2,54.7,1762,1346,416,76.39,23.61,276,1070,61,355,337,1425,20.5,14.7,19.1,"50% - 75% P.O.C.","$86000 or more"
"48201542700","Census Tract 5427, Harris County, Texas",5299,59261,3238,256,0,225,0,1471,61.1,4.8,0,4.2,0,27.8,38.9,1855,1362,493,73.42,26.58,89,1273,67,426,156,1699,6.5,13.6,8.4,"25% - 50% P.O.C.","$59000 - $86000"
"48201542800","Census Tract 5428, Harris County, Texas",9529,96792,5383,222,0,136,0,3583,56.5,2.3,0,1.4,0,37.6,43.5,2894,2617,277,90.43,9.57,369,2248,87,190,456,2438,14.1,31.4,15.8,"25% - 50% P.O.C.","$86000 or more"
"48201542900","Census Tract 5429, Harris County, Texas",26770,100833,10396,4406,0,1644,0,9679,38.8,16.5,0,6.1,0,36.2,61.2,7726,6246,1480,80.84,19.16,1134,5112,174,1306,1308,6418,18.2,11.8,16.9,"50% - 75% P.O.C.","$86000 or more"
"48201543001","Census Tract 5430.01, Harris County, Texas",17355,134754,7211,3473,0,2402,0,3935,41.5,20,0,13.8,0,22.7,58.5,4953,4714,239,95.17,4.83,774,3940,43,196,817,4136,16.4,18,16.5,"50% - 75% P.O.C.","$86000 or more"
"48201543002","Census Tract 5430.02, Harris County, Texas",27645,125743,12189,4505,43,4498,0,5843,44.1,16.3,0.2,16.3,0,21.1,55.9,8504,6942,1562,81.63,18.37,1050,5892,392,1170,1442,7062,15.1,25.1,17,"50% - 75% P.O.C.","$86000 or more"
"48201543003","Census Tract 5430.03, Harris County, Texas",20730,75738,2815,4618,0,1395,0,11564,13.6,22.3,0,6.7,0,55.8,86.4,5839,4923,916,84.31,15.69,983,3940,368,548,1351,4488,20,40.2,23.1,"75% or more P.O.C.","$59000 - $86000"
"48201543100","Census Tract 5431, Harris County, Texas",2536,76181,969,231,34,13,0,1195,38.2,9.1,1.3,0.5,0,47.1,61.8,778,632,146,81.23,18.77,110,522,8,138,118,660,17.4,5.5,15.2,"50% - 75% P.O.C.","$59000 - $86000"
"48201543200","Census Tract 5432, Harris County, Texas",8493,69385,3574,486,28,1003,0,3234,42.1,5.7,0.3,11.8,0,38.1,57.9,3293,1370,1923,41.6,58.4,121,1249,149,1774,270,3023,8.8,7.7,8.2,"50% - 75% P.O.C.","$59000 - $86000"
"48201550100","Census Tract 5501, Harris County, Texas",5609,26825,266,2644,0,3,0,2630,4.7,47.1,0,0.1,0,46.9,95.3,2034,144,1890,7.08,92.92,11,133,184,1706,195,1839,7.6,9.7,9.6,"75% or more P.O.C.","Less than $44000"
"48201550200","Census Tract 5502, Harris County, Texas",4381,26070,318,2327,12,15,0,1592,7.3,53.1,0.3,0.3,0,36.3,92.7,1407,41,1366,2.91,97.09,5,36,276,1090,281,1126,12.2,20.2,20,"75% or more P.O.C.","Less than $44000"
"48201550301","Census Tract 5503.01, Harris County, Texas",7639,30236,508,4271,0,0,0,2664,6.7,55.9,0,0,0,34.9,93.3,3297,0,3297,0,100,0,0,189,3108,189,3108,NA,5.7,5.7,"75% or more P.O.C.","Less than $44000"
"48201550302","Census Tract 5503.02, Harris County, Texas",13811,47829,1068,7682,0,329,0,4131,7.7,55.6,0,2.4,0,29.9,92.3,5067,1271,3796,25.08,74.92,239,1032,258,3538,497,4570,18.8,6.8,9.8,"75% or more P.O.C.","$44000 - $59000"
"48201550401","Census Tract 5504.01, Harris County, Texas",15733,50941,1043,6200,0,1186,291,6757,6.6,39.4,0,7.5,1.8,42.9,93.4,5051,2003,3048,39.66,60.34,640,1363,316,2732,956,4095,32,10.4,18.9,"75% or more P.O.C.","$44000 - $59000"
"48201550402","Census Tract 5504.02, Harris County, Texas",11442,54078,352,6898,0,818,0,3233,3.1,60.3,0,7.1,0,28.3,96.9,3549,1558,1991,43.9,56.1,336,1222,246,1745,582,2967,21.6,12.4,16.4,"75% or more P.O.C.","$44000 - $59000"
"48201550500","Census Tract 5505, Harris County, Texas",6803,49292,126,2150,0,700,0,3636,1.9,31.6,0,10.3,0,53.4,98.1,1924,874,1050,45.43,54.57,285,589,185,865,470,1454,32.6,17.6,24.4,"75% or more P.O.C.","$44000 - $59000"
"48201550601","Census Tract 5506.01, Harris County, Texas",6982,62045,224,1934,0,519,0,4088,3.2,27.7,0,7.4,0,58.6,96.8,1864,1284,580,68.88,31.12,324,960,274,306,598,1266,25.2,47.2,32.1,"75% or more P.O.C.","$59000 - $86000"
"48201550602","Census Tract 5506.02, Harris County, Texas",3178,69792,116,1067,19,181,0,1741,3.7,33.6,0.6,5.7,0,54.8,96.3,851,686,165,80.61,19.39,195,491,49,116,244,607,28.4,29.7,28.7,"75% or more P.O.C.","$59000 - $86000"
"48201550603","Census Tract 5506.03, Harris County, Texas",6537,52875,222,1333,0,411,0,4535,3.4,20.4,0,6.3,0,69.4,96.6,1656,856,800,51.69,48.31,288,568,165,635,453,1203,33.6,20.6,27.4,"75% or more P.O.C.","$44000 - $59000"
"48201550700","Census Tract 5507, Harris County, Texas",3955,66724,335,1405,0,386,0,1820,8.5,35.5,0,9.8,0,46,91.5,1092,835,257,76.47,23.53,229,606,74,183,303,789,27.4,28.8,27.7,"75% or more P.O.C.","$59000 - $86000"
"48201550800","Census Tract 5508, Harris County, Texas",3668,55604,146,1494,0,149,0,1688,4,40.7,0,4.1,0,46,96,991,586,405,59.13,40.87,134,452,103,302,237,754,22.9,25.4,23.9,"75% or more P.O.C.","$44000 - $59000"
"48201550900","Census Tract 5509, Harris County, Texas",9552,53286,767,1888,0,1409,0,5248,8,19.8,0,14.8,0,54.9,92,2648,1987,661,75.04,24.96,554,1433,100,561,654,1994,27.9,15.1,24.7,"75% or more P.O.C.","$44000 - $59000"
"48201551000","Census Tract 5510, Harris County, Texas",3621,44750,258,760,0,274,0,2321,7.1,21,0,7.6,0,64.1,92.9,893,533,360,59.69,40.31,108,425,128,232,236,657,20.3,35.6,26.4,"75% or more P.O.C.","$44000 - $59000"
"48201551100","Census Tract 5511, Harris County, Texas",11366,46152,641,4057,0,1686,0,4817,5.6,35.7,0,14.8,0,42.4,94.4,3578,1690,1888,47.23,52.77,261,1429,255,1633,516,3062,15.4,13.5,14.4,"75% or more P.O.C.","$44000 - $59000"
"48201551200","Census Tract 5512, Harris County, Texas",7480,48273,2858,1211,144,891,0,2229,38.2,16.2,1.9,11.9,0,29.8,61.8,2678,1390,1288,51.9,48.1,183,1207,111,1177,294,2384,13.2,8.6,11,"50% - 75% P.O.C.","$44000 - $59000"
"48201551300","Census Tract 5513, Harris County, Texas",4219,75625,781,1261,0,838,0,1266,18.5,29.9,0,19.9,0,30,81.5,1190,880,310,73.95,26.05,155,725,66,244,221,969,17.6,21.3,18.6,"75% or more P.O.C.","$59000 - $86000"
"48201551400","Census Tract 5514, Harris County, Texas",5122,79122,1616,1090,0,533,29,1712,31.6,21.3,0,10.4,0.6,33.4,68.4,1969,1299,670,65.97,34.03,59,1240,129,541,188,1781,4.5,19.3,9.5,"50% - 75% P.O.C.","$59000 - $86000"
"48201551500","Census Tract 5515, Harris County, Texas",8050,54368,1281,2448,61,1335,38,2845,15.9,30.4,0.8,16.6,0.5,35.3,84.1,2775,1078,1697,38.85,61.15,125,953,93,1604,218,2557,11.6,5.5,7.9,"75% or more P.O.C.","$44000 - $59000"
"48201551600","Census Tract 5516, Harris County, Texas",8975,57500,2374,1359,24,533,0,4236,26.5,15.1,0.3,5.9,0,47.2,73.5,2774,1765,1009,63.63,36.37,237,1528,278,731,515,2259,13.4,27.6,18.6,"50% - 75% P.O.C.","$44000 - $59000"
"48201551701","Census Tract 5517.01, Harris County, Texas",8792,69564,3418,1254,0,1073,0,2635,38.9,14.3,0,12.2,0,30,61.1,3422,1938,1484,56.63,43.37,198,1740,148,1336,346,3076,10.2,10,10.1,"50% - 75% P.O.C.","$59000 - $86000"
"48201551702","Census Tract 5517.02, Harris County, Texas",3972,119125,2083,97,0,919,0,788,52.4,2.4,0,23.1,0,19.8,47.6,1316,1211,105,92.02,7.98,179,1032,50,55,229,1087,14.8,47.6,17.4,"25% - 50% P.O.C.","$86000 or more"
"48201551703","Census Tract 5517.03, Harris County, Texas",8597,86815,3493,719,0,2223,0,1977,40.6,8.4,0,25.9,0,23,59.4,3177,1600,1577,50.36,49.64,255,1345,192,1385,447,2730,15.9,12.2,14.1,"50% - 75% P.O.C.","$86000 or more"
"48201551800","Census Tract 5518, Harris County, Texas",4210,115726,3299,135,0,180,0,567,78.4,3.2,0,4.3,0,13.5,21.6,1710,1665,45,97.37,2.63,69,1596,14,31,83,1627,4.1,31.1,4.9,"Less than 25% P.O.C.","$86000 or more"
"48201551900","Census Tract 5519, Harris County, Texas",6185,43346,1594,2583,0,139,0,1736,25.8,41.8,0,2.2,0,28.1,74.2,2994,21,2973,0.7,99.3,0,21,120,2853,120,2874,0,4,4,"50% - 75% P.O.C.","Less than $44000"
"48201552001","Census Tract 5520.01, Harris County, Texas",8955,62167,3405,1516,0,1357,0,2469,38,16.9,0,15.2,0,27.6,62,3743,1912,1831,51.08,48.92,188,1724,90,1741,278,3465,9.8,4.9,7.4,"50% - 75% P.O.C.","$59000 - $86000"
"48201552002","Census Tract 5520.02, Harris County, Texas",1328,70833,543,287,0,158,0,310,40.9,21.6,0,11.9,0,23.3,59.1,492,278,214,56.5,43.5,27,251,17,197,44,448,9.7,7.9,8.9,"50% - 75% P.O.C.","$59000 - $86000"
"48201552101","Census Tract 5521.01, Harris County, Texas",4324,74352,1494,750,13,403,0,1565,34.6,17.3,0.3,9.3,0,36.2,65.4,1529,536,993,35.06,64.94,95,441,35,958,130,1399,17.7,3.5,8.5,"50% - 75% P.O.C.","$59000 - $86000"
"48201552102","Census Tract 5521.02, Harris County, Texas",6166,74809,3276,470,0,750,0,1670,53.1,7.6,0,12.2,0,27.1,46.9,2179,1766,413,81.05,18.95,224,1542,38,375,262,1917,12.7,9.2,12,"25% - 50% P.O.C.","$59000 - $86000"
"48201552103","Census Tract 5521.03, Harris County, Texas",3136,58938,1567,523,15,222,0,775,50,16.7,0.5,7.1,0,24.7,50,1135,777,358,68.46,31.54,137,640,46,312,183,952,17.6,12.8,16.1,"50% - 75% P.O.C.","$44000 - $59000"
"48201552200","Census Tract 5522, Harris County, Texas",7811,52330,2574,1243,0,1002,0,2894,33,15.9,0,12.8,0,37.1,67,2741,1377,1364,50.24,49.76,163,1214,208,1156,371,2370,11.8,15.2,13.5,"50% - 75% P.O.C.","$44000 - $59000"
"48201552301","Census Tract 5523.01, Harris County, Texas",4307,78047,2692,617,40,169,0,772,62.5,14.3,0.9,3.9,0,17.9,37.5,1562,1192,370,76.31,23.69,134,1058,113,257,247,1315,11.2,30.5,15.8,"25% - 50% P.O.C.","$59000 - $86000"
"48201552302","Census Tract 5523.02, Harris County, Texas",4235,65756,2162,828,0,408,0,631,51.1,19.6,0,9.6,0,14.9,48.9,1858,843,1015,45.37,54.63,11,832,31,984,42,1816,1.3,3.1,2.3,"25% - 50% P.O.C.","$59000 - $86000"
"48201552400","Census Tract 5524, Harris County, Texas",7519,54159,2609,1582,0,634,0,2602,34.7,21,0,8.4,0,34.6,65.3,2695,1666,1029,61.82,38.18,202,1464,70,959,272,2423,12.1,6.8,10.1,"50% - 75% P.O.C.","$44000 - $59000"
"48201552500","Census Tract 5525, Harris County, Texas",11484,63906,3540,1685,0,1437,0,4717,30.8,14.7,0,12.5,0,41.1,69.2,3646,2354,1292,64.56,35.44,355,1999,318,974,673,2973,15.1,24.6,18.5,"50% - 75% P.O.C.","$59000 - $86000"
"48201552601","Census Tract 5526.01, Harris County, Texas",6479,37205,1485,2966,19,883,0,1008,22.9,45.8,0.3,13.6,0,15.6,77.1,2365,498,1867,21.06,78.94,59,439,142,1725,201,2164,11.8,7.6,8.5,"75% or more P.O.C.","Less than $44000"
"48201552602","Census Tract 5526.02, Harris County, Texas",6648,72763,3556,983,0,812,0,1246,53.5,14.8,0,12.2,0,18.7,46.5,2946,1302,1644,44.2,55.8,54,1248,0,1644,54,2892,4.1,0,1.8,"25% - 50% P.O.C.","$59000 - $86000"
"48201552700","Census Tract 5527, Harris County, Texas",8427,56375,3690,1492,0,494,0,2429,43.8,17.7,0,5.9,0,28.8,56.2,3773,1499,2274,39.73,60.27,143,1356,93,2181,236,3537,9.5,4.1,6.3,"50% - 75% P.O.C.","$44000 - $59000"
"48201552800","Census Tract 5528, Harris County, Texas",9636,75156,5677,1923,0,554,0,1120,58.9,20,0,5.7,0,11.6,41.1,4258,2514,1744,59.04,40.96,161,2353,46,1698,207,4051,6.4,2.6,4.9,"25% - 50% P.O.C.","$59000 - $86000"
"48201552900","Census Tract 5529, Harris County, Texas",9033,61406,4252,2151,0,253,239,1813,47.1,23.8,0,2.8,2.6,20.1,52.9,3758,2123,1635,56.49,43.51,142,1981,183,1452,325,3433,6.7,11.2,8.6,"50% - 75% P.O.C.","$59000 - $86000"
"48201553001","Census Tract 5530.01, Harris County, Texas",5833,82917,2443,1130,80,510,0,1574,41.9,19.4,1.4,8.7,0,27,58.1,2141,1503,638,70.2,29.8,133,1370,57,581,190,1951,8.8,8.9,8.9,"50% - 75% P.O.C.","$59000 - $86000"
"48201553002","Census Tract 5530.02, Harris County, Texas",4813,90000,1326,890,0,437,0,2093,27.6,18.5,0,9.1,0,43.5,72.4,1676,1240,436,73.99,26.01,92,1148,23,413,115,1561,7.4,5.3,6.9,"50% - 75% P.O.C.","$86000 or more"
"48201553100","Census Tract 5531, Harris County, Texas",6335,65352,1947,1426,0,215,0,2688,30.7,22.5,0,3.4,0,42.4,69.3,2303,1182,1121,51.32,48.68,128,1054,74,1047,202,2101,10.8,6.6,8.8,"50% - 75% P.O.C.","$59000 - $86000"
"48201553200","Census Tract 5532, Harris County, Texas",6827,41089,1888,2164,0,423,0,2199,27.7,31.7,0,6.2,0,32.2,72.3,2684,978,1706,36.44,63.56,223,755,29,1677,252,2432,22.8,1.7,9.4,"50% - 75% P.O.C.","Less than $44000"
"48201553300","Census Tract 5533, Harris County, Texas",6149,31896,598,3539,91,19,0,1859,9.7,57.6,1.5,0.3,0,30.2,90.3,2576,11,2565,0.43,99.57,0,11,257,2308,257,2319,0,10,10,"75% or more P.O.C.","Less than $44000"
"48201553401","Census Tract 5534.01, Harris County, Texas",4090,113750,2975,254,32,170,0,585,72.7,6.2,0.8,4.2,0,14.3,27.3,1462,1300,162,88.92,11.08,100,1200,47,115,147,1315,7.7,29,10.1,"25% - 50% P.O.C.","$86000 or more"
"48201553402","Census Tract 5534.02, Harris County, Texas",9127,101364,4733,1414,0,532,0,2273,51.9,15.5,0,5.8,0,24.9,48.1,3186,2320,866,72.82,27.18,283,2037,181,685,464,2722,12.2,20.9,14.6,"25% - 50% P.O.C.","$86000 or more"
"48201553403","Census Tract 5534.03, Harris County, Texas",7843,88313,3798,723,38,1177,0,2031,48.4,9.2,0.5,15,0,25.9,51.6,2524,1919,605,76.03,23.97,269,1650,0,605,269,2255,14,0,10.7,"50% - 75% P.O.C.","$86000 or more"
"48201553500","Census Tract 5535, Harris County, Texas",6620,90735,4438,298,0,338,0,1227,67,4.5,0,5.1,0,18.5,33,2424,1775,649,73.23,26.77,147,1628,68,581,215,2209,8.3,10.5,8.9,"25% - 50% P.O.C.","$86000 or more"
"48201553600","Census Tract 5536, Harris County, Texas",7383,78984,4542,1128,25,660,0,895,61.5,15.3,0.3,8.9,0,12.1,38.5,2737,1682,1055,61.45,38.55,63,1619,33,1022,96,2641,3.7,3.1,3.5,"25% - 50% P.O.C.","$59000 - $86000"
"48201553700","Census Tract 5537, Harris County, Texas",4166,93323,2124,558,0,461,0,792,51,13.4,0,11.1,0,19,49,1467,1037,430,70.69,29.31,118,919,96,334,214,1253,11.4,22.3,14.6,"25% - 50% P.O.C.","$86000 or more"
"48201553801","Census Tract 5538.01, Harris County, Texas",2779,151477,1984,128,0,64,0,508,71.4,4.6,0,2.3,0,18.3,28.6,905,800,105,88.4,11.6,119,681,0,105,119,786,14.9,0,13.1,"25% - 50% P.O.C.","$86000 or more"
"48201553802","Census Tract 5538.02, Harris County, Texas",10168,72342,4593,1157,0,1366,0,2893,45.2,11.4,0,13.4,0,28.5,54.8,3506,2122,1384,60.52,39.48,379,1743,156,1228,535,2971,17.9,11.3,15.3,"50% - 75% P.O.C.","$59000 - $86000"
"48201553900","Census Tract 5539, Harris County, Texas",8107,125455,5214,532,0,1076,0,1086,64.3,6.6,0,13.3,0,13.4,35.7,2574,2486,88,96.58,3.42,274,2212,72,16,346,2228,11,81.8,13.4,"25% - 50% P.O.C.","$86000 or more"
"48201554001","Census Tract 5540.01, Harris County, Texas",3387,70625,1739,279,0,279,0,1056,51.3,8.2,0,8.2,0,31.2,48.7,1328,564,764,42.47,57.53,48,516,71,693,119,1209,8.5,9.3,9,"25% - 50% P.O.C.","$59000 - $86000"
"48201554002","Census Tract 5540.02, Harris County, Texas",4178,138382,3289,157,0,217,0,515,78.7,3.8,0,5.2,0,12.3,21.3,1492,1434,58,96.11,3.89,164,1270,0,58,164,1328,11.4,0,11,"Less than 25% P.O.C.","$86000 or more"
"48201554101","Census Tract 5541.01, Harris County, Texas",1161,132639,883,48,0,60,0,135,76.1,4.1,0,5.2,0,11.6,23.9,413,402,11,97.34,2.66,56,346,0,11,56,357,13.9,0,13.6,"Less than 25% P.O.C.","$86000 or more"
"48201554102","Census Tract 5541.02, Harris County, Texas",9725,98875,5385,976,0,1258,0,2025,55.4,10,0,12.9,0,20.8,44.6,3178,2784,394,87.6,12.4,356,2428,52,342,408,2770,12.8,13.2,12.8,"25% - 50% P.O.C.","$86000 or more"
"48201554200","Census Tract 5542, Harris County, Texas",9537,76688,4705,1354,0,554,0,2881,49.3,14.2,0,5.8,0,30.2,50.7,3841,1661,2180,43.24,56.76,193,1468,121,2059,314,3527,11.6,5.6,8.2,"50% - 75% P.O.C.","$59000 - $86000"
"48201554301","Census Tract 5543.01, Harris County, Texas",7238,118454,5344,694,0,258,0,796,73.8,9.6,0,3.6,0,11,26.2,2549,2299,250,90.19,9.81,280,2019,0,250,280,2269,12.2,0,11,"25% - 50% P.O.C.","$86000 or more"
"48201554302","Census Tract 5543.02, Harris County, Texas",4639,94176,2579,1159,0,375,0,501,55.6,25,0,8.1,0,10.8,44.4,1545,1087,458,70.36,29.64,80,1007,73,385,153,1392,7.4,15.9,9.9,"25% - 50% P.O.C.","$86000 or more"
"48201554401","Census Tract 5544.01, Harris County, Texas",15028,136020,10298,459,0,1844,0,2153,68.5,3.1,0,12.3,0,14.3,31.5,4777,4230,547,88.55,11.45,627,3603,101,446,728,4049,14.8,18.5,15.2,"25% - 50% P.O.C.","$86000 or more"
"48201554402","Census Tract 5544.02, Harris County, Texas",16345,115063,9551,1775,0,1458,0,3230,58.4,10.9,0,8.9,0,19.8,41.6,4998,4522,476,90.48,9.52,824,3698,107,369,931,4067,18.2,22.5,18.6,"25% - 50% P.O.C.","$86000 or more"
"48201554403","Census Tract 5544.03, Harris County, Texas",13044,101867,5823,1689,0,1545,0,3840,44.6,12.9,0,11.8,0,29.4,55.4,4056,3403,653,83.9,16.1,555,2848,43,610,598,3458,16.3,6.6,14.7,"50% - 75% P.O.C.","$86000 or more"
"48201554501","Census Tract 5545.01, Harris County, Texas",6353,125000,3875,494,0,334,0,1518,61,7.8,0,5.3,0,23.9,39,1982,1957,25,98.74,1.26,212,1745,0,25,212,1770,10.8,0,10.7,"25% - 50% P.O.C.","$86000 or more"
"48201554502","Census Tract 5545.02, Harris County, Texas",6045,124400,4613,165,66,251,0,812,76.3,2.7,1.1,4.2,0,13.4,23.7,2136,2072,64,97,3,148,1924,0,64,148,1988,7.1,0,6.9,"Less than 25% P.O.C.","$86000 or more"
"48201554600","Census Tract 5546, Harris County, Texas",4504,129669,3664,135,0,95,0,535,81.3,3,0,2.1,0,11.9,18.7,1603,1486,117,92.7,7.3,207,1279,20,97,227,1376,13.9,17.1,14.2,"Less than 25% P.O.C.","$86000 or more"
"48201554700","Census Tract 5547, Harris County, Texas",7773,100453,5262,302,0,642,0,1360,67.7,3.9,0,8.3,0,17.5,32.3,2875,1974,901,68.66,31.34,283,1691,10,891,293,2582,14.3,1.1,10.2,"25% - 50% P.O.C.","$86000 or more"
"48201554801","Census Tract 5548.01, Harris County, Texas",17986,92945,6955,2952,343,1436,0,5881,38.7,16.4,1.9,8,0,32.7,61.3,5140,4392,748,85.45,14.55,1032,3360,181,567,1213,3927,23.5,24.2,23.6,"50% - 75% P.O.C.","$86000 or more"
"48201554802","Census Tract 5548.02, Harris County, Texas",21422,118100,13214,2073,0,2282,0,3595,61.7,9.7,0,10.7,0,16.8,38.3,7277,6438,839,88.47,11.53,633,5805,52,787,685,6592,9.8,6.2,9.4,"25% - 50% P.O.C.","$86000 or more"
"48201554901","Census Tract 5549.01, Harris County, Texas",10446,71869,4644,1135,118,581,0,3879,44.5,10.9,1.1,5.6,0,37.1,55.5,3227,2448,779,75.86,24.14,396,2052,82,697,478,2749,16.2,10.5,14.8,"50% - 75% P.O.C.","$59000 - $86000"
"48201554902","Census Tract 5549.02, Harris County, Texas",9646,109087,6075,779,0,602,0,1933,63,8.1,0,6.2,0,20,37,3135,2715,420,86.6,13.4,402,2313,0,420,402,2733,14.8,0,12.8,"25% - 50% P.O.C.","$86000 or more"
"48201554903","Census Tract 5549.03, Harris County, Texas",13121,109615,7531,1067,0,1489,0,2510,57.4,8.1,0,11.3,0,19.1,42.6,4300,3648,652,84.84,15.16,396,3252,43,609,439,3861,10.9,6.6,10.2,"25% - 50% P.O.C.","$86000 or more"
"48201555000","Census Tract 5550, Harris County, Texas",8293,86737,4315,841,0,639,0,2315,52,10.1,0,7.7,0,27.9,48,2582,1932,650,74.83,25.17,307,1625,142,508,449,2133,15.9,21.8,17.4,"25% - 50% P.O.C.","$86000 or more"
"48201555100","Census Tract 5551, Harris County, Texas",11024,89706,4744,1594,523,1012,26,2861,43,14.5,4.7,9.2,0.2,26,57,3484,2412,1072,69.23,30.77,311,2101,293,779,604,2880,12.9,27.3,17.3,"50% - 75% P.O.C.","$86000 or more"
"48201555200","Census Tract 5552, Harris County, Texas",10255,95263,4542,1224,0,379,0,3741,44.3,11.9,0,3.7,0,36.5,55.7,3062,1993,1069,65.09,34.91,241,1752,442,627,683,2379,12.1,41.3,22.3,"50% - 75% P.O.C.","$86000 or more"
"48201555301","Census Tract 5553.01, Harris County, Texas",2224,116136,1407,60,0,22,0,705,63.3,2.7,0,1,0,31.7,36.7,864,547,317,63.31,36.69,75,472,0,317,75,789,13.7,0,8.7,"25% - 50% P.O.C.","$86000 or more"
"48201555302","Census Tract 5553.02, Harris County, Texas",19893,143542,11818,892,76,1572,17,4730,59.4,4.5,0.4,7.9,0.1,23.8,40.6,6224,5275,949,84.75,15.25,989,4286,19,930,1008,5216,18.7,2,16.2,"25% - 50% P.O.C.","$86000 or more"
"48201555303","Census Tract 5553.03, Harris County, Texas",11985,102681,6965,1069,0,557,0,2986,58.1,8.9,0,4.6,0,24.9,41.9,4083,2737,1346,67.03,32.97,375,2362,82,1264,457,3626,13.7,6.1,11.2,"25% - 50% P.O.C.","$86000 or more"
"48201555401","Census Tract 5554.01, Harris County, Texas",2379,66615,1496,251,0,3,0,621,62.9,10.6,0,0.1,0,26.1,37.1,792,524,268,66.16,33.84,87,437,16,252,103,689,16.6,6,13,"25% - 50% P.O.C.","$59000 - $86000"
"48201555402","Census Tract 5554.02, Harris County, Texas",8255,57438,5133,757,0,9,0,2249,62.2,9.2,0,0.1,0,27.2,37.8,3206,1328,1878,41.42,58.58,172,1156,134,1744,306,2900,13,7.1,9.5,"25% - 50% P.O.C.","$44000 - $59000"
"48201555501","Census Tract 5555.01, Harris County, Texas",5030,71587,2832,299,0,38,0,1781,56.3,5.9,0,0.8,0,35.4,43.7,1577,1163,414,73.75,26.25,160,1003,44,370,204,1373,13.8,10.6,12.9,"25% - 50% P.O.C.","$59000 - $86000"
"48201555502","Census Tract 5555.02, Harris County, Texas",29605,104765,17986,1673,0,3198,0,5653,60.8,5.7,0,10.8,0,19.1,39.2,9228,7956,1272,86.22,13.78,1313,6643,159,1113,1472,7756,16.5,12.5,16,"25% - 50% P.O.C.","$86000 or more"
"48201555600","Census Tract 5556, Harris County, Texas",5743,103703,3884,267,0,235,0,1271,67.6,4.6,0,4.1,0,22.1,32.4,1903,1764,139,92.7,7.3,301,1463,0,139,301,1602,17.1,0,15.8,"25% - 50% P.O.C.","$86000 or more"
"48201555701","Census Tract 5557.01, Harris County, Texas",9990,114417,5922,1015,0,618,0,2192,59.3,10.2,0,6.2,0,21.9,40.7,2995,2611,384,87.18,12.82,474,2137,69,315,543,2452,18.2,18,18.1,"25% - 50% P.O.C.","$86000 or more"
"48201555702","Census Tract 5557.02, Harris County, Texas",14796,124344,9792,1001,0,1210,38,2397,66.2,6.8,0,8.2,0.3,16.2,33.8,4491,3744,747,83.37,16.63,809,2935,31,716,840,3651,21.6,4.1,18.7,"25% - 50% P.O.C.","$86000 or more"
"48201556000","Census Tract 5560, Harris County, Texas",8639,64800,3372,1289,26,325,15,3503,39,14.9,0.3,3.8,0.2,40.5,61,2841,1984,857,69.83,30.17,261,1723,206,651,467,2374,13.2,24,16.4,"50% - 75% P.O.C.","$59000 - $86000"
"48201980000","Census Tract 9800, Harris County, Texas",4,NA,4,0,0,0,0,0,100,0,0,0,0,0,0,4,0,4,0,100,0,0,0,4,0,4,NA,0,0,"Less than 25% P.O.C.","N/A"
"48201980100","Census Tract 9801, Harris County, Texas",519,28571,46,276,0,0,0,192,8.9,53.2,0,0,0,37,91.1,212,5,207,2.36,97.64,0,5,10,197,10,202,0,4.8,4.7,"75% or more P.O.C.","Less than $44000"
"48239950100","Census Tract 9501, Jackson County, Texas",5438,68993,3052,30,0,32,0,2307,56.1,0.6,0,0.6,0,42.4,43.9,1826,1299,527,71.14,28.86,150,1149,62,465,212,1614,11.5,11.8,11.6,"25% - 50% P.O.C.","$59000 - $86000"
"48239950200","Census Tract 9502, Jackson County, Texas",4127,50121,2259,579,0,123,9,1137,54.7,14,0,3,0.2,27.6,45.3,1456,901,555,61.88,38.12,88,813,99,456,187,1269,9.8,17.8,12.8,"25% - 50% P.O.C.","$44000 - $59000"
"48239950300","Census Tract 9503, Jackson County, Texas",5251,70560,3354,351,0,0,0,1461,63.9,6.7,0,0,0,27.8,36.1,1635,1222,413,74.74,25.26,152,1070,74,339,226,1409,12.4,17.9,13.8,"25% - 50% P.O.C.","$59000 - $86000"
"48291700100","Census Tract 7001, Liberty County, Texas",4334,44272,2149,127,0,0,0,2022,49.6,2.9,0,0,0,46.7,50.4,1351,1010,341,74.76,25.24,185,825,47,294,232,1119,18.3,13.8,17.2,"50% - 75% P.O.C.","$44000 - $59000"
"48291700200","Census Tract 7002, Liberty County, Texas",3076,33990,1318,1132,0,9,0,546,42.8,36.8,0,0.3,0,17.8,57.2,1082,291,791,26.89,73.11,46,245,35,756,81,1001,15.8,4.4,7.5,"50% - 75% P.O.C.","Less than $44000"
"48291700300","Census Tract 7003, Liberty County, Texas",12482,44043,6673,151,0,109,0,5470,53.5,1.2,0,0.9,0,43.8,46.5,3919,2774,1145,70.78,29.22,453,2321,71,1074,524,3395,16.3,6.2,13.4,"25% - 50% P.O.C.","$44000 - $59000"
"48291700400","Census Tract 7004, Liberty County, Texas",6908,52474,5855,414,0,37,0,588,84.8,6,0,0.5,0,8.5,15.2,2526,2108,418,83.45,16.55,268,1840,93,325,361,2165,12.7,22.2,14.3,"Less than 25% P.O.C.","$44000 - $59000"
"48291700500","Census Tract 7005, Liberty County, Texas",2840,68320,2251,233,0,0,0,356,79.3,8.2,0,0,0,12.5,20.7,885,778,107,87.91,12.09,185,593,33,74,218,667,23.8,30.8,24.6,"Less than 25% P.O.C.","$59000 - $86000"
"48291700600","Census Tract 7006, Liberty County, Texas",2268,33004,1708,259,0,10,0,291,75.3,11.4,0,0.4,0,12.8,24.7,1009,790,219,78.3,21.7,0,790,0,219,0,1009,0,0,0,"Less than 25% P.O.C.","Less than $44000"
"48291700700","Census Tract 7007, Liberty County, Texas",2342,73333,1836,144,8,0,0,271,78.4,6.1,0.3,0,0,11.6,21.6,810,674,136,83.21,16.79,42,632,10,126,52,758,6.2,7.4,6.4,"Less than 25% P.O.C.","$59000 - $86000"
"48291700800","Census Tract 7008, Liberty County, Texas",8529,50603,6598,776,11,115,0,1029,77.4,9.1,0.1,1.3,0,12.1,22.6,3287,2481,806,75.48,24.52,169,2312,59,747,228,3059,6.8,7.3,6.9,"Less than 25% P.O.C.","$44000 - $59000"
"48291700900","Census Tract 7009, Liberty County, Texas",8864,74762,4333,1744,0,3,8,2675,48.9,19.7,0,0,0.1,30.2,51.1,838,685,153,81.74,18.26,129,556,33,120,162,676,18.8,21.6,19.3,"50% - 75% P.O.C.","$59000 - $86000"
"48291701000","Census Tract 7010, Liberty County, Texas",7417,52660,3021,389,28,81,0,3787,40.7,5.2,0.4,1.1,0,51.1,59.3,2311,1796,515,77.72,22.28,464,1332,16,499,480,1831,25.8,3.1,20.8,"50% - 75% P.O.C.","$44000 - $59000"
"48291701100","Census Tract 7011, Liberty County, Texas",6467,53031,5628,291,65,16,0,390,87,4.5,1,0.2,0,6,13,2228,1936,292,86.89,13.11,140,1796,95,197,235,1993,7.2,32.5,10.5,"Less than 25% P.O.C.","$44000 - $59000"
"48291701200","Census Tract 7012, Liberty County, Texas",6699,60207,4786,708,45,59,0,1069,71.4,10.6,0.7,0.9,0,16,28.6,2483,1719,764,69.23,30.77,277,1442,0,764,277,2206,16.1,0,11.2,"25% - 50% P.O.C.","$59000 - $86000"
"48291701300","Census Tract 7013, Liberty County, Texas",3322,58219,2794,154,71,0,0,287,84.1,4.6,2.1,0,0,8.6,15.9,1251,1020,231,81.53,18.47,71,949,41,190,112,1139,7,17.7,9,"Less than 25% P.O.C.","$44000 - $59000"
"48291701400","Census Tract 7014, Liberty County, Texas",8154,52406,4033,1717,183,0,0,2007,49.5,21.1,2.2,0,0,24.6,50.5,2893,2240,653,77.43,22.57,287,1953,68,585,355,2538,12.8,10.4,12.3,"50% - 75% P.O.C.","$44000 - $59000"
"48321730100","Census Tract 7301, Matagorda County, Texas",2404,42670,655,193,0,6,64,1447,27.2,8,0,0.2,2.7,60.2,72.8,851,520,331,61.1,38.9,68,452,40,291,108,743,13.1,12.1,12.7,"50% - 75% P.O.C.","Less than $44000"
"48321730201","Census Tract 7302.01, Matagorda County, Texas",6767,49071,2777,484,0,0,0,3305,41,7.2,0,0,0,48.8,59,2339,1789,550,76.49,23.51,297,1492,98,452,395,1944,16.6,17.8,16.9,"50% - 75% P.O.C.","$44000 - $59000"
"48321730202","Census Tract 7302.02, Matagorda County, Texas",1874,46771,1048,149,0,4,0,666,55.9,8,0,0.2,0,35.5,44.1,700,566,134,80.86,19.14,45,521,9,125,54,646,8,6.7,7.7,"25% - 50% P.O.C.","$44000 - $59000"
"48321730301","Census Tract 7303.01, Matagorda County, Texas",4068,56189,1668,173,8,52,0,2167,41,4.3,0.2,1.3,0,53.3,59,1451,829,622,57.13,42.87,76,753,138,484,214,1237,9.2,22.2,14.7,"50% - 75% P.O.C.","$44000 - $59000"
"48321730302","Census Tract 7303.02, Matagorda County, Texas",4876,49881,1447,931,0,7,27,2389,29.7,19.1,0,0.1,0.6,49,70.3,1876,775,1101,41.31,58.69,73,702,122,979,195,1681,9.4,11.1,10.4,"50% - 75% P.O.C.","$44000 - $59000"
"48321730303","Census Tract 7303.03, Matagorda County, Texas",996,73424,706,105,0,0,0,185,70.9,10.5,0,0,0,18.6,29.1,361,311,50,86.15,13.85,35,276,12,38,47,314,11.3,24,13,"25% - 50% P.O.C.","$59000 - $86000"
"48321730400","Census Tract 7304, Matagorda County, Texas",2149,50000,636,845,8,84,0,571,29.6,39.3,0.4,3.9,0,26.6,70.4,834,591,243,70.86,29.14,20,571,29,214,49,785,3.4,11.9,5.9,"50% - 75% P.O.C.","$44000 - $59000"
"48321730501","Census Tract 7305.01, Matagorda County, Texas",3746,37500,2844,713,24,50,29,86,75.9,19,0.6,1.3,0.8,2.3,24.1,1732,1516,216,87.53,12.47,79,1437,13,203,92,1640,5.2,6,5.3,"Less than 25% P.O.C.","Less than $44000"
"48321730600","Census Tract 7306, Matagorda County, Texas",5342,43287,1464,129,19,507,0,3168,27.4,2.4,0.4,9.5,0,59.3,72.6,1963,1423,540,72.49,27.51,160,1263,86,454,246,1717,11.2,15.9,12.5,"50% - 75% P.O.C.","Less than $44000"
"48321730700","Census Tract 7307, Matagorda County, Texas",4552,50219,2800,63,40,0,0,1628,61.5,1.4,0.9,0,0,35.8,38.5,1741,1467,274,84.26,15.74,193,1274,30,244,223,1518,13.2,10.9,12.8,"25% - 50% P.O.C.","$44000 - $59000"
"48321990000","Census Tract 9900, Matagorda County, Texas",0,NA,0,0,0,0,0,0,NA,NA,NA,NA,NA,NA,NA,0,0,0,NA,NA,0,0,0,0,0,0,NA,NA,NA,"N/A","N/A"
"48339690100","Census Tract 6901, Montgomery County, Texas",11151,71487,7681,170,77,13,0,3112,68.9,1.5,0.7,0.1,0,27.9,31.1,3786,3161,625,83.49,16.51,298,2863,223,402,521,3265,9.4,35.7,13.8,"25% - 50% P.O.C.","$59000 - $86000"
"48339690201","Census Tract 6902.01, Montgomery County, Texas",11831,88008,9590,163,104,65,97,1543,81.1,1.4,0.9,0.5,0.8,13,18.9,3819,3119,700,81.67,18.33,461,2658,167,533,628,3191,14.8,23.9,16.4,"Less than 25% P.O.C.","$86000 or more"
"48339690202","Census Tract 6902.02, Montgomery County, Texas",8913,95165,6903,135,14,0,2,1806,77.4,1.5,0.2,0,0,20.3,22.6,2599,2348,251,90.34,9.66,374,1974,168,83,542,2057,15.9,66.9,20.9,"Less than 25% P.O.C.","$86000 or more"
"48339690300","Census Tract 6903, Montgomery County, Texas",5645,43182,3003,159,0,29,0,2070,53.2,2.8,0,0.5,0,36.7,46.8,1744,1401,343,80.33,19.67,202,1199,60,283,262,1482,14.4,17.5,15,"25% - 50% P.O.C.","Less than $44000"
"48339690401","Census Tract 6904.01, Montgomery County, Texas",7738,102961,6024,177,43,548,0,897,77.8,2.3,0.6,7.1,0,11.6,22.2,2409,2151,258,89.29,10.71,383,1768,51,207,434,1975,17.8,19.8,18,"Less than 25% P.O.C.","$86000 or more"
"48339690402","Census Tract 6904.02, Montgomery County, Texas",18149,89245,12728,786,0,102,59,3828,70.1,4.3,0,0.6,0.3,21.1,29.9,5809,4842,967,83.35,16.65,879,3963,98,869,977,4832,18.2,10.1,16.8,"25% - 50% P.O.C.","$86000 or more"
"48339690500","Census Tract 6905, Montgomery County, Texas",12443,135463,10116,503,47,538,37,862,81.3,4,0.4,4.3,0.3,6.9,18.7,4264,3847,417,90.22,9.78,507,3340,45,372,552,3712,13.2,10.8,12.9,"Less than 25% P.O.C.","$86000 or more"
"48339690601","Census Tract 6906.01, Montgomery County, Texas",21684,101927,16139,575,0,1245,0,3123,74.4,2.7,0,5.7,0,14.4,25.6,7958,5539,2419,69.6,30.4,590,4949,122,2297,712,7246,10.7,5,8.9,"25% - 50% P.O.C.","$86000 or more"
"48339690602","Census Tract 6906.02, Montgomery County, Texas",26079,168737,16639,2146,0,1760,0,4987,63.8,8.2,0,6.7,0,19.1,36.2,8030,5452,2578,67.9,32.1,1057,4395,386,2192,1443,6587,19.4,15,18,"25% - 50% P.O.C.","$86000 or more"
"48339690700","Census Tract 6907, Montgomery County, Texas",11099,81528,8131,616,19,1099,0,1158,73.3,5.6,0.2,9.9,0,10.4,26.7,5061,2113,2948,41.75,58.25,110,2003,119,2829,229,4832,5.2,4,4.5,"25% - 50% P.O.C.","$59000 - $86000"
"48339690800","Census Tract 6908, Montgomery County, Texas",4329,132344,3248,246,9,243,0,558,75,5.7,0.2,5.6,0,12.9,25,1539,1182,357,76.8,23.2,99,1083,48,309,147,1392,8.4,13.4,9.6,"25% - 50% P.O.C.","$86000 or more"
"48339690900","Census Tract 6909, Montgomery County, Texas",4391,158750,3425,30,0,200,0,603,78,0.7,0,4.6,0,13.7,22,1443,1364,79,94.53,5.47,107,1257,34,45,141,1302,7.8,43,9.8,"Less than 25% P.O.C.","$86000 or more"
"48339691000","Census Tract 6910, Montgomery County, Texas",3938,186250,3166,18,0,275,0,432,80.4,0.5,0,7,0,11,19.6,1428,1364,64,95.52,4.48,136,1228,16,48,152,1276,10,25,10.6,"Less than 25% P.O.C.","$86000 or more"
"48339691100","Census Tract 6911, Montgomery County, Texas",4308,121188,3458,17,0,173,0,577,80.3,0.4,0,4,0,13.4,19.7,1559,1203,356,77.16,22.84,86,1117,38,318,124,1435,7.1,10.7,8,"Less than 25% P.O.C.","$86000 or more"
"48339691200","Census Tract 6912, Montgomery County, Texas",7246,136207,6175,165,0,193,0,707,85.2,2.3,0,2.7,0,9.8,14.8,2800,1918,882,68.5,31.5,124,1794,70,812,194,2606,6.5,7.9,6.9,"Less than 25% P.O.C.","$86000 or more"
"48339691301","Census Tract 6913.01, Montgomery County, Texas",4848,135598,3588,112,0,240,0,797,74,2.3,0,5,0,16.4,26,1639,1429,210,87.19,12.81,63,1366,74,136,137,1502,4.4,35.2,8.4,"25% - 50% P.O.C.","$86000 or more"
"48339691302","Census Tract 6913.02, Montgomery County, Texas",5453,32080,3506,242,0,128,0,1183,64.3,4.4,0,2.3,0,21.7,35.7,2483,1076,1407,43.33,56.67,19,1057,95,1312,114,2369,1.8,6.8,4.6,"25% - 50% P.O.C.","Less than $44000"
"48339691400","Census Tract 6914, Montgomery County, Texas",9188,68806,5722,900,0,546,0,1951,62.3,9.8,0,5.9,0,21.2,37.7,4296,1555,2741,36.2,63.8,103,1452,13,2728,116,4180,6.6,0.5,2.7,"25% - 50% P.O.C.","$59000 - $86000"
"48339691500","Census Tract 6915, Montgomery County, Texas",4416,85820,2767,751,0,208,0,496,62.7,17,0,4.7,0,11.2,37.3,2032,825,1207,40.6,59.4,16,809,28,1179,44,1988,1.9,2.3,2.2,"25% - 50% P.O.C.","$59000 - $86000"
"48339691601","Census Tract 6916.01, Montgomery County, Texas",3828,74191,2758,107,26,208,0,646,72,2.8,0.7,5.4,0,16.9,28,1789,959,830,53.61,46.39,74,885,22,808,96,1693,7.7,2.7,5.4,"25% - 50% P.O.C.","$59000 - $86000"
"48339691602","Census Tract 6916.02, Montgomery County, Texas",5045,54367,2841,389,0,204,0,1481,56.3,7.7,0,4,0,29.4,43.7,2052,778,1274,37.91,62.09,13,765,101,1173,114,1938,1.7,7.9,5.6,"25% - 50% P.O.C.","$44000 - $59000"
"48339691700","Census Tract 6917, Montgomery County, Texas",3124,150000,2425,38,0,270,0,335,77.6,1.2,0,8.6,0,10.7,22.4,1714,413,1301,24.1,75.9,0,413,17,1284,17,1697,0,1.3,1,"Less than 25% P.O.C.","$86000 or more"
"48339691800","Census Tract 6918, Montgomery County, Texas",10163,78070,5697,1201,0,263,0,2843,56.1,11.8,0,2.6,0,28,43.9,3496,2035,1461,58.21,41.79,207,1828,220,1241,427,3069,10.2,15.1,12.2,"25% - 50% P.O.C.","$59000 - $86000"
"48339691900","Census Tract 6919, Montgomery County, Texas",6522,98375,4842,320,0,30,0,1124,74.2,4.9,0,0.5,0,17.2,25.8,2069,1375,694,66.46,33.54,122,1253,113,581,235,1834,8.9,16.3,11.4,"25% - 50% P.O.C.","$86000 or more"
"48339692001","Census Tract 6920.01, Montgomery County, Texas",35550,117795,21763,3469,0,1731,0,8327,61.2,9.8,0,4.9,0,23.4,38.8,11526,9456,2070,82.04,17.96,1009,8447,256,1814,1265,10261,10.7,12.4,11,"25% - 50% P.O.C.","$86000 or more"
"48339692002","Census Tract 6920.02, Montgomery County, Texas",15069,162232,9893,1359,11,1108,0,2159,65.7,9,0.1,7.4,0,14.3,34.3,4435,3862,573,87.08,12.92,610,3252,85,488,695,3740,15.8,14.8,15.7,"25% - 50% P.O.C.","$86000 or more"
"48339692100","Census Tract 6921, Montgomery County, Texas",15277,92298,8682,1018,63,860,0,4340,56.8,6.7,0.4,5.6,0,28.4,43.2,5235,4045,1190,77.27,22.73,663,3382,143,1047,806,4429,16.4,12,15.4,"25% - 50% P.O.C.","$86000 or more"
"48339692200","Census Tract 6922, Montgomery County, Texas",8710,62247,6363,55,0,0,0,2188,73.1,0.6,0,0,0,25.1,26.9,2858,2113,745,73.93,26.07,151,1962,107,638,258,2600,7.1,14.4,9,"25% - 50% P.O.C.","$59000 - $86000"
"48339692300","Census Tract 6923, Montgomery County, Texas",20762,84608,11168,661,29,641,0,8054,53.8,3.2,0.1,3.1,0,38.8,46.2,6957,4887,2070,70.25,29.75,763,4124,0,2070,763,6194,15.6,0,11,"25% - 50% P.O.C.","$59000 - $86000"
"48339692400","Census Tract 6924, Montgomery County, Texas",10506,64393,6577,508,0,496,0,2348,62.6,4.8,0,4.7,0,22.3,37.4,4342,2065,2277,47.56,52.44,381,1684,80,2197,461,3881,18.5,3.5,10.6,"25% - 50% P.O.C.","$59000 - $86000"
"48339692500","Census Tract 6925, Montgomery County, Texas",8690,48435,5330,200,0,54,0,3020,61.3,2.3,0,0.6,0,34.8,38.7,3026,1999,1027,66.06,33.94,225,1774,88,939,313,2713,11.3,8.6,10.3,"25% - 50% P.O.C.","$44000 - $59000"
"48339692601","Census Tract 6926.01, Montgomery County, Texas",4520,48804,1966,24,0,0,0,2249,43.5,0.5,0,0,0,49.8,56.5,1370,956,414,69.78,30.22,179,777,81,333,260,1110,18.7,19.6,19,"50% - 75% P.O.C.","$44000 - $59000"
"48339692602","Census Tract 6926.02, Montgomery County, Texas",15966,67663,8222,28,30,183,0,6668,51.5,0.2,0.2,1.1,0,41.8,48.5,4597,3334,1263,72.53,27.47,645,2689,374,889,1019,3578,19.3,29.6,22.2,"25% - 50% P.O.C.","$59000 - $86000"
"48339692700","Census Tract 6927, Montgomery County, Texas",7918,57351,5105,83,99,0,0,2557,64.5,1,1.3,0,0,32.3,35.5,2656,2201,455,82.87,17.13,404,1797,0,455,404,2252,18.4,0,15.2,"25% - 50% P.O.C.","$44000 - $59000"
"48339692801","Census Tract 6928.01, Montgomery County, Texas",10179,66750,7632,20,52,38,0,2255,75,0.2,0.5,0.4,0,22.2,25,3056,2632,424,86.13,13.87,517,2115,149,275,666,2390,19.6,35.1,21.8,"25% - 50% P.O.C.","$59000 - $86000"
"48339692802","Census Tract 6928.02, Montgomery County, Texas",7720,56905,3237,356,0,27,0,3817,41.9,4.6,0,0.3,0,49.4,58.1,2192,1691,501,77.14,22.86,388,1303,149,352,537,1655,22.9,29.7,24.5,"50% - 75% P.O.C.","$44000 - $59000"
"48339692900","Census Tract 6929, Montgomery County, Texas",4924,59853,4025,66,0,3,0,805,81.7,1.3,0,0.1,0,16.3,18.3,1646,1229,417,74.67,25.33,138,1091,61,356,199,1447,11.2,14.6,12.1,"Less than 25% P.O.C.","$59000 - $86000"
"48339693000","Census Tract 6930, Montgomery County, Texas",11141,52568,5649,63,10,67,0,5335,50.7,0.6,0.1,0.6,0,47.9,49.3,3483,2634,849,75.62,24.38,455,2179,211,638,666,2817,17.3,24.9,19.1,"25% - 50% P.O.C.","$44000 - $59000"
"48339693101","Census Tract 6931.01, Montgomery County, Texas",6114,41268,1104,964,28,10,0,3973,18.1,15.8,0.5,0.2,0,65,81.9,1735,952,783,54.87,45.13,204,748,98,685,302,1433,21.4,12.5,17.4,"75% or more P.O.C.","Less than $44000"
"48339693102","Census Tract 6931.02, Montgomery County, Texas",4974,59938,1568,452,0,11,0,2943,31.5,9.1,0,0.2,0,59.2,68.5,1548,1118,430,72.22,27.78,200,918,60,370,260,1288,17.9,14,16.8,"50% - 75% P.O.C.","$59000 - $86000"
"48339693200","Census Tract 6932, Montgomery County, Texas",8319,103558,6153,209,0,599,12,1207,74,2.5,0,7.2,0.1,14.5,26,2784,2496,288,89.66,10.34,203,2293,47,241,250,2534,8.1,16.3,9,"25% - 50% P.O.C.","$86000 or more"
"48339693300","Census Tract 6933, Montgomery County, Texas",8475,64883,6068,469,0,245,0,1556,71.6,5.5,0,2.9,0,18.4,28.4,3310,1668,1642,50.39,49.61,106,1562,106,1536,212,3098,6.4,6.5,6.4,"25% - 50% P.O.C.","$59000 - $86000"
"48339693400","Census Tract 6934, Montgomery County, Texas",4716,32606,838,1096,0,0,0,2587,17.8,23.2,0,0,0,54.9,82.2,1430,213,1217,14.9,85.1,78,135,157,1060,235,1195,36.6,12.9,16.4,"75% or more P.O.C.","Less than $44000"
"48339693500","Census Tract 6935, Montgomery County, Texas",5809,51997,3343,294,37,42,0,2065,57.5,5.1,0.6,0.7,0,35.5,42.5,2315,954,1361,41.21,58.79,105,849,103,1258,208,2107,11,7.6,9,"25% - 50% P.O.C.","$44000 - $59000"
"48339693600","Census Tract 6936, Montgomery County, Texas",4156,44426,2583,430,0,60,0,1046,62.2,10.3,0,1.4,0,25.2,37.8,2032,578,1454,28.44,71.56,0,578,57,1397,57,1975,0,3.9,2.8,"25% - 50% P.O.C.","$44000 - $59000"
"48339693700","Census Tract 6937, Montgomery County, Texas",13653,86827,9533,814,18,487,0,2571,69.8,6,0.1,3.6,0,18.8,30.2,5045,2884,2161,57.17,42.83,374,2510,122,2039,496,4549,13,5.6,9.8,"25% - 50% P.O.C.","$86000 or more"
"48339693800","Census Tract 6938, Montgomery County, Texas",4732,43763,2065,577,0,163,0,1880,43.6,12.2,0,3.4,0,39.7,56.4,1696,746,950,43.99,56.01,124,622,60,890,184,1512,16.6,6.3,10.8,"50% - 75% P.O.C.","Less than $44000"
"48339693900","Census Tract 6939, Montgomery County, Texas",13671,47798,5823,819,34,11,0,6976,42.6,6,0.2,0.1,0,51,57.4,3799,2301,1498,60.57,39.43,496,1805,271,1227,767,3032,21.6,18.1,20.2,"50% - 75% P.O.C.","$44000 - $59000"
"48339694000","Census Tract 6940, Montgomery County, Texas",12040,58495,8360,90,112,134,0,3272,69.4,0.7,0.9,1.1,0,27.2,30.6,3843,3254,589,84.67,15.33,561,2693,102,487,663,3180,17.2,17.3,17.3,"25% - 50% P.O.C.","$44000 - $59000"
"48339694101","Census Tract 6941.01, Montgomery County, Texas",13717,56964,7278,908,0,64,0,5269,53.1,6.6,0,0.5,0,38.4,46.9,4259,2937,1322,68.96,31.04,476,2461,230,1092,706,3553,16.2,17.4,16.6,"25% - 50% P.O.C.","$44000 - $59000"
"48339694102","Census Tract 6941.02, Montgomery County, Texas",5474,61086,3309,183,16,0,0,1627,60.4,3.3,0.3,0,0,29.7,39.6,1949,1688,261,86.61,13.39,366,1322,12,249,378,1571,21.7,4.6,19.4,"25% - 50% P.O.C.","$59000 - $86000"
"48339694201","Census Tract 6942.01, Montgomery County, Texas",7885,48762,4871,20,19,0,0,2835,61.8,0.3,0.2,0,0,36,38.2,2955,2061,894,69.75,30.25,117,1944,168,726,285,2670,5.7,18.8,9.6,"25% - 50% P.O.C.","$44000 - $59000"
"48339694202","Census Tract 6942.02, Montgomery County, Texas",12609,65018,10880,193,15,371,0,1093,86.3,1.5,0.1,2.9,0,8.7,13.7,5065,4369,696,86.26,13.74,203,4166,98,598,301,4764,4.6,14.1,5.9,"Less than 25% P.O.C.","$59000 - $86000"
"48339694301","Census Tract 6943.01, Montgomery County, Texas",13619,101898,11426,772,69,269,0,992,83.9,5.7,0.5,2,0,7.3,16.1,5953,5042,911,84.7,15.3,187,4855,0,911,187,5766,3.7,0,3.1,"Less than 25% P.O.C.","$86000 or more"
"48339694302","Census Tract 6943.02, Montgomery County, Texas",8150,91288,6924,279,0,169,0,609,85,3.4,0,2.1,0,7.5,15,3632,3021,611,83.18,16.82,104,2917,0,611,104,3528,3.4,0,2.9,"Less than 25% P.O.C.","$86000 or more"
"48339694400","Census Tract 6944, Montgomery County, Texas",9676,66385,7470,229,19,41,0,1840,77.2,2.4,0.2,0.4,0,19,22.8,3426,2676,750,78.11,21.89,357,2319,71,679,428,2998,13.3,9.5,12.5,"Less than 25% P.O.C.","$59000 - $86000"
"48339694500","Census Tract 6945, Montgomery County, Texas",13777,130040,12027,93,57,178,0,1220,87.3,0.7,0.4,1.3,0,8.9,12.7,4289,4030,259,93.96,6.04,697,3333,15,244,712,3577,17.3,5.8,16.6,"Less than 25% P.O.C.","$86000 or more"
"48339694600","Census Tract 6946, Montgomery County, Texas",8745,77461,7162,378,0,20,0,1150,81.9,4.3,0,0.2,0,13.2,18.1,3111,2463,648,79.17,20.83,357,2106,63,585,420,2691,14.5,9.7,13.5,"Less than 25% P.O.C.","$59000 - $86000"
"48339694700","Census Tract 6947, Montgomery County, Texas",3175,79583,2654,290,28,15,0,129,83.6,9.1,0.9,0.5,0,4.1,16.4,1276,1133,143,88.79,11.21,98,1035,0,143,98,1178,8.6,0,7.7,"Less than 25% P.O.C.","$59000 - $86000"
"48373210101","Census Tract 2101.01, Polk County, Texas",5135,53693,4339,0,0,0,0,767,84.5,0,0,0,0,14.9,15.5,2256,1837,419,81.43,18.57,145,1692,27,392,172,2084,7.9,6.4,7.6,"Less than 25% P.O.C.","$44000 - $59000"
"48373210102","Census Tract 2101.02, Polk County, Texas",6631,49688,5763,88,56,0,49,511,86.9,1.3,0.8,0,0.7,7.7,13.1,2625,2033,592,77.45,22.55,177,1856,93,499,270,2355,8.7,15.7,10.3,"Less than 25% P.O.C.","$44000 - $59000"
"48373210203","Census Tract 2102.03, Polk County, Texas",6408,49722,3088,1364,13,7,21,1894,48.2,21.3,0.2,0.1,0.3,29.6,51.8,1138,901,237,79.17,20.83,147,754,31,206,178,960,16.3,13.1,15.6,"50% - 75% P.O.C.","$44000 - $59000"
"48373210204","Census Tract 2102.04, Polk County, Texas",5147,46667,3252,533,0,217,0,1073,63.2,10.4,0,4.2,0,20.8,36.8,1948,1405,543,72.13,27.87,167,1238,27,516,194,1754,11.9,5,10,"25% - 50% P.O.C.","$44000 - $59000"
"48373210205","Census Tract 2102.05, Polk County, Texas",3070,45263,2363,162,0,106,0,421,77,5.3,0,3.5,0,13.7,23,1226,925,301,75.45,24.55,38,887,54,247,92,1134,4.1,17.9,7.5,"Less than 25% P.O.C.","$44000 - $59000"
"48373210206","Census Tract 2102.06, Polk County, Texas",3445,56162,3247,11,14,32,0,116,94.3,0.3,0.4,0.9,0,3.4,5.7,1551,1231,320,79.37,20.63,46,1185,80,240,126,1425,3.7,25,8.1,"Less than 25% P.O.C.","$44000 - $59000"
"48373210301","Census Tract 2103.01, Polk County, Texas",3589,39696,3312,13,0,0,0,202,92.3,0.4,0,0,0,5.6,7.7,1567,1252,315,79.9,20.1,51,1201,72,243,123,1444,4.1,22.9,7.8,"Less than 25% P.O.C.","Less than $44000"
"48373210302","Census Tract 2103.02, Polk County, Texas",4596,50913,3110,794,46,0,0,586,67.7,17.3,1,0,0,12.8,32.3,1735,1349,386,77.75,22.25,157,1192,14,372,171,1564,11.6,3.6,9.9,"25% - 50% P.O.C.","$44000 - $59000"
"48373210400","Census Tract 2104, Polk County, Texas",5924,42071,2935,1307,5,0,0,1457,49.5,22.1,0.1,0,0,24.6,50.5,2134,1386,748,64.95,35.05,223,1163,82,666,305,1829,16.1,11,14.3,"50% - 75% P.O.C.","Less than $44000"
"48373210500","Census Tract 2105, Polk County, Texas",4968,50869,3263,470,576,13,0,444,65.7,9.5,11.6,0.3,0,8.9,34.3,1853,1392,461,75.12,24.88,190,1202,41,420,231,1622,13.6,8.9,12.5,"25% - 50% P.O.C.","$44000 - $59000"
"48407200101","Census Tract 2001.01, San Jacinto County, Texas",7305,44101,5717,557,0,0,10,853,78.3,7.6,0,0,0.1,11.7,21.7,2198,1596,602,72.61,27.39,228,1368,90,512,318,1880,14.3,15,14.5,"Less than 25% P.O.C.","$44000 - $59000"
"48407200102","Census Tract 2001.02, San Jacinto County, Texas",11071,40682,7731,1062,211,0,0,1904,69.8,9.6,1.9,0,0,17.2,30.2,3628,2981,647,82.17,17.83,410,2571,143,504,553,3075,13.8,22.1,15.2,"25% - 50% P.O.C.","Less than $44000"
"48407200200","Census Tract 2002, San Jacinto County, Texas",5054,42141,3549,488,7,0,0,851,70.2,9.7,0.1,0,0,16.8,29.8,2021,1606,415,79.47,20.53,117,1489,61,354,178,1843,7.3,14.7,8.8,"25% - 50% P.O.C.","Less than $44000"
"48407200300","Census Tract 2003, San Jacinto County, Texas",4750,39505,4046,410,0,9,0,85,85.2,8.6,0,0.2,0,1.8,14.8,2196,1915,281,87.2,12.8,83,1832,0,281,83,2113,4.3,0,3.8,"Less than 25% P.O.C.","Less than $44000"
"48455950100","Census Tract 9501, Trinity County, Texas",2426,46250,2084,226,0,0,0,71,85.9,9.3,0,0,0,2.9,14.1,1005,879,126,87.46,12.54,60,819,20,106,80,925,6.8,15.9,8,"Less than 25% P.O.C.","$44000 - $59000"
"48455950200","Census Tract 9502, Trinity County, Texas",3644,41455,2943,291,0,0,0,401,80.8,8,0,0,0,11,19.2,1480,1142,338,77.16,22.84,80,1062,8,330,88,1392,7,2.4,5.9,"Less than 25% P.O.C.","Less than $44000"
"48455950300","Census Tract 9503, Trinity County, Texas",2316,44500,1945,166,0,5,0,200,84,7.2,0,0.2,0,8.6,16,800,609,191,76.12,23.88,16,593,60,131,76,724,2.6,31.4,9.5,"Less than 25% P.O.C.","$44000 - $59000"
"48455950400","Census Tract 9504, Trinity County, Texas",4179,50191,3810,107,18,0,0,206,91.2,2.6,0.4,0,0,4.9,8.8,1807,1437,370,79.52,20.48,79,1358,33,337,112,1695,5.5,8.9,6.2,"Less than 25% P.O.C.","$44000 - $59000"
"48455950500","Census Tract 9505, Trinity County, Texas",2055,26803,675,664,0,0,0,582,32.8,32.3,0,0,0,28.3,67.2,938,599,339,63.86,36.14,50,549,40,299,90,848,8.3,11.8,9.6,"50% - 75% P.O.C.","Less than $44000"
"48471790101","Census Tract 7901.01, Walker County, Texas",6977,72344,3391,1669,16,37,9,1830,48.6,23.9,0.2,0.5,0.1,26.2,51.4,725,624,101,86.07,13.93,79,545,34,67,113,612,12.7,33.7,15.6,"50% - 75% P.O.C.","$59000 - $86000"
"48471790102","Census Tract 7901.02, Walker County, Texas",3653,51121,2592,225,0,18,0,818,71,6.2,0,0.5,0,22.4,29,1218,1068,150,87.68,12.32,125,943,52,98,177,1041,11.7,34.7,14.5,"25% - 50% P.O.C.","$44000 - $59000"
"48471790103","Census Tract 7901.03, Walker County, Texas",5968,66205,4160,1250,21,0,0,472,69.7,20.9,0.4,0,0,7.9,30.3,2111,1594,517,75.51,24.49,98,1496,63,454,161,1950,6.1,12.2,7.6,"25% - 50% P.O.C.","$59000 - $86000"
"48471790200","Census Tract 7902, Walker County, Texas",7292,52237,4613,1408,55,12,0,1185,63.3,19.3,0.8,0.2,0,16.3,36.7,2340,1476,864,63.08,36.92,254,1222,119,745,373,1967,17.2,13.8,15.9,"25% - 50% P.O.C.","$44000 - $59000"
"48471790300","Census Tract 7903, Walker County, Texas",7640,57538,6214,577,67,28,0,406,81.3,7.6,0.9,0.4,0,5.3,18.7,3381,2957,424,87.46,12.54,212,2745,35,389,247,3134,7.2,8.3,7.3,"Less than 25% P.O.C.","$44000 - $59000"
"48471790400","Census Tract 7904, Walker County, Texas",12013,65050,6247,3104,59,2,0,2542,52,25.8,0.5,0,0,21.2,48,2281,1660,621,72.78,27.22,149,1511,22,599,171,2110,9,3.5,7.5,"25% - 50% P.O.C.","$59000 - $86000"
"48471790500","Census Tract 7905, Walker County, Texas",8656,39310,5186,2202,0,189,0,1079,59.9,25.4,0,2.2,0,12.5,40.1,2995,767,2228,25.61,74.39,31,736,134,2094,165,2830,4,6,5.5,"25% - 50% P.O.C.","Less than $44000"
"48471790600","Census Tract 7906, Walker County, Texas",4153,30945,1023,1300,13,24,0,1793,24.6,31.3,0.3,0.6,0,43.2,75.4,991,313,678,31.58,68.42,64,249,23,655,87,904,20.4,3.4,8.8,"75% or more P.O.C.","Less than $44000"
"48471790700","Census Tract 7907, Walker County, Texas",8188,27717,3636,2764,0,73,0,1600,44.4,33.8,0,0.9,0,19.5,55.6,2860,477,2383,16.68,83.32,98,379,144,2239,242,2618,20.5,6,8.5,"50% - 75% P.O.C.","Less than $44000"
"48471790800","Census Tract 7908, Walker County, Texas",7781,26322,3727,2157,84,529,0,1248,47.9,27.7,1.1,6.8,0,16,52.1,3061,354,2707,11.56,88.44,0,354,88,2619,88,2973,0,3.3,2.9,"50% - 75% P.O.C.","Less than $44000"
"48473680100","Census Tract 6801, Waller County, Texas",6655,125104,4208,340,49,269,0,1560,63.2,5.1,0.7,4,0,23.4,36.8,1918,1748,170,91.14,8.86,326,1422,46,124,372,1546,18.6,27.1,19.4,"25% - 50% P.O.C.","$86000 or more"
"48473680200","Census Tract 6802, Waller County, Texas",9916,49195,2827,1768,11,57,0,5158,28.5,17.8,0.1,0.6,0,52,71.5,3060,2319,741,75.78,24.22,252,2067,144,597,396,2664,10.9,19.4,12.9,"50% - 75% P.O.C.","$44000 - $59000"
"48473680300","Census Tract 6803, Waller County, Texas",10627,42663,4514,3117,0,77,0,2821,42.5,29.3,0,0.7,0,26.5,57.5,3483,1940,1543,55.7,44.3,175,1765,239,1304,414,3069,9,15.5,11.9,"50% - 75% P.O.C.","Less than $44000"
"48473680400","Census Tract 6804, Waller County, Texas",4052,NA,31,3717,5,13,25,215,0.8,91.7,0.1,0.3,0.6,5.3,99.2,0,0,0,NA,NA,0,0,0,0,0,0,NA,NA,NA,"75% or more P.O.C.","N/A"
"48473680500","Census Tract 6805, Waller County, Texas",11609,41472,3774,3832,32,57,0,3792,32.5,33,0.3,0.5,0,32.7,67.5,3990,2038,1952,51.08,48.92,236,1802,361,1591,597,3393,11.6,18.5,15,"50% - 75% P.O.C.","Less than $44000"
"48473680600","Census Tract 6806, Waller County, Texas",8973,80000,6868,57,0,13,0,2035,76.5,0.6,0,0.1,0,22.7,23.5,2720,2322,398,85.37,14.63,400,1922,15,383,415,2305,17.2,3.8,15.3,"Less than 25% P.O.C.","$59000 - $86000"
"48477170100","Census Tract 1701, Washington County, Texas",3812,41875,1753,1250,0,0,0,799,46,32.8,0,0,0,21,54,1403,969,434,69.07,30.93,65,904,0,434,65,1338,6.7,0,4.6,"50% - 75% P.O.C.","Less than $44000"
"48477170200","Census Tract 1702, Washington County, Texas",6693,52930,4463,934,0,230,0,972,66.7,14,0,3.4,0,14.5,33.3,2317,1709,608,73.76,26.24,175,1534,21,587,196,2121,10.2,3.5,8.5,"25% - 50% P.O.C.","$44000 - $59000"
"48477170300","Census Tract 1703, Washington County, Texas",5561,55707,3954,439,0,95,0,756,71.1,7.9,0,1.7,0,13.6,28.9,2271,1729,542,76.13,23.87,73,1656,100,442,173,2098,4.2,18.5,7.6,"25% - 50% P.O.C.","$44000 - $59000"
"48477170400","Census Tract 1704, Washington County, Texas",7230,51927,3799,1423,47,229,0,1682,52.5,19.7,0.7,3.2,0,23.3,47.5,2063,1153,910,55.89,44.11,73,1080,83,827,156,1907,6.3,9.1,7.6,"25% - 50% P.O.C.","$44000 - $59000"
"48477170500","Census Tract 1705, Washington County, Texas",6842,61491,5393,774,41,4,0,608,78.8,11.3,0.6,0.1,0,8.9,21.2,2812,2417,395,85.95,14.05,132,2285,88,307,220,2592,5.5,22.3,7.8,"Less than 25% P.O.C.","$59000 - $86000"
"48477170600","Census Tract 1706, Washington County, Texas",5025,61767,3146,943,0,24,38,829,62.6,18.8,0,0.5,0.8,16.5,37.4,1759,1381,378,78.51,21.49,91,1290,172,206,263,1496,6.6,45.5,15,"25% - 50% P.O.C.","$59000 - $86000"
"48481740100","Census Tract 7401, Wharton County, Texas",5269,54056,3318,674,3,0,0,1274,63,12.8,0.1,0,0,24.2,37,2082,1618,464,77.71,22.29,251,1367,28,436,279,1803,15.5,6,13.4,"25% - 50% P.O.C.","$44000 - $59000"
"48481740200","Census Tract 7402, Wharton County, Texas",1969,55324,801,378,0,17,0,742,40.7,19.2,0,0.9,0,37.7,59.3,638,377,261,59.09,40.91,110,267,37,224,147,491,29.2,14.2,23,"50% - 75% P.O.C.","$44000 - $59000"
"48481740300","Census Tract 7403, Wharton County, Texas",1334,32344,305,626,0,36,0,338,22.9,46.9,0,2.7,0,25.3,77.1,446,251,195,56.28,43.72,29,222,58,137,87,359,11.6,29.7,19.5,"75% or more P.O.C.","Less than $44000"
"48481740400","Census Tract 7404, Wharton County, Texas",5754,45636,2670,1076,0,0,0,2008,46.4,18.7,0,0,0,34.9,53.6,2274,1419,855,62.4,37.6,176,1243,16,839,192,2082,12.4,1.9,8.4,"50% - 75% P.O.C.","$44000 - $59000"
"48481740500","Census Tract 7405, Wharton County, Texas",3285,30313,1041,1328,0,11,0,905,31.7,40.4,0,0.3,0,27.5,68.3,1260,659,601,52.3,47.7,58,601,20,581,78,1182,8.8,3.3,6.2,"50% - 75% P.O.C.","Less than $44000"
"48481740600","Census Tract 7406, Wharton County, Texas",4669,61600,1822,460,0,53,0,2334,39,9.9,0,1.1,0,50,61,1498,1125,373,75.1,24.9,160,965,120,253,280,1218,14.2,32.2,18.7,"50% - 75% P.O.C.","$59000 - $86000"
"48481740700","Census Tract 7407, Wharton County, Texas",1889,35250,410,103,0,0,0,1376,21.7,5.5,0,0,0,72.8,78.3,634,368,266,58.04,41.96,53,315,51,215,104,530,14.4,19.2,16.4,"75% or more P.O.C.","Less than $44000"
"48481740800","Census Tract 7408, Wharton County, Texas",3848,33603,1074,373,17,0,0,2384,27.9,9.7,0.4,0,0,62,72.1,1411,798,613,56.56,43.44,176,622,106,507,282,1129,22.1,17.3,20,"50% - 75% P.O.C.","Less than $44000"
"48481740900","Census Tract 7409, Wharton County, Texas",7109,73361,4533,43,0,14,0,2519,63.8,0.6,0,0.2,0,35.4,36.2,2727,1998,729,73.27,26.73,168,1830,0,729,168,2559,8.4,0,6.2,"25% - 50% P.O.C.","$59000 - $86000"
"48481741000","Census Tract 7410, Wharton County, Texas",3939,39755,1102,513,5,0,0,2284,28,13,0.1,0,0,58,72,1331,770,561,57.85,42.15,101,669,134,427,235,1096,13.1,23.9,17.7,"50% - 75% P.O.C.","Less than $44000"
"48481741100","Census Tract 7411, Wharton County, Texas",2512,57054,1408,49,0,11,0,1044,56.1,2,0,0.4,0,41.6,43.9,898,795,103,88.53,11.47,97,698,18,85,115,783,12.2,17.5,12.8,"25% - 50% P.O.C.","$44000 - $59000"
