"GEOID","NAME","total_pop","median_hh_income","white","black","ai_an","asian","hi_pi","hisp_lat","pct_white","pct_black","pct_ai_an","pct_asian","pct_hi_pi","pct_hisp_lat","pct_poc","total_hh","total_hh_owner","total_hh_renter","pct_owners","pct_renters","total_owner_more_than_4","total_owner_less_than_4","total_renter_more_than_4","total_renter_less_than_4","total_hh_more_than_4","total_hh_less_than_4","pct_owner_more_than_4","pct_renter_more_than_4","pct_total_hh_more_than_4","poc_bin","income_bin"
"36005000100","Census Tract 1, Bronx County, New York",6864,NA,603,3601,18,181,0,2407,8.8,52.5,0.3,2.6,0,35.1,91.2,0,0,0,NA,NA,0,0,0,0,0,0,NA,NA,NA,"75% or more P.O.C.","N/A"
"36005000200","Census Tract 2, Bronx County, New York",4532,51100,33,920,0,75,0,3444,0.7,20.3,0,1.7,0,76,99.3,1342,704,638,52.46,47.54,101,603,135,503,236,1106,14.3,21.2,17.6,"75% or more P.O.C.","Less than $55000"
"36005000400","Census Tract 4, Bronx County, New York",5516,78409,387,1264,0,121,0,3661,7,22.9,0,2.2,0,66.4,93,2042,1614,428,79.04,20.96,194,1420,0,428,194,1848,12,0,9.5,"75% or more P.O.C.","$78000 - $104000"
"36005001600","Census Tract 16, Bronx County, New York",5825,34093,213,2021,0,64,0,3452,3.7,34.7,0,1.1,0,59.3,96.3,1971,245,1726,12.43,87.57,22,223,206,1520,228,1743,9,11.9,11.6,"75% or more P.O.C.","Less than $55000"
"36005001900","Census Tract 19, Bronx County, New York",3141,45156,340,937,0,72,0,1714,10.8,29.8,0,2.3,0,54.6,89.2,1079,114,965,10.57,89.43,19,95,85,880,104,975,16.7,8.8,9.6,"75% or more P.O.C.","Less than $55000"
"36005002000","Census Tract 20, Bronx County, New York",9040,20592,21,3031,0,0,0,5912,0.2,33.5,0,0,0,65.4,99.8,3269,417,2852,12.76,87.24,111,306,308,2544,419,2850,26.6,10.8,12.8,"75% or more P.O.C.","Less than $55000"
"36005002300","Census Tract 23, Bronx County, New York",4302,18688,1,1192,16,0,0,3062,0,27.7,0.4,0,0,71.2,100,1914,0,1914,0,100,0,0,166,1748,166,1748,NA,8.7,8.7,"75% or more P.O.C.","Less than $55000"
"36005002400","Census Tract 24, Bronx County, New York",155,NA,65,90,0,0,0,0,41.9,58.1,0,0,0,0,58.1,38,0,38,0,100,0,0,0,38,0,38,NA,0,0,"50% - 75% P.O.C.","N/A"
"36005002500","Census Tract 25, Bronx County, New York",5610,23115,220,1355,0,6,0,3986,3.9,24.2,0,0.1,0,71.1,96.1,1977,72,1905,3.64,96.36,0,72,373,1532,373,1604,0,19.6,18.9,"75% or more P.O.C.","Less than $55000"
"36005002701","Census Tract 27.01, Bronx County, New York",2608,18832,0,643,0,0,0,1965,0,24.7,0,0,0,75.3,100,1043,0,1043,0,100,0,0,97,946,97,946,NA,9.3,9.3,"75% or more P.O.C.","Less than $55000"
"36005002702","Census Tract 27.02, Bronx County, New York",4560,13097,36,1917,20,0,0,2566,0.8,42,0.4,0,0,56.3,99.2,1520,56,1464,3.68,96.32,30,26,235,1229,265,1255,53.6,16.1,17.4,"75% or more P.O.C.","Less than $55000"
"36005002800","Census Tract 28, Bronx County, New York",5151,51138,51,3520,0,0,0,1546,1,68.3,0,0,0,30,99,2305,330,1975,14.32,85.68,0,330,49,1926,49,2256,0,2.5,2.1,"75% or more P.O.C.","Less than $55000"
"36005003100","Census Tract 31, Bronx County, New York",1689,43255,24,394,0,74,0,1190,1.4,23.3,0,4.4,0,70.5,98.6,658,146,512,22.19,77.81,44,102,18,494,62,596,30.1,3.5,9.4,"75% or more P.O.C.","Less than $55000"
"36005003300","Census Tract 33, Bronx County, New York",3277,22127,92,995,68,0,0,1990,2.8,30.4,2.1,0,0,60.7,97.2,1183,115,1068,9.72,90.28,48,67,92,976,140,1043,41.7,8.6,11.8,"75% or more P.O.C.","Less than $55000"
"36005003500","Census Tract 35, Bronx County, New York",3907,31310,17,1243,0,0,0,2647,0.4,31.8,0,0,0,67.8,99.6,1322,76,1246,5.75,94.25,0,76,142,1104,142,1180,0,11.4,10.7,"75% or more P.O.C.","Less than $55000"
"36005003700","Census Tract 37, Bronx County, New York",250,NA,21,77,0,0,0,152,8.4,30.8,0,0,0,60.8,91.6,145,0,145,0,100,0,0,0,145,0,145,NA,0,0,"75% or more P.O.C.","N/A"
"36005003800","Census Tract 38, Bronx County, New York",1350,33681,0,322,0,0,0,1028,0,23.9,0,0,0,76.1,100,415,144,271,34.7,65.3,18,126,59,212,77,338,12.5,21.8,18.6,"75% or more P.O.C.","Less than $55000"
"36005003900","Census Tract 39, Bronx County, New York",6260,25772,520,973,0,0,0,4767,8.3,15.5,0,0,0,76.2,91.7,2104,117,1987,5.56,94.44,0,117,336,1651,336,1768,0,16.9,16,"75% or more P.O.C.","Less than $55000"
"36005004001","Census Tract 40.01, Bronx County, New York",1475,54868,128,127,19,161,0,991,8.7,8.6,1.3,10.9,0,67.2,91.3,498,241,257,48.39,51.61,41,200,52,205,93,405,17,20.2,18.7,"75% or more P.O.C.","Less than $55000"
"36005004100","Census Tract 41, Bronx County, New York",5942,19643,102,1625,0,12,0,4192,1.7,27.3,0,0.2,0,70.5,98.3,2188,274,1914,12.52,87.48,43,231,185,1729,228,1960,15.7,9.7,10.4,"75% or more P.O.C.","Less than $55000"
"36005004200","Census Tract 42, Bronx County, New York",7697,43293,409,2663,0,32,0,4566,5.3,34.6,0,0.4,0,59.3,94.7,2726,358,2368,13.13,86.87,0,358,392,1976,392,2334,0,16.6,14.4,"75% or more P.O.C.","Less than $55000"
"36005004300","Census Tract 43, Bronx County, New York",5552,21689,64,1472,0,52,0,3956,1.2,26.5,0,0.9,0,71.3,98.8,2061,152,1909,7.38,92.62,59,93,249,1660,308,1753,38.8,13,14.9,"75% or more P.O.C.","Less than $55000"
"36005004400","Census Tract 44, Bronx County, New York",4401,17297,294,1530,0,113,0,2415,6.7,34.8,0,2.6,0,54.9,93.3,1648,69,1579,4.19,95.81,0,69,128,1451,128,1520,0,8.1,7.8,"75% or more P.O.C.","Less than $55000"
"36005004600","Census Tract 46, Bronx County, New York",1961,21360,95,677,0,0,0,1189,4.8,34.5,0,0,0,60.6,95.2,721,161,560,22.33,77.67,0,161,59,501,59,662,0,10.5,8.2,"75% or more P.O.C.","Less than $55000"
"36005004800","Census Tract 48, Bronx County, New York",4563,33403,28,799,60,122,0,3484,0.6,17.5,1.3,2.7,0,76.4,99.4,1406,119,1287,8.46,91.54,46,73,152,1135,198,1208,38.7,11.8,14.1,"75% or more P.O.C.","Less than $55000"
"36005005001","Census Tract 50.01, Bronx County, New York",4604,27009,42,1124,55,48,0,3308,0.9,24.4,1.2,1,0,71.9,99.1,1516,200,1316,13.19,86.81,49,151,175,1141,224,1292,24.5,13.3,14.8,"75% or more P.O.C.","Less than $55000"
"36005005002","Census Tract 50.02, Bronx County, New York",5592,31795,60,1019,5,54,0,4418,1.1,18.2,0.1,1,0,79,98.9,1933,99,1834,5.12,94.88,9,90,261,1573,270,1663,9.1,14.2,14,"75% or more P.O.C.","Less than $55000"
"36005005100","Census Tract 51, Bronx County, New York",5737,19115,0,1744,0,34,0,3959,0,30.4,0,0.6,0,69,100,2161,0,2161,0,100,0,0,96,2065,96,2065,NA,4.4,4.4,"75% or more P.O.C.","Less than $55000"
"36005005200","Census Tract 52, Bronx County, New York",1956,21140,0,505,0,8,0,1430,0,25.8,0,0.4,0,73.1,100,813,24,789,2.95,97.05,0,24,51,738,51,762,0,6.5,6.3,"75% or more P.O.C.","Less than $55000"
"36005005300","Census Tract 53, Bronx County, New York",4888,16583,56,2399,0,7,0,2365,1.1,49.1,0,0.1,0,48.4,98.9,1686,0,1686,0,100,0,0,225,1461,225,1461,NA,13.3,13.3,"75% or more P.O.C.","Less than $55000"
"36005005400","Census Tract 54, Bronx County, New York",5324,35189,78,1301,0,129,0,3581,1.5,24.4,0,2.4,0,67.3,98.5,1672,262,1410,15.67,84.33,51,211,193,1217,244,1428,19.5,13.7,14.6,"75% or more P.O.C.","Less than $55000"
"36005005600","Census Tract 56, Bronx County, New York",2279,27153,55,552,26,47,0,1542,2.4,24.2,1.1,2.1,0,67.7,97.6,868,166,702,19.12,80.88,39,127,67,635,106,762,23.5,9.5,12.2,"75% or more P.O.C.","Less than $55000"
"36005005902","Census Tract 59.02, Bronx County, New York",2751,30844,133,622,0,42,0,1826,4.8,22.6,0,1.5,0,66.4,95.2,1051,194,857,18.46,81.54,11,183,120,737,131,920,5.7,14,12.5,"75% or more P.O.C.","Less than $55000"
"36005006000","Census Tract 60, Bronx County, New York",1386,34898,9,264,0,36,0,1027,0.6,19,0,2.6,0,74.1,99.4,376,37,339,9.84,90.16,18,19,80,259,98,278,48.6,23.6,26.1,"75% or more P.O.C.","Less than $55000"
"36005006100","Census Tract 61, Bronx County, New York",3720,45361,113,2529,0,16,0,1021,3,68,0,0.4,0,27.4,97,2063,768,1295,37.23,62.77,9,759,0,1295,9,2054,1.2,0,0.4,"75% or more P.O.C.","Less than $55000"
"36005006200","Census Tract 62, Bronx County, New York",7233,25206,117,2488,54,148,0,4425,1.6,34.4,0.7,2,0,61.2,98.4,2418,77,2341,3.18,96.82,10,67,371,1970,381,2037,13,15.8,15.8,"75% or more P.O.C.","Less than $55000"
"36005006300","Census Tract 63, Bronx County, New York",4582,37306,462,1163,0,62,0,2843,10.1,25.4,0,1.4,0,62,89.9,1918,161,1757,8.39,91.61,23,138,146,1611,169,1749,14.3,8.3,8.8,"75% or more P.O.C.","Less than $55000"
"36005006400","Census Tract 64, Bronx County, New York",3932,38415,194,1418,0,192,0,1967,4.9,36.1,0,4.9,0,50,95.1,1271,267,1004,21.01,78.99,74,193,80,924,154,1117,27.7,8,12.1,"75% or more P.O.C.","Less than $55000"
"36005006500","Census Tract 65, Bronx County, New York",5377,25467,298,1286,0,113,0,3662,5.5,23.9,0,2.1,0,68.1,94.5,1962,42,1920,2.14,97.86,0,42,253,1667,253,1709,0,13.2,12.9,"75% or more P.O.C.","Less than $55000"
"36005006700","Census Tract 67, Bronx County, New York",6705,19813,18,1604,0,0,0,5018,0.3,23.9,0,0,0,74.8,99.7,2330,117,2213,5.02,94.98,0,117,306,1907,306,2024,0,13.8,13.1,"75% or more P.O.C.","Less than $55000"
"36005006800","Census Tract 68, Bronx County, New York",3230,54395,0,844,54,416,0,1899,0,26.1,1.7,12.9,0,58.8,100,1011,214,797,21.17,78.83,15,199,200,597,215,796,7,25.1,21.3,"75% or more P.O.C.","Less than $55000"
"36005006900","Census Tract 69, Bronx County, New York",7801,37590,313,2853,6,30,0,4462,4,36.6,0.1,0.4,0,57.2,96,2800,200,2600,7.14,92.86,98,102,286,2314,384,2416,49,11,13.7,"75% or more P.O.C.","Less than $55000"
"36005007000","Census Tract 70, Bronx County, New York",4378,50500,151,973,0,602,0,2423,3.4,22.2,0,13.8,0,55.3,96.6,1306,307,999,23.51,76.49,75,232,198,801,273,1033,24.4,19.8,20.9,"75% or more P.O.C.","Less than $55000"
"36005007100","Census Tract 71, Bronx County, New York",2795,42292,52,888,0,69,0,1750,1.9,31.8,0,2.5,0,62.6,98.1,1005,366,639,36.42,63.58,29,337,70,569,99,906,7.9,11,9.9,"75% or more P.O.C.","Less than $55000"
"36005007200","Census Tract 72, Bronx County, New York",6255,43197,373,708,0,2118,0,2681,6,11.3,0,33.9,0,42.9,94,1632,371,1261,22.73,77.27,140,231,271,990,411,1221,37.7,21.5,25.2,"75% or more P.O.C.","Less than $55000"
"36005007300","Census Tract 73, Bronx County, New York",4297,22344,72,1092,0,0,0,3050,1.7,25.4,0,0,0,71,98.3,1351,12,1339,0.89,99.11,12,0,268,1071,280,1071,100,20,20.7,"75% or more P.O.C.","Less than $55000"
"36005007400","Census Tract 74, Bronx County, New York",3634,39537,79,1039,0,0,0,2423,2.2,28.6,0,0,0,66.7,97.8,1348,571,777,42.36,57.64,35,536,120,657,155,1193,6.1,15.4,11.5,"75% or more P.O.C.","Less than $55000"
"36005007500","Census Tract 75, Bronx County, New York",6692,30706,61,2359,91,50,0,4117,0.9,35.3,1.4,0.7,0,61.5,99.1,2356,353,2003,14.98,85.02,29,324,287,1716,316,2040,8.2,14.3,13.4,"75% or more P.O.C.","Less than $55000"
"36005007600","Census Tract 76, Bronx County, New York",5311,46176,208,1104,0,500,0,3435,3.9,20.8,0,9.4,0,64.7,96.1,1642,345,1297,21.01,78.99,69,276,196,1101,265,1377,20,15.1,16.1,"75% or more P.O.C.","Less than $55000"
"36005007700","Census Tract 77, Bronx County, New York",2022,38417,62,377,0,19,0,1564,3.1,18.6,0,0.9,0,77.3,96.9,592,146,446,24.66,75.34,5,141,133,313,138,454,3.4,29.8,23.3,"75% or more P.O.C.","Less than $55000"
"36005007800","Census Tract 78, Bronx County, New York",7415,52360,220,1709,0,725,0,4585,3,23,0,9.8,0,61.8,97,2201,402,1799,18.26,81.74,93,309,312,1487,405,1796,23.1,17.3,18.4,"75% or more P.O.C.","Less than $55000"
"36005007900","Census Tract 79, Bronx County, New York",7188,26307,10,1960,0,0,110,5023,0.1,27.3,0,0,1.5,69.9,99.9,2441,27,2414,1.11,98.89,22,5,332,2082,354,2087,81.5,13.8,14.5,"75% or more P.O.C.","Less than $55000"
"36005008300","Census Tract 83, Bronx County, New York",6713,32167,135,960,0,145,0,5419,2,14.3,0,2.2,0,80.7,98,2152,283,1869,13.15,86.85,59,224,349,1520,408,1744,20.8,18.7,19,"75% or more P.O.C.","Less than $55000"
"36005008400","Census Tract 84, Bronx County, New York",2899,85750,65,743,67,222,0,1784,2.2,25.6,2.3,7.7,0,61.5,97.8,753,554,199,73.57,26.43,213,341,39,160,252,501,38.4,19.6,33.5,"75% or more P.O.C.","$78000 - $104000"
"36005008500","Census Tract 85, Bronx County, New York",5631,31370,66,1504,0,17,0,3905,1.2,26.7,0,0.3,0,69.3,98.8,1952,345,1607,17.67,82.33,33,312,158,1449,191,1761,9.6,9.8,9.8,"75% or more P.O.C.","Less than $55000"
"36005008600","Census Tract 86, Bronx County, New York",3936,21848,65,1966,0,22,0,1831,1.7,49.9,0,0.6,0,46.5,98.3,1460,118,1342,8.08,91.92,19,99,221,1121,240,1220,16.1,16.5,16.4,"75% or more P.O.C.","Less than $55000"
"36005008700","Census Tract 87, Bronx County, New York",6127,23967,116,1317,58,34,0,4546,1.9,21.5,0.9,0.6,0,74.2,98.1,2056,54,2002,2.63,97.37,0,54,222,1780,222,1834,0,11.1,10.8,"75% or more P.O.C.","Less than $55000"
"36005008900","Census Tract 89, Bronx County, New York",3218,28642,48,749,0,0,0,2421,1.5,23.3,0,0,0,75.2,98.5,1177,106,1071,9.01,90.99,0,106,115,956,115,1062,0,10.7,9.8,"75% or more P.O.C.","Less than $55000"
"36005009000","Census Tract 90, Bronx County, New York",3459,24487,55,765,20,75,0,2498,1.6,22.1,0.6,2.2,0,72.2,98.4,1164,225,939,19.33,80.67,57,168,118,821,175,989,25.3,12.6,15,"75% or more P.O.C.","Less than $55000"
"36005009200","Census Tract 92, Bronx County, New York",5848,50176,258,741,0,905,0,3238,4.4,12.7,0,15.5,0,55.4,95.6,1849,465,1384,25.15,74.85,144,321,215,1169,359,1490,31,15.5,19.4,"75% or more P.O.C.","Less than $55000"
"36005009300","Census Tract 93, Bronx County, New York",6154,32852,139,1913,12,12,0,4070,2.3,31.1,0.2,0.2,0,66.1,97.7,1793,164,1629,9.15,90.85,41,123,269,1360,310,1483,25,16.5,17.3,"75% or more P.O.C.","Less than $55000"
"36005009600","Census Tract 96, Bronx County, New York",2792,50809,179,545,0,540,0,1381,6.4,19.5,0,19.3,0,49.5,93.6,765,264,501,34.51,65.49,86,178,73,428,159,606,32.6,14.6,20.8,"75% or more P.O.C.","Less than $55000"
"36005009800","Census Tract 98, Bronx County, New York",4756,68487,167,846,0,202,0,3431,3.5,17.8,0,4.2,0,72.1,96.5,1726,718,1008,41.6,58.4,117,601,94,914,211,1515,16.3,9.3,12.2,"75% or more P.O.C.","$55000 - $78000"
"36005011000","Census Tract 110, Bronx County, New York",0,NA,0,0,0,0,0,0,NA,NA,NA,NA,NA,NA,NA,0,0,0,NA,NA,0,0,0,0,0,0,NA,NA,NA,"N/A","N/A"
"36005011502","Census Tract 115.02, Bronx County, New York",4582,17656,33,1841,0,9,0,2653,0.7,40.2,0,0.2,0,57.9,99.3,1304,87,1217,6.67,93.33,18,69,292,925,310,994,20.7,24,23.8,"75% or more P.O.C.","Less than $55000"
"36005011700","Census Tract 117, Bronx County, New York",1443,21595,16,557,0,0,0,870,1.1,38.6,0,0,0,60.3,98.9,526,20,506,3.8,96.2,0,20,45,461,45,481,0,8.9,8.6,"75% or more P.O.C.","Less than $55000"
"36005011800","Census Tract 118, Bronx County, New York",5503,86250,3105,189,0,184,8,1965,56.4,3.4,0,3.3,0.1,35.7,43.6,1616,1098,518,67.95,32.05,131,967,36,482,167,1449,11.9,6.9,10.3,"25% - 50% P.O.C.","$78000 - $104000"
"36005011900","Census Tract 119, Bronx County, New York",5440,28988,199,1166,0,12,0,3958,3.7,21.4,0,0.2,0,72.8,96.3,1933,135,1798,6.98,93.02,21,114,238,1560,259,1674,15.6,13.2,13.4,"75% or more P.O.C.","Less than $55000"
"36005012101","Census Tract 121.01, Bronx County, New York",3070,39514,76,1001,0,14,0,1951,2.5,32.6,0,0.5,0,63.6,97.5,975,229,746,23.49,76.51,41,188,121,625,162,813,17.9,16.2,16.6,"75% or more P.O.C.","Less than $55000"
"36005012102","Census Tract 121.02, Bronx County, New York",1447,23244,5,187,0,0,0,1248,0.3,12.9,0,0,0,86.2,99.7,523,5,518,0.96,99.04,5,0,58,460,63,460,100,11.2,12,"75% or more P.O.C.","Less than $55000"
"36005012300","Census Tract 123, Bronx County, New York",4268,31519,51,1256,4,18,0,2939,1.2,29.4,0.1,0.4,0,68.9,98.8,1608,60,1548,3.73,96.27,34,26,46,1502,80,1528,56.7,3,5,"75% or more P.O.C.","Less than $55000"
"36005012500","Census Tract 125, Bronx County, New York",3860,34903,53,1105,0,93,0,2579,1.4,28.6,0,2.4,0,66.8,98.6,1316,246,1070,18.69,81.31,44,202,54,1016,98,1218,17.9,5,7.4,"75% or more P.O.C.","Less than $55000"
"36005012701","Census Tract 127.01, Bronx County, New York",1928,31212,36,365,24,68,0,1410,1.9,18.9,1.2,3.5,0,73.1,98.1,762,152,610,19.95,80.05,0,152,29,581,29,733,0,4.8,3.8,"75% or more P.O.C.","Less than $55000"
"36005012901","Census Tract 129.01, Bronx County, New York",4419,25633,119,1268,0,4,0,3006,2.7,28.7,0,0.1,0,68,97.3,1537,130,1407,8.46,91.54,15,115,228,1179,243,1294,11.5,16.2,15.8,"75% or more P.O.C.","Less than $55000"
"36005013000","Census Tract 130, Bronx County, New York",1476,106346,658,82,0,0,0,729,44.6,5.6,0,0,0,49.4,55.4,464,314,150,67.67,32.33,77,237,6,144,83,381,24.5,4,17.9,"50% - 75% P.O.C.","$104000 or more"
"36005013100","Census Tract 131, Bronx County, New York",5084,26750,104,1461,0,0,0,3489,2,28.7,0,0,0,68.6,98,1715,179,1536,10.44,89.56,45,134,218,1318,263,1452,25.1,14.2,15.3,"75% or more P.O.C.","Less than $55000"
"36005013200","Census Tract 132, Bronx County, New York",7272,118211,2043,1197,0,141,0,3805,28.1,16.5,0,1.9,0,52.3,71.9,2481,1773,708,71.46,28.54,302,1471,61,647,363,2118,17,8.6,14.6,"50% - 75% P.O.C.","$104000 or more"
"36005013300","Census Tract 133, Bronx County, New York",6000,23484,51,1916,206,241,0,3519,0.9,31.9,3.4,4,0,58.7,99.1,2382,101,2281,4.24,95.76,0,101,115,2166,115,2267,0,5,4.8,"75% or more P.O.C.","Less than $55000"
"36005013500","Census Tract 135, Bronx County, New York",3590,24392,0,1487,0,0,0,2012,0,41.4,0,0,0,56,100,1442,122,1320,8.46,91.54,15,107,85,1235,100,1342,12.3,6.4,6.9,"75% or more P.O.C.","Less than $55000"
"36005013800","Census Tract 138, Bronx County, New York",2588,67705,1361,32,0,39,0,1132,52.6,1.2,0,1.5,0,43.7,47.4,1131,665,466,58.8,41.2,39,626,12,454,51,1080,5.9,2.6,4.5,"25% - 50% P.O.C.","$55000 - $78000"
"36005014100","Census Tract 141, Bronx County, New York",5851,31205,105,1759,0,21,0,3871,1.8,30.1,0,0.4,0,66.2,98.2,2302,113,2189,4.91,95.09,10,103,271,1918,281,2021,8.8,12.4,12.2,"75% or more P.O.C.","Less than $55000"
"36005014300","Census Tract 143, Bronx County, New York",1482,17204,13,736,12,0,0,702,0.9,49.7,0.8,0,0,47.4,99.1,663,22,641,3.32,96.68,22,0,65,576,87,576,100,10.1,13.1,"75% or more P.O.C.","Less than $55000"
"36005014400","Census Tract 144, Bronx County, New York",5138,22095,100,1509,0,69,0,3364,1.9,29.4,0,1.3,0,65.5,98.1,2236,314,1922,14.04,85.96,114,200,152,1770,266,1970,36.3,7.9,11.9,"75% or more P.O.C.","Less than $55000"
"36005014500","Census Tract 145, Bronx County, New York",7436,30676,233,2897,38,5,0,4246,3.1,39,0.5,0.1,0,57.1,96.9,2400,64,2336,2.67,97.33,0,64,292,2044,292,2108,0,12.5,12.2,"75% or more P.O.C.","Less than $55000"
"36005014701","Census Tract 147.01, Bronx County, New York",7003,17013,54,3839,0,1,0,2982,0.8,54.8,0,0,0,42.6,99.2,1995,0,1995,0,100,0,0,515,1480,515,1480,NA,25.8,25.8,"75% or more P.O.C.","Less than $55000"
"36005014702","Census Tract 147.02, Bronx County, New York",5435,22237,64,2188,0,0,0,3146,1.2,40.3,0,0,0,57.9,98.8,1664,6,1658,0.36,99.64,0,6,300,1358,300,1364,0,18.1,18,"75% or more P.O.C.","Less than $55000"
"36005014900","Census Tract 149, Bronx County, New York",4419,29079,91,1669,0,0,0,2494,2.1,37.8,0,0,0,56.4,97.9,1612,131,1481,8.13,91.87,39,92,133,1348,172,1440,29.8,9,10.7,"75% or more P.O.C.","Less than $55000"
"36005015100","Census Tract 151, Bronx County, New York",5309,29276,74,2451,0,0,0,2771,1.4,46.2,0,0,0,52.2,98.6,1840,240,1600,13.04,86.96,50,190,163,1437,213,1627,20.8,10.2,11.6,"75% or more P.O.C.","Less than $55000"
"36005015200","Census Tract 152, Bronx County, New York",2481,73929,790,179,0,99,0,1378,31.8,7.2,0,4,0,55.5,68.2,896,491,405,54.8,45.2,27,464,52,353,79,817,5.5,12.8,8.8,"50% - 75% P.O.C.","$55000 - $78000"
"36005015300","Census Tract 153, Bronx County, New York",4474,24438,14,2184,0,47,0,2229,0.3,48.8,0,1.1,0,49.8,99.7,1485,225,1260,15.15,84.85,45,180,178,1082,223,1262,20,14.1,15,"75% or more P.O.C.","Less than $55000"
"36005015500","Census Tract 155, Bronx County, New York",2927,22067,0,664,16,24,0,2196,0,22.7,0.5,0.8,0,75,100,1128,64,1064,5.67,94.33,11,53,78,986,89,1039,17.2,7.3,7.9,"75% or more P.O.C.","Less than $55000"
"36005015700","Census Tract 157, Bronx County, New York",4704,33468,54,1333,0,83,0,3165,1.1,28.3,0,1.8,0,67.3,98.9,1695,161,1534,9.5,90.5,31,130,149,1385,180,1515,19.3,9.7,10.6,"75% or more P.O.C.","Less than $55000"
"36005015800","Census Tract 158, Bronx County, New York",1314,55700,532,35,0,50,0,679,40.5,2.7,0,3.8,0,51.7,59.5,470,220,250,46.81,53.19,16,204,43,207,59,411,7.3,17.2,12.6,"50% - 75% P.O.C.","$55000 - $78000"
"36005015900","Census Tract 159, Bronx County, New York",1969,16400,14,144,0,14,0,1790,0.7,7.3,0,0.7,0,90.9,99.3,702,72,630,10.26,89.74,7,65,81,549,88,614,9.7,12.9,12.5,"75% or more P.O.C.","Less than $55000"
"36005016000","Census Tract 160, Bronx County, New York",3666,79756,1963,115,0,136,0,1351,53.5,3.1,0,3.7,0,36.9,46.5,1482,881,601,59.45,40.55,104,777,85,516,189,1293,11.8,14.1,12.8,"25% - 50% P.O.C.","$78000 - $104000"
"36005016100","Census Tract 161, Bronx County, New York",4650,17960,27,1575,0,0,0,3048,0.6,33.9,0,0,0,65.5,99.4,1801,19,1782,1.05,98.95,13,6,69,1713,82,1719,68.4,3.9,4.6,"75% or more P.O.C.","Less than $55000"
"36005016200","Census Tract 162, Bronx County, New York",1870,81210,591,78,0,87,0,1104,31.6,4.2,0,4.7,0,59,68.4,560,272,288,48.57,51.43,49,223,32,256,81,479,18,11.1,14.5,"50% - 75% P.O.C.","$78000 - $104000"
"36005016300","Census Tract 163, Bronx County, New York",0,NA,0,0,0,0,0,0,NA,NA,NA,NA,NA,NA,NA,0,0,0,NA,NA,0,0,0,0,0,0,NA,NA,NA,"N/A","N/A"
"36005016400","Census Tract 164, Bronx County, New York",1046,80000,711,24,0,0,0,311,68,2.3,0,0,0,29.7,32,418,236,182,56.46,43.54,19,217,17,165,36,382,8.1,9.3,8.6,"25% - 50% P.O.C.","$78000 - $104000"
"36005016500","Census Tract 165, Bronx County, New York",965,26739,0,444,0,9,0,512,0,46,0,0.9,0,53.1,100,330,3,327,0.91,99.09,3,0,29,298,32,298,100,8.9,9.7,"75% or more P.O.C.","Less than $55000"
"36005016600","Census Tract 166, Bronx County, New York",2244,78333,480,179,0,100,0,1404,21.4,8,0,4.5,0,62.6,78.6,786,521,265,66.28,33.72,61,460,14,251,75,711,11.7,5.3,9.5,"75% or more P.O.C.","$78000 - $104000"
"36005016700","Census Tract 167, Bronx County, New York",3695,31600,32,1588,0,0,0,2037,0.9,43,0,0,0,55.1,99.1,1047,53,994,5.06,94.94,7,46,229,765,236,811,13.2,23,22.5,"75% or more P.O.C.","Less than $55000"
"36005016900","Census Tract 169, Bronx County, New York",1633,30221,5,754,0,0,0,874,0.3,46.2,0,0,0,53.5,99.7,503,80,423,15.9,84.1,12,68,60,363,72,431,15,14.2,14.3,"75% or more P.O.C.","Less than $55000"
"36005017100","Census Tract 171, Bronx County, New York",0,NA,0,0,0,0,0,0,NA,NA,NA,NA,NA,NA,NA,0,0,0,NA,NA,0,0,0,0,0,0,NA,NA,NA,"N/A","N/A"
"36005017300","Census Tract 173, Bronx County, New York",5746,20662,163,1415,46,260,0,3801,2.8,24.6,0.8,4.5,0,66.2,97.2,2135,139,1996,6.51,93.49,0,139,323,1673,323,1812,0,16.2,15.1,"75% or more P.O.C.","Less than $55000"
"36005017500","Census Tract 175, Bronx County, New York",6536,26630,185,2331,0,17,0,3781,2.8,35.7,0,0.3,0,57.8,97.2,2597,0,2597,0,100,0,0,151,2446,151,2446,NA,5.8,5.8,"75% or more P.O.C.","Less than $55000"
"36005017701","Census Tract 177.01, Bronx County, New York",4650,28750,62,1767,0,0,0,2794,1.3,38,0,0,0,60.1,98.7,1180,152,1028,12.88,87.12,70,82,217,811,287,893,46.1,21.1,24.3,"75% or more P.O.C.","Less than $55000"
"36005017702","Census Tract 177.02, Bronx County, New York",5423,34567,108,1962,0,42,0,3120,2,36.2,0,0.8,0,57.5,98,1674,218,1456,13.02,86.98,51,167,215,1241,266,1408,23.4,14.8,15.9,"75% or more P.O.C.","Less than $55000"
"36005017901","Census Tract 179.01, Bronx County, New York",4831,39036,61,1252,208,72,0,3238,1.3,25.9,4.3,1.5,0,67,98.7,1665,124,1541,7.45,92.55,14,110,215,1326,229,1436,11.3,14,13.8,"75% or more P.O.C.","Less than $55000"
"36005017902","Census Tract 179.02, Bronx County, New York",4032,37250,18,1036,0,9,0,2963,0.4,25.7,0,0.2,0,73.5,99.6,1235,0,1235,0,100,0,0,272,963,272,963,NA,22,22,"75% or more P.O.C.","Less than $55000"
"36005018101","Census Tract 181.01, Bronx County, New York",3351,NA,11,1010,92,0,0,2174,0.3,30.1,2.7,0,0,64.9,99.7,1059,108,951,10.2,89.8,17,91,173,778,190,869,15.7,18.2,17.9,"75% or more P.O.C.","N/A"
"36005018102","Census Tract 181.02, Bronx County, New York",5294,31602,95,2019,0,97,0,2943,1.8,38.1,0,1.8,0,55.6,98.2,1653,46,1607,2.78,97.22,10,36,225,1382,235,1418,21.7,14,14.2,"75% or more P.O.C.","Less than $55000"
"36005018301","Census Tract 183.01, Bronx County, New York",4320,37105,247,1332,0,65,0,2620,5.7,30.8,0,1.5,0,60.6,94.3,2028,410,1618,20.22,79.78,22,388,123,1495,145,1883,5.4,7.6,7.1,"75% or more P.O.C.","Less than $55000"
"36005018302","Census Tract 183.02, Bronx County, New York",3824,41894,101,1045,0,23,0,2632,2.6,27.3,0,0.6,0,68.8,97.4,1262,70,1192,5.55,94.45,0,70,158,1034,158,1104,0,13.3,12.5,"75% or more P.O.C.","Less than $55000"
"36005018400","Census Tract 184, Bronx County, New York",3793,79191,1539,80,0,229,28,1917,40.6,2.1,0,6,0.7,50.5,59.4,1541,645,896,41.86,58.14,46,599,35,861,81,1460,7.1,3.9,5.3,"50% - 75% P.O.C.","$78000 - $104000"
"36005018500","Census Tract 185, Bronx County, New York",9001,25808,57,3966,0,0,0,4854,0.6,44.1,0,0,0,53.9,99.4,2969,61,2908,2.05,97.95,34,27,370,2538,404,2565,55.7,12.7,13.6,"75% or more P.O.C.","Less than $55000"
"36005018900","Census Tract 189, Bronx County, New York",8210,27339,340,2341,0,34,0,5357,4.1,28.5,0,0.4,0,65.2,95.9,2939,180,2759,6.12,93.88,16,164,371,2388,387,2552,8.9,13.4,13.2,"75% or more P.O.C.","Less than $55000"
"36005019300","Census Tract 193, Bronx County, New York",6350,23927,21,1960,30,69,0,4240,0.3,30.9,0.5,1.1,0,66.8,99.7,2225,19,2206,0.85,99.15,0,19,243,1963,243,1982,0,11,10.9,"75% or more P.O.C.","Less than $55000"
"36005019400","Census Tract 194, Bronx County, New York",2375,54167,358,233,35,103,3,1572,15.1,9.8,1.5,4.3,0.1,66.2,84.9,738,282,456,38.21,61.79,42,240,74,382,116,622,14.9,16.2,15.7,"75% or more P.O.C.","Less than $55000"
"36005019500","Census Tract 195, Bronx County, New York",7060,27227,142,2030,4,46,0,4620,2,28.8,0.1,0.7,0,65.4,98,2694,146,2548,5.42,94.58,15,131,296,2252,311,2383,10.3,11.6,11.5,"75% or more P.O.C.","Less than $55000"
"36005019700","Census Tract 197, Bronx County, New York",7561,35100,76,1326,0,467,0,5621,1,17.5,0,6.2,0,74.3,99,2297,15,2282,0.65,99.35,15,0,486,1796,501,1796,100,21.3,21.8,"75% or more P.O.C.","Less than $55000"
"36005019900","Census Tract 199, Bronx County, New York",8338,42569,143,2491,0,0,0,5599,1.7,29.9,0,0,0,67.2,98.3,2922,110,2812,3.76,96.24,46,64,390,2422,436,2486,41.8,13.9,14.9,"75% or more P.O.C.","Less than $55000"
"36005020000","Census Tract 200, Bronx County, New York",4711,40184,130,442,0,1102,26,2883,2.8,9.4,0,23.4,0.6,61.2,97.2,1469,181,1288,12.32,87.68,53,128,217,1071,270,1199,29.3,16.8,18.4,"75% or more P.O.C.","Less than $55000"
"36005020100","Census Tract 201, Bronx County, New York",3993,34038,132,1228,0,8,0,2625,3.3,30.8,0,0.2,0,65.7,96.7,1272,8,1264,0.63,99.37,0,8,180,1084,180,1092,0,14.2,14.2,"75% or more P.O.C.","Less than $55000"
"36005020200","Census Tract 202, Bronx County, New York",2385,39306,104,360,0,383,0,1461,4.4,15.1,0,16.1,0,61.3,95.6,863,138,725,15.99,84.01,55,83,81,644,136,727,39.9,11.2,15.8,"75% or more P.O.C.","Less than $55000"
"36005020400","Census Tract 204, Bronx County, New York",3011,51199,269,108,0,543,0,2022,8.9,3.6,0,18,0,67.2,91.1,1025,230,795,22.44,77.56,61,169,63,732,124,901,26.5,7.9,12.1,"75% or more P.O.C.","Less than $55000"
"36005020501","Census Tract 205.01, Bronx County, New York",6976,17601,73,1837,0,55,0,4990,1,26.3,0,0.8,0,71.5,99,2858,56,2802,1.96,98.04,0,56,180,2622,180,2678,0,6.4,6.3,"75% or more P.O.C.","Less than $55000"
"36005020502","Census Tract 205.02, Bronx County, New York",2160,18919,36,571,0,3,0,1544,1.7,26.4,0,0.1,0,71.5,98.3,926,105,821,11.34,88.66,8,97,23,798,31,895,7.6,2.8,3.3,"75% or more P.O.C.","Less than $55000"
"36005020601","Census Tract 206.01, Bronx County, New York",2237,48367,79,170,0,724,0,1176,3.5,7.6,0,32.4,0,52.6,96.5,906,262,644,28.92,71.08,27,235,96,548,123,783,10.3,14.9,13.6,"75% or more P.O.C.","Less than $55000"
"36005020900","Census Tract 209, Bronx County, New York",4287,31190,164,1612,0,11,0,2481,3.8,37.6,0,0.3,0,57.9,96.2,1732,0,1732,0,100,0,0,112,1620,112,1620,NA,6.5,6.5,"75% or more P.O.C.","Less than $55000"
"36005021001","Census Tract 210.01, Bronx County, New York",8930,54076,195,4507,63,786,0,3226,2.2,50.5,0.7,8.8,0,36.1,97.8,3841,809,3032,21.06,78.94,47,762,67,2965,114,3727,5.8,2.2,3,"75% or more P.O.C.","Less than $55000"
"36005021002","Census Tract 210.02, Bronx County, New York",7613,55961,86,3565,0,1582,0,2298,1.1,46.8,0,20.8,0,30.2,98.9,3003,621,2382,20.68,79.32,98,523,93,2289,191,2812,15.8,3.9,6.4,"75% or more P.O.C.","$55000 - $78000"
"36005021100","Census Tract 211, Bronx County, New York",5343,30092,40,1585,0,62,0,3598,0.7,29.7,0,1.2,0,67.3,99.3,1935,103,1832,5.32,94.68,20,83,172,1660,192,1743,19.4,9.4,9.9,"75% or more P.O.C.","Less than $55000"
"36005021200","Census Tract 212, Bronx County, New York",4850,57500,68,2004,25,1136,0,1561,1.4,41.3,0.5,23.4,0,32.2,98.6,2306,381,1925,16.52,83.48,13,368,84,1841,97,2209,3.4,4.4,4.2,"75% or more P.O.C.","$55000 - $78000"
"36005021301","Census Tract 213.01, Bronx County, New York",1267,25509,70,125,0,0,19,1053,5.5,9.9,0,0,1.5,83.1,94.5,469,92,377,19.62,80.38,18,74,23,354,41,428,19.6,6.1,8.7,"75% or more P.O.C.","Less than $55000"
"36005021302","Census Tract 213.02, Bronx County, New York",5513,25512,18,2003,0,44,0,3448,0.3,36.3,0,0.8,0,62.5,99.7,2098,54,2044,2.57,97.43,0,54,365,1679,365,1733,0,17.9,17.4,"75% or more P.O.C.","Less than $55000"
"36005021501","Census Tract 215.01, Bronx County, New York",4565,33750,56,988,0,0,0,3515,1.2,21.6,0,0,0,77,98.8,1390,17,1373,1.22,98.78,10,7,296,1077,306,1084,58.8,21.6,22,"75% or more P.O.C.","Less than $55000"
"36005021502","Census Tract 215.02, Bronx County, New York",6532,25238,19,1520,0,0,0,4901,0.3,23.3,0,0,0,75,99.7,2149,117,2032,5.44,94.56,17,100,236,1796,253,1896,14.5,11.6,11.8,"75% or more P.O.C.","Less than $55000"
"36005021601","Census Tract 216.01, Bronx County, New York",4720,34510,199,1094,0,152,0,2964,4.2,23.2,0,3.2,0,62.8,95.8,1677,283,1394,16.88,83.12,45,238,239,1155,284,1393,15.9,17.1,16.9,"75% or more P.O.C.","Less than $55000"
"36005021602","Census Tract 216.02, Bronx County, New York",5632,55354,213,1890,61,1049,0,2185,3.8,33.6,1.1,18.6,0,38.8,96.2,2443,521,1922,21.33,78.67,26,495,147,1775,173,2270,5,7.6,7.1,"75% or more P.O.C.","$55000 - $78000"
"36005021700","Census Tract 217, Bronx County, New York",5124,36420,101,2397,0,130,0,2450,2,46.8,0,2.5,0,47.8,98,1675,15,1660,0.9,99.1,7,8,143,1517,150,1525,46.7,8.6,9,"75% or more P.O.C.","Less than $55000"
"36005021800","Census Tract 218, Bronx County, New York",6520,47581,143,1316,0,223,0,4756,2.2,20.2,0,3.4,0,72.9,97.8,2329,477,1852,20.48,79.52,48,429,186,1666,234,2095,10.1,10,10,"75% or more P.O.C.","Less than $55000"
"36005021900","Census Tract 219, Bronx County, New York",882,26316,33,39,7,19,0,784,3.7,4.4,0.8,2.2,0,88.9,96.3,366,0,366,0,100,0,0,0,366,0,366,NA,0,0,"75% or more P.O.C.","Less than $55000"
"36005022000","Census Tract 220, Bronx County, New York",2007,35781,30,450,0,106,0,1421,1.5,22.4,0,5.3,0,70.8,98.5,678,26,652,3.83,96.17,6,20,75,577,81,597,23.1,11.5,11.9,"75% or more P.O.C.","Less than $55000"
"36005022101","Census Tract 221.01, Bronx County, New York",4133,32600,11,895,0,235,0,2957,0.3,21.7,0,5.7,0,71.5,99.7,1262,0,1262,0,100,0,0,289,973,289,973,NA,22.9,22.9,"75% or more P.O.C.","Less than $55000"
"36005022102","Census Tract 221.02, Bronx County, New York",5411,32792,55,717,0,33,0,4551,1,13.3,0,0.6,0,84.1,99,1678,53,1625,3.16,96.84,26,27,223,1402,249,1429,49.1,13.7,14.8,"75% or more P.O.C.","Less than $55000"
"36005022200","Census Tract 222, Bronx County, New York",3293,51064,181,352,85,932,0,1592,5.5,10.7,2.6,28.3,0,48.3,94.5,1104,199,905,18.03,81.97,21,178,158,747,179,925,10.6,17.5,16.2,"75% or more P.O.C.","Less than $55000"
"36005022300","Census Tract 223, Bronx County, New York",5278,26761,126,760,43,12,0,4197,2.4,14.4,0.8,0.2,0,79.5,97.6,1846,0,1846,0,100,0,0,207,1639,207,1639,NA,11.2,11.2,"75% or more P.O.C.","Less than $55000"
"36005022401","Census Tract 224.01, Bronx County, New York",2498,55909,200,411,0,134,0,1668,8,16.5,0,5.4,0,66.8,92,1102,111,991,10.07,89.93,0,111,74,917,74,1028,0,7.5,6.7,"75% or more P.O.C.","$55000 - $78000"
"36005022403","Census Tract 224.03, Bronx County, New York",3194,51767,631,754,0,26,0,1723,19.8,23.6,0,0.8,0,53.9,80.2,1279,153,1126,11.96,88.04,18,135,72,1054,90,1189,11.8,6.4,7,"75% or more P.O.C.","Less than $55000"
"36005022404","Census Tract 224.04, Bronx County, New York",4203,53346,746,754,53,234,0,2371,17.7,17.9,1.3,5.6,0,56.4,82.3,1861,400,1461,21.49,78.51,31,369,63,1398,94,1767,7.8,4.3,5.1,"75% or more P.O.C.","Less than $55000"
"36005022500","Census Tract 225, Bronx County, New York",8499,38489,312,1524,0,126,0,6537,3.7,17.9,0,1.5,0,76.9,96.3,2337,110,2227,4.71,95.29,41,69,345,1882,386,1951,37.3,15.5,16.5,"75% or more P.O.C.","Less than $55000"
"36005022701","Census Tract 227.01, Bronx County, New York",5151,34159,78,2062,0,100,0,2872,1.5,40,0,1.9,0,55.8,98.5,1833,44,1789,2.4,97.6,0,44,207,1582,207,1626,0,11.6,11.3,"75% or more P.O.C.","Less than $55000"
"36005022702","Census Tract 227.02, Bronx County, New York",1607,26554,0,263,17,114,0,1161,0,16.4,1.1,7.1,0,72.2,100,568,8,560,1.41,98.59,8,0,53,507,61,507,100,9.5,10.7,"75% or more P.O.C.","Less than $55000"
"36005022703","Census Tract 227.03, Bronx County, New York",1688,60938,74,367,0,88,0,1144,4.4,21.7,0,5.2,0,67.8,95.6,586,13,573,2.22,97.78,0,13,82,491,82,504,0,14.3,14,"75% or more P.O.C.","$55000 - $78000"
"36005022800","Census Tract 228, Bronx County, New York",6128,58431,1088,934,0,818,0,2977,17.8,15.2,0,13.3,0,48.6,82.2,2390,291,2099,12.18,87.82,0,291,159,1940,159,2231,0,7.6,6.7,"75% or more P.O.C.","$55000 - $78000"
"36005022901","Census Tract 229.01, Bronx County, New York",5743,35461,88,1995,24,59,0,3414,1.5,34.7,0.4,1,0,59.4,98.5,2011,98,1913,4.87,95.13,30,68,221,1692,251,1760,30.6,11.6,12.5,"75% or more P.O.C.","Less than $55000"
"36005022902","Census Tract 229.02, Bronx County, New York",3614,34167,32,619,0,53,0,2777,0.9,17.1,0,1.5,0,76.8,99.1,1114,162,952,14.54,85.46,0,162,181,771,181,933,0,19,16.2,"75% or more P.O.C.","Less than $55000"
"36005023000","Census Tract 230, Bronx County, New York",2802,38958,533,499,0,257,0,1448,19,17.8,0,9.2,0,51.7,81,991,207,784,20.89,79.11,49,158,122,662,171,820,23.7,15.6,17.3,"75% or more P.O.C.","Less than $55000"
"36005023100","Census Tract 231, Bronx County, New York",1537,29263,40,549,0,0,0,948,2.6,35.7,0,0,0,61.7,97.4,443,19,424,4.29,95.71,4,15,61,363,65,378,21.1,14.4,14.7,"75% or more P.O.C.","Less than $55000"
"36005023200","Census Tract 232, Bronx County, New York",2476,56528,704,315,16,139,0,1238,28.4,12.7,0.6,5.6,0,50,71.6,814,363,451,44.59,55.41,67,296,95,356,162,652,18.5,21.1,19.9,"50% - 75% P.O.C.","$55000 - $78000"
"36005023301","Census Tract 233.01, Bronx County, New York",3956,30861,0,1292,0,81,0,2500,0,32.7,0,2,0,63.2,100,1584,104,1480,6.57,93.43,0,104,136,1344,136,1448,0,9.2,8.6,"75% or more P.O.C.","Less than $55000"
"36005023302","Census Tract 233.02, Bronx County, New York",3706,42500,47,515,0,65,0,3079,1.3,13.9,0,1.8,0,83.1,98.7,1006,4,1002,0.4,99.6,0,4,333,669,333,673,0,33.2,33.1,"75% or more P.O.C.","Less than $55000"
"36005023501","Census Tract 235.01, Bronx County, New York",3184,34591,21,169,0,22,0,2943,0.7,5.3,0,0.7,0,92.4,99.3,1127,0,1127,0,100,0,0,146,981,146,981,NA,13,13,"75% or more P.O.C.","Less than $55000"
"36005023502","Census Tract 235.02, Bronx County, New York",4153,29342,17,794,0,43,0,3299,0.4,19.1,0,1,0,79.4,99.6,1674,67,1607,4,96,0,67,140,1467,140,1534,0,8.7,8.4,"75% or more P.O.C.","Less than $55000"
"36005023600","Census Tract 236, Bronx County, New York",1816,38021,564,314,0,197,0,740,31.1,17.3,0,10.8,0,40.7,68.9,585,121,464,20.68,79.32,55,66,44,420,99,486,45.5,9.5,16.9,"50% - 75% P.O.C.","Less than $55000"
"36005023702","Census Tract 237.02, Bronx County, New York",1180,37734,11,214,0,0,0,952,0.9,18.1,0,0,0,80.7,99.1,347,2,345,0.58,99.42,0,2,69,276,69,278,0,20,19.9,"75% or more P.O.C.","Less than $55000"
"36005023703","Census Tract 237.03, Bronx County, New York",5574,30109,71,955,0,20,0,4495,1.3,17.1,0,0.4,0,80.6,98.7,1608,10,1598,0.62,99.38,0,10,330,1268,330,1278,0,20.7,20.5,"75% or more P.O.C.","Less than $55000"
"36005023704","Census Tract 237.04, Bronx County, New York",3803,20679,14,675,0,0,0,3071,0.4,17.7,0,0,0,80.8,99.6,1320,15,1305,1.14,98.86,0,15,174,1131,174,1146,0,13.3,13.2,"75% or more P.O.C.","Less than $55000"
"36005023800","Census Tract 238, Bronx County, New York",2241,52599,409,380,0,174,0,1206,18.3,17,0,7.8,0,53.8,81.7,801,277,524,34.58,65.42,36,241,76,448,112,689,13,14.5,14,"75% or more P.O.C.","Less than $55000"
"36005023900","Census Tract 239, Bronx County, New York",7873,27615,0,1968,0,87,0,5535,0,25,0,1.1,0,70.3,100,2572,55,2517,2.14,97.86,33,22,339,2178,372,2200,60,13.5,14.5,"75% or more P.O.C.","Less than $55000"
"36005024000","Census Tract 240, Bronx County, New York",3903,39688,409,688,0,82,0,2652,10.5,17.6,0,2.1,0,67.9,89.5,1222,427,795,34.94,65.06,112,315,101,694,213,1009,26.2,12.7,17.4,"75% or more P.O.C.","Less than $55000"
"36005024100","Census Tract 241, Bronx County, New York",6621,41322,305,2030,0,184,0,4068,4.6,30.7,0,2.8,0,61.4,95.4,2012,76,1936,3.78,96.22,33,43,312,1624,345,1667,43.4,16.1,17.1,"75% or more P.O.C.","Less than $55000"
"36005024300","Census Tract 243, Bronx County, New York",5737,25088,74,1055,0,59,0,4487,1.3,18.4,0,1,0,78.2,98.7,2029,53,1976,2.61,97.39,0,53,216,1760,216,1813,0,10.9,10.6,"75% or more P.O.C.","Less than $55000"
"36005024400","Census Tract 244, Bronx County, New York",2146,60709,748,82,8,62,0,1197,34.9,3.8,0.4,2.9,0,55.8,65.1,809,322,487,39.8,60.2,84,238,23,464,107,702,26.1,4.7,13.2,"50% - 75% P.O.C.","$55000 - $78000"
"36005024501","Census Tract 245.01, Bronx County, New York",4871,24146,68,779,0,40,0,3935,1.4,16,0,0.8,0,80.8,98.6,1510,44,1466,2.91,97.09,0,44,260,1206,260,1250,0,17.7,17.2,"75% or more P.O.C.","Less than $55000"
"36005024502","Census Tract 245.02, Bronx County, New York",3677,29835,28,791,0,0,0,2858,0.8,21.5,0,0,0,77.7,99.2,1191,19,1172,1.6,98.4,0,19,154,1018,154,1037,0,13.1,12.9,"75% or more P.O.C.","Less than $55000"
"36005024600","Census Tract 246, Bronx County, New York",2011,65473,855,97,0,356,0,703,42.5,4.8,0,17.7,0,35,57.5,728,317,411,43.54,56.46,13,304,62,349,75,653,4.1,15.1,10.3,"50% - 75% P.O.C.","$55000 - $78000"
"36005024700","Census Tract 247, Bronx County, New York",2058,49107,28,890,0,6,0,1125,1.4,43.2,0,0.3,0,54.7,98.6,781,33,748,4.23,95.77,0,33,44,704,44,737,0,5.9,5.6,"75% or more P.O.C.","Less than $55000"
"36005024800","Census Tract 248, Bronx County, New York",3078,69786,1485,355,16,302,0,903,48.2,11.5,0.5,9.8,0,29.3,51.8,1126,280,846,24.87,75.13,71,209,44,802,115,1011,25.4,5.2,10.2,"50% - 75% P.O.C.","$55000 - $78000"
"36005024900","Census Tract 249, Bronx County, New York",0,NA,0,0,0,0,0,0,NA,NA,NA,NA,NA,NA,NA,0,0,0,NA,NA,0,0,0,0,0,0,NA,NA,NA,"N/A","N/A"
"36005025000","Census Tract 250, Bronx County, New York",2591,85868,1270,2,32,490,0,797,49,0.1,1.2,18.9,0,30.8,51,957,473,484,49.43,50.57,64,409,75,409,139,818,13.5,15.5,14.5,"50% - 75% P.O.C.","$78000 - $104000"
"36005025100","Census Tract 251, Bronx County, New York",7360,36830,64,1440,0,545,0,5276,0.9,19.6,0,7.4,0,71.7,99.1,2172,296,1876,13.63,86.37,82,214,508,1368,590,1582,27.7,27.1,27.2,"75% or more P.O.C.","Less than $55000"
"36005025200","Census Tract 252, Bronx County, New York",2787,77500,1103,112,0,294,0,1208,39.6,4,0,10.5,0,43.3,60.4,936,400,536,42.74,57.26,67,333,52,484,119,817,16.8,9.7,12.7,"50% - 75% P.O.C.","$55000 - $78000"
"36005025300","Census Tract 253, Bronx County, New York",6199,36481,24,830,0,213,0,4932,0.4,13.4,0,3.4,0,79.6,99.6,1984,101,1883,5.09,94.91,10,91,286,1597,296,1688,9.9,15.2,14.9,"75% or more P.O.C.","Less than $55000"
"36005025400","Census Tract 254, Bronx County, New York",1997,52853,1192,63,0,216,0,508,59.7,3.2,0,10.8,0,25.4,40.3,755,368,387,48.74,51.26,62,306,39,348,101,654,16.8,10.1,13.4,"25% - 50% P.O.C.","Less than $55000"
"36005025500","Census Tract 255, Bronx County, New York",7674,35466,233,608,26,0,0,6600,3,7.9,0.3,0,0,86,97,2296,117,2179,5.1,94.9,25,92,287,1892,312,1984,21.4,13.2,13.6,"75% or more P.O.C.","Less than $55000"
"36005025600","Census Tract 256, Bronx County, New York",1696,52700,264,122,0,161,0,1113,15.6,7.2,0,9.5,0,65.6,84.4,610,193,417,31.64,68.36,44,149,54,363,98,512,22.8,12.9,16.1,"75% or more P.O.C.","Less than $55000"
"36005025700","Census Tract 257, Bronx County, New York",1999,52926,36,285,0,4,0,1642,1.8,14.3,0,0.2,0,82.1,98.2,695,46,649,6.62,93.38,29,17,64,585,93,602,63,9.9,13.4,"75% or more P.O.C.","Less than $55000"
"36005026100","Census Tract 261, Bronx County, New York",2097,76272,99,967,0,70,0,908,4.7,46.1,0,3.3,0,43.3,95.3,1055,847,208,80.28,19.72,6,841,0,208,6,1049,0.7,0,0.6,"75% or more P.O.C.","$55000 - $78000"
"36005026300","Census Tract 263, Bronx County, New York",6218,19629,544,1189,109,0,0,4319,8.7,19.1,1.8,0,0,69.5,91.3,2291,107,2184,4.67,95.33,14,93,254,1930,268,2023,13.1,11.6,11.7,"75% or more P.O.C.","Less than $55000"
"36005026400","Census Tract 264, Bronx County, New York",4868,48832,1614,248,0,419,0,2514,33.2,5.1,0,8.6,0,51.6,66.8,1873,1015,858,54.19,45.81,75,940,23,835,98,1775,7.4,2.7,5.2,"50% - 75% P.O.C.","Less than $55000"
"36005026500","Census Tract 265, Bronx County, New York",7851,41187,244,608,0,242,0,6492,3.1,7.7,0,3.1,0,82.7,96.9,2151,55,2096,2.56,97.44,0,55,594,1502,594,1557,0,28.3,27.6,"75% or more P.O.C.","Less than $55000"
"36005026601","Census Tract 266.01, Bronx County, New York",3452,60357,883,198,0,91,0,2198,25.6,5.7,0,2.6,0,63.7,74.4,1440,328,1112,22.78,77.22,9,319,73,1039,82,1358,2.7,6.6,5.7,"50% - 75% P.O.C.","$55000 - $78000"
"36005026602","Census Tract 266.02, Bronx County, New York",5084,64143,1771,486,0,74,0,2685,34.8,9.6,0,1.5,0,52.8,65.2,2440,549,1891,22.5,77.5,52,497,27,1864,79,2361,9.5,1.4,3.2,"50% - 75% P.O.C.","$55000 - $78000"
"36005026701","Census Tract 267.01, Bronx County, New York",4185,47656,117,485,0,511,0,3072,2.8,11.6,0,12.2,0,73.4,97.2,1295,32,1263,2.47,97.53,23,9,301,962,324,971,71.9,23.8,25,"75% or more P.O.C.","Less than $55000"
"36005026702","Census Tract 267.02, Bronx County, New York",7895,35557,236,971,0,0,0,6562,3,12.3,0,0,0,83.1,97,2607,111,2496,4.26,95.74,35,76,366,2130,401,2206,31.5,14.7,15.4,"75% or more P.O.C.","Less than $55000"
"36005026900","Census Tract 269, Bronx County, New York",3703,39167,7,541,0,50,0,3002,0.2,14.6,0,1.4,0,81.1,99.8,1362,171,1191,12.56,87.44,14,157,121,1070,135,1227,8.2,10.2,9.9,"75% or more P.O.C.","Less than $55000"
"36005027300","Census Tract 273, Bronx County, New York",7778,44154,446,1511,0,42,0,5577,5.7,19.4,0,0.5,0,71.7,94.3,2627,345,2282,13.13,86.87,47,298,146,2136,193,2434,13.6,6.4,7.3,"75% or more P.O.C.","Less than $55000"
"36005027401","Census Tract 274.01, Bronx County, New York",4693,87500,3267,88,0,88,0,1250,69.6,1.9,0,1.9,0,26.6,30.4,1720,1281,439,74.48,25.52,123,1158,0,439,123,1597,9.6,0,7.2,"25% - 50% P.O.C.","$78000 - $104000"
"36005027402","Census Tract 274.02, Bronx County, New York",3481,88654,2277,101,0,48,0,958,65.4,2.9,0,1.4,0,27.5,34.6,1278,699,579,54.69,45.31,54,645,8,571,62,1216,7.7,1.4,4.9,"25% - 50% P.O.C.","$78000 - $104000"
"36005027600","Census Tract 276, Bronx County, New York",24,NA,0,20,0,0,0,4,0,83.3,0,0,0,16.7,100,8,0,8,0,100,0,0,0,8,0,8,NA,0,0,"75% or more P.O.C.","N/A"
"36005027700","Census Tract 277, Bronx County, New York",4660,29621,540,558,79,107,0,3270,11.6,12,1.7,2.3,0,70.2,88.4,1779,109,1670,6.13,93.87,22,87,224,1446,246,1533,20.2,13.4,13.8,"75% or more P.O.C.","Less than $55000"
"36005027900","Census Tract 279, Bronx County, New York",7379,56033,1080,794,0,326,0,5023,14.6,10.8,0,4.4,0,68.1,85.4,2809,816,1993,29.05,70.95,28,788,283,1710,311,2498,3.4,14.2,11.1,"75% or more P.O.C.","$55000 - $78000"
"36005028100","Census Tract 281, Bronx County, New York",3954,67933,1215,753,0,142,43,1760,30.7,19,0,3.6,1.1,44.5,69.3,1671,862,809,51.59,48.41,37,825,19,790,56,1615,4.3,2.3,3.4,"50% - 75% P.O.C.","$55000 - $78000"
"36005028300","Census Tract 283, Bronx County, New York",2489,26887,297,719,0,0,0,1437,11.9,28.9,0,0,0,57.7,88.1,1091,72,1019,6.6,93.4,0,72,56,963,56,1035,0,5.5,5.1,"75% or more P.O.C.","Less than $55000"
"36005028400","Census Tract 284, Bronx County, New York",554,NA,319,112,0,0,0,123,57.6,20.2,0,0,0,22.2,42.4,5,0,5,0,100,0,0,5,0,5,0,NA,100,100,"25% - 50% P.O.C.","N/A"
"36005028500","Census Tract 285, Bronx County, New York",3523,58467,1613,105,0,582,0,1162,45.8,3,0,16.5,0,33,54.2,1617,294,1323,18.18,81.82,25,269,16,1307,41,1576,8.5,1.2,2.5,"50% - 75% P.O.C.","$55000 - $78000"
"36005028600","Census Tract 286, Bronx County, New York",1085,85625,484,39,0,259,0,244,44.6,3.6,0,23.9,0,22.5,55.4,446,237,209,53.14,46.86,26,211,6,203,32,414,11,2.9,7.2,"50% - 75% P.O.C.","$78000 - $104000"
"36005028700","Census Tract 287, Bronx County, New York",3153,56518,764,272,17,183,0,1904,24.2,8.6,0.5,5.8,0,60.4,75.8,1233,296,937,24.01,75.99,76,220,101,836,177,1056,25.7,10.8,14.4,"75% or more P.O.C.","$55000 - $78000"
"36005028800","Census Tract 288, Bronx County, New York",3330,74459,1703,288,0,547,0,792,51.1,8.6,0,16.4,0,23.8,48.9,1141,643,498,56.35,43.65,103,540,0,498,103,1038,16,0,9,"25% - 50% P.O.C.","$55000 - $78000"
"36005028900","Census Tract 289, Bronx County, New York",4807,52754,815,260,0,197,0,3283,17,5.4,0,4.1,0,68.3,83,1903,229,1674,12.03,87.97,23,206,159,1515,182,1721,10,9.5,9.6,"75% or more P.O.C.","Less than $55000"
"36005029301","Census Tract 293.01, Bronx County, New York",1806,103125,1222,129,0,89,0,260,67.7,7.1,0,4.9,0,14.4,32.3,882,743,139,84.24,15.76,13,730,0,139,13,869,1.7,0,1.5,"25% - 50% P.O.C.","$78000 - $104000"
"36005029302","Census Tract 293.02, Bronx County, New York",5569,95239,3388,438,0,140,0,1478,60.8,7.9,0,2.5,0,26.5,39.2,2615,1510,1105,57.74,42.26,45,1465,29,1076,74,2541,3,2.6,2.8,"25% - 50% P.O.C.","$78000 - $104000"
"36005029500","Census Tract 295, Bronx County, New York",4564,95833,2629,572,0,312,0,825,57.6,12.5,0,6.8,0,18.1,42.4,1996,969,1027,48.55,51.45,35,934,90,937,125,1871,3.6,8.8,6.3,"25% - 50% P.O.C.","$78000 - $104000"
"36005029600","Census Tract 296, Bronx County, New York",1575,54250,365,246,0,336,0,628,23.2,15.6,0,21.3,0,39.9,76.8,686,140,546,20.41,79.59,22,118,6,540,28,658,15.7,1.1,4.1,"75% or more P.O.C.","Less than $55000"
"36005029700","Census Tract 297, Bronx County, New York",3799,91210,2491,166,0,215,0,858,65.6,4.4,0,5.7,0,22.6,34.4,1638,955,683,58.3,41.7,43,912,8,675,51,1587,4.5,1.2,3.1,"25% - 50% P.O.C.","$78000 - $104000"
"36005030000","Census Tract 300, Bronx County, New York",6021,59899,1907,613,0,422,0,2979,31.7,10.2,0,7,0,49.5,68.3,2554,755,1799,29.56,70.44,90,665,180,1619,270,2284,11.9,10,10.6,"50% - 75% P.O.C.","$55000 - $78000"
"36005030100","Census Tract 301, Bronx County, New York",1413,84375,700,102,0,46,0,505,49.5,7.2,0,3.3,0,35.7,50.5,569,321,248,56.41,43.59,7,314,12,236,19,550,2.2,4.8,3.3,"50% - 75% P.O.C.","$78000 - $104000"
"36005030200","Census Tract 302, Bronx County, New York",8704,54087,442,6011,0,51,0,1899,5.1,69.1,0,0.6,0,21.8,94.9,4103,2060,2043,50.21,49.79,32,2028,72,1971,104,3999,1.6,3.5,2.5,"75% or more P.O.C.","Less than $55000"
"36005030701","Census Tract 307.01, Bronx County, New York",5726,121389,4104,601,0,204,0,605,71.7,10.5,0,3.6,0,10.6,28.3,2542,1072,1470,42.17,57.83,0,1072,33,1437,33,2509,0,2.2,1.3,"25% - 50% P.O.C.","$104000 or more"
"36005030900","Census Tract 309, Bronx County, New York",3709,107768,2534,165,17,153,0,773,68.3,4.4,0.5,4.1,0,20.8,31.7,1289,698,591,54.15,45.85,39,659,37,554,76,1213,5.6,6.3,5.9,"25% - 50% P.O.C.","$104000 or more"
"36005031000","Census Tract 310, Bronx County, New York",4753,87336,1368,1110,0,576,0,1656,28.8,23.4,0,12.1,0,34.8,71.2,1217,858,359,70.5,29.5,164,694,32,327,196,1021,19.1,8.9,16.1,"50% - 75% P.O.C.","$78000 - $104000"
"36005031200","Census Tract 312, Bronx County, New York",1678,98250,563,469,0,242,0,355,33.6,27.9,0,14.4,0,21.2,66.4,597,362,235,60.64,39.36,101,261,0,235,101,496,27.9,0,16.9,"50% - 75% P.O.C.","$78000 - $104000"
"36005031400","Census Tract 314, Bronx County, New York",2079,92396,738,261,0,139,0,901,35.5,12.6,0,6.7,0,43.3,64.5,617,442,175,71.64,28.36,67,375,13,162,80,537,15.2,7.4,13,"50% - 75% P.O.C.","$78000 - $104000"
"36005031600","Census Tract 316, Bronx County, New York",1900,86048,678,112,0,313,0,551,35.7,5.9,0,16.5,0,29,64.3,610,348,262,57.05,42.95,77,271,8,254,85,525,22.1,3.1,13.9,"50% - 75% P.O.C.","$78000 - $104000"
"36005031800","Census Tract 318, Bronx County, New York",2179,86429,630,580,0,178,0,791,28.9,26.6,0,8.2,0,36.3,71.1,578,381,197,65.92,34.08,90,291,28,169,118,460,23.6,14.2,20.4,"50% - 75% P.O.C.","$78000 - $104000"
"36005031900","Census Tract 319, Bronx County, New York",633,NA,320,93,0,38,0,171,50.6,14.7,0,6,0,27,49.4,0,0,0,NA,NA,0,0,0,0,0,0,NA,NA,NA,"25% - 50% P.O.C.","N/A"
"36005032300","Census Tract 323, Bronx County, New York",4575,85448,2809,425,0,302,0,739,61.4,9.3,0,6.6,0,16.2,38.6,2502,1447,1055,57.83,42.17,31,1416,14,1041,45,2457,2.1,1.3,1.8,"25% - 50% P.O.C.","$78000 - $104000"
"36005032400","Census Tract 324, Bronx County, New York",3177,19349,362,822,0,207,0,1662,11.4,25.9,0,6.5,0,52.3,88.6,1137,150,987,13.19,86.81,82,68,71,916,153,984,54.7,7.2,13.5,"75% or more P.O.C.","Less than $55000"
"36005032600","Census Tract 326, Bronx County, New York",3407,90656,1309,510,4,672,0,861,38.4,15,0.1,19.7,0,25.3,61.6,1037,531,506,51.21,48.79,104,427,65,441,169,868,19.6,12.8,16.3,"50% - 75% P.O.C.","$78000 - $104000"
"36005032800","Census Tract 328, Bronx County, New York",3839,29219,516,389,0,398,0,2478,13.4,10.1,0,10.4,0,64.5,86.6,1422,189,1233,13.29,86.71,50,139,74,1159,124,1298,26.5,6,8.7,"75% or more P.O.C.","Less than $55000"
"36005033000","Census Tract 330, Bronx County, New York",5776,39836,2506,963,0,0,0,2113,43.4,16.7,0,0,0,36.6,56.6,2204,190,2014,8.62,91.38,38,152,209,1805,247,1957,20,10.4,11.2,"50% - 75% P.O.C.","Less than $55000"
"36005033201","Census Tract 332.01, Bronx County, New York",5564,47529,837,609,0,35,0,3986,15,10.9,0,0.6,0,71.6,85,2245,489,1756,21.78,78.22,28,461,146,1610,174,2071,5.7,8.3,7.8,"75% or more P.O.C.","Less than $55000"
"36005033202","Census Tract 332.02, Bronx County, New York",4033,41969,507,1016,39,6,0,2374,12.6,25.2,1,0.1,0,58.9,87.4,1633,363,1270,22.23,77.77,35,328,60,1210,95,1538,9.6,4.7,5.8,"75% or more P.O.C.","Less than $55000"
"36005033400","Census Tract 334, Bronx County, New York",15,NA,0,10,0,0,0,5,0,66.7,0,0,0,33.3,100,5,5,0,100,0,0,5,0,0,0,5,0,NA,0,"75% or more P.O.C.","N/A"
"36005033500","Census Tract 335, Bronx County, New York",2048,96250,1416,128,0,104,0,346,69.1,6.2,0,5.1,0,16.9,30.9,672,397,275,59.08,40.92,36,361,9,266,45,627,9.1,3.3,6.7,"25% - 50% P.O.C.","$78000 - $104000"
"36005033600","Census Tract 336, Bronx County, New York",6714,38387,215,2646,0,216,0,3627,3.2,39.4,0,3.2,0,54,96.8,2634,459,2175,17.43,82.57,81,378,194,1981,275,2359,17.6,8.9,10.4,"75% or more P.O.C.","Less than $55000"
"36005033700","Census Tract 337, Bronx County, New York",2521,97847,1550,122,0,185,0,595,61.5,4.8,0,7.3,0,23.6,38.5,883,557,326,63.08,36.92,57,500,27,299,84,799,10.2,8.3,9.5,"25% - 50% P.O.C.","$78000 - $104000"
"36005033800","Census Tract 338, Bronx County, New York",4105,51204,234,1932,0,325,0,1567,5.7,47.1,0,7.9,0,38.2,94.3,1376,234,1142,17.01,82.99,92,142,128,1014,220,1156,39.3,11.2,16,"75% or more P.O.C.","Less than $55000"
"36005034000","Census Tract 340, Bronx County, New York",5606,52772,305,2141,47,197,0,2726,5.4,38.2,0.8,3.5,0,48.6,94.6,1778,363,1415,20.42,79.58,73,290,309,1106,382,1396,20.1,21.8,21.5,"75% or more P.O.C.","Less than $55000"
"36005034200","Census Tract 342, Bronx County, New York",1888,60893,163,862,0,79,0,689,8.6,45.7,0,4.2,0,36.5,91.4,581,349,232,60.07,39.93,55,294,27,205,82,499,15.8,11.6,14.1,"75% or more P.O.C.","$55000 - $78000"
"36005034300","Census Tract 343, Bronx County, New York",1665,78869,613,319,0,25,0,674,36.8,19.2,0,1.5,0,40.5,63.2,586,194,392,33.11,66.89,6,188,25,367,31,555,3.1,6.4,5.3,"50% - 75% P.O.C.","$78000 - $104000"
"36005034400","Census Tract 344, Bronx County, New York",2172,63017,62,724,0,148,0,1182,2.9,33.3,0,6.8,0,54.4,97.1,656,423,233,64.48,35.52,69,354,35,198,104,552,16.3,15,15.9,"75% or more P.O.C.","$55000 - $78000"
"36005034500","Census Tract 345, Bronx County, New York",3540,74013,1666,295,0,143,0,1349,47.1,8.3,0,4,0,38.1,52.9,1435,600,835,41.81,58.19,29,571,36,799,65,1370,4.8,4.3,4.5,"50% - 75% P.O.C.","$55000 - $78000"
"36005034800","Census Tract 348, Bronx County, New York",5707,42813,153,2998,0,124,0,2342,2.7,52.5,0,2.2,0,41,97.3,2059,733,1326,35.6,64.4,69,664,156,1170,225,1834,9.4,11.8,10.9,"75% or more P.O.C.","Less than $55000"
"36005035000","Census Tract 350, Bronx County, New York",2063,74583,117,1195,0,131,0,577,5.7,57.9,0,6.3,0,28,94.3,662,405,257,61.18,38.82,34,371,15,242,49,613,8.4,5.8,7.4,"75% or more P.O.C.","$55000 - $78000"
"36005035100","Census Tract 351, Bronx County, New York",3740,93750,2031,248,0,173,0,1196,54.3,6.6,0,4.6,0,32,45.7,1212,615,597,50.74,49.26,67,548,10,587,77,1135,10.9,1.7,6.4,"25% - 50% P.O.C.","$78000 - $104000"
"36005035600","Census Tract 356, Bronx County, New York",2254,73194,33,1686,0,160,0,320,1.5,74.8,0,7.1,0,14.2,98.5,702,485,217,69.09,30.91,81,404,0,217,81,621,16.7,0,11.5,"75% or more P.O.C.","$55000 - $78000"
"36005035800","Census Tract 358, Bronx County, New York",8172,69766,406,5604,0,131,0,1967,5,68.6,0,1.6,0,24.1,95,2484,1550,934,62.4,37.6,255,1295,163,771,418,2066,16.5,17.5,16.8,"75% or more P.O.C.","$55000 - $78000"
"36005035900","Census Tract 359, Bronx County, New York",2053,23750,11,408,0,52,0,1582,0.5,19.9,0,2.5,0,77.1,99.5,746,39,707,5.23,94.77,10,29,72,635,82,664,25.6,10.2,11,"75% or more P.O.C.","Less than $55000"
"36005036000","Census Tract 360, Bronx County, New York",3271,83043,388,1448,27,340,0,1038,11.9,44.3,0.8,10.4,0,31.7,88.1,944,697,247,73.83,26.17,116,581,56,191,172,772,16.6,22.7,18.2,"75% or more P.O.C.","$78000 - $104000"
"36005036100","Census Tract 361, Bronx County, New York",5576,21947,25,1466,0,3,0,4082,0.4,26.3,0,0.1,0,73.2,99.6,2160,32,2128,1.48,98.52,0,32,138,1990,138,2022,0,6.5,6.4,"75% or more P.O.C.","Less than $55000"
"36005036300","Census Tract 363, Bronx County, New York",7517,22226,223,1635,0,0,96,5518,3,21.8,0,0,1.3,73.4,97,2534,178,2356,7.02,92.98,21,157,219,2137,240,2294,11.8,9.3,9.5,"75% or more P.O.C.","Less than $55000"
"36005036400","Census Tract 364, Bronx County, New York",2565,69750,1,2302,0,0,0,220,0,89.7,0,0,0,8.6,100,844,533,311,63.15,36.85,97,436,35,276,132,712,18.2,11.3,15.6,"75% or more P.O.C.","$55000 - $78000"
"36005036501","Census Tract 365.01, Bronx County, New York",3901,27304,12,1750,0,0,0,2120,0.3,44.9,0,0,0,54.3,99.7,1391,123,1268,8.84,91.16,56,67,130,1138,186,1205,45.5,10.3,13.4,"75% or more P.O.C.","Less than $55000"
"36005036502","Census Tract 365.02, Bronx County, New York",2620,31588,34,701,4,0,0,1867,1.3,26.8,0.2,0,0,71.3,98.7,775,46,729,5.94,94.06,25,21,123,606,148,627,54.3,16.9,19.1,"75% or more P.O.C.","Less than $55000"
"36005036700","Census Tract 367, Bronx County, New York",2395,34500,45,700,0,66,0,1581,1.9,29.2,0,2.8,0,66,98.1,606,179,427,29.54,70.46,48,131,73,354,121,485,26.8,17.1,20,"75% or more P.O.C.","Less than $55000"
"36005036800","Census Tract 368, Bronx County, New York",2109,50919,57,1523,0,0,0,460,2.7,72.2,0,0,0,21.8,97.3,607,280,327,46.13,53.87,59,221,48,279,107,500,21.1,14.7,17.6,"75% or more P.O.C.","Less than $55000"
"36005036901","Census Tract 369.01, Bronx County, New York",2101,22273,3,492,0,0,0,1606,0.1,23.4,0,0,0,76.4,99.9,798,0,798,0,100,0,0,79,719,79,719,NA,9.9,9.9,"75% or more P.O.C.","Less than $55000"
"36005036902","Census Tract 369.02, Bronx County, New York",2074,16293,36,766,0,0,0,1272,1.7,36.9,0,0,0,61.3,98.3,798,36,762,4.51,95.49,0,36,66,696,66,732,0,8.7,8.3,"75% or more P.O.C.","Less than $55000"
"36005037000","Census Tract 370, Bronx County, New York",2416,58636,38,1734,0,156,0,450,1.6,71.8,0,6.5,0,18.6,98.4,758,497,261,65.57,34.43,51,446,59,202,110,648,10.3,22.6,14.5,"75% or more P.O.C.","$55000 - $78000"
"36005037100","Census Tract 371, Bronx County, New York",4226,22685,54,866,0,17,0,3175,1.3,20.5,0,0.4,0,75.1,98.7,1784,97,1687,5.44,94.56,13,84,173,1514,186,1598,13.4,10.3,10.4,"75% or more P.O.C.","Less than $55000"
"36005037200","Census Tract 372, Bronx County, New York",2132,41346,18,948,87,51,0,926,0.8,44.5,4.1,2.4,0,43.4,99.2,770,189,581,24.55,75.45,56,133,60,521,116,654,29.6,10.3,15.1,"75% or more P.O.C.","Less than $55000"
"36005037300","Census Tract 373, Bronx County, New York",6373,28900,52,2503,1,0,0,3809,0.8,39.3,0,0,0,59.8,99.2,1974,280,1694,14.18,85.82,69,211,388,1306,457,1517,24.6,22.9,23.2,"75% or more P.O.C.","Less than $55000"
"36005037400","Census Tract 374, Bronx County, New York",3861,27695,74,1732,0,32,0,1933,1.9,44.9,0,0.8,0,50.1,98.1,1561,130,1431,8.33,91.67,26,104,152,1279,178,1383,20,10.6,11.4,"75% or more P.O.C.","Less than $55000"
"36005037504","Census Tract 375.04, Bronx County, New York",3323,20644,91,935,0,0,0,2297,2.7,28.1,0,0,0,69.1,97.3,1258,22,1236,1.75,98.25,10,12,69,1167,79,1179,45.5,5.6,6.3,"75% or more P.O.C.","Less than $55000"
"36005037600","Census Tract 376, Bronx County, New York",2197,49237,217,767,52,45,0,1092,9.9,34.9,2.4,2,0,49.7,90.1,776,275,501,35.44,64.56,22,253,71,430,93,683,8,14.2,12,"75% or more P.O.C.","Less than $55000"
"36005037800","Census Tract 378, Bronx County, New York",2900,41333,30,1836,0,19,0,1015,1,63.3,0,0.7,0,35,99,1110,151,959,13.6,86.4,58,93,25,934,83,1027,38.4,2.6,7.5,"75% or more P.O.C.","Less than $55000"
"36005037900","Census Tract 379, Bronx County, New York",5469,24183,16,2443,0,115,0,2760,0.3,44.7,0,2.1,0,50.5,99.7,1547,61,1486,3.94,96.06,0,61,281,1205,281,1266,0,18.9,18.2,"75% or more P.O.C.","Less than $55000"
"36005038000","Census Tract 380, Bronx County, New York",5239,37544,208,3197,0,67,0,1641,4,61,0,1.3,0,31.3,96,1944,683,1261,35.13,64.87,76,607,124,1137,200,1744,11.1,9.8,10.3,"75% or more P.O.C.","Less than $55000"
"36005038100","Census Tract 381, Bronx County, New York",7647,38905,26,1536,0,20,0,5852,0.3,20.1,0,0.3,0,76.5,99.7,2356,153,2203,6.49,93.51,26,127,285,1918,311,2045,17,12.9,13.2,"75% or more P.O.C.","Less than $55000"
"36005038200","Census Tract 382, Bronx County, New York",3100,46806,49,1880,0,113,0,1038,1.6,60.6,0,3.6,0,33.5,98.4,945,409,536,43.28,56.72,96,313,129,407,225,720,23.5,24.1,23.8,"75% or more P.O.C.","Less than $55000"
"36005038301","Census Tract 383.01, Bronx County, New York",5084,43155,71,1061,0,76,0,3848,1.4,20.9,0,1.5,0,75.7,98.6,1520,23,1497,1.51,98.49,0,23,337,1160,337,1183,0,22.5,22.2,"75% or more P.O.C.","Less than $55000"
"36005038302","Census Tract 383.02, Bronx County, New York",6032,20519,33,2205,52,0,0,3572,0.5,36.6,0.9,0,0,59.2,99.5,2018,34,1984,1.68,98.32,10,24,385,1599,395,1623,29.4,19.4,19.6,"75% or more P.O.C.","Less than $55000"
"36005038500","Census Tract 385, Bronx County, New York",4766,26509,28,1354,0,0,0,3368,0.6,28.4,0,0,0,70.7,99.4,1676,42,1634,2.51,97.49,0,42,202,1432,202,1474,0,12.4,12.1,"75% or more P.O.C.","Less than $55000"
"36005038600","Census Tract 386, Bronx County, New York",8889,51798,3,6177,0,636,0,1930,0,69.5,0,7.2,0,21.7,100,2771,719,2052,25.95,74.05,179,540,238,1814,417,2354,24.9,11.6,15,"75% or more P.O.C.","Less than $55000"
"36005038700","Census Tract 387, Bronx County, New York",3823,35970,581,748,0,26,0,2449,15.2,19.6,0,0.7,0,64.1,84.8,1256,57,1199,4.54,95.46,0,57,172,1027,172,1084,0,14.3,13.7,"75% or more P.O.C.","Less than $55000"
"36005038800","Census Tract 388, Bronx County, New York",2763,63017,49,2002,0,60,0,648,1.8,72.5,0,2.2,0,23.5,98.2,878,494,384,56.26,43.74,93,401,45,339,138,740,18.8,11.7,15.7,"75% or more P.O.C.","$55000 - $78000"
"36005038900","Census Tract 389, Bronx County, New York",5521,37028,1282,405,0,220,0,3565,23.2,7.3,0,4,0,64.6,76.8,1705,66,1639,3.87,96.13,10,56,255,1384,265,1440,15.2,15.6,15.5,"75% or more P.O.C.","Less than $55000"
"36005039000","Census Tract 390, Bronx County, New York",2861,45738,69,1959,0,96,0,670,2.4,68.5,0,3.4,0,23.4,97.6,1026,191,835,18.62,81.38,63,128,82,753,145,881,33,9.8,14.1,"75% or more P.O.C.","Less than $55000"
"36005039100","Census Tract 391, Bronx County, New York",7544,31985,537,1060,0,272,0,5521,7.1,14.1,0,3.6,0,73.2,92.9,2437,176,2261,7.22,92.78,37,139,418,1843,455,1982,21,18.5,18.7,"75% or more P.O.C.","Less than $55000"
"36005039200","Census Tract 392, Bronx County, New York",1602,50723,20,1121,0,0,0,461,1.2,70,0,0,0,28.8,98.8,636,131,505,20.6,79.4,23,108,21,484,44,592,17.6,4.2,6.9,"75% or more P.O.C.","Less than $55000"
"36005039300","Census Tract 393, Bronx County, New York",8330,19808,301,2661,0,33,0,5206,3.6,31.9,0,0.4,0,62.5,96.4,3232,149,3083,4.61,95.39,58,91,242,2841,300,2932,38.9,7.8,9.3,"75% or more P.O.C.","Less than $55000"
"36005039400","Census Tract 394, Bronx County, New York",5647,48023,61,3391,218,0,0,1967,1.1,60,3.9,0,0,34.8,98.9,1723,311,1412,18.05,81.95,79,232,191,1221,270,1453,25.4,13.5,15.7,"75% or more P.O.C.","Less than $55000"
"36005039500","Census Tract 395, Bronx County, New York",4257,29000,31,1615,62,31,0,2480,0.7,37.9,1.5,0.7,0,58.3,99.3,1586,168,1418,10.59,89.41,39,129,142,1276,181,1405,23.2,10,11.4,"75% or more P.O.C.","Less than $55000"
"36005039600","Census Tract 396, Bronx County, New York",5022,44458,41,3641,0,12,0,1093,0.8,72.5,0,0.2,0,21.8,99.2,1481,337,1144,22.75,77.25,79,258,253,891,332,1149,23.4,22.1,22.4,"75% or more P.O.C.","Less than $55000"
"36005039700","Census Tract 397, Bronx County, New York",3744,33854,2127,211,0,196,0,1059,56.8,5.6,0,5.2,0,28.3,43.2,517,15,502,2.9,97.1,0,15,16,486,16,501,0,3.2,3.1,"25% - 50% P.O.C.","Less than $55000"
"36005039800","Census Tract 398, Bronx County, New York",3842,80024,11,3278,0,31,0,522,0.3,85.3,0,0.8,0,13.6,99.7,1069,583,486,54.54,45.46,311,272,14,472,325,744,53.3,2.9,30.4,"75% or more P.O.C.","$78000 - $104000"
"36005039901","Census Tract 399.01, Bronx County, New York",5618,28049,161,1020,0,213,0,4163,2.9,18.2,0,3.8,0,74.1,97.1,1718,35,1683,2.04,97.96,24,11,312,1371,336,1382,68.6,18.5,19.6,"75% or more P.O.C.","Less than $55000"
"36005039902","Census Tract 399.02, Bronx County, New York",5646,36683,214,692,44,32,48,4562,3.8,12.3,0.8,0.6,0.9,80.8,96.2,1743,9,1734,0.52,99.48,0,9,298,1436,298,1445,0,17.2,17.1,"75% or more P.O.C.","Less than $55000"
"36005040100","Census Tract 401, Bronx County, New York",4478,37012,88,443,17,27,0,3891,2,9.9,0.4,0.6,0,86.9,98,1528,12,1516,0.79,99.21,0,12,241,1275,241,1287,0,15.9,15.8,"75% or more P.O.C.","Less than $55000"
"36005040302","Census Tract 403.02, Bronx County, New York",4192,37759,77,536,0,170,0,3409,1.8,12.8,0,4.1,0,81.3,98.2,1410,11,1399,0.78,99.22,8,3,152,1247,160,1250,72.7,10.9,11.3,"75% or more P.O.C.","Less than $55000"
"36005040303","Census Tract 403.03, Bronx County, New York",4900,37043,50,707,206,149,0,3612,1,14.4,4.2,3,0,73.7,99,1602,106,1496,6.62,93.38,11,95,132,1364,143,1459,10.4,8.8,8.9,"75% or more P.O.C.","Less than $55000"
"36005040304","Census Tract 403.04, Bronx County, New York",3593,25897,37,91,0,155,0,3279,1,2.5,0,4.3,0,91.3,99,1216,26,1190,2.14,97.86,15,11,185,1005,200,1016,57.7,15.5,16.4,"75% or more P.O.C.","Less than $55000"
"36005040400","Census Tract 404, Bronx County, New York",3600,79442,33,2946,33,0,0,545,0.9,81.8,0.9,0,0,15.1,99.1,1121,688,433,61.37,38.63,194,494,0,433,194,927,28.2,0,17.3,"75% or more P.O.C.","$78000 - $104000"
"36005040501","Census Tract 405.01, Bronx County, New York",4399,37935,88,441,0,101,0,3727,2,10,0,2.3,0,84.7,98,1340,70,1270,5.22,94.78,44,26,239,1031,283,1057,62.9,18.8,21.1,"75% or more P.O.C.","Less than $55000"
"36005040502","Census Tract 405.02, Bronx County, New York",7264,29670,87,2075,0,436,0,4646,1.2,28.6,0,6,0,64,98.8,2351,242,2109,10.29,89.71,68,174,303,1806,371,1980,28.1,14.4,15.8,"75% or more P.O.C.","Less than $55000"
"36005040600","Census Tract 406, Bronx County, New York",3547,49671,2,2823,0,54,0,668,0.1,79.6,0,1.5,0,18.8,99.9,1251,392,859,31.33,68.67,10,382,163,696,173,1078,2.6,19,13.8,"75% or more P.O.C.","Less than $55000"
"36005040701","Census Tract 407.01, Bronx County, New York",3120,34695,104,287,0,39,0,2682,3.3,9.2,0,1.2,0,86,96.7,1226,0,1226,0,100,0,0,100,1126,100,1126,NA,8.2,8.2,"75% or more P.O.C.","Less than $55000"
"36005040702","Census Tract 407.02, Bronx County, New York",7023,37275,351,564,0,407,0,5527,5,8,0,5.8,0,78.7,95,2695,150,2545,5.57,94.43,42,108,367,2178,409,2286,28,14.4,15.2,"75% or more P.O.C.","Less than $55000"
"36005040800","Census Tract 408, Bronx County, New York",4826,31110,461,2814,13,27,0,1387,9.6,58.3,0.3,0.6,0,28.7,90.4,1657,271,1386,16.35,83.65,78,193,94,1292,172,1485,28.8,6.8,10.4,"75% or more P.O.C.","Less than $55000"
"36005040900","Census Tract 409, Bronx County, New York",3194,52956,656,1896,0,84,0,489,20.5,59.4,0,2.6,0,15.3,79.5,1387,320,1067,23.07,76.93,7,313,93,974,100,1287,2.2,8.7,7.2,"75% or more P.O.C.","Less than $55000"
"36005041100","Census Tract 411, Bronx County, New York",3510,41587,337,747,0,172,0,2230,9.6,21.3,0,4.9,0,63.5,90.4,1231,140,1091,11.37,88.63,0,140,167,924,167,1064,0,15.3,13.6,"75% or more P.O.C.","Less than $55000"
"36005041300","Census Tract 413, Bronx County, New York",8677,53032,657,1005,0,220,0,6605,7.6,11.6,0,2.5,0,76.1,92.4,2965,135,2830,4.55,95.45,0,135,385,2445,385,2580,0,13.6,13,"75% or more P.O.C.","Less than $55000"
"36005041400","Census Tract 414, Bronx County, New York",5158,49545,169,3465,0,147,0,1233,3.3,67.2,0,2.8,0,23.9,96.7,1736,625,1111,36,64,148,477,96,1015,244,1492,23.7,8.6,14.1,"75% or more P.O.C.","Less than $55000"
"36005041500","Census Tract 415, Bronx County, New York",6367,43538,498,810,0,220,0,4673,7.8,12.7,0,3.5,0,73.4,92.2,2339,92,2247,3.93,96.07,9,83,315,1932,324,2015,9.8,14,13.9,"75% or more P.O.C.","Less than $55000"
"36005041800","Census Tract 418, Bronx County, New York",3876,39712,99,1463,0,517,0,1432,2.6,37.7,0,13.3,0,36.9,97.4,1274,322,952,25.27,74.73,78,244,155,797,233,1041,24.2,16.3,18.3,"75% or more P.O.C.","Less than $55000"
"36005041900","Census Tract 419, Bronx County, New York",6035,35837,625,697,0,716,0,3936,10.4,11.5,0,11.9,0,65.2,89.6,2469,26,2443,1.05,98.95,21,5,174,2269,195,2274,80.8,7.1,7.9,"75% or more P.O.C.","Less than $55000"
"36005042000","Census Tract 420, Bronx County, New York",4206,42689,135,2457,0,232,37,1316,3.2,58.4,0,5.5,0.9,31.3,96.8,1478,122,1356,8.25,91.75,26,96,102,1254,128,1350,21.3,7.5,8.7,"75% or more P.O.C.","Less than $55000"
"36005042100","Census Tract 421, Bronx County, New York",5661,38083,485,859,0,625,0,3354,8.6,15.2,0,11,0,59.2,91.4,2148,122,2026,5.68,94.32,0,122,249,1777,249,1899,0,12.3,11.6,"75% or more P.O.C.","Less than $55000"
"36005042200","Census Tract 422, Bronx County, New York",3285,60500,109,2388,0,49,0,592,3.3,72.7,0,1.5,0,18,96.7,1168,532,636,45.55,54.45,66,466,63,573,129,1039,12.4,9.9,11,"75% or more P.O.C.","$55000 - $78000"
"36005042300","Census Tract 423, Bronx County, New York",4313,38802,608,436,0,429,0,2827,14.1,10.1,0,9.9,0,65.5,85.9,1337,43,1294,3.22,96.78,28,15,217,1077,245,1092,65.1,16.8,18.3,"75% or more P.O.C.","Less than $55000"
"36005042400","Census Tract 424, Bronx County, New York",2569,86422,85,2008,7,43,0,378,3.3,78.2,0.3,1.7,0,14.7,96.7,833,505,328,60.62,39.38,78,427,25,303,103,730,15.4,7.6,12.4,"75% or more P.O.C.","$78000 - $104000"
"36005042500","Census Tract 425, Bronx County, New York",6175,31723,760,549,0,680,0,4126,12.3,8.9,0,11,0,66.8,87.7,2093,56,2037,2.68,97.32,0,56,314,1723,314,1779,0,15.4,15,"75% or more P.O.C.","Less than $55000"
"36005042600","Census Tract 426, Bronx County, New York",6729,85023,417,5592,0,314,0,392,6.2,83.1,0,4.7,0,5.8,93.8,2028,1324,704,65.29,34.71,355,969,153,551,508,1520,26.8,21.7,25,"75% or more P.O.C.","$78000 - $104000"
"36005042800","Census Tract 428, Bronx County, New York",2120,82599,55,1698,0,11,0,287,2.6,80.1,0,0.5,0,13.5,97.4,715,470,245,65.73,34.27,71,399,0,245,71,644,15.1,0,9.9,"75% or more P.O.C.","$78000 - $104000"
"36005042901","Census Tract 429.01, Bronx County, New York",3561,40024,290,164,0,645,0,2393,8.1,4.6,0,18.1,0,67.2,91.9,1255,104,1151,8.29,91.71,44,60,163,988,207,1048,42.3,14.2,16.5,"75% or more P.O.C.","Less than $55000"
"36005042902","Census Tract 429.02, Bronx County, New York",4041,35956,198,1108,0,86,0,2573,4.9,27.4,0,2.1,0,63.7,95.1,1658,121,1537,7.3,92.7,0,121,201,1336,201,1457,0,13.1,12.1,"75% or more P.O.C.","Less than $55000"
"36005043000","Census Tract 430, Bronx County, New York",3499,63324,60,2155,13,277,0,449,1.7,61.6,0.4,7.9,0,12.8,98.3,1023,736,287,71.95,28.05,209,527,60,227,269,754,28.4,20.9,26.3,"75% or more P.O.C.","$55000 - $78000"
"36005043100","Census Tract 431, Bronx County, New York",10246,35995,590,2020,0,1074,0,6170,5.8,19.7,0,10.5,0,60.2,94.2,3579,220,3359,6.15,93.85,33,187,563,2796,596,2983,15,16.8,16.7,"75% or more P.O.C.","Less than $55000"
"36005043400","Census Tract 434, Bronx County, New York",3710,62000,118,2085,0,242,0,1091,3.2,56.2,0,6.5,0,29.4,96.8,1268,360,908,28.39,71.61,78,282,68,840,146,1122,21.7,7.5,11.5,"75% or more P.O.C.","$55000 - $78000"
"36005043500","Census Tract 435, Bronx County, New York",499,27813,16,154,125,0,19,179,3.2,30.9,25.1,0,3.8,35.9,96.8,219,0,219,0,100,0,0,7,212,7,212,NA,3.2,3.2,"75% or more P.O.C.","Less than $55000"
"36005043600","Census Tract 436, Bronx County, New York",2020,66250,136,1274,0,89,0,372,6.7,63.1,0,4.4,0,18.4,93.3,717,363,354,50.63,49.37,89,274,0,354,89,628,24.5,0,12.4,"75% or more P.O.C.","$55000 - $78000"
"36005044200","Census Tract 442, Bronx County, New York",4019,55000,12,2819,0,0,0,1053,0.3,70.1,0,0,0,26.2,99.7,1346,495,851,36.78,63.22,69,426,176,675,245,1101,13.9,20.7,18.2,"75% or more P.O.C.","$55000 - $78000"
"36005044400","Census Tract 444, Bronx County, New York",4295,77740,122,3430,0,165,0,499,2.8,79.9,0,3.8,0,11.6,97.2,1325,832,493,62.79,37.21,172,660,96,397,268,1057,20.7,19.5,20.2,"75% or more P.O.C.","$55000 - $78000"
"36005044800","Census Tract 448, Bronx County, New York",2075,96875,62,1747,0,0,0,120,3,84.2,0,0,0,5.8,97,654,501,153,76.61,23.39,105,396,27,126,132,522,21,17.6,20.2,"75% or more P.O.C.","$78000 - $104000"
"36005044901","Census Tract 449.01, Bronx County, New York",1763,69200,1360,156,0,32,0,206,77.1,8.8,0,1.8,0,11.7,22.9,844,381,463,45.14,54.86,44,337,6,457,50,794,11.5,1.3,5.9,"Less than 25% P.O.C.","$55000 - $78000"
"36005044902","Census Tract 449.02, Bronx County, New York",2041,80833,1453,171,0,101,0,296,71.2,8.4,0,4.9,0,14.5,28.8,856,386,470,45.09,54.91,45,341,20,450,65,791,11.7,4.3,7.6,"25% - 50% P.O.C.","$78000 - $104000"
"36005045101","Census Tract 451.01, Bronx County, New York",1455,81094,1112,60,0,118,0,111,76.4,4.1,0,8.1,0,7.6,23.6,745,265,480,35.57,64.43,31,234,7,473,38,707,11.7,1.5,5.1,"Less than 25% P.O.C.","$78000 - $104000"
"36005045102","Census Tract 451.02, Bronx County, New York",1955,75089,1452,99,0,23,0,320,74.3,5.1,0,1.2,0,16.4,25.7,869,354,515,40.74,59.26,93,261,15,500,108,761,26.3,2.9,12.4,"25% - 50% P.O.C.","$55000 - $78000"
"36005045600","Census Tract 456, Bronx County, New York",3220,93472,447,1762,0,57,0,899,13.9,54.7,0,1.8,0,27.9,86.1,988,709,279,71.76,28.24,81,628,37,242,118,870,11.4,13.3,11.9,"75% or more P.O.C.","$78000 - $104000"
"36005045800","Census Tract 458, Bronx County, New York",5744,24341,24,2071,0,54,0,3440,0.4,36.1,0,0.9,0,59.9,99.6,2040,0,2040,0,100,0,0,327,1713,327,1713,NA,16,16,"75% or more P.O.C.","Less than $55000"
"36005046000","Census Tract 460, Bronx County, New York",3246,31932,111,2119,6,26,0,971,3.4,65.3,0.2,0.8,0,29.9,96.6,1021,174,847,17.04,82.96,12,162,181,666,193,828,6.9,21.4,18.9,"75% or more P.O.C.","Less than $55000"
"36005046201","Census Tract 462.01, Bronx County, New York",28109,52601,1983,16423,0,876,0,8110,7.1,58.4,0,3.1,0,28.9,92.9,12998,5905,7093,45.43,54.57,201,5704,449,6644,650,12348,3.4,6.3,5,"75% or more P.O.C.","Less than $55000"
"36005046202","Census Tract 462.02, Bronx County, New York",9912,62532,114,6226,112,125,0,3162,1.2,62.8,1.1,1.3,0,31.9,98.8,2720,948,1772,34.85,65.15,315,633,270,1502,585,2135,33.2,15.2,21.5,"75% or more P.O.C.","$55000 - $78000"
"36005048400","Census Tract 484, Bronx County, New York",4277,74958,102,3341,38,0,0,774,2.4,78.1,0.9,0,0,18.1,97.6,1283,636,647,49.57,50.43,138,498,96,551,234,1049,21.7,14.8,18.2,"75% or more P.O.C.","$55000 - $78000"
"36005050400","Census Tract 504, Bronx County, New York",0,NA,0,0,0,0,0,0,NA,NA,NA,NA,NA,NA,NA,0,0,0,NA,NA,0,0,0,0,0,0,NA,NA,NA,"N/A","N/A"
"36005051600","Census Tract 516, Bronx County, New York",4531,96366,2379,1,0,227,0,1904,52.5,0,0,5,0,42,47.5,1851,1126,725,60.83,39.17,41,1085,14,711,55,1796,3.6,1.9,3,"25% - 50% P.O.C.","$78000 - $104000"
"36027010000","Census Tract 100, Dutchess County, New York",4303,54243,3271,125,0,37,0,781,76,2.9,0,0.9,0,18.2,24,1593,896,697,56.25,43.75,55,841,98,599,153,1440,6.1,14.1,9.6,"Less than 25% P.O.C.","Less than $55000"
"36027020003","Census Tract 200.03, Dutchess County, New York",4391,81623,3460,579,0,56,0,243,78.8,13.2,0,1.3,0,5.5,21.2,1492,1288,204,86.33,13.67,143,1145,62,142,205,1287,11.1,30.4,13.7,"Less than 25% P.O.C.","$78000 - $104000"
"36027020004","Census Tract 200.04, Dutchess County, New York",2923,116641,2326,234,0,40,0,318,79.6,8,0,1.4,0,10.9,20.4,933,853,80,91.43,8.57,126,727,0,80,126,807,14.8,0,13.5,"Less than 25% P.O.C.","$104000 or more"
"36027020005","Census Tract 200.05, Dutchess County, New York",5023,97703,4348,101,0,104,0,449,86.6,2,0,2.1,0,8.9,13.4,1830,1590,240,86.89,13.11,118,1472,38,202,156,1674,7.4,15.8,8.5,"Less than 25% P.O.C.","$78000 - $104000"
"36027030000","Census Tract 300, Dutchess County, New York",4215,107286,3872,78,0,15,0,222,91.9,1.9,0,0.4,0,5.3,8.1,1534,1299,235,84.68,15.32,100,1199,29,206,129,1405,7.7,12.3,8.4,"Less than 25% P.O.C.","$104000 or more"
"36027040001","Census Tract 400.01, Dutchess County, New York",4492,60956,3681,45,0,70,0,681,81.9,1,0,1.6,0,15.2,18.1,1855,1418,437,76.44,23.56,138,1280,0,437,138,1717,9.7,0,7.4,"Less than 25% P.O.C.","$55000 - $78000"
"36027040003","Census Tract 400.03, Dutchess County, New York",3904,65094,2627,203,0,47,0,956,67.3,5.2,0,1.2,0,24.5,32.7,1490,1094,396,73.42,26.58,135,959,27,369,162,1328,12.3,6.8,10.9,"25% - 50% P.O.C.","$55000 - $78000"
"36027050102","Census Tract 501.02, Dutchess County, New York",3838,96537,2884,185,10,218,0,413,75.1,4.8,0.3,5.7,0,10.8,24.9,1249,1142,107,91.43,8.57,190,952,14,93,204,1045,16.6,13.1,16.3,"Less than 25% P.O.C.","$78000 - $104000"
"36027050103","Census Tract 501.03, Dutchess County, New York",5583,120761,4962,63,0,34,0,487,88.9,1.1,0,0.6,0,8.7,11.1,1808,1669,139,92.31,7.69,239,1430,0,139,239,1569,14.3,0,13.2,"Less than 25% P.O.C.","$104000 or more"
"36027050104","Census Tract 501.04, Dutchess County, New York",6416,116715,5019,296,0,473,0,259,78.2,4.6,0,7.4,0,4,21.8,2117,2011,106,94.99,5.01,279,1732,8,98,287,1830,13.9,7.5,13.6,"Less than 25% P.O.C.","$104000 or more"
"36027050203","Census Tract 502.03, Dutchess County, New York",4866,104918,3803,35,0,205,0,583,78.2,0.7,0,4.2,0,12,21.8,1714,1426,288,83.2,16.8,163,1263,0,288,163,1551,11.4,0,9.5,"Less than 25% P.O.C.","$104000 or more"
"36027050204","Census Tract 502.04, Dutchess County, New York",2942,135608,2259,115,0,230,0,338,76.8,3.9,0,7.8,0,11.5,23.2,986,929,57,94.22,5.78,135,794,0,57,135,851,14.5,0,13.7,"Less than 25% P.O.C.","$104000 or more"
"36027050205","Census Tract 502.05, Dutchess County, New York",5654,108633,4808,48,39,61,0,278,85,0.8,0.7,1.1,0,4.9,15,1856,1663,193,89.6,10.4,245,1418,14,179,259,1597,14.7,7.3,14,"Less than 25% P.O.C.","$104000 or more"
"36027060100","Census Tract 601, Dutchess County, New York",4710,94630,2587,825,49,471,2,755,54.9,17.5,1,10,0,16,45.1,1856,863,993,46.5,53.5,57,806,94,899,151,1705,6.6,9.5,8.1,"25% - 50% P.O.C.","$78000 - $104000"
"36027060201","Census Tract 602.01, Dutchess County, New York",3524,85540,2497,240,0,179,0,553,70.9,6.8,0,5.1,0,15.7,29.1,1455,1104,351,75.88,24.12,101,1003,57,294,158,1297,9.1,16.2,10.9,"25% - 50% P.O.C.","$78000 - $104000"
"36027060202","Census Tract 602.02, Dutchess County, New York",4535,75046,3114,256,0,49,0,889,68.7,5.6,0,1.1,0,19.6,31.3,1768,1269,499,71.78,28.22,112,1157,112,387,224,1544,8.8,22.4,12.7,"25% - 50% P.O.C.","$55000 - $78000"
"36027060301","Census Tract 603.01, Dutchess County, New York",4122,94571,3325,182,0,100,0,474,80.7,4.4,0,2.4,0,11.5,19.3,1460,1279,181,87.6,12.4,179,1100,8,173,187,1273,14,4.4,12.8,"Less than 25% P.O.C.","$78000 - $104000"
"36027060302","Census Tract 603.02, Dutchess County, New York",2539,95000,1669,56,0,627,0,133,65.7,2.2,0,24.7,0,5.2,34.3,1104,865,239,78.35,21.65,43,822,6,233,49,1055,5,2.5,4.4,"25% - 50% P.O.C.","$78000 - $104000"
"36027060400","Census Tract 604, Dutchess County, New York",2014,78750,1515,118,0,62,0,301,75.2,5.9,0,3.1,0,14.9,24.8,1007,332,675,32.97,67.03,7,325,28,647,35,972,2.1,4.1,3.5,"Less than 25% P.O.C.","$78000 - $104000"
"36027070101","Census Tract 701.01, Dutchess County, New York",4469,84811,3703,128,0,122,12,380,82.9,2.9,0,2.7,0.3,8.5,17.1,1719,1304,415,75.86,24.14,20,1284,32,383,52,1667,1.5,7.7,3,"Less than 25% P.O.C.","$78000 - $104000"
"36027070102","Census Tract 701.02, Dutchess County, New York",3492,68942,2634,191,0,81,0,489,75.4,5.5,0,2.3,0,14,24.6,1237,1025,212,82.86,17.14,88,937,59,153,147,1090,8.6,27.8,11.9,"Less than 25% P.O.C.","$55000 - $78000"
"36027070201","Census Tract 702.01, Dutchess County, New York",2826,67361,2262,183,22,41,0,292,80,6.5,0.8,1.5,0,10.3,20,1277,717,560,56.15,43.85,63,654,0,560,63,1214,8.8,0,4.9,"Less than 25% P.O.C.","$55000 - $78000"
"36027070301","Census Tract 703.01, Dutchess County, New York",5654,73044,4159,816,0,253,0,348,73.6,14.4,0,4.5,0,6.2,26.4,2325,1703,622,73.25,26.75,148,1555,48,574,196,2129,8.7,7.7,8.4,"25% - 50% P.O.C.","$55000 - $78000"
"36027070401","Census Tract 704.01, Dutchess County, New York",4513,98289,3110,310,9,334,0,597,68.9,6.9,0.2,7.4,0,13.2,31.1,1066,845,221,79.27,20.73,60,785,40,181,100,966,7.1,18.1,9.4,"25% - 50% P.O.C.","$78000 - $104000"
"36027080103","Census Tract 801.03, Dutchess County, New York",4864,132679,4048,221,0,158,0,328,83.2,4.5,0,3.2,0,6.7,16.8,1556,1495,61,96.08,3.92,209,1286,17,44,226,1330,14,27.9,14.5,"Less than 25% P.O.C.","$104000 or more"
"36027080104","Census Tract 801.04, Dutchess County, New York",3952,114625,3290,50,5,133,0,417,83.2,1.3,0.1,3.4,0,10.6,16.8,1309,1176,133,89.84,10.16,181,995,22,111,203,1106,15.4,16.5,15.5,"Less than 25% P.O.C.","$104000 or more"
"36027080201","Census Tract 802.01, Dutchess County, New York",4000,108734,3308,106,11,191,0,383,82.7,2.6,0.3,4.8,0,9.6,17.3,1639,1557,82,95,5,128,1429,0,82,128,1511,8.2,0,7.8,"Less than 25% P.O.C.","$104000 or more"
"36027080202","Census Tract 802.02, Dutchess County, New York",2761,125769,2152,139,0,217,0,228,77.9,5,0,7.9,0,8.3,22.1,924,846,78,91.56,8.44,92,754,22,56,114,810,10.9,28.2,12.3,"Less than 25% P.O.C.","$104000 or more"
"36027090000","Census Tract 900, Dutchess County, New York",2402,80172,2027,66,0,49,0,220,84.4,2.7,0,2,0,9.2,15.6,1008,840,168,83.33,16.67,47,793,5,163,52,956,5.6,3,5.2,"Less than 25% P.O.C.","$78000 - $104000"
"36027100000","Census Tract 1000, Dutchess County, New York",2943,66716,2398,101,0,66,0,341,81.5,3.4,0,2.2,0,11.6,18.5,1209,799,410,66.09,33.91,30,769,63,347,93,1116,3.8,15.4,7.7,"Less than 25% P.O.C.","$55000 - $78000"
"36027110003","Census Tract 1100.03, Dutchess County, New York",4340,115527,3765,224,0,27,0,273,86.8,5.2,0,0.6,0,6.3,13.2,1489,1304,185,87.58,12.42,215,1089,29,156,244,1245,16.5,15.7,16.4,"Less than 25% P.O.C.","$104000 or more"
"36027110004","Census Tract 1100.04, Dutchess County, New York",1887,71488,1484,26,0,0,5,357,78.6,1.4,0,0,0.3,18.9,21.4,797,526,271,66,34,21,505,39,232,60,737,4,14.4,7.5,"Less than 25% P.O.C.","$55000 - $78000"
"36027110005","Census Tract 1100.05, Dutchess County, New York",2029,73938,1487,21,0,82,0,434,73.3,1,0,4,0,21.4,26.7,884,532,352,60.18,39.82,68,464,4,348,72,812,12.8,1.1,8.1,"25% - 50% P.O.C.","$55000 - $78000"
"36027120000","Census Tract 1200, Dutchess County, New York",2353,60909,2222,14,0,5,14,98,94.4,0.6,0,0.2,0.6,4.2,5.6,1002,721,281,71.96,28.04,16,705,41,240,57,945,2.2,14.6,5.7,"Less than 25% P.O.C.","$55000 - $78000"
"36027130003","Census Tract 1300.03, Dutchess County, New York",5473,81136,4397,273,0,84,0,314,80.3,5,0,1.5,0,5.7,19.7,2236,1202,1034,53.76,46.24,95,1107,45,989,140,2096,7.9,4.4,6.3,"Less than 25% P.O.C.","$78000 - $104000"
"36027130004","Census Tract 1300.04, Dutchess County, New York",1595,100875,1463,31,0,26,0,35,91.7,1.9,0,1.6,0,2.2,8.3,601,545,56,90.68,9.32,35,510,18,38,53,548,6.4,32.1,8.8,"Less than 25% P.O.C.","$78000 - $104000"
"36027130005","Census Tract 1300.05, Dutchess County, New York",2635,84429,2281,18,0,0,0,336,86.6,0.7,0,0,0,12.8,13.4,1016,830,186,81.69,18.31,25,805,15,171,40,976,3,8.1,3.9,"Less than 25% P.O.C.","$78000 - $104000"
"36027140101","Census Tract 1401.01, Dutchess County, New York",6028,87500,3908,880,23,248,0,701,64.8,14.6,0.4,4.1,0,11.6,35.2,1258,830,428,65.98,34.02,25,805,85,343,110,1148,3,19.9,8.7,"25% - 50% P.O.C.","$78000 - $104000"
"36027140200","Census Tract 1402, Dutchess County, New York",6657,78636,4811,563,0,155,46,973,72.3,8.5,0,2.3,0.7,14.6,27.7,2908,1798,1110,61.83,38.17,127,1671,0,1110,127,2781,7.1,0,4.4,"25% - 50% P.O.C.","$78000 - $104000"
"36027140300","Census Tract 1403, Dutchess County, New York",5772,58097,3138,841,7,102,0,1223,54.4,14.6,0.1,1.8,0,21.2,45.6,2526,1052,1474,41.65,58.35,142,910,53,1421,195,2331,13.5,3.6,7.7,"25% - 50% P.O.C.","$55000 - $78000"
"36027140400","Census Tract 1404, Dutchess County, New York",5323,124375,4171,203,0,458,0,406,78.4,3.8,0,8.6,0,7.6,21.6,1811,1668,143,92.1,7.9,126,1542,49,94,175,1636,7.6,34.3,9.7,"Less than 25% P.O.C.","$104000 or more"
"36027140500","Census Tract 1405, Dutchess County, New York",2750,75650,1605,475,0,170,0,391,58.4,17.3,0,6.2,0,14.2,41.6,1237,621,616,50.2,49.8,58,563,8,608,66,1171,9.3,1.3,5.3,"25% - 50% P.O.C.","$55000 - $78000"
"36027140602","Census Tract 1406.02, Dutchess County, New York",2850,86120,1940,408,0,220,0,254,68.1,14.3,0,7.7,0,8.9,31.9,1035,853,182,82.42,17.58,93,760,52,130,145,890,10.9,28.6,14,"25% - 50% P.O.C.","$78000 - $104000"
"36027140700","Census Tract 1407, Dutchess County, New York",6921,113823,4917,846,45,382,0,685,71,12.2,0.7,5.5,0,9.9,29,2493,2155,338,86.44,13.56,268,1887,0,338,268,2225,12.4,0,10.8,"25% - 50% P.O.C.","$104000 or more"
"36027140801","Census Tract 1408.01, Dutchess County, New York",2725,108472,2406,115,0,69,0,67,88.3,4.2,0,2.5,0,2.5,11.7,977,928,49,94.98,5.02,79,849,0,49,79,898,8.5,0,8.1,"Less than 25% P.O.C.","$104000 or more"
"36027150003","Census Tract 1500.03, Dutchess County, New York",3069,76019,2441,90,15,240,0,206,79.5,2.9,0.5,7.8,0,6.7,20.5,680,358,322,52.65,47.35,32,326,8,314,40,640,8.9,2.5,5.9,"Less than 25% P.O.C.","$55000 - $78000"
"36027150004","Census Tract 1500.04, Dutchess County, New York",3481,95590,3037,114,0,99,0,187,87.2,3.3,0,2.8,0,5.4,12.8,1272,1019,253,80.11,19.89,42,977,75,178,117,1155,4.1,29.6,9.2,"Less than 25% P.O.C.","$78000 - $104000"
"36027150005","Census Tract 1500.05, Dutchess County, New York",2705,87409,2351,85,0,34,0,154,86.9,3.1,0,1.3,0,5.7,13.1,1015,847,168,83.45,16.55,80,767,0,168,80,935,9.4,0,7.9,"Less than 25% P.O.C.","$78000 - $104000"
"36027150006","Census Tract 1500.06, Dutchess County, New York",1899,65850,1674,37,0,72,0,88,88.2,1.9,0,3.8,0,4.6,11.8,843,437,406,51.84,48.16,17,420,14,392,31,812,3.9,3.4,3.7,"Less than 25% P.O.C.","$55000 - $78000"
"36027160003","Census Tract 1600.03, Dutchess County, New York",2663,83750,2306,61,0,56,0,210,86.6,2.3,0,2.1,0,7.9,13.4,938,664,274,70.79,29.21,35,629,18,256,53,885,5.3,6.6,5.7,"Less than 25% P.O.C.","$78000 - $104000"
"36027160004","Census Tract 1600.04, Dutchess County, New York",2539,85625,2309,59,0,0,0,103,90.9,2.3,0,0,0,4.1,9.1,1010,752,258,74.46,25.54,47,705,0,258,47,963,6.2,0,4.7,"Less than 25% P.O.C.","$78000 - $104000"
"36027160005","Census Tract 1600.05, Dutchess County, New York",2570,64327,2183,35,0,218,0,131,84.9,1.4,0,8.5,0,5.1,15.1,1269,658,611,51.85,48.15,14,644,21,590,35,1234,2.1,3.4,2.8,"Less than 25% P.O.C.","$55000 - $78000"
"36027170000","Census Tract 1700, Dutchess County, New York",3743,102386,3141,65,7,140,0,360,83.9,1.7,0.2,3.7,0,9.6,16.1,1515,1267,248,83.63,16.37,69,1198,8,240,77,1438,5.4,3.2,5.1,"Less than 25% P.O.C.","$78000 - $104000"
"36027180001","Census Tract 1800.01, Dutchess County, New York",4616,95852,4065,153,2,86,0,269,88.1,3.3,0,1.9,0,5.8,11.9,1720,1391,329,80.87,19.13,111,1280,29,300,140,1580,8,8.8,8.1,"Less than 25% P.O.C.","$78000 - $104000"
"36027190101","Census Tract 1901.01, Dutchess County, New York",3610,103377,2791,144,30,259,0,332,77.3,4,0.8,7.2,0,9.2,22.7,1336,1273,63,95.28,4.72,109,1164,0,63,109,1227,8.6,0,8.2,"Less than 25% P.O.C.","$78000 - $104000"
"36027190102","Census Tract 1901.02, Dutchess County, New York",1841,63929,1527,121,0,25,0,122,82.9,6.6,0,1.4,0,6.6,17.1,714,327,387,45.8,54.2,55,272,8,379,63,651,16.8,2.1,8.8,"Less than 25% P.O.C.","$55000 - $78000"
"36027190203","Census Tract 1902.03, Dutchess County, New York",2530,81324,1559,221,0,74,0,476,61.6,8.7,0,2.9,0,18.8,38.4,956,741,215,77.51,22.49,86,655,32,183,118,838,11.6,14.9,12.3,"25% - 50% P.O.C.","$78000 - $104000"
"36027190204","Census Tract 1902.04, Dutchess County, New York",4995,110917,3728,69,0,514,0,580,74.6,1.4,0,10.3,0,11.6,25.4,1750,1679,71,95.94,4.06,227,1452,0,71,227,1523,13.5,0,13,"25% - 50% P.O.C.","$104000 or more"
"36027190301","Census Tract 1903.01, Dutchess County, New York",3589,84688,2443,456,0,116,0,460,68.1,12.7,0,3.2,0,12.8,31.9,1567,691,876,44.1,55.9,26,665,0,876,26,1541,3.8,0,1.7,"25% - 50% P.O.C.","$78000 - $104000"
"36027190401","Census Tract 1904.01, Dutchess County, New York",2227,86313,1515,236,0,0,0,411,68,10.6,0,0,0,18.5,32,789,586,203,74.27,25.73,42,544,25,178,67,722,7.2,12.3,8.5,"25% - 50% P.O.C.","$78000 - $104000"
"36027190402","Census Tract 1904.02, Dutchess County, New York",3245,70216,2163,93,0,180,0,644,66.7,2.9,0,5.5,0,19.8,33.3,1337,991,346,74.12,25.88,136,855,17,329,153,1184,13.7,4.9,11.4,"25% - 50% P.O.C.","$55000 - $78000"
"36027200001","Census Tract 2000.01, Dutchess County, New York",3179,105721,2598,184,0,34,0,288,81.7,5.8,0,1.1,0,9.1,18.3,1289,972,317,75.41,24.59,27,945,43,274,70,1219,2.8,13.6,5.4,"Less than 25% P.O.C.","$104000 or more"
"36027200002","Census Tract 2000.02, Dutchess County, New York",1443,76667,1200,20,3,85,0,103,83.2,1.4,0.2,5.9,0,7.1,16.8,724,370,354,51.1,48.9,30,340,3,351,33,691,8.1,0.8,4.6,"Less than 25% P.O.C.","$55000 - $78000"
"36027210101","Census Tract 2101.01, Dutchess County, New York",5319,65426,3443,555,15,134,0,1078,64.7,10.4,0.3,2.5,0,20.3,35.3,2045,898,1147,43.91,56.09,137,761,74,1073,211,1834,15.3,6.5,10.3,"25% - 50% P.O.C.","$55000 - $78000"
"36027210201","Census Tract 2102.01, Dutchess County, New York",3863,62372,1729,1030,15,53,0,977,44.8,26.7,0.4,1.4,0,25.3,55.2,1627,858,769,52.74,47.26,20,838,87,682,107,1520,2.3,11.3,6.6,"50% - 75% P.O.C.","$55000 - $78000"
"36027210301","Census Tract 2103.01, Dutchess County, New York",4275,89375,3190,155,7,105,13,491,74.6,3.6,0.2,2.5,0.3,11.5,25.4,1587,1252,335,78.89,21.11,98,1154,31,304,129,1458,7.8,9.3,8.1,"25% - 50% P.O.C.","$78000 - $104000"
"36027220100","Census Tract 2201, Dutchess County, New York",4764,39191,1894,1091,0,90,5,1221,39.8,22.9,0,1.9,0.1,25.6,60.2,2196,315,1881,14.34,85.66,0,315,146,1735,146,2050,0,7.8,6.6,"50% - 75% P.O.C.","Less than $55000"
"36027220201","Census Tract 2202.01, Dutchess County, New York",3522,35392,925,1310,15,16,0,864,26.3,37.2,0.4,0.5,0,24.5,73.7,1170,236,934,20.17,79.83,29,207,76,858,105,1065,12.3,8.1,9,"50% - 75% P.O.C.","Less than $55000"
"36027220300","Census Tract 2203, Dutchess County, New York",4708,33946,867,3094,8,75,0,562,18.4,65.7,0.2,1.6,0,11.9,81.6,1919,402,1517,20.95,79.05,10,392,99,1418,109,1810,2.5,6.5,5.7,"75% or more P.O.C.","Less than $55000"
"36027220700","Census Tract 2207, Dutchess County, New York",2537,48112,833,1210,29,0,0,327,32.8,47.7,1.1,0,0,12.9,67.2,1095,319,776,29.13,70.87,14,305,50,726,64,1031,4.4,6.4,5.8,"50% - 75% P.O.C.","Less than $55000"
"36027220801","Census Tract 2208.01, Dutchess County, New York",3684,37156,2183,712,6,16,0,452,59.3,19.3,0.2,0.4,0,12.3,40.7,1711,567,1144,33.14,66.86,25,542,103,1041,128,1583,4.4,9,7.5,"25% - 50% P.O.C.","Less than $55000"
"36027220901","Census Tract 2209.01, Dutchess County, New York",3991,59531,1706,1546,12,0,0,438,42.7,38.7,0.3,0,0,11,57.3,1528,739,789,48.36,51.64,112,627,82,707,194,1334,15.2,10.4,12.7,"50% - 75% P.O.C.","$55000 - $78000"
"36027221001","Census Tract 2210.01, Dutchess County, New York",3779,87057,2751,550,0,63,10,405,72.8,14.6,0,1.7,0.3,10.7,27.2,1711,1604,107,93.75,6.25,22,1582,0,107,22,1689,1.4,0,1.3,"25% - 50% P.O.C.","$78000 - $104000"
"36027221100","Census Tract 2211, Dutchess County, New York",3396,35332,1227,1252,0,30,0,707,36.1,36.9,0,0.9,0,20.8,63.9,1561,286,1275,18.32,81.68,17,269,90,1185,107,1454,5.9,7.1,6.9,"50% - 75% P.O.C.","Less than $55000"
"36027300000","Census Tract 3000, Dutchess County, New York",5648,50083,3322,338,0,289,0,1664,58.8,6,0,5.1,0,29.5,41.2,2125,684,1441,32.19,67.81,108,576,108,1333,216,1909,15.8,7.5,10.2,"25% - 50% P.O.C.","Less than $55000"
"36027410000","Census Tract 4100, Dutchess County, New York",4126,95093,2622,278,6,376,0,597,63.5,6.7,0.1,9.1,0,14.5,36.5,750,495,255,66,34,84,411,46,209,130,620,17,18,17.3,"25% - 50% P.O.C.","$78000 - $104000"
"36027610000","Census Tract 6100, Dutchess County, New York",2106,NA,367,1104,0,64,0,496,17.4,52.4,0,3,0,23.6,82.6,18,0,18,0,100,0,0,12,6,12,6,NA,66.7,66.7,"75% or more P.O.C.","N/A"
"36027640001","Census Tract 6400.01, Dutchess County, New York",1442,NA,318,613,28,27,0,409,22.1,42.5,1.9,1.9,0,28.4,77.9,0,0,0,NA,NA,0,0,0,0,0,0,NA,NA,NA,"75% or more P.O.C.","N/A"
"36027640002","Census Tract 6400.02, Dutchess County, New York",1442,NA,420,673,11,11,0,317,29.1,46.7,0.8,0.8,0,22,70.9,0,0,0,NA,NA,0,0,0,0,0,0,NA,NA,NA,"50% - 75% P.O.C.","N/A"
"36047000100","Census Tract 1, Kings County, New York",4405,96250,2911,645,34,367,0,223,66.1,14.6,0.8,8.3,0,5.1,33.9,2304,1173,1131,50.91,49.09,15,1158,0,1131,15,2289,1.3,0,0.7,"25% - 50% P.O.C.","$78000 - $104000"
"36047000200","Census Tract 2, Kings County, New York",1167,56080,146,22,0,58,0,908,12.5,1.9,0,5,0,77.8,87.5,331,50,281,15.11,84.89,8,42,73,208,81,250,16,26,24.5,"75% or more P.O.C.","$55000 - $78000"
"36047000301","Census Tract 3.01, Kings County, New York",3924,137157,3287,115,0,219,0,72,83.8,2.9,0,5.6,0,1.8,16.2,1808,1140,668,63.05,36.95,36,1104,0,668,36,1772,3.2,0,2,"Less than 25% P.O.C.","$104000 or more"
"36047000501","Census Tract 5.01, Kings County, New York",4308,133750,2968,175,10,469,9,485,68.9,4.1,0.2,10.9,0.2,11.3,31.1,1769,807,962,45.62,54.38,25,782,9,953,34,1735,3.1,0.9,1.9,"25% - 50% P.O.C.","$104000 or more"
"36047000502","Census Tract 5.02, Kings County, New York",2697,146574,2143,60,0,308,0,126,79.5,2.2,0,11.4,0,4.7,20.5,1534,664,870,43.29,56.71,8,656,0,870,8,1526,1.2,0,0.5,"Less than 25% P.O.C.","$104000 or more"
"36047000700","Census Tract 7, Kings County, New York",3906,160272,3137,138,0,180,0,244,80.3,3.5,0,4.6,0,6.2,19.7,1637,712,925,43.49,56.51,49,663,47,878,96,1541,6.9,5.1,5.9,"Less than 25% P.O.C.","$104000 or more"
"36047000900","Census Tract 9, Kings County, New York",4518,169255,3197,197,0,498,0,367,70.8,4.4,0,11,0,8.1,29.2,2098,736,1362,35.08,64.92,0,736,45,1317,45,2053,0,3.3,2.1,"25% - 50% P.O.C.","$104000 or more"
"36047001100","Census Tract 11, Kings County, New York",1468,142813,865,141,0,244,0,163,58.9,9.6,0,16.6,0,11.1,41.1,810,46,764,5.68,94.32,6,40,0,764,6,804,13,0,0.7,"25% - 50% P.O.C.","$104000 or more"
"36047001300","Census Tract 13, Kings County, New York",1917,109208,1174,188,0,184,0,320,61.2,9.8,0,9.6,0,16.7,38.8,913,816,97,89.38,10.62,0,816,0,97,0,913,0,0,0,"25% - 50% P.O.C.","$104000 or more"
"36047001500","Census Tract 15, Kings County, New York",9011,87237,2569,2181,0,2159,13,1612,28.5,24.2,0,24,0.1,17.9,71.5,4188,526,3662,12.56,87.44,0,526,119,3543,119,4069,0,3.2,2.8,"50% - 75% P.O.C.","$78000 - $104000"
"36047001800","Census Tract 18, Kings County, New York",1897,NA,325,687,38,57,18,712,17.1,36.2,2,3,0.9,37.5,82.9,0,0,0,NA,NA,0,0,0,0,0,0,NA,NA,NA,"75% or more P.O.C.","N/A"
"36047002000","Census Tract 20, Kings County, New York",1412,45511,27,10,0,99,0,1276,1.9,0.7,0,7,0,90.4,98.1,393,87,306,22.14,77.86,19,68,107,199,126,267,21.8,35,32.1,"75% or more P.O.C.","Less than $55000"
"36047002100","Census Tract 21, Kings County, New York",5106,228276,3781,164,0,524,0,326,74.1,3.2,0,10.3,0,6.4,25.9,2160,885,1275,40.97,59.03,26,859,6,1269,32,2128,2.9,0.5,1.5,"25% - 50% P.O.C.","$104000 or more"
"36047002200","Census Tract 22, Kings County, New York",4698,41811,841,295,0,502,0,3060,17.9,6.3,0,10.7,0,65.1,82.1,1625,503,1122,30.95,69.05,81,422,248,874,329,1296,16.1,22.1,20.2,"75% or more P.O.C.","Less than $55000"
"36047002300","Census Tract 23, Kings County, New York",4219,18387,32,1787,0,533,0,1644,0.8,42.4,0,12.6,0,39,99.2,1622,58,1564,3.58,96.42,0,58,145,1419,145,1477,0,9.3,8.9,"75% or more P.O.C.","Less than $55000"
"36047002901","Census Tract 29.01, Kings County, New York",4447,29651,107,2315,97,789,0,840,2.4,52.1,2.2,17.7,0,18.9,97.6,1383,11,1372,0.8,99.2,0,11,252,1120,252,1131,0,18.4,18.2,"75% or more P.O.C.","Less than $55000"
"36047003000","Census Tract 30, Kings County, New York",1718,88750,975,149,0,229,0,279,56.8,8.7,0,13.3,0,16.2,43.2,712,411,301,57.72,42.28,26,385,31,270,57,655,6.3,10.3,8,"25% - 50% P.O.C.","$78000 - $104000"
"36047003100","Census Tract 31, Kings County, New York",3259,116250,1335,790,0,694,0,320,41,24.2,0,21.3,0,9.8,59,1139,632,507,55.49,44.51,0,632,0,507,0,1139,0,0,0,"50% - 75% P.O.C.","$104000 or more"
"36047003300","Census Tract 33, Kings County, New York",4202,136250,1860,1235,0,480,0,349,44.3,29.4,0,11.4,0,8.3,55.7,2160,385,1775,17.82,82.18,45,340,40,1735,85,2075,11.7,2.3,3.9,"50% - 75% P.O.C.","$104000 or more"
"36047003400","Census Tract 34, Kings County, New York",3161,78833,1647,182,0,779,0,513,52.1,5.8,0,24.6,0,16.2,47.9,1222,652,570,53.36,46.64,99,553,39,531,138,1084,15.2,6.8,11.3,"25% - 50% P.O.C.","$78000 - $104000"
"36047003500","Census Tract 35, Kings County, New York",1907,112917,890,522,0,194,0,183,46.7,27.4,0,10.2,0,9.6,53.3,1000,224,776,22.4,77.6,3,221,8,768,11,989,1.3,1,1.1,"50% - 75% P.O.C.","$104000 or more"
"36047003600","Census Tract 36, Kings County, New York",3500,69632,2061,57,0,628,0,658,58.9,1.6,0,17.9,0,18.8,41.1,1753,811,942,46.26,53.74,28,783,48,894,76,1677,3.5,5.1,4.3,"25% - 50% P.O.C.","$55000 - $78000"
"36047003700","Census Tract 37, Kings County, New York",2250,155682,1404,221,0,361,0,149,62.4,9.8,0,16,0,6.6,37.6,1184,204,980,17.23,82.77,0,204,23,957,23,1161,0,2.3,1.9,"25% - 50% P.O.C.","$104000 or more"
"36047003800","Census Tract 38, Kings County, New York",1371,81576,914,0,0,278,0,65,66.7,0,0,20.3,0,4.7,33.3,605,406,199,67.11,32.89,67,339,0,199,67,538,16.5,0,11.1,"25% - 50% P.O.C.","$78000 - $104000"
"36047003900","Census Tract 39, Kings County, New York",2262,105000,1252,194,0,374,0,309,55.3,8.6,0,16.5,0,13.7,44.7,1104,316,788,28.62,71.38,11,305,21,767,32,1072,3.5,2.7,2.9,"25% - 50% P.O.C.","$104000 or more"
"36047004100","Census Tract 41, Kings County, New York",3654,166339,2518,358,0,267,0,335,68.9,9.8,0,7.3,0,9.2,31.1,1359,492,867,36.2,63.8,40,452,19,848,59,1300,8.1,2.2,4.3,"25% - 50% P.O.C.","$104000 or more"
"36047004300","Census Tract 43, Kings County, New York",3727,137095,2262,316,0,406,27,526,60.7,8.5,0,10.9,0.7,14.1,39.3,1714,485,1229,28.3,71.7,15,470,46,1183,61,1653,3.1,3.7,3.6,"25% - 50% P.O.C.","$104000 or more"
"36047004400","Census Tract 44, Kings County, New York",2518,118594,2034,10,0,253,0,213,80.8,0.4,0,10,0,8.5,19.2,990,769,221,77.68,22.32,65,704,7,214,72,918,8.5,3.2,7.3,"Less than 25% P.O.C.","$104000 or more"
"36047004500","Census Tract 45, Kings County, New York",3385,148064,2651,113,0,340,0,125,78.3,3.3,0,10,0,3.7,21.7,1649,680,969,41.24,58.76,46,634,23,946,69,1580,6.8,2.4,4.2,"Less than 25% P.O.C.","$104000 or more"
"36047004600","Census Tract 46, Kings County, New York",1301,131806,997,0,0,115,0,189,76.6,0,0,8.8,0,14.5,23.4,501,419,82,83.63,16.37,50,369,6,76,56,445,11.9,7.3,11.2,"Less than 25% P.O.C.","$104000 or more"
"36047004700","Census Tract 47, Kings County, New York",1877,119500,1106,280,0,104,0,282,58.9,14.9,0,5.5,0,15,41.1,770,265,505,34.42,65.58,18,247,12,493,30,740,6.8,2.4,3.9,"25% - 50% P.O.C.","$104000 or more"
"36047004900","Census Tract 49, Kings County, New York",2612,134706,1514,395,0,211,0,332,58,15.1,0,8.1,0,12.7,42,976,421,555,43.14,56.86,12,409,8,547,20,956,2.9,1.4,2,"25% - 50% P.O.C.","$104000 or more"
"36047005000","Census Tract 50, Kings County, New York",2260,131042,1753,34,0,218,0,244,77.6,1.5,0,9.6,0,10.8,22.4,988,605,383,61.23,38.77,74,531,9,374,83,905,12.2,2.3,8.4,"Less than 25% P.O.C.","$104000 or more"
"36047005100","Census Tract 51, Kings County, New York",2744,147188,1989,36,0,162,0,221,72.5,1.3,0,5.9,0,8.1,27.5,1047,530,517,50.62,49.38,73,457,21,496,94,953,13.8,4.1,9,"25% - 50% P.O.C.","$104000 or more"
"36047005201","Census Tract 52.01, Kings County, New York",1707,NA,1108,18,15,335,0,207,64.9,1.1,0.9,19.6,0,12.1,35.1,1066,211,855,19.79,80.21,37,174,16,839,53,1013,17.5,1.9,5,"25% - 50% P.O.C.","N/A"
"36047005202","Census Tract 52.02, Kings County, New York",2442,77240,2095,44,0,52,0,212,85.8,1.8,0,2.1,0,8.7,14.2,1324,620,704,46.83,53.17,23,597,0,704,23,1301,3.7,0,1.7,"Less than 25% P.O.C.","$55000 - $78000"
"36047005300","Census Tract 53, Kings County, New York",2167,104583,1254,222,0,68,0,527,57.9,10.2,0,3.1,0,24.3,42.1,914,289,625,31.62,68.38,35,254,42,583,77,837,12.1,6.7,8.4,"25% - 50% P.O.C.","$104000 or more"
"36047005400","Census Tract 54, Kings County, New York",3185,77569,2190,68,27,543,0,292,68.8,2.1,0.8,17,0,9.2,31.2,1614,490,1124,30.36,69.64,40,450,16,1108,56,1558,8.2,1.4,3.5,"25% - 50% P.O.C.","$55000 - $78000"
"36047005601","Census Tract 56.01, Kings County, New York",2447,85923,1745,146,0,161,0,351,71.3,6,0,6.6,0,14.3,28.7,1333,577,756,43.29,56.71,6,571,43,713,49,1284,1,5.7,3.7,"25% - 50% P.O.C.","$78000 - $104000"
"36047005602","Census Tract 56.02, Kings County, New York",1687,74167,1070,17,0,198,0,368,63.4,1,0,11.7,0,21.8,36.6,858,377,481,43.94,56.06,40,337,11,470,51,807,10.6,2.3,5.9,"25% - 50% P.O.C.","$55000 - $78000"
"36047005800","Census Tract 58, Kings County, New York",2827,64875,1855,26,0,331,0,527,65.6,0.9,0,11.7,0,18.6,34.4,1403,355,1048,25.3,74.7,30,325,49,999,79,1324,8.5,4.7,5.6,"25% - 50% P.O.C.","$55000 - $78000"
"36047005900","Census Tract 59, Kings County, New York",1213,71042,722,120,0,19,0,310,59.5,9.9,0,1.6,0,25.6,40.5,561,44,517,7.84,92.16,0,44,18,499,18,543,0,3.5,3.2,"25% - 50% P.O.C.","$55000 - $78000"
"36047006000","Census Tract 60, Kings County, New York",3148,100324,1586,0,0,460,0,1016,50.4,0,0,14.6,0,32.3,49.6,1032,324,708,31.4,68.6,19,305,185,523,204,828,5.9,26.1,19.8,"25% - 50% P.O.C.","$78000 - $104000"
"36047006200","Census Tract 62, Kings County, New York",2676,83387,1668,46,0,472,0,453,62.3,1.7,0,17.6,0,16.9,37.7,1128,310,818,27.48,72.52,58,252,63,755,121,1007,18.7,7.7,10.7,"25% - 50% P.O.C.","$78000 - $104000"
"36047006300","Census Tract 63, Kings County, New York",1866,124853,1468,27,0,129,0,120,78.7,1.4,0,6.9,0,6.4,21.3,874,245,629,28.03,71.97,0,245,14,615,14,860,0,2.2,1.6,"Less than 25% P.O.C.","$104000 or more"
"36047006400","Census Tract 64, Kings County, New York",3042,76694,2277,29,0,243,0,427,74.9,1,0,8,0,14,25.1,1336,672,664,50.3,49.7,45,627,16,648,61,1275,6.7,2.4,4.6,"25% - 50% P.O.C.","$55000 - $78000"
"36047006500","Census Tract 65, Kings County, New York",5976,165859,4977,104,0,262,0,409,83.3,1.7,0,4.4,0,6.8,16.7,2467,1042,1425,42.24,57.76,53,989,20,1405,73,2394,5.1,1.4,3,"Less than 25% P.O.C.","$104000 or more"
"36047006600","Census Tract 66, Kings County, New York",3542,70250,2289,39,0,439,0,679,64.6,1.1,0,12.4,0,19.2,35.4,1569,370,1199,23.58,76.42,59,311,39,1160,98,1471,15.9,3.3,6.2,"25% - 50% P.O.C.","$55000 - $78000"
"36047006700","Census Tract 67, Kings County, New York",3886,171477,3220,83,0,109,0,352,82.9,2.1,0,2.8,0,9.1,17.1,1463,652,811,44.57,55.43,68,584,7,804,75,1388,10.4,0.9,5.1,"Less than 25% P.O.C.","$104000 or more"
"36047006800","Census Tract 68, Kings County, New York",4900,56768,2020,58,0,1026,0,1681,41.2,1.2,0,20.9,0,34.3,58.8,1773,447,1326,25.21,74.79,58,389,176,1150,234,1539,13,13.3,13.2,"50% - 75% P.O.C.","$55000 - $78000"
"36047006900","Census Tract 69, Kings County, New York",3591,154625,2870,147,0,188,0,252,79.9,4.1,0,5.2,0,7,20.1,1658,531,1127,32.03,67.97,41,490,19,1108,60,1598,7.7,1.7,3.6,"Less than 25% P.O.C.","$104000 or more"
"36047007000","Census Tract 70, Kings County, New York",2538,78906,1371,126,59,536,0,325,54,5,2.3,21.1,0,12.8,46,1051,648,403,61.66,38.34,85,563,9,394,94,957,13.1,2.2,8.9,"25% - 50% P.O.C.","$78000 - $104000"
"36047007100","Census Tract 71, Kings County, New York",5050,40938,907,1631,0,226,0,2131,18,32.3,0,4.5,0,42.2,82,1803,269,1534,14.92,85.08,22,247,141,1393,163,1640,8.2,9.2,9,"75% or more P.O.C.","Less than $55000"
"36047007200","Census Tract 72, Kings County, New York",1900,40574,154,31,6,378,0,1323,8.1,1.6,0.3,19.9,0,69.6,91.9,583,75,508,12.86,87.14,8,67,116,392,124,459,10.7,22.8,21.3,"75% or more P.O.C.","Less than $55000"
"36047007400","Census Tract 74, Kings County, New York",5259,33934,687,15,0,1418,0,3127,13.1,0.3,0,27,0,59.5,86.9,1443,399,1044,27.65,72.35,92,307,348,696,440,1003,23.1,33.3,30.5,"75% or more P.O.C.","Less than $55000"
"36047007500","Census Tract 75, Kings County, New York",4969,138188,3672,25,0,263,0,860,73.9,0.5,0,5.3,0,17.3,26.1,2081,1075,1006,51.66,48.34,60,1015,0,1006,60,2021,5.6,0,2.9,"25% - 50% P.O.C.","$104000 or more"
"36047007600","Census Tract 76, Kings County, New York",5151,42950,720,213,0,690,0,3481,14,4.1,0,13.4,0,67.6,86,1401,350,1051,24.98,75.02,75,275,285,766,360,1041,21.4,27.1,25.7,"75% or more P.O.C.","Less than $55000"
"36047007700","Census Tract 77, Kings County, New York",5159,151307,3440,170,30,549,0,629,66.7,3.3,0.6,10.6,0,12.2,33.3,2232,859,1373,38.49,61.51,35,824,53,1320,88,2144,4.1,3.9,3.9,"25% - 50% P.O.C.","$104000 or more"
"36047007800","Census Tract 78, Kings County, New York",5246,43792,476,38,0,709,0,4016,9.1,0.7,0,13.5,0,76.6,90.9,1465,287,1178,19.59,80.41,93,194,307,871,400,1065,32.4,26.1,27.3,"75% or more P.O.C.","Less than $55000"
"36047008000","Census Tract 80, Kings County, New York",3615,64225,665,58,0,346,0,2502,18.4,1.6,0,9.6,0,69.2,81.6,1134,413,721,36.42,63.58,118,295,89,632,207,927,28.6,12.3,18.3,"75% or more P.O.C.","$55000 - $78000"
"36047008200","Census Tract 82, Kings County, New York",3594,41831,573,153,0,473,0,2288,15.9,4.3,0,13.2,0,63.7,84.1,1297,190,1107,14.65,85.35,21,169,154,953,175,1122,11.1,13.9,13.5,"75% or more P.O.C.","Less than $55000"
"36047008400","Census Tract 84, Kings County, New York",3621,53304,573,87,0,251,0,2575,15.8,2.4,0,6.9,0,71.1,84.2,1169,227,942,19.42,80.58,14,213,225,717,239,930,6.2,23.9,20.4,"75% or more P.O.C.","Less than $55000"
"36047008500","Census Tract 85, Kings County, New York",7793,15283,66,4194,0,413,303,2702,0.8,53.8,0,5.3,3.9,34.7,99.2,3119,0,3119,0,100,0,0,321,2798,321,2798,NA,10.3,10.3,"75% or more P.O.C.","Less than $55000"
"36047008600","Census Tract 86, Kings County, New York",0,NA,0,0,0,0,0,0,NA,NA,NA,NA,NA,NA,NA,0,0,0,NA,NA,0,0,0,0,0,0,NA,NA,NA,"N/A","N/A"
"36047008800","Census Tract 88, Kings County, New York",2235,64091,880,130,0,465,0,670,39.4,5.8,0,20.8,0,30,60.6,1082,484,598,44.73,55.27,32,452,18,580,50,1032,6.6,3,4.6,"50% - 75% P.O.C.","$55000 - $78000"
"36047009000","Census Tract 90, Kings County, New York",3000,47197,271,82,12,1027,0,1601,9,2.7,0.4,34.2,0,53.4,91,882,208,674,23.58,76.42,46,162,235,439,281,601,22.1,34.9,31.9,"75% or more P.O.C.","Less than $55000"
"36047009200","Census Tract 92, Kings County, New York",5322,46622,567,182,0,2389,0,2095,10.7,3.4,0,44.9,0,39.4,89.3,1667,384,1283,23.04,76.96,83,301,188,1095,271,1396,21.6,14.7,16.3,"75% or more P.O.C.","Less than $55000"
"36047009400","Census Tract 94, Kings County, New York",5066,51042,518,75,0,3428,0,888,10.2,1.5,0,67.7,0,17.5,89.8,1443,338,1105,23.42,76.58,137,201,318,787,455,988,40.5,28.8,31.5,"75% or more P.O.C.","Less than $55000"
"36047009600","Census Tract 96, Kings County, New York",6079,44671,877,98,0,1589,0,3260,14.4,1.6,0,26.1,0,53.6,85.6,1806,439,1367,24.31,75.69,36,403,453,914,489,1317,8.2,33.1,27.1,"75% or more P.O.C.","Less than $55000"
"36047009800","Census Tract 98, Kings County, New York",6479,46250,294,192,0,2663,0,3273,4.5,3,0,41.1,0,50.5,95.5,1687,342,1345,20.27,79.73,91,251,478,867,569,1118,26.6,35.5,33.7,"75% or more P.O.C.","Less than $55000"
"36047010000","Census Tract 100, Kings County, New York",6035,56512,565,57,0,3178,0,2207,9.4,0.9,0,52.7,0,36.6,90.6,1647,379,1268,23.01,76.99,90,289,394,874,484,1163,23.7,31.1,29.4,"75% or more P.O.C.","$55000 - $78000"
"36047010100","Census Tract 101, Kings County, New York",4001,75707,1014,141,0,488,0,2185,25.3,3.5,0,12.2,0,54.6,74.7,1415,451,964,31.87,68.13,51,400,127,837,178,1237,11.3,13.2,12.6,"50% - 75% P.O.C.","$55000 - $78000"
"36047010200","Census Tract 102, Kings County, New York",4698,56082,135,10,0,3363,0,1187,2.9,0.2,0,71.6,0,25.3,97.1,1239,349,890,28.17,71.83,116,233,295,595,411,828,33.2,33.1,33.2,"75% or more P.O.C.","$55000 - $78000"
"36047010400","Census Tract 104, Kings County, New York",4805,44288,385,29,0,4009,0,297,8,0.6,0,83.4,0,6.2,92,1395,406,989,29.1,70.9,81,325,322,667,403,992,20,32.6,28.9,"75% or more P.O.C.","Less than $55000"
"36047010600","Census Tract 106, Kings County, New York",4417,49702,281,33,0,3373,0,632,6.4,0.7,0,76.4,0,14.3,93.6,1215,287,928,23.62,76.38,47,240,303,625,350,865,16.4,32.7,28.8,"75% or more P.O.C.","Less than $55000"
"36047010800","Census Tract 108, Kings County, New York",3866,45082,303,49,0,2658,0,856,7.8,1.3,0,68.8,0,22.1,92.2,1291,321,970,24.86,75.14,30,291,213,757,243,1048,9.3,22,18.8,"75% or more P.O.C.","Less than $55000"
"36047011000","Census Tract 110, Kings County, New York",2662,61042,1012,14,0,692,0,885,38,0.5,0,26,0,33.2,62,599,236,363,39.4,60.6,107,129,141,222,248,351,45.3,38.8,41.4,"50% - 75% P.O.C.","$55000 - $78000"
"36047011200","Census Tract 112, Kings County, New York",6188,33673,2650,165,0,1529,0,1827,42.8,2.7,0,24.7,0,29.5,57.2,1926,315,1611,16.36,83.64,155,160,275,1336,430,1496,49.2,17.1,22.3,"50% - 75% P.O.C.","Less than $55000"
"36047011400","Census Tract 114, Kings County, New York",3796,47306,1916,288,0,1139,0,438,50.5,7.6,0,30,0,11.5,49.5,955,231,724,24.19,75.81,13,218,173,551,186,769,5.6,23.9,19.5,"25% - 50% P.O.C.","Less than $55000"
"36047011600","Census Tract 116, Kings County, New York",3594,40640,416,13,18,2790,0,346,11.6,0.4,0.5,77.6,0,9.6,88.4,1076,248,828,23.05,76.95,85,163,230,598,315,761,34.3,27.8,29.3,"75% or more P.O.C.","Less than $55000"
"36047011700","Census Tract 117, Kings County, New York",2677,101628,1426,221,34,298,0,563,53.3,8.3,1.3,11.1,0,21,46.7,1160,394,766,33.97,66.03,0,394,38,728,38,1122,0,5,3.3,"25% - 50% P.O.C.","$78000 - $104000"
"36047011800","Census Tract 118, Kings County, New York",2105,54236,92,0,0,1781,0,212,4.4,0,0,84.6,0,10.1,95.6,600,111,489,18.5,81.5,39,72,106,383,145,455,35.1,21.7,24.2,"75% or more P.O.C.","Less than $55000"
"36047011900","Census Tract 119, Kings County, New York",1322,93854,845,99,0,56,0,279,63.9,7.5,0,4.2,0,21.1,36.1,575,174,401,30.26,69.74,21,153,4,397,25,550,12.1,1,4.3,"25% - 50% P.O.C.","$78000 - $104000"
"36047012000","Census Tract 120, Kings County, New York",1213,50833,32,0,0,958,0,219,2.6,0,0,79,0,18.1,97.4,304,76,228,25,75,30,46,74,154,104,200,39.5,32.5,34.2,"75% or more P.O.C.","Less than $55000"
"36047012100","Census Tract 121, Kings County, New York",1962,98906,1035,101,0,187,0,595,52.8,5.1,0,9.5,0,30.3,47.2,845,271,574,32.07,67.93,27,244,17,557,44,801,10,3,5.2,"25% - 50% P.O.C.","$78000 - $104000"
"36047012200","Census Tract 122, Kings County, New York",5482,50384,431,0,4,2585,0,2451,7.9,0,0.1,47.2,0,44.7,92.1,1505,194,1311,12.89,87.11,52,142,426,885,478,1027,26.8,32.5,31.8,"75% or more P.O.C.","Less than $55000"
"36047012600","Census Tract 126, Kings County, New York",2838,53621,759,105,0,1000,0,792,26.7,3.7,0,35.2,0,27.9,73.3,870,271,599,31.15,68.85,62,209,145,454,207,663,22.9,24.2,23.8,"50% - 75% P.O.C.","Less than $55000"
"36047012700","Census Tract 127, Kings County, New York",4318,55145,1408,1802,0,230,0,822,32.6,41.7,0,5.3,0,19,67.4,1603,231,1372,14.41,85.59,38,193,111,1261,149,1454,16.5,8.1,9.3,"50% - 75% P.O.C.","$55000 - $78000"
"36047012801","Census Tract 128.01, Kings County, New York",2293,38580,684,41,0,1473,0,95,29.8,1.8,0,64.2,0,4.1,70.2,757,245,512,32.36,67.64,29,216,82,430,111,646,11.8,16,14.7,"50% - 75% P.O.C.","Less than $55000"
"36047012901","Census Tract 129.01, Kings County, New York",2387,119875,1474,192,0,155,0,448,61.8,8,0,6.5,0,18.8,38.2,1027,346,681,33.69,66.31,19,327,22,659,41,986,5.5,3.2,4,"25% - 50% P.O.C.","$104000 or more"
"36047012902","Census Tract 129.02, Kings County, New York",2554,127159,1479,367,0,162,0,409,57.9,14.4,0,6.3,0,16,42.1,1051,263,788,25.02,74.98,36,227,44,744,80,971,13.7,5.6,7.6,"25% - 50% P.O.C.","$104000 or more"
"36047013000","Census Tract 130, Kings County, New York",4615,77166,2279,236,0,840,0,1119,49.4,5.1,0,18.2,0,24.2,50.6,1687,386,1301,22.88,77.12,33,353,225,1076,258,1429,8.5,17.3,15.3,"50% - 75% P.O.C.","$55000 - $78000"
"36047013100","Census Tract 131, Kings County, New York",4155,147969,2411,294,0,416,18,705,58,7.1,0,10,0.4,17,42,1860,684,1176,36.77,63.23,45,639,48,1128,93,1767,6.6,4.1,5,"25% - 50% P.O.C.","$104000 or more"
"36047013200","Census Tract 132, Kings County, New York",2372,55865,780,0,0,1152,0,432,32.9,0,0,48.6,0,18.2,67.1,726,294,432,40.5,59.5,77,217,133,299,210,516,26.2,30.8,28.9,"50% - 75% P.O.C.","$55000 - $78000"
"36047013300","Census Tract 133, Kings County, New York",4454,192813,3011,236,0,447,0,426,67.6,5.3,0,10,0,9.6,32.4,1803,636,1167,35.27,64.73,44,592,27,1140,71,1732,6.9,2.3,3.9,"25% - 50% P.O.C.","$104000 or more"
"36047013400","Census Tract 134, Kings County, New York",4117,81774,2506,48,0,863,0,625,60.9,1.2,0,21,0,15.2,39.1,1494,671,823,44.91,55.09,78,593,126,697,204,1290,11.6,15.3,13.7,"25% - 50% P.O.C.","$78000 - $104000"
"36047013500","Census Tract 135, Kings County, New York",4014,156027,3000,56,0,461,0,215,74.7,1.4,0,11.5,0,5.4,25.3,1489,822,667,55.2,44.8,91,731,20,647,111,1378,11.1,3,7.5,"25% - 50% P.O.C.","$104000 or more"
"36047013600","Census Tract 136, Kings County, New York",3609,86165,2688,24,0,289,0,533,74.5,0.7,0,8,0,14.8,25.5,1357,710,647,52.32,47.68,143,567,77,570,220,1137,20.1,11.9,16.2,"25% - 50% P.O.C.","$78000 - $104000"
"36047013700","Census Tract 137, Kings County, New York",3554,116438,2178,327,0,322,0,559,61.3,9.2,0,9.1,0,15.7,38.7,1496,396,1100,26.47,73.53,17,379,18,1082,35,1461,4.3,1.6,2.3,"25% - 50% P.O.C.","$104000 or more"
"36047013800","Census Tract 138, Kings County, New York",3169,60950,1955,121,0,422,0,619,61.7,3.8,0,13.3,0,19.5,38.3,1261,307,954,24.35,75.65,102,205,86,868,188,1073,33.2,9,14.9,"25% - 50% P.O.C.","$55000 - $78000"
"36047013900","Census Tract 139, Kings County, New York",3650,143169,2381,352,0,189,0,473,65.2,9.6,0,5.2,0,13,34.8,1459,353,1106,24.19,75.81,0,353,19,1087,19,1440,0,1.7,1.3,"25% - 50% P.O.C.","$104000 or more"
"36047014000","Census Tract 140, Kings County, New York",1986,69750,1231,140,0,345,0,270,62,7,0,17.4,0,13.6,38,829,311,518,37.52,62.48,81,230,21,497,102,727,26,4.1,12.3,"25% - 50% P.O.C.","$55000 - $78000"
"36047014100","Census Tract 141, Kings County, New York",2766,101250,1598,95,0,294,0,564,57.8,3.4,0,10.6,0,20.4,42.2,1302,375,927,28.8,71.2,24,351,35,892,59,1243,6.4,3.8,4.5,"25% - 50% P.O.C.","$78000 - $104000"
"36047014200","Census Tract 142, Kings County, New York",3051,58558,1832,48,26,432,0,541,60,1.6,0.9,14.2,0,17.7,40,1246,421,825,33.79,66.21,65,356,43,782,108,1138,15.4,5.2,8.7,"25% - 50% P.O.C.","$55000 - $78000"
"36047014300","Census Tract 143, Kings County, New York",3672,110329,1801,99,0,235,0,1271,49,2.7,0,6.4,0,34.6,51,1468,364,1104,24.8,75.2,59,305,55,1049,114,1354,16.2,5,7.8,"50% - 75% P.O.C.","$104000 or more"
"36047014500","Census Tract 145, Kings County, New York",3815,87543,2108,15,30,220,0,1299,55.3,0.4,0.8,5.8,0,34,44.7,1727,376,1351,21.77,78.23,19,357,37,1314,56,1671,5.1,2.7,3.2,"25% - 50% P.O.C.","$78000 - $104000"
"36047014700","Census Tract 147, Kings County, New York",2408,97589,1226,50,0,120,0,922,50.9,2.1,0,5,0,38.3,49.1,869,349,520,40.16,59.84,39,310,36,484,75,794,11.2,6.9,8.6,"25% - 50% P.O.C.","$78000 - $104000"
"36047014800","Census Tract 148, Kings County, New York",1213,83068,852,0,0,152,0,203,70.2,0,0,12.5,0,16.7,29.8,433,306,127,70.67,29.33,28,278,14,113,42,391,9.2,11,9.7,"25% - 50% P.O.C.","$78000 - $104000"
"36047014900","Census Tract 149, Kings County, New York",5859,140481,3898,50,0,540,0,1213,66.5,0.9,0,9.2,0,20.7,33.5,2137,967,1170,45.25,54.75,59,908,74,1096,133,2004,6.1,6.3,6.2,"25% - 50% P.O.C.","$104000 or more"
"36047015000","Census Tract 150, Kings County, New York",1598,76083,1062,5,0,376,0,129,66.5,0.3,0,23.5,0,8.1,33.5,629,377,252,59.94,40.06,72,305,12,240,84,545,19.1,4.8,13.4,"25% - 50% P.O.C.","$55000 - $78000"
"36047015100","Census Tract 151, Kings County, New York",4240,146458,2892,83,0,361,0,548,68.2,2,0,8.5,0,12.9,31.8,1683,894,789,53.12,46.88,43,851,0,789,43,1640,4.8,0,2.6,"25% - 50% P.O.C.","$104000 or more"
"36047015200","Census Tract 152, Kings County, New York",2499,92650,1424,106,0,615,0,336,57,4.2,0,24.6,0,13.4,43,879,532,347,60.52,39.48,61,471,48,299,109,770,11.5,13.8,12.4,"25% - 50% P.O.C.","$78000 - $104000"
"36047015300","Census Tract 153, Kings County, New York",2622,138594,1850,79,0,188,0,385,70.6,3,0,7.2,0,14.7,29.4,1099,481,618,43.77,56.23,24,457,9,609,33,1066,5,1.5,3,"25% - 50% P.O.C.","$104000 or more"
"36047015400","Census Tract 154, Kings County, New York",11,NA,0,11,0,0,0,0,0,100,0,0,0,0,100,11,11,0,100,0,0,11,0,0,0,11,0,NA,0,"75% or more P.O.C.","N/A"
"36047015500","Census Tract 155, Kings County, New York",3993,163967,3016,321,0,88,0,396,75.5,8,0,2.2,0,9.9,24.5,1547,846,701,54.69,45.31,90,756,30,671,120,1427,10.6,4.3,7.8,"Less than 25% P.O.C.","$104000 or more"
"36047015700","Census Tract 157, Kings County, New York",4111,123008,2963,225,0,420,0,304,72.1,5.5,0,10.2,0,7.4,27.9,2017,983,1034,48.74,51.26,20,963,15,1019,35,1982,2,1.5,1.7,"25% - 50% P.O.C.","$104000 or more"
"36047015900","Census Tract 159, Kings County, New York",4804,149900,3710,200,0,436,0,224,77.2,4.2,0,9.1,0,4.7,22.8,2246,1168,1078,52,48,13,1155,18,1060,31,2215,1.1,1.7,1.4,"Less than 25% P.O.C.","$104000 or more"
"36047016000","Census Tract 160, Kings County, New York",3965,82837,2114,155,0,835,26,761,53.3,3.9,0,21.1,0.7,19.2,46.7,1502,367,1135,24.43,75.57,37,330,219,916,256,1246,10.1,19.3,17,"25% - 50% P.O.C.","$78000 - $104000"
"36047016100","Census Tract 161, Kings County, New York",3595,150469,2075,394,6,250,0,717,57.7,11,0.2,7,0,19.9,42.3,1411,562,849,39.83,60.17,45,517,69,780,114,1297,8,8.1,8.1,"25% - 50% P.O.C.","$104000 or more"
"36047016200","Census Tract 162, Kings County, New York",2294,80590,1426,121,0,60,0,628,62.2,5.3,0,2.6,0,27.4,37.8,1154,374,780,32.41,67.59,38,336,14,766,52,1102,10.2,1.8,4.5,"25% - 50% P.O.C.","$78000 - $104000"
"36047016300","Census Tract 163, Kings County, New York",3388,101688,2391,487,0,148,0,216,70.6,14.4,0,4.4,0,6.4,29.4,1532,522,1010,34.07,65.93,8,514,10,1000,18,1514,1.5,1,1.2,"25% - 50% P.O.C.","$78000 - $104000"
"36047016400","Census Tract 164, Kings County, New York",1264,106570,472,459,0,52,23,153,37.3,36.3,0,4.1,1.8,12.1,62.7,335,26,309,7.76,92.24,0,26,41,268,41,294,0,13.3,12.2,"50% - 75% P.O.C.","$104000 or more"
"36047016500","Census Tract 165, Kings County, New York",5919,173939,4580,195,20,453,0,340,77.4,3.3,0.3,7.7,0,5.7,22.6,2361,1421,940,60.19,39.81,98,1323,40,900,138,2223,6.9,4.3,5.8,"Less than 25% P.O.C.","$104000 or more"
"36047016600","Census Tract 166, Kings County, New York",1791,113527,1462,0,0,206,0,109,81.6,0,0,11.5,0,6.1,18.4,663,595,68,89.74,10.26,52,543,0,68,52,611,8.7,0,7.8,"Less than 25% P.O.C.","$104000 or more"
"36047016700","Census Tract 167, Kings County, New York",5422,173113,4304,130,0,328,0,487,79.4,2.4,0,6,0,9,20.6,2150,932,1218,43.35,56.65,56,876,0,1218,56,2094,6,0,2.6,"Less than 25% P.O.C.","$104000 or more"
"36047016800","Census Tract 168, Kings County, New York",1905,88750,991,0,0,725,0,148,52,0,0,38.1,0,7.8,48,750,550,200,73.33,26.67,113,437,0,200,113,637,20.5,0,15.1,"25% - 50% P.O.C.","$78000 - $104000"
"36047016900","Census Tract 169, Kings County, New York",4822,117256,3546,20,0,433,0,591,73.5,0.4,0,9,0,12.3,26.5,2092,568,1524,27.15,72.85,134,434,0,1524,134,1958,23.6,0,6.4,"25% - 50% P.O.C.","$104000 or more"
"36047017000","Census Tract 170, Kings County, New York",3484,76857,1341,40,0,1508,0,595,38.5,1.1,0,43.3,0,17.1,61.5,1132,579,553,51.15,48.85,101,478,88,465,189,943,17.4,15.9,16.7,"50% - 75% P.O.C.","$55000 - $78000"
"36047017100","Census Tract 171, Kings County, New York",4069,134821,3052,33,0,334,0,474,75,0.8,0,8.2,0,11.6,25,1549,880,669,56.81,43.19,50,830,0,669,50,1499,5.7,0,3.2,"25% - 50% P.O.C.","$104000 or more"
"36047017200","Census Tract 172, Kings County, New York",3262,82869,1039,1,0,1542,14,628,31.9,0,0,47.3,0.4,19.3,68.1,1053,465,588,44.16,55.84,99,366,117,471,216,837,21.3,19.9,20.5,"50% - 75% P.O.C.","$78000 - $104000"
"36047017400","Census Tract 174, Kings County, New York",2191,99750,1095,0,10,767,0,270,50,0,0.5,35,0,12.3,50,709,477,232,67.28,32.72,76,401,33,199,109,600,15.9,14.2,15.4,"50% - 75% P.O.C.","$78000 - $104000"
"36047017500","Census Tract 175, Kings County, New York",0,NA,0,0,0,0,0,0,NA,NA,NA,NA,NA,NA,NA,0,0,0,NA,NA,0,0,0,0,0,0,NA,NA,NA,"N/A","N/A"
"36047017600","Census Tract 176, Kings County, New York",2413,63981,1346,23,0,634,0,380,55.8,1,0,26.3,0,15.7,44.2,886,462,424,52.14,47.86,69,393,36,388,105,781,14.9,8.5,11.9,"25% - 50% P.O.C.","$55000 - $78000"
"36047017700","Census Tract 177, Kings County, New York",0,NA,0,0,0,0,0,0,NA,NA,NA,NA,NA,NA,NA,0,0,0,NA,NA,0,0,0,0,0,0,NA,NA,NA,"N/A","N/A"
"36047017800","Census Tract 178, Kings County, New York",3073,70491,750,76,0,1168,5,1061,24.4,2.5,0,38,0.2,34.5,75.6,882,306,576,34.69,65.31,38,268,171,405,209,673,12.4,29.7,23.7,"75% or more P.O.C.","$55000 - $78000"
"36047017900","Census Tract 179, Kings County, New York",4348,61311,947,2197,0,336,0,555,21.8,50.5,0,7.7,0,12.8,78.2,1657,429,1228,25.89,74.11,139,290,10,1218,149,1508,32.4,0.8,9,"75% or more P.O.C.","$55000 - $78000"
"36047018000","Census Tract 180, Kings County, New York",3518,68690,1142,0,0,1433,0,929,32.5,0,0,40.7,0,26.4,67.5,1084,520,564,47.97,52.03,132,388,97,467,229,855,25.4,17.2,21.1,"50% - 75% P.O.C.","$55000 - $78000"
"36047018100","Census Tract 181, Kings County, New York",3691,96452,2053,1023,0,230,0,224,55.6,27.7,0,6.2,0,6.1,44.4,2031,716,1315,35.25,64.75,33,683,15,1300,48,1983,4.6,1.1,2.4,"25% - 50% P.O.C.","$78000 - $104000"
"36047018200","Census Tract 182, Kings County, New York",3501,53625,1090,60,0,1767,0,505,31.1,1.7,0,50.5,0,14.4,68.9,1201,476,725,39.63,60.37,99,377,92,633,191,1010,20.8,12.7,15.9,"50% - 75% P.O.C.","Less than $55000"
"36047018300","Census Tract 183, Kings County, New York",2675,126507,1768,463,0,124,0,121,66.1,17.3,0,4.6,0,4.5,33.9,1226,400,826,32.63,67.37,32,368,10,816,42,1184,8,1.2,3.4,"25% - 50% P.O.C.","$104000 or more"
"36047018400","Census Tract 184, Kings County, New York",2617,63333,1152,0,0,1268,0,169,44,0,0,48.5,0,6.5,56,848,566,282,66.75,33.25,112,454,34,248,146,702,19.8,12.1,17.2,"50% - 75% P.O.C.","$55000 - $78000"
"36047018501","Census Tract 185.01, Kings County, New York",4153,26130,330,2158,37,206,0,1351,7.9,52,0.9,5,0,32.5,92.1,1792,23,1769,1.28,98.72,0,23,191,1578,191,1601,0,10.8,10.7,"75% or more P.O.C.","Less than $55000"
"36047018600","Census Tract 186, Kings County, New York",2155,55000,1148,0,0,855,0,148,53.3,0,0,39.7,0,6.9,46.7,726,374,352,51.52,48.48,67,307,29,323,96,630,17.9,8.2,13.2,"25% - 50% P.O.C.","$55000 - $78000"
"36047018700","Census Tract 187, Kings County, New York",1488,108661,650,223,0,172,0,329,43.7,15,0,11.6,0,22.1,56.3,521,99,422,19,81,22,77,31,391,53,468,22.2,7.3,10.2,"50% - 75% P.O.C.","$104000 or more"
"36047018800","Census Tract 188, Kings County, New York",2836,76422,1477,9,0,1097,0,196,52.1,0.3,0,38.7,0,6.9,47.9,967,494,473,51.09,48.91,79,415,23,450,102,865,16,4.9,10.5,"25% - 50% P.O.C.","$55000 - $78000"
"36047019000","Census Tract 190, Kings County, New York",4763,50875,1377,51,0,2001,0,1324,28.9,1.1,0,42,0,27.8,71.1,1556,553,1003,35.54,64.46,99,454,142,861,241,1315,17.9,14.2,15.5,"50% - 75% P.O.C.","Less than $55000"
"36047019100","Census Tract 191, Kings County, New York",2972,89176,1499,613,0,301,0,425,50.4,20.6,0,10.1,0,14.3,49.6,1113,356,757,31.99,68.01,26,330,32,725,58,1055,7.3,4.2,5.2,"25% - 50% P.O.C.","$78000 - $104000"
"36047019200","Census Tract 192, Kings County, New York",2934,42828,1084,23,28,1262,0,537,36.9,0.8,1,43,0,18.3,63.1,782,333,449,42.58,57.42,95,238,126,323,221,561,28.5,28.1,28.3,"50% - 75% P.O.C.","Less than $55000"
"36047019300","Census Tract 193, Kings County, New York",5882,55389,2034,2176,10,683,4,879,34.6,37,0.2,11.6,0.1,14.9,65.4,2311,1127,1184,48.77,51.23,25,1102,30,1154,55,2256,2.2,2.5,2.4,"50% - 75% P.O.C.","$55000 - $78000"
"36047019400","Census Tract 194, Kings County, New York",4027,44258,816,7,0,1963,0,1225,20.3,0.2,0,48.7,0,30.4,79.7,1139,376,763,33.01,66.99,50,326,212,551,262,877,13.3,27.8,23,"75% or more P.O.C.","Less than $55000"
"36047019500","Census Tract 195, Kings County, New York",3441,99853,1847,1000,0,130,0,319,53.7,29.1,0,3.8,0,9.3,46.3,1740,931,809,53.51,46.49,11,920,18,791,29,1711,1.2,2.2,1.7,"25% - 50% P.O.C.","$78000 - $104000"
"36047019600","Census Tract 196, Kings County, New York",4214,47389,1441,50,0,1661,0,1012,34.2,1.2,0,39.4,0,24,65.8,1425,432,993,30.32,69.68,101,331,64,929,165,1260,23.4,6.4,11.6,"50% - 75% P.O.C.","Less than $55000"
"36047019700","Census Tract 197, Kings County, New York",3714,118958,2030,1090,0,243,0,234,54.7,29.3,0,6.5,0,6.3,45.3,1638,895,743,54.64,45.36,1,894,10,733,11,1627,0.1,1.3,0.7,"25% - 50% P.O.C.","$104000 or more"
"36047019800","Census Tract 198, Kings County, New York",1926,67813,785,0,0,801,0,318,40.8,0,0,41.6,0,16.5,59.2,614,317,297,51.63,48.37,56,261,49,248,105,509,17.7,16.5,17.1,"50% - 75% P.O.C.","$55000 - $78000"
"36047019900","Census Tract 199, Kings County, New York",3432,108333,1861,849,0,144,0,484,54.2,24.7,0,4.2,0,14.1,45.8,1540,346,1194,22.47,77.53,55,291,19,1175,74,1466,15.9,1.6,4.8,"25% - 50% P.O.C.","$104000 or more"
"36047020000","Census Tract 200, Kings County, New York",2417,75438,1030,14,0,889,0,484,42.6,0.6,0,36.8,0,20,57.4,755,427,328,56.56,43.44,83,344,47,281,130,625,19.4,14.3,17.2,"50% - 75% P.O.C.","$55000 - $78000"
"36047020100","Census Tract 201, Kings County, New York",3945,118285,2261,1018,0,195,0,174,57.3,25.8,0,4.9,0,4.4,42.7,1791,576,1215,32.16,67.84,91,485,45,1170,136,1655,15.8,3.7,7.6,"25% - 50% P.O.C.","$104000 or more"
"36047020200","Census Tract 202, Kings County, New York",1963,89000,1128,19,37,590,0,177,57.5,1,1.9,30.1,0,9,42.5,640,409,231,63.91,36.09,46,363,32,199,78,562,11.2,13.9,12.2,"25% - 50% P.O.C.","$78000 - $104000"
"36047020300","Census Tract 203, Kings County, New York",1826,123229,680,504,0,183,0,391,37.2,27.6,0,10,0,21.4,62.8,687,255,432,37.12,62.88,51,204,0,432,51,636,20,0,7.4,"50% - 75% P.O.C.","$104000 or more"
"36047020400","Census Tract 204, Kings County, New York",1837,102000,1251,0,0,487,22,49,68.1,0,0,26.5,1.2,2.7,31.9,656,498,158,75.91,24.09,67,431,11,147,78,578,13.5,7,11.9,"25% - 50% P.O.C.","$78000 - $104000"
"36047020500","Census Tract 205, Kings County, New York",3128,123274,1695,494,12,491,0,89,54.2,15.8,0.4,15.7,0,2.8,45.8,1415,457,958,32.3,67.7,24,433,22,936,46,1369,5.3,2.3,3.3,"25% - 50% P.O.C.","$104000 or more"
"36047020600","Census Tract 206, Kings County, New York",2311,101449,1347,11,0,626,0,301,58.3,0.5,0,27.1,0,13,41.7,831,515,316,61.97,38.03,53,462,53,263,106,725,10.3,16.8,12.8,"25% - 50% P.O.C.","$78000 - $104000"
"36047020700","Census Tract 207, Kings County, New York",4726,119462,2786,735,0,190,0,748,59,15.6,0,4,0,15.8,41,2255,914,1341,40.53,59.47,0,914,15,1326,15,2240,0,1.1,0.7,"25% - 50% P.O.C.","$104000 or more"
"36047020800","Census Tract 208, Kings County, New York",3092,62432,908,79,0,1743,0,140,29.4,2.6,0,56.4,0,4.5,70.6,957,395,562,41.27,58.73,109,286,59,503,168,789,27.6,10.5,17.6,"50% - 75% P.O.C.","$55000 - $78000"
"36047021000","Census Tract 210, Kings County, New York",3967,56875,1113,35,0,2210,0,484,28.1,0.9,0,55.7,0,12.2,71.9,1293,434,859,33.57,66.43,115,319,226,633,341,952,26.5,26.3,26.4,"50% - 75% P.O.C.","$55000 - $78000"
"36047021100","Census Tract 211, Kings County, New York",2206,49679,391,916,0,88,0,769,17.7,41.5,0,4,0,34.9,82.3,996,210,786,21.08,78.92,49,161,5,781,54,942,23.3,0.6,5.4,"75% or more P.O.C.","Less than $55000"
"36047021200","Census Tract 212, Kings County, New York",4334,44967,944,0,0,2713,0,647,21.8,0,0,62.6,0,14.9,78.2,1317,468,849,35.54,64.46,149,319,174,675,323,994,31.8,20.5,24.5,"75% or more P.O.C.","Less than $55000"
"36047021300","Census Tract 213, Kings County, New York",4113,52885,756,2888,0,36,0,301,18.4,70.2,0,0.9,0,7.3,81.6,1978,40,1938,2.02,97.98,0,40,0,1938,0,1978,0,0,0,"75% or more P.O.C.","Less than $55000"
"36047021400","Census Tract 214, Kings County, New York",2187,57875,1153,0,0,762,0,272,52.7,0,0,34.8,0,12.4,47.3,524,207,317,39.5,60.5,93,114,134,183,227,297,44.9,42.3,43.3,"25% - 50% P.O.C.","$55000 - $78000"
"36047021500","Census Tract 215, Kings County, New York",5638,86534,2286,2026,22,375,0,358,40.5,35.9,0.4,6.7,0,6.3,59.5,2491,802,1689,32.2,67.8,106,696,49,1640,155,2336,13.2,2.9,6.2,"50% - 75% P.O.C.","$78000 - $104000"
"36047021600","Census Tract 216, Kings County, New York",4022,48716,3251,0,0,309,0,462,80.8,0,0,7.7,0,11.5,19.2,836,267,569,31.94,68.06,134,133,198,371,332,504,50.2,34.8,39.7,"Less than 25% P.O.C.","Less than $55000"
"36047021700","Census Tract 217, Kings County, New York",3733,61466,820,1756,0,256,0,679,22,47,0,6.9,0,18.2,78,1684,235,1449,13.95,86.05,17,218,92,1357,109,1575,7.2,6.3,6.5,"75% or more P.O.C.","$55000 - $78000"
"36047021800","Census Tract 218, Kings County, New York",3128,31047,2755,0,0,144,0,229,88.1,0,0,4.6,0,7.3,11.9,864,374,490,43.29,56.71,105,269,156,334,261,603,28.1,31.8,30.2,"Less than 25% P.O.C.","Less than $55000"
"36047021900","Census Tract 219, Kings County, New York",3557,72440,1017,1927,0,265,0,284,28.6,54.2,0,7.5,0,8,71.4,1573,241,1332,15.32,84.68,33,208,80,1252,113,1460,13.7,6,7.2,"50% - 75% P.O.C.","$55000 - $78000"
"36047022000","Census Tract 220, Kings County, New York",4776,32088,3816,256,0,296,0,155,79.9,5.4,0,6.2,0,3.2,20.1,1188,325,863,27.36,72.64,63,262,363,500,426,762,19.4,42.1,35.9,"Less than 25% P.O.C.","Less than $55000"
"36047022100","Census Tract 221, Kings County, New York",3976,54898,1459,1724,0,195,0,472,36.7,43.4,0,4.9,0,11.9,63.3,1584,221,1363,13.95,86.05,62,159,83,1280,145,1439,28.1,6.1,9.2,"50% - 75% P.O.C.","Less than $55000"
"36047022200","Census Tract 222, Kings County, New York",4008,33088,3745,0,0,121,0,142,93.4,0,0,3,0,3.5,6.6,1026,263,763,25.63,74.37,76,187,247,516,323,703,28.9,32.4,31.5,"Less than 25% P.O.C.","Less than $55000"
"36047022400","Census Tract 224, Kings County, New York",5785,47995,4180,7,0,968,0,630,72.3,0.1,0,16.7,0,10.9,27.7,1339,270,1069,20.16,79.84,100,170,369,700,469,870,37,34.5,35,"25% - 50% P.O.C.","Less than $55000"
"36047022600","Census Tract 226, Kings County, New York",2233,46611,899,58,0,258,0,935,40.3,2.6,0,11.6,0,41.9,59.7,593,120,473,20.24,79.76,32,88,108,365,140,453,26.7,22.8,23.6,"50% - 75% P.O.C.","Less than $55000"
"36047022700","Census Tract 227, Kings County, New York",3794,95882,1446,1614,0,179,10,266,38.1,42.5,0,4.7,0.3,7,61.9,1712,471,1241,27.51,72.49,63,408,34,1207,97,1615,13.4,2.7,5.7,"50% - 75% P.O.C.","$78000 - $104000"
"36047022800","Census Tract 228, Kings County, New York",3627,35985,2374,108,0,759,0,294,65.5,3,0,20.9,0,8.1,34.5,862,277,585,32.13,67.87,138,139,177,408,315,547,49.8,30.3,36.5,"25% - 50% P.O.C.","Less than $55000"
"36047022900","Census Tract 229, Kings County, New York",3675,83043,1524,1500,0,293,0,283,41.5,40.8,0,8,0,7.7,58.5,1724,468,1256,27.15,72.85,49,419,52,1204,101,1623,10.5,4.1,5.9,"50% - 75% P.O.C.","$78000 - $104000"
"36047023000","Census Tract 230, Kings County, New York",4251,43459,3571,89,0,150,0,432,84,2.1,0,3.5,0,10.2,16,929,235,694,25.3,74.7,138,97,277,417,415,514,58.7,39.9,44.7,"Less than 25% P.O.C.","Less than $55000"
"36047023100","Census Tract 231, Kings County, New York",3696,91047,1518,1228,0,145,0,518,41.1,33.2,0,3.9,0,14,58.9,1614,558,1056,34.57,65.43,88,470,12,1044,100,1514,15.8,1.1,6.2,"50% - 75% P.O.C.","$78000 - $104000"
"36047023200","Census Tract 232, Kings County, New York",5561,38818,4468,0,28,297,0,732,80.3,0,0.5,5.3,0,13.2,19.7,1224,360,864,29.41,70.59,184,176,308,556,492,732,51.1,35.6,40.2,"Less than 25% P.O.C.","Less than $55000"
"36047023300","Census Tract 233, Kings County, New York",5884,57721,1713,2511,0,354,0,1088,29.1,42.7,0,6,0,18.5,70.9,2221,504,1717,22.69,77.31,20,484,258,1459,278,1943,4,15,12.5,"50% - 75% P.O.C.","$55000 - $78000"
"36047023400","Census Tract 234, Kings County, New York",4563,32237,4333,13,15,10,0,192,95,0.3,0.3,0.2,0,4.2,5,1170,138,1032,11.79,88.21,10,128,414,618,424,746,7.2,40.1,36.2,"Less than 25% P.O.C.","Less than $55000"
"36047023500","Census Tract 235, Kings County, New York",4694,61607,2835,669,0,140,0,969,60.4,14.3,0,3,0,20.6,39.6,1493,362,1131,24.25,75.75,58,304,213,918,271,1222,16,18.8,18.2,"25% - 50% P.O.C.","$55000 - $78000"
"36047023600","Census Tract 236, Kings County, New York",5549,26855,5170,0,45,207,0,66,93.2,0,0.8,3.7,0,1.2,6.8,1470,100,1370,6.8,93.2,10,90,443,927,453,1017,10,32.3,30.8,"Less than 25% P.O.C.","Less than $55000"
"36047023800","Census Tract 238, Kings County, New York",3634,33780,3463,0,0,0,0,85,95.3,0,0,0,0,2.3,4.7,1174,394,780,33.56,66.44,35,359,188,592,223,951,8.9,24.1,19,"Less than 25% P.O.C.","Less than $55000"
"36047024000","Census Tract 240, Kings County, New York",4823,39034,4245,36,0,6,0,494,88,0.7,0,0.1,0,10.2,12,1362,408,954,29.96,70.04,110,298,301,653,411,951,27,31.6,30.2,"Less than 25% P.O.C.","Less than $55000"
"36047024100","Census Tract 241, Kings County, New York",2765,61192,1570,372,0,68,0,679,56.8,13.5,0,2.5,0,24.6,43.2,1017,191,826,18.78,81.22,53,138,89,737,142,875,27.7,10.8,14,"25% - 50% P.O.C.","$55000 - $78000"
"36047024200","Census Tract 242, Kings County, New York",2868,63698,2548,0,0,194,0,126,88.8,0,0,6.8,0,4.4,11.2,761,307,454,40.34,59.66,83,224,107,347,190,571,27,23.6,25,"Less than 25% P.O.C.","$55000 - $78000"
"36047024300","Census Tract 243, Kings County, New York",4122,59779,1343,2046,0,128,0,466,32.6,49.6,0,3.1,0,11.3,67.4,1731,444,1287,25.65,74.35,97,347,75,1212,172,1559,21.8,5.8,9.9,"50% - 75% P.O.C.","$55000 - $78000"
"36047024400","Census Tract 244, Kings County, New York",3609,68516,2864,7,0,405,10,295,79.4,0.2,0,11.2,0.3,8.2,20.6,841,413,428,49.11,50.89,155,258,162,266,317,524,37.5,37.9,37.7,"Less than 25% P.O.C.","$55000 - $78000"
"36047024500","Census Tract 245, Kings County, New York",4491,85169,1224,2471,0,403,0,322,27.3,55,0,9,0,7.2,72.7,1811,510,1301,28.16,71.84,156,354,41,1260,197,1614,30.6,3.2,10.9,"50% - 75% P.O.C.","$78000 - $104000"
"36047024600","Census Tract 246, Kings County, New York",2880,51354,1542,21,0,897,0,400,53.5,0.7,0,31.1,0,13.9,46.5,912,424,488,46.49,53.51,121,303,72,416,193,719,28.5,14.8,21.2,"25% - 50% P.O.C.","Less than $55000"
"36047024700","Census Tract 247, Kings County, New York",2672,46518,538,1541,15,180,0,214,20.1,57.7,0.6,6.7,0,8,79.9,1064,72,992,6.77,93.23,6,66,78,914,84,980,8.3,7.9,7.9,"75% or more P.O.C.","Less than $55000"
"36047024800","Census Tract 248, Kings County, New York",2653,49940,958,5,26,1085,0,484,36.1,0.2,1,40.9,0,18.2,63.9,801,347,454,43.32,56.68,98,249,74,380,172,629,28.2,16.3,21.5,"50% - 75% P.O.C.","Less than $55000"
"36047024900","Census Tract 249, Kings County, New York",4018,70268,1341,2116,14,98,0,341,33.4,52.7,0.3,2.4,0,8.5,66.6,1835,413,1422,22.51,77.49,93,320,40,1382,133,1702,22.5,2.8,7.2,"50% - 75% P.O.C.","$55000 - $78000"
"36047025000","Census Tract 250, Kings County, New York",1853,53186,225,0,0,1222,0,392,12.1,0,0,65.9,0,21.2,87.9,568,303,265,53.35,46.65,43,260,65,200,108,460,14.2,24.5,19,"75% or more P.O.C.","Less than $55000"
"36047025100","Census Tract 251, Kings County, New York",3741,39474,876,2088,0,91,0,562,23.4,55.8,0,2.4,0,15,76.6,1568,241,1327,15.37,84.63,23,218,126,1201,149,1419,9.5,9.5,9.5,"75% or more P.O.C.","Less than $55000"
"36047025200","Census Tract 252, Kings County, New York",5299,60173,1864,126,48,2104,0,1080,35.2,2.4,0.9,39.7,0,20.4,64.8,1865,512,1353,27.45,72.55,78,434,130,1223,208,1657,15.2,9.6,11.2,"50% - 75% P.O.C.","$55000 - $78000"
"36047025300","Census Tract 253, Kings County, New York",3496,55417,1059,1743,0,156,0,499,30.3,49.9,0,4.5,0,14.3,69.7,1281,296,985,23.11,76.89,112,184,52,933,164,1117,37.8,5.3,12.8,"50% - 75% P.O.C.","$55000 - $78000"
"36047025400","Census Tract 254, Kings County, New York",3413,44886,1351,0,22,1761,0,198,39.6,0,0.6,51.6,0,5.8,60.4,1105,509,596,46.06,53.94,150,359,60,536,210,895,29.5,10.1,19,"50% - 75% P.O.C.","Less than $55000"
"36047025500","Census Tract 255, Kings County, New York",5598,21865,65,1695,24,122,0,3649,1.2,30.3,0.4,2.2,0,65.2,98.8,1934,37,1897,1.91,98.09,0,37,213,1684,213,1721,0,11.2,11,"75% or more P.O.C.","Less than $55000"
"36047025600","Census Tract 256, Kings County, New York",3199,51625,738,54,0,2087,0,184,23.1,1.7,0,65.2,0,5.8,76.9,948,486,462,51.27,48.73,115,371,109,353,224,724,23.7,23.6,23.6,"75% or more P.O.C.","Less than $55000"
"36047025700","Census Tract 257, Kings County, New York",2476,69074,663,624,0,33,0,1088,26.8,25.2,0,1.3,0,43.9,73.2,710,127,583,17.89,82.11,21,106,103,480,124,586,16.5,17.7,17.5,"50% - 75% P.O.C.","$55000 - $78000"
"36047025800","Census Tract 258, Kings County, New York",4354,50625,1850,1,0,1687,0,816,42.5,0,0,38.7,0,18.7,57.5,1543,395,1148,25.6,74.4,16,379,149,999,165,1378,4.1,13,10.7,"50% - 75% P.O.C.","Less than $55000"
"36047025901","Census Tract 259.01, Kings County, New York",2257,59762,636,805,0,37,0,723,28.2,35.7,0,1.6,0,32,71.8,714,111,603,15.55,84.45,36,75,96,507,132,582,32.4,15.9,18.5,"50% - 75% P.O.C.","$55000 - $78000"
"36047025902","Census Tract 259.02, Kings County, New York",3533,18167,0,1674,0,102,0,1751,0,47.4,0,2.9,0,49.6,100,1190,0,1190,0,100,0,0,177,1013,177,1013,NA,14.9,14.9,"75% or more P.O.C.","Less than $55000"
"36047026000","Census Tract 260, Kings County, New York",3214,48214,1112,0,0,1781,0,205,34.6,0,0,55.4,0,6.4,65.4,1092,588,504,53.85,46.15,95,493,86,418,181,911,16.2,17.1,16.6,"50% - 75% P.O.C.","Less than $55000"
"36047026100","Census Tract 261, Kings County, New York",4497,51885,896,1970,0,113,0,1383,19.9,43.8,0,2.5,0,30.8,80.1,2236,124,2112,5.55,94.45,42,82,72,2040,114,2122,33.9,3.4,5.1,"75% or more P.O.C.","Less than $55000"
"36047026200","Census Tract 262, Kings County, New York",2425,65577,746,54,0,1230,0,342,30.8,2.2,0,50.7,0,14.1,69.2,788,387,401,49.11,50.89,106,281,22,379,128,660,27.4,5.5,16.2,"50% - 75% P.O.C.","$55000 - $78000"
"36047026300","Census Tract 263, Kings County, New York",2015,41875,482,1217,0,63,7,218,23.9,60.4,0,3.1,0.3,10.8,76.1,890,161,729,18.09,81.91,8,153,31,698,39,851,5,4.3,4.4,"75% or more P.O.C.","Less than $55000"
"36047026400","Census Tract 264, Kings County, New York",4594,48942,1270,110,44,2132,0,999,27.6,2.4,1,46.4,0,21.7,72.4,1542,329,1213,21.34,78.66,120,209,84,1129,204,1338,36.5,6.9,13.2,"50% - 75% P.O.C.","Less than $55000"
"36047026500","Census Tract 265, Kings County, New York",4118,70707,877,2201,32,87,0,869,21.3,53.4,0.8,2.1,0,21.1,78.7,1547,505,1042,32.64,67.36,81,424,58,984,139,1408,16,5.6,9,"75% or more P.O.C.","$55000 - $78000"
"36047026600","Census Tract 266, Kings County, New York",3517,51250,735,0,24,2342,0,416,20.9,0,0.7,66.6,0,11.8,79.1,1076,479,597,44.52,55.48,118,361,188,409,306,770,24.6,31.5,28.4,"75% or more P.O.C.","Less than $55000"
"36047026700","Census Tract 267, Kings County, New York",4055,64401,1154,2121,0,102,0,528,28.5,52.3,0,2.5,0,13,71.5,1793,669,1124,37.31,62.69,80,589,59,1065,139,1654,12,5.2,7.8,"50% - 75% P.O.C.","$55000 - $78000"
"36047026800","Census Tract 268, Kings County, New York",3965,44517,1603,3,0,1483,0,862,40.4,0.1,0,37.4,0,21.7,59.6,1379,370,1009,26.83,73.17,96,274,117,892,213,1166,25.9,11.6,15.4,"50% - 75% P.O.C.","Less than $55000"
"36047026900","Census Tract 269, Kings County, New York",3147,66534,474,2145,0,228,0,285,15.1,68.2,0,7.2,0,9.1,84.9,1261,404,857,32.04,67.96,58,346,80,777,138,1123,14.4,9.3,10.9,"75% or more P.O.C.","$55000 - $78000"
"36047027000","Census Tract 270, Kings County, New York",2139,50775,1283,0,17,633,0,197,60,0,0.8,29.6,0,9.2,40,857,270,587,31.51,68.49,38,232,52,535,90,767,14.1,8.9,10.5,"25% - 50% P.O.C.","Less than $55000"
"36047027100","Census Tract 271, Kings County, New York",3103,56136,377,2036,0,233,0,396,12.1,65.6,0,7.5,0,12.8,87.9,1180,262,918,22.2,77.8,14,248,122,796,136,1044,5.3,13.3,11.5,"75% or more P.O.C.","$55000 - $78000"
"36047027200","Census Tract 272, Kings County, New York",3755,58477,1276,0,0,1247,0,1226,34,0,0,33.2,0,32.6,66,1157,316,841,27.31,72.69,51,265,191,650,242,915,16.1,22.7,20.9,"50% - 75% P.O.C.","$55000 - $78000"
"36047027300","Census Tract 273, Kings County, New York",3431,56786,472,2592,0,75,0,130,13.8,75.5,0,2.2,0,3.8,86.2,1384,432,952,31.21,68.79,80,352,28,924,108,1276,18.5,2.9,7.8,"75% or more P.O.C.","$55000 - $78000"
"36047027400","Census Tract 274, Kings County, New York",3602,70625,1320,30,0,1419,0,625,36.6,0.8,0,39.4,0,17.4,63.4,1011,444,567,43.92,56.08,171,273,129,438,300,711,38.5,22.8,29.7,"50% - 75% P.O.C.","$55000 - $78000"
"36047027500","Census Tract 275, Kings County, New York",4438,82069,707,2955,0,277,0,312,15.9,66.6,0,6.2,0,7,84.1,1784,534,1250,29.93,70.07,115,419,39,1211,154,1630,21.5,3.1,8.6,"75% or more P.O.C.","$78000 - $104000"
"36047027600","Census Tract 276, Kings County, New York",3646,53283,966,10,0,1326,0,1257,26.5,0.3,0,36.4,0,34.5,73.5,1174,147,1027,12.52,87.48,25,122,176,851,201,973,17,17.1,17.1,"50% - 75% P.O.C.","Less than $55000"
"36047027700","Census Tract 277, Kings County, New York",4582,50290,528,3290,0,44,0,555,11.5,71.8,0,1,0,12.1,88.5,1759,388,1371,22.06,77.94,19,369,131,1240,150,1609,4.9,9.6,8.5,"75% or more P.O.C.","Less than $55000"
"36047027800","Census Tract 278, Kings County, New York",3118,57202,1222,32,0,1505,0,359,39.2,1,0,48.3,0,11.5,60.8,1207,346,861,28.67,71.33,97,249,48,813,145,1062,28,5.6,12,"50% - 75% P.O.C.","$55000 - $78000"
"36047027900","Census Tract 279, Kings County, New York",3660,64700,534,2553,0,43,0,335,14.6,69.8,0,1.2,0,9.2,85.4,1578,452,1126,28.64,71.36,45,407,92,1034,137,1441,10,8.2,8.7,"75% or more P.O.C.","$55000 - $78000"
"36047028000","Census Tract 280, Kings County, New York",1829,75677,712,40,0,771,0,300,38.9,2.2,0,42.2,0,16.4,61.1,629,312,317,49.6,50.4,32,280,40,277,72,557,10.3,12.6,11.4,"50% - 75% P.O.C.","$55000 - $78000"
"36047028100","Census Tract 281, Kings County, New York",4764,31682,624,2418,9,147,0,1321,13.1,50.8,0.2,3.1,0,27.7,86.9,1869,213,1656,11.4,88.6,10,203,94,1562,104,1765,4.7,5.7,5.6,"75% or more P.O.C.","Less than $55000"
"36047028200","Census Tract 282, Kings County, New York",3762,67212,1121,164,0,1972,0,365,29.8,4.4,0,52.4,0,9.7,70.2,1230,509,721,41.38,58.62,60,449,127,594,187,1043,11.8,17.6,15.2,"50% - 75% P.O.C.","$55000 - $78000"
"36047028300","Census Tract 283, Kings County, New York",3863,29306,606,1713,16,73,0,1415,15.7,44.3,0.4,1.9,0,36.6,84.3,1407,104,1303,7.39,92.61,71,33,124,1179,195,1212,68.3,9.5,13.9,"75% or more P.O.C.","Less than $55000"
"36047028400","Census Tract 284, Kings County, New York",3532,61331,1470,31,0,1271,0,685,41.6,0.9,0,36,0,19.4,58.4,1245,184,1061,14.78,85.22,39,145,137,924,176,1069,21.2,12.9,14.1,"50% - 75% P.O.C.","$55000 - $78000"
"36047028501","Census Tract 285.01, Kings County, New York",454,87778,102,23,0,51,0,278,22.5,5.1,0,11.2,0,61.2,77.5,132,10,122,7.58,92.42,0,10,19,103,19,113,0,15.6,14.4,"75% or more P.O.C.","$78000 - $104000"
"36047028502","Census Tract 285.02, Kings County, New York",3205,23899,0,1671,0,154,0,1349,0,52.1,0,4.8,0,42.1,100,1157,0,1157,0,100,0,0,67,1090,67,1090,NA,5.8,5.8,"75% or more P.O.C.","Less than $55000"
"36047028600","Census Tract 286, Kings County, New York",5110,40325,2402,84,0,1218,0,892,47,1.6,0,23.8,0,17.5,53,1960,98,1862,5,95,26,72,269,1593,295,1665,26.5,14.4,15.1,"50% - 75% P.O.C.","Less than $55000"
"36047028700","Census Tract 287, Kings County, New York",3093,40969,478,1488,29,368,0,730,15.5,48.1,0.9,11.9,0,23.6,84.5,1285,259,1026,20.16,79.84,52,207,29,997,81,1204,20.1,2.8,6.3,"75% or more P.O.C.","Less than $55000"
"36047028800","Census Tract 288, Kings County, New York",3836,55625,1384,19,0,1288,0,1102,36.1,0.5,0,33.6,0,28.7,63.9,1155,320,835,27.71,72.29,46,274,245,590,291,864,14.4,29.3,25.2,"50% - 75% P.O.C.","$55000 - $78000"
"36047028900","Census Tract 289, Kings County, New York",3619,44313,439,2023,45,113,0,970,12.1,55.9,1.2,3.1,0,26.8,87.9,1319,289,1030,21.91,78.09,70,219,185,845,255,1064,24.2,18,19.3,"75% or more P.O.C.","Less than $55000"
"36047029000","Census Tract 290, Kings County, New York",3580,44318,2191,0,0,891,0,289,61.2,0,0,24.9,0,8.1,38.8,1458,245,1213,16.8,83.2,19,226,102,1111,121,1337,7.8,8.4,8.3,"25% - 50% P.O.C.","Less than $55000"
"36047029100","Census Tract 291, Kings County, New York",2991,80526,513,1995,0,11,0,440,17.2,66.7,0,0.4,0,14.7,82.8,1202,267,935,22.21,77.79,18,249,70,865,88,1114,6.7,7.5,7.3,"75% or more P.O.C.","$78000 - $104000"
"36047029200","Census Tract 292, Kings County, New York",3033,49145,1279,92,0,904,0,655,42.2,3,0,29.8,0,21.6,57.8,997,213,784,21.36,78.64,38,175,153,631,191,806,17.8,19.5,19.2,"50% - 75% P.O.C.","Less than $55000"
"36047029300","Census Tract 293, Kings County, New York",3437,42238,395,1989,81,186,0,744,11.5,57.9,2.4,5.4,0,21.6,88.5,1425,276,1149,19.37,80.63,92,184,66,1083,158,1267,33.3,5.7,11.1,"75% or more P.O.C.","Less than $55000"
"36047029400","Census Tract 294, Kings County, New York",2474,57895,1223,206,0,695,0,296,49.4,8.3,0,28.1,0,12,50.6,596,111,485,18.62,81.38,32,79,93,392,125,471,28.8,19.2,21,"50% - 75% P.O.C.","$55000 - $78000"
"36047029500","Census Tract 295, Kings County, New York",4160,60881,923,2557,0,202,0,315,22.2,61.5,0,4.9,0,7.6,77.8,1744,587,1157,33.66,66.34,123,464,53,1104,176,1568,21,4.6,10.1,"75% or more P.O.C.","$55000 - $78000"
"36047029600","Census Tract 296, Kings County, New York",5849,56250,2758,5,0,1955,0,924,47.2,0.1,0,33.4,0,15.8,52.8,2095,649,1446,30.98,69.02,113,536,228,1218,341,1754,17.4,15.8,16.3,"50% - 75% P.O.C.","$55000 - $78000"
"36047029700","Census Tract 297, Kings County, New York",4253,70556,662,3161,0,56,17,207,15.6,74.3,0,1.3,0.4,4.9,84.4,1768,811,957,45.87,54.13,116,695,44,913,160,1608,14.3,4.6,9,"75% or more P.O.C.","$55000 - $78000"
"36047029800","Census Tract 298, Kings County, New York",3794,55060,1446,76,0,1337,0,759,38.1,2,0,35.2,0,20,61.9,1271,575,696,45.24,54.76,111,464,77,619,188,1083,19.3,11.1,14.8,"50% - 75% P.O.C.","$55000 - $78000"
"36047029900","Census Tract 299, Kings County, New York",2941,50144,191,1892,0,64,0,746,6.5,64.3,0,2.2,0,25.4,93.5,1021,247,774,24.19,75.81,21,226,121,653,142,879,8.5,15.6,13.9,"75% or more P.O.C.","Less than $55000"
"36047030000","Census Tract 300, Kings County, New York",4207,52663,1203,78,11,1932,0,950,28.6,1.9,0.3,45.9,0,22.6,71.4,1381,443,938,32.08,67.92,126,317,116,822,242,1139,28.4,12.4,17.5,"50% - 75% P.O.C.","Less than $55000"
"36047030100","Census Tract 301, Kings County, New York",2963,49196,195,2284,0,19,0,465,6.6,77.1,0,0.6,0,15.7,93.4,1072,416,656,38.81,61.19,77,339,30,626,107,965,18.5,4.6,10,"75% or more P.O.C.","Less than $55000"
"36047030200","Census Tract 302, Kings County, New York",4448,65000,1569,77,0,2594,0,139,35.3,1.7,0,58.3,0,3.1,64.7,1448,591,857,40.81,59.19,136,455,114,743,250,1198,23,13.3,17.3,"50% - 75% P.O.C.","$55000 - $78000"
"36047030300","Census Tract 303, Kings County, New York",4914,38571,98,3541,0,27,0,1170,2,72.1,0,0.5,0,23.8,98,1932,362,1570,18.74,81.26,77,285,99,1471,176,1756,21.3,6.3,9.1,"75% or more P.O.C.","Less than $55000"
"36047030400","Census Tract 304, Kings County, New York",4189,41017,1548,107,0,1636,0,597,37,2.6,0,39.1,0,14.3,63,1676,412,1264,24.58,75.42,43,369,115,1149,158,1518,10.4,9.1,9.4,"50% - 75% P.O.C.","Less than $55000"
"36047030500","Census Tract 305, Kings County, New York",6528,85985,2971,2206,0,291,0,914,45.5,33.8,0,4.5,0,14,54.5,2922,176,2746,6.02,93.98,0,176,116,2630,116,2806,0,4.2,4,"50% - 75% P.O.C.","$78000 - $104000"
"36047030600","Census Tract 306, Kings County, New York",1736,50833,654,7,0,782,0,252,37.7,0.4,0,45,0,14.5,62.3,644,350,294,54.35,45.65,16,334,33,261,49,595,4.6,11.2,7.6,"50% - 75% P.O.C.","Less than $55000"
"36047030700","Census Tract 307, Kings County, New York",5954,24502,275,4397,0,0,0,1218,4.6,73.8,0,0,0,20.5,95.4,2480,226,2254,9.11,90.89,0,226,217,2037,217,2263,0,9.6,8.8,"75% or more P.O.C.","Less than $55000"
"36047030800","Census Tract 308, Kings County, New York",1980,47461,1251,25,0,475,0,198,63.2,1.3,0,24,0,10,36.8,762,497,265,65.22,34.78,43,454,21,244,64,698,8.7,7.9,8.4,"25% - 50% P.O.C.","Less than $55000"
"36047030900","Census Tract 309, Kings County, New York",2405,46309,41,1815,0,119,0,286,1.7,75.5,0,4.9,0,11.9,98.3,781,222,559,28.43,71.57,36,186,109,450,145,636,16.2,19.5,18.6,"75% or more P.O.C.","Less than $55000"
"36047031100","Census Tract 311, Kings County, New York",2924,37014,236,2043,0,30,0,406,8.1,69.9,0,1,0,13.9,91.9,1245,148,1097,11.89,88.11,0,148,38,1059,38,1207,0,3.5,3.1,"75% or more P.O.C.","Less than $55000"
"36047031300","Census Tract 313, Kings County, New York",5055,51818,825,3296,0,52,0,784,16.3,65.2,0,1,0,15.5,83.7,2258,354,1904,15.68,84.32,35,319,114,1790,149,2109,9.9,6,6.6,"75% or more P.O.C.","Less than $55000"
"36047031400","Census Tract 314, Kings County, New York",4978,80439,3283,24,24,1379,0,268,66,0.5,0.5,27.7,0,5.4,34,1893,1049,844,55.41,44.59,126,923,17,827,143,1750,12,2,7.6,"25% - 50% P.O.C.","$78000 - $104000"
"36047031500","Census Tract 315, Kings County, New York",4970,63313,1743,2121,0,218,0,653,35.1,42.7,0,4.4,0,13.1,64.9,2481,301,2180,12.13,87.87,1,300,103,2077,104,2377,0.3,4.7,4.2,"50% - 75% P.O.C.","$55000 - $78000"
"36047031701","Census Tract 317.01, Kings County, New York",3805,78750,1201,2011,0,172,0,267,31.6,52.9,0,4.5,0,7,68.4,1471,359,1112,24.41,75.59,83,276,31,1081,114,1357,23.1,2.8,7.7,"50% - 75% P.O.C.","$78000 - $104000"
"36047031702","Census Tract 317.02, Kings County, New York",3315,78355,1173,1307,0,172,0,425,35.4,39.4,0,5.2,0,12.8,64.6,1477,351,1126,23.76,76.24,44,307,43,1083,87,1390,12.5,3.8,5.9,"50% - 75% P.O.C.","$78000 - $104000"
"36047031900","Census Tract 319, Kings County, New York",3141,55357,1454,1402,0,25,0,202,46.3,44.6,0,0.8,0,6.4,53.7,1322,255,1067,19.29,80.71,31,224,98,969,129,1193,12.2,9.2,9.8,"50% - 75% P.O.C.","$55000 - $78000"
"36047032100","Census Tract 321, Kings County, New York",5488,57574,1148,3221,0,175,0,519,20.9,58.7,0,3.2,0,9.5,79.1,2179,209,1970,9.59,90.41,0,209,97,1873,97,2082,0,4.9,4.5,"75% or more P.O.C.","$55000 - $78000"
"36047032300","Census Tract 323, Kings County, New York",3506,77645,825,2274,0,12,0,332,23.5,64.9,0,0.3,0,9.5,76.5,1502,210,1292,13.98,86.02,8,202,83,1209,91,1411,3.8,6.4,6.1,"75% or more P.O.C.","$55000 - $78000"
"36047032500","Census Tract 325, Kings County, New York",6076,51721,520,4800,0,158,0,442,8.6,79,0,2.6,0,7.3,91.4,2559,124,2435,4.85,95.15,0,124,231,2204,231,2328,0,9.5,9,"75% or more P.O.C.","Less than $55000"
"36047032600","Census Tract 326, Kings County, New York",6730,23470,885,2661,35,831,0,1993,13.2,39.5,0.5,12.3,0,29.6,86.8,2197,195,2002,8.88,91.12,98,97,266,1736,364,1833,50.3,13.3,16.6,"75% or more P.O.C.","Less than $55000"
"36047032700","Census Tract 327, Kings County, New York",2544,55795,418,1514,0,100,0,469,16.4,59.5,0,3.9,0,18.4,83.6,1326,197,1129,14.86,85.14,24,173,52,1077,76,1250,12.2,4.6,5.7,"75% or more P.O.C.","$55000 - $78000"
"36047032800","Census Tract 328, Kings County, New York",2688,41353,378,877,15,810,0,581,14.1,32.6,0.6,30.1,0,21.6,85.9,1061,410,651,38.64,61.36,56,354,54,597,110,951,13.7,8.3,10.4,"75% or more P.O.C.","Less than $55000"
"36047032900","Census Tract 329, Kings County, New York",6105,44922,2244,3054,0,110,0,609,36.8,50,0,1.8,0,10,63.2,2365,240,2125,10.15,89.85,63,177,248,1877,311,2054,26.2,11.7,13.2,"50% - 75% P.O.C.","Less than $55000"
"36047033000","Census Tract 330, Kings County, New York",5006,22933,821,2453,0,392,0,1186,16.4,49,0,7.8,0,23.7,83.6,1837,207,1630,11.27,88.73,0,207,277,1353,277,1560,0,17,15.1,"75% or more P.O.C.","Less than $55000"
"36047033100","Census Tract 331, Kings County, New York",4058,40216,2486,1407,0,0,0,155,61.3,34.7,0,0,0,3.8,38.7,1525,320,1205,20.98,79.02,49,271,149,1056,198,1327,15.3,12.4,13,"25% - 50% P.O.C.","Less than $55000"
"36047033300","Census Tract 333, Kings County, New York",4547,49444,3241,1122,13,10,0,133,71.3,24.7,0.3,0.2,0,2.9,28.7,1318,433,885,32.85,67.15,204,229,200,685,404,914,47.1,22.6,30.7,"25% - 50% P.O.C.","Less than $55000"
"36047033500","Census Tract 335, Kings County, New York",3034,68036,2146,717,0,29,0,50,70.7,23.6,0,1,0,1.6,29.3,788,389,399,49.37,50.63,155,234,89,310,244,544,39.8,22.3,31,"25% - 50% P.O.C.","$55000 - $78000"
"36047033600","Census Tract 336, Kings County, New York",4443,82850,3335,255,0,315,0,448,75.1,5.7,0,7.1,0,10.1,24.9,1572,780,792,49.62,50.38,108,672,78,714,186,1386,13.8,9.8,11.8,"Less than 25% P.O.C.","$78000 - $104000"
"36047033700","Census Tract 337, Kings County, New York",3856,54006,1638,1323,0,139,0,734,42.5,34.3,0,3.6,0,19,57.5,1325,329,996,24.83,75.17,98,231,111,885,209,1116,29.8,11.1,15.8,"50% - 75% P.O.C.","Less than $55000"
"36047033900","Census Tract 339, Kings County, New York",4538,40417,877,2975,0,391,0,217,19.3,65.6,0,8.6,0,4.8,80.7,1983,446,1537,22.49,77.51,58,388,98,1439,156,1827,13,6.4,7.9,"75% or more P.O.C.","Less than $55000"
"36047034000","Census Tract 340, Kings County, New York",2050,21224,726,703,0,145,0,476,35.4,34.3,0,7.1,0,23.2,64.6,631,7,624,1.11,98.89,0,7,40,584,40,591,0,6.4,6.3,"50% - 75% P.O.C.","Less than $55000"
"36047034100","Census Tract 341, Kings County, New York",3056,51250,593,2137,48,45,0,198,19.4,69.9,1.6,1.5,0,6.5,80.6,1195,117,1078,9.79,90.21,45,72,50,1028,95,1100,38.5,4.6,7.9,"75% or more P.O.C.","Less than $55000"
"36047034200","Census Tract 342, Kings County, New York",6064,17932,2103,1972,0,190,0,1756,34.7,32.5,0,3.1,0,29,65.3,2933,54,2879,1.84,98.16,16,38,125,2754,141,2792,29.6,4.3,4.8,"50% - 75% P.O.C.","Less than $55000"
"36047034300","Census Tract 343, Kings County, New York",5163,33385,546,3435,0,28,0,1044,10.6,66.5,0,0.5,0,20.2,89.4,2103,238,1865,11.32,88.68,11,227,211,1654,222,1881,4.6,11.3,10.6,"75% or more P.O.C.","Less than $55000"
"36047034500","Census Tract 345, Kings County, New York",3108,44483,447,2119,0,16,0,232,14.4,68.2,0,0.5,0,7.5,85.6,1160,336,824,28.97,71.03,147,189,47,777,194,966,43.8,5.7,16.7,"75% or more P.O.C.","Less than $55000"
"36047034700","Census Tract 347, Kings County, New York",3350,43849,74,2729,0,93,0,443,2.2,81.5,0,2.8,0,13.2,97.8,1655,287,1368,17.34,82.66,8,279,27,1341,35,1620,2.8,2,2.1,"75% or more P.O.C.","Less than $55000"
"36047034800","Census Tract 348, Kings County, New York",2885,54405,715,107,0,666,0,1397,24.8,3.7,0,23.1,0,48.4,75.2,804,111,693,13.81,86.19,27,84,241,452,268,536,24.3,34.8,33.3,"75% or more P.O.C.","Less than $55000"
"36047034900","Census Tract 349, Kings County, New York",6145,41061,479,4861,0,77,0,589,7.8,79.1,0,1.3,0,9.6,92.2,2244,166,2078,7.4,92.6,30,136,308,1770,338,1906,18.1,14.8,15.1,"75% or more P.O.C.","Less than $55000"
"36047035000","Census Tract 350, Kings County, New York",3124,42102,3011,18,0,0,0,95,96.4,0.6,0,0,0,3,3.6,1526,464,1062,30.41,69.59,0,464,0,1062,0,1526,0,0,0,"Less than 25% P.O.C.","Less than $55000"
"36047035100","Census Tract 351, Kings County, New York",4650,44624,1074,2455,0,92,0,883,23.1,52.8,0,2,0,19,76.9,1768,167,1601,9.45,90.55,33,134,108,1493,141,1627,19.8,6.7,8,"75% or more P.O.C.","Less than $55000"
"36047035200","Census Tract 352, Kings County, New York",1254,14167,766,235,0,72,0,181,61.1,18.7,0,5.7,0,14.4,38.9,518,0,518,0,100,0,0,0,518,0,518,NA,0,0,"25% - 50% P.O.C.","Less than $55000"
"36047035300","Census Tract 353, Kings County, New York",5407,47321,1004,3298,0,166,0,824,18.6,61,0,3.1,0,15.2,81.4,2086,227,1859,10.88,89.12,127,100,122,1737,249,1837,55.9,6.6,11.9,"75% or more P.O.C.","Less than $55000"
"36047035400","Census Tract 354, Kings County, New York",5765,50599,5207,55,22,0,0,396,90.3,1,0.4,0,0,6.9,9.7,2749,1254,1495,45.62,54.38,97,1157,70,1425,167,2582,7.7,4.7,6.1,"Less than 25% P.O.C.","Less than $55000"
"36047035500","Census Tract 355, Kings County, New York",5631,51875,1064,3719,0,0,0,672,18.9,66,0,0,0,11.9,81.1,2079,106,1973,5.1,94.9,28,78,285,1688,313,1766,26.4,14.4,15.1,"75% or more P.O.C.","Less than $55000"
"36047035601","Census Tract 356.01, Kings County, New York",2834,32111,2491,170,0,0,6,102,87.9,6,0,0,0.2,3.6,12.1,1482,396,1086,26.72,73.28,0,396,15,1071,15,1467,0,1.4,1,"Less than 25% P.O.C.","Less than $55000"
"36047035602","Census Tract 356.02, Kings County, New York",5529,45163,5003,2,0,137,0,103,90.5,0,0,2.5,0,1.9,9.5,2790,1010,1780,36.2,63.8,0,1010,0,1780,0,2790,0,0,0,"Less than 25% P.O.C.","Less than $55000"
"36047035700","Census Tract 357, Kings County, New York",2328,30495,48,1825,0,10,0,373,2.1,78.4,0,0.4,0,16,97.9,987,33,954,3.34,96.66,10,23,60,894,70,917,30.3,6.3,7.1,"75% or more P.O.C.","Less than $55000"
"36047035900","Census Tract 359, Kings County, New York",5593,32326,225,4481,25,51,0,693,4,80.1,0.4,0.9,0,12.4,96,2261,107,2154,4.73,95.27,0,107,99,2055,99,2162,0,4.6,4.4,"75% or more P.O.C.","Less than $55000"
"36047036001","Census Tract 360.01, Kings County, New York",3155,25265,2890,17,0,23,0,51,91.6,0.5,0,0.7,0,1.6,8.4,1732,385,1347,22.23,77.77,0,385,53,1294,53,1679,0,3.9,3.1,"Less than 25% P.O.C.","Less than $55000"
"36047036002","Census Tract 360.02, Kings County, New York",4074,16073,3681,15,0,81,0,16,90.4,0.4,0,2,0,0.4,9.6,2047,120,1927,5.86,94.14,0,120,149,1778,149,1898,0,7.7,7.3,"Less than 25% P.O.C.","Less than $55000"
"36047036100","Census Tract 361, Kings County, New York",2787,25694,158,1993,0,23,0,604,5.7,71.5,0,0.8,0,21.7,94.3,1152,123,1029,10.68,89.32,24,99,25,1004,49,1103,19.5,2.4,4.3,"75% or more P.O.C.","Less than $55000"
"36047036200","Census Tract 362, Kings County, New York",3855,42670,1845,30,34,782,0,996,47.9,0.8,0.9,20.3,0,25.8,52.1,1335,404,931,30.26,69.74,71,333,124,807,195,1140,17.6,13.3,14.6,"50% - 75% P.O.C.","Less than $55000"
"36047036300","Census Tract 363, Kings County, New York",5044,34063,201,3964,0,25,0,792,4,78.6,0,0.5,0,15.7,96,1899,378,1521,19.91,80.09,107,271,110,1411,217,1682,28.3,7.2,11.4,"75% or more P.O.C.","Less than $55000"
"36047036400","Census Tract 364, Kings County, New York",2443,59712,1632,38,0,399,0,278,66.8,1.6,0,16.3,0,11.4,33.2,899,253,646,28.14,71.86,26,227,68,578,94,805,10.3,10.5,10.5,"25% - 50% P.O.C.","$55000 - $78000"
"36047036501","Census Tract 365.01, Kings County, New York",3417,46538,8,2956,0,27,0,426,0.2,86.5,0,0.8,0,12.5,99.8,1296,75,1221,5.79,94.21,19,56,179,1042,198,1098,25.3,14.7,15.3,"75% or more P.O.C.","Less than $55000"
"36047036502","Census Tract 365.02, Kings County, New York",1415,38750,50,708,0,7,0,621,3.5,50,0,0.5,0,43.9,96.5,509,131,378,25.74,74.26,19,112,26,352,45,464,14.5,6.9,8.8,"75% or more P.O.C.","Less than $55000"
"36047036600","Census Tract 366, Kings County, New York",4268,48050,2042,87,0,1160,0,817,47.8,2,0,27.2,0,19.1,52.2,1343,338,1005,25.17,74.83,59,279,203,802,262,1081,17.5,20.2,19.5,"50% - 75% P.O.C.","Less than $55000"
"36047036700","Census Tract 367, Kings County, New York",1281,54432,73,683,0,72,0,431,5.7,53.3,0,5.6,0,33.6,94.3,515,155,360,30.1,69.9,15,140,20,340,35,480,9.7,5.6,6.8,"75% or more P.O.C.","Less than $55000"
"36047036900","Census Tract 369, Kings County, New York",5787,35977,467,3961,0,95,0,1225,8.1,68.4,0,1.6,0,21.2,91.9,2167,223,1944,10.29,89.71,44,179,248,1696,292,1875,19.7,12.8,13.5,"75% or more P.O.C.","Less than $55000"
"36047037000","Census Tract 370, Kings County, New York",4231,57888,2722,10,38,1211,0,163,64.3,0.2,0.9,28.6,0,3.9,35.7,1481,1051,430,70.97,29.03,92,959,81,349,173,1308,8.8,18.8,11.7,"25% - 50% P.O.C.","$55000 - $78000"
"36047037100","Census Tract 371, Kings County, New York",4711,64848,463,3315,0,45,0,806,9.8,70.4,0,1,0,17.1,90.2,1720,457,1263,26.57,73.43,71,386,114,1149,185,1535,15.5,9,10.8,"75% or more P.O.C.","$55000 - $78000"
"36047037300","Census Tract 373, Kings County, New York",4486,45179,697,2772,47,99,0,784,15.5,61.8,1,2.2,0,17.5,84.5,1706,328,1378,19.23,80.77,62,266,149,1229,211,1495,18.9,10.8,12.4,"75% or more P.O.C.","Less than $55000"
"36047037401","Census Tract 374.01, Kings County, New York",4376,55341,3023,331,0,451,0,151,69.1,7.6,0,10.3,0,3.5,30.9,1881,574,1307,30.52,69.48,72,502,26,1281,98,1783,12.5,2,5.2,"25% - 50% P.O.C.","$55000 - $78000"
"36047037402","Census Tract 374.02, Kings County, New York",4937,31832,2738,167,0,1086,0,650,55.5,3.4,0,22,0,13.2,44.5,2121,303,1818,14.29,85.71,110,193,82,1736,192,1929,36.3,4.5,9.1,"25% - 50% P.O.C.","Less than $55000"
"36047037500","Census Tract 375, Kings County, New York",3229,51495,633,1656,6,191,0,670,19.6,51.3,0.2,5.9,0,20.7,80.4,1351,212,1139,15.69,84.31,6,206,47,1092,53,1298,2.8,4.1,3.9,"75% or more P.O.C.","Less than $55000"
"36047037700","Census Tract 377, Kings County, New York",4541,52367,549,3131,0,87,0,591,12.1,68.9,0,1.9,0,13,87.9,1709,654,1055,38.27,61.73,122,532,41,1014,163,1546,18.7,3.9,9.5,"75% or more P.O.C.","Less than $55000"
"36047037900","Census Tract 379, Kings County, New York",4660,46429,454,3752,0,44,0,339,9.7,80.5,0,0.9,0,7.3,90.3,1686,603,1083,35.77,64.23,64,539,39,1044,103,1583,10.6,3.6,6.1,"75% or more P.O.C.","Less than $55000"
"36047038100","Census Tract 381, Kings County, New York",5397,45667,650,3818,0,106,0,690,12,70.7,0,2,0,12.8,88,2254,431,1823,19.12,80.88,45,386,76,1747,121,2133,10.4,4.2,5.4,"75% or more P.O.C.","Less than $55000"
"36047038200","Census Tract 382, Kings County, New York",5740,18169,154,1931,0,1525,0,1968,2.7,33.6,0,26.6,0,34.3,97.3,2196,51,2145,2.32,97.68,35,16,224,1921,259,1937,68.6,10.4,11.8,"75% or more P.O.C.","Less than $55000"
"36047038300","Census Tract 383, Kings County, New York",4720,73641,588,3359,17,463,0,158,12.5,71.2,0.4,9.8,0,3.3,87.5,1727,648,1079,37.52,62.48,92,556,177,902,269,1458,14.2,16.4,15.6,"75% or more P.O.C.","$55000 - $78000"
"36047038500","Census Tract 385, Kings County, New York",3963,79107,621,2702,0,219,0,401,15.7,68.2,0,5.5,0,10.1,84.3,1378,415,963,30.12,69.88,114,301,80,883,194,1184,27.5,8.3,14.1,"75% or more P.O.C.","$78000 - $104000"
"36047038600","Census Tract 386, Kings County, New York",3669,83594,1308,1,0,1264,0,1011,35.7,0,0,34.5,0,27.6,64.3,1082,631,451,58.32,41.68,198,433,133,318,331,751,31.4,29.5,30.6,"50% - 75% P.O.C.","$78000 - $104000"
"36047038700","Census Tract 387, Kings County, New York",3882,64917,838,2188,24,119,0,667,21.6,56.4,0.6,3.1,0,17.2,78.4,1467,529,938,36.06,63.94,124,405,50,888,174,1293,23.4,5.3,11.9,"75% or more P.O.C.","$55000 - $78000"
"36047038800","Census Tract 388, Kings County, New York",4094,64375,2755,489,0,538,0,277,67.3,11.9,0,13.1,0,6.8,32.7,1604,435,1169,27.12,72.88,54,381,79,1090,133,1471,12.4,6.8,8.3,"25% - 50% P.O.C.","$55000 - $78000"
"36047038900","Census Tract 389, Kings County, New York",2837,74352,904,153,0,272,0,1436,31.9,5.4,0,9.6,0,50.6,68.1,1138,275,863,24.17,75.83,67,208,88,775,155,983,24.4,10.2,13.6,"50% - 75% P.O.C.","$55000 - $78000"
"36047039000","Census Tract 390, Kings County, New York",2397,70114,2081,0,0,63,0,198,86.8,0,0,2.6,0,8.3,13.2,763,470,293,61.6,38.4,115,355,75,218,190,573,24.5,25.6,24.9,"Less than 25% P.O.C.","$55000 - $78000"
"36047039100","Census Tract 391, Kings County, New York",3239,70945,837,109,0,223,0,1984,25.8,3.4,0,6.9,0,61.3,74.2,1371,115,1256,8.39,91.61,27,88,125,1131,152,1219,23.5,10,11.1,"50% - 75% P.O.C.","$55000 - $78000"
"36047039200","Census Tract 392, Kings County, New York",2880,64500,2490,34,0,199,0,157,86.5,1.2,0,6.9,0,5.5,13.5,1066,425,641,39.87,60.13,111,314,71,570,182,884,26.1,11.1,17.1,"Less than 25% P.O.C.","$55000 - $78000"
"36047039300","Census Tract 393, Kings County, New York",3890,75256,1022,602,0,288,0,1883,26.3,15.5,0,7.4,0,48.4,73.7,1487,366,1121,24.61,75.39,79,287,129,992,208,1279,21.6,11.5,14,"50% - 75% P.O.C.","$55000 - $78000"
"36047039400","Census Tract 394, Kings County, New York",2338,46198,1854,56,0,19,0,300,79.3,2.4,0,0.8,0,12.8,20.7,697,376,321,53.95,46.05,138,238,51,270,189,508,36.7,15.9,27.1,"Less than 25% P.O.C.","Less than $55000"
"36047039500","Census Tract 395, Kings County, New York",3858,56598,943,1319,0,255,0,1262,24.4,34.2,0,6.6,0,32.7,75.6,1290,277,1013,21.47,78.53,75,202,143,870,218,1072,27.1,14.1,16.9,"75% or more P.O.C.","$55000 - $78000"
"36047039600","Census Tract 396, Kings County, New York",2058,64375,1690,0,144,38,148,32,82.1,0,7,1.8,7.2,1.6,17.9,666,277,389,41.59,58.41,86,191,67,322,153,513,31,17.2,23,"Less than 25% P.O.C.","$55000 - $78000"
"36047039700","Census Tract 397, Kings County, New York",3553,45685,646,1668,0,37,0,1138,18.2,46.9,0,1,0,32,81.8,1374,419,955,30.49,69.51,104,315,45,910,149,1225,24.8,4.7,10.8,"75% or more P.O.C.","Less than $55000"
"36047039800","Census Tract 398, Kings County, New York",2878,71679,816,0,0,1353,0,598,28.4,0,0,47,0,20.8,71.6,842,445,397,52.85,47.15,110,335,121,276,231,611,24.7,30.5,27.4,"50% - 75% P.O.C.","$55000 - $78000"
"36047039900","Census Tract 399, Kings County, New York",3873,51776,467,1276,0,23,0,1908,12.1,32.9,0,0.6,0,49.3,87.9,1449,239,1210,16.49,83.51,60,179,218,992,278,1171,25.1,18,19.2,"75% or more P.O.C.","Less than $55000"
"36047040000","Census Tract 400, Kings County, New York",3003,52125,1220,24,0,1348,0,404,40.6,0.8,0,44.9,0,13.5,59.4,1058,475,583,44.9,55.1,108,367,64,519,172,886,22.7,11,16.3,"50% - 75% P.O.C.","Less than $55000"
"36047040100","Census Tract 401, Kings County, New York",3162,55625,562,1421,0,139,0,952,17.8,44.9,0,4.4,0,30.1,82.2,1120,334,786,29.82,70.18,75,259,59,727,134,986,22.5,7.5,12,"75% or more P.O.C.","$55000 - $78000"
"36047040200","Census Tract 402, Kings County, New York",2988,57404,964,0,0,1486,0,477,32.3,0,0,49.7,0,16,67.7,955,467,488,48.9,51.1,117,350,49,439,166,789,25.1,10,17.4,"50% - 75% P.O.C.","$55000 - $78000"
"36047040300","Census Tract 403, Kings County, New York",3529,60855,448,2035,0,82,0,964,12.7,57.7,0,2.3,0,27.3,87.3,1295,431,864,33.28,66.72,86,345,92,772,178,1117,20,10.6,13.7,"75% or more P.O.C.","$55000 - $78000"
"36047040400","Census Tract 404, Kings County, New York",2459,61087,1086,36,15,1140,0,146,44.2,1.5,0.6,46.4,0,5.9,55.8,838,433,405,51.67,48.33,80,353,48,357,128,710,18.5,11.9,15.3,"50% - 75% P.O.C.","$55000 - $78000"
"36047040500","Census Tract 405, Kings County, New York",1513,63438,206,559,0,52,0,647,13.6,36.9,0,3.4,0,42.8,86.4,613,116,497,18.92,81.08,24,92,7,490,31,582,20.7,1.4,5.1,"75% or more P.O.C.","$55000 - $78000"
"36047040600","Census Tract 406, Kings County, New York",3692,52986,1081,41,0,1882,0,589,29.3,1.1,0,51,0,16,70.7,1151,491,660,42.66,57.34,195,296,48,612,243,908,39.7,7.3,21.1,"50% - 75% P.O.C.","Less than $55000"
"36047040700","Census Tract 407, Kings County, New York",0,NA,0,0,0,0,0,0,NA,NA,NA,NA,NA,NA,NA,0,0,0,NA,NA,0,0,0,0,0,0,NA,NA,NA,"N/A","N/A"
"36047040800","Census Tract 408, Kings County, New York",3646,80169,1060,15,0,1828,0,677,29.1,0.4,0,50.1,0,18.6,70.9,1118,530,588,47.41,52.59,122,408,143,445,265,853,23,24.3,23.7,"50% - 75% P.O.C.","$78000 - $104000"
"36047040900","Census Tract 409, Kings County, New York",3836,52629,430,781,0,23,0,2564,11.2,20.4,0,0.6,0,66.8,88.8,1330,167,1163,12.56,87.44,40,127,203,960,243,1087,24,17.5,18.3,"75% or more P.O.C.","Less than $55000"
"36047041000","Census Tract 410, Kings County, New York",2048,48400,1342,19,0,609,0,48,65.5,0.9,0,29.7,0,2.3,34.5,694,346,348,49.86,50.14,97,249,31,317,128,566,28,8.9,18.4,"25% - 50% P.O.C.","Less than $55000"
"36047041100","Census Tract 411, Kings County, New York",3034,38214,623,1144,0,68,0,1016,20.5,37.7,0,2.2,0,33.5,79.5,1178,192,986,16.3,83.7,93,99,64,922,157,1021,48.4,6.5,13.3,"75% or more P.O.C.","Less than $55000"
"36047041200","Census Tract 412, Kings County, New York",3328,63641,1791,0,0,1070,0,341,53.8,0,0,32.2,0,10.2,46.2,1069,508,561,47.52,52.48,210,298,6,555,216,853,41.3,1.1,20.2,"25% - 50% P.O.C.","$55000 - $78000"
"36047041300","Census Tract 413, Kings County, New York",3986,63750,625,1083,0,223,0,1967,15.7,27.2,0,5.6,0,49.3,84.3,1343,247,1096,18.39,81.61,27,220,151,945,178,1165,10.9,13.8,13.3,"75% or more P.O.C.","$55000 - $78000"
"36047041401","Census Tract 414.01, Kings County, New York",1541,67972,1219,8,0,115,0,199,79.1,0.5,0,7.5,0,12.9,20.9,478,223,255,46.65,53.35,52,171,84,171,136,342,23.3,32.9,28.5,"Less than 25% P.O.C.","$55000 - $78000"
"36047041402","Census Tract 414.02, Kings County, New York",1824,52946,1607,0,0,0,0,171,88.1,0,0,0,0,9.4,11.9,683,166,517,24.3,75.7,15,151,91,426,106,577,9,17.6,15.5,"Less than 25% P.O.C.","Less than $55000"
"36047041500","Census Tract 415, Kings County, New York",4353,64844,489,1460,0,119,0,2181,11.2,33.5,0,2.7,0,50.1,88.8,1331,351,980,26.37,73.63,149,202,149,831,298,1033,42.5,15.2,22.4,"75% or more P.O.C.","$55000 - $78000"
"36047041600","Census Tract 416, Kings County, New York",2338,61414,1928,36,0,120,0,236,82.5,1.5,0,5.1,0,10.1,17.5,727,334,393,45.94,54.06,83,251,83,310,166,561,24.9,21.1,22.8,"Less than 25% P.O.C.","$55000 - $78000"
"36047041700","Census Tract 417, Kings County, New York",3132,24433,357,660,0,177,0,1906,11.4,21.1,0,5.7,0,60.9,88.6,1376,192,1184,13.95,86.05,0,192,95,1089,95,1281,0,8,6.9,"75% or more P.O.C.","Less than $55000"
"36047041800","Census Tract 418, Kings County, New York",2960,45536,2353,8,0,123,0,428,79.5,0.3,0,4.2,0,14.5,20.5,855,280,575,32.75,67.25,105,175,147,428,252,603,37.5,25.6,29.5,"Less than 25% P.O.C.","Less than $55000"
"36047041900","Census Tract 419, Kings County, New York",3623,56550,456,683,0,205,0,2279,12.6,18.9,0,5.7,0,62.9,87.4,1297,164,1133,12.64,87.36,18,146,161,972,179,1118,11,14.2,13.8,"75% or more P.O.C.","$55000 - $78000"
"36047042000","Census Tract 420, Kings County, New York",1837,58571,1643,17,0,22,0,155,89.4,0.9,0,1.2,0,8.4,10.6,532,300,232,56.39,43.61,101,199,67,165,168,364,33.7,28.9,31.6,"Less than 25% P.O.C.","$55000 - $78000"
"36047042100","Census Tract 421, Kings County, New York",4259,51341,781,466,23,88,0,2855,18.3,10.9,0.5,2.1,0,67,81.7,1436,247,1189,17.2,82.8,71,176,166,1023,237,1199,28.7,14,16.5,"75% or more P.O.C.","Less than $55000"
"36047042200","Census Tract 422, Kings County, New York",3535,59904,2102,104,18,156,0,705,59.5,2.9,0.5,4.4,0,19.9,40.5,1067,340,727,31.87,68.13,90,250,152,575,242,825,26.5,20.9,22.7,"25% - 50% P.O.C.","$55000 - $78000"
"36047042300","Census Tract 423, Kings County, New York",3978,67056,1239,186,0,107,0,2313,31.1,4.7,0,2.7,0,58.1,68.9,1350,118,1232,8.74,91.26,20,98,170,1062,190,1160,16.9,13.8,14.1,"50% - 75% P.O.C.","$55000 - $78000"
"36047042400","Census Tract 424, Kings County, New York",3480,61005,1610,5,13,848,0,904,46.3,0.1,0.4,24.4,0,26,53.7,1187,397,790,33.45,66.55,67,330,186,604,253,934,16.9,23.5,21.3,"50% - 75% P.O.C.","$55000 - $78000"
"36047042500","Census Tract 425, Kings County, New York",3338,77477,885,251,0,91,0,2043,26.5,7.5,0,2.7,0,61.2,73.5,1111,42,1069,3.78,96.22,0,42,161,908,161,950,0,15.1,14.5,"50% - 75% P.O.C.","$55000 - $78000"
"36047042600","Census Tract 426, Kings County, New York",4302,49954,1526,81,0,1857,0,686,35.5,1.9,0,43.2,0,15.9,64.5,1553,457,1096,29.43,70.57,80,377,86,1010,166,1387,17.5,7.8,10.7,"50% - 75% P.O.C.","Less than $55000"
"36047042700","Census Tract 427, Kings County, New York",4896,59965,1360,204,38,263,0,2914,27.8,4.2,0.8,5.4,0,59.5,72.2,1761,134,1627,7.61,92.39,14,120,190,1437,204,1557,10.4,11.7,11.6,"50% - 75% P.O.C.","$55000 - $78000"
"36047042800","Census Tract 428, Kings County, New York",3785,60708,2106,55,0,1265,0,120,55.6,1.5,0,33.4,0,3.2,44.4,1504,619,885,41.16,58.84,78,541,45,840,123,1381,12.6,5.1,8.2,"25% - 50% P.O.C.","$55000 - $78000"
"36047042900","Census Tract 429, Kings County, New York",5441,50170,1252,133,0,282,0,3639,23,2.4,0,5.2,0,66.9,77,1867,79,1788,4.23,95.77,0,79,267,1521,267,1600,0,14.9,14.3,"75% or more P.O.C.","Less than $55000"
"36047043000","Census Tract 430, Kings County, New York",3283,38160,1449,0,0,1408,0,366,44.1,0,0,42.9,0,11.1,55.9,1191,193,998,16.2,83.8,12,181,140,858,152,1039,6.2,14,12.8,"50% - 75% P.O.C.","Less than $55000"
"36047043100","Census Tract 431, Kings County, New York",4694,57111,1380,98,0,304,0,2790,29.4,2.1,0,6.5,0,59.4,70.6,1765,67,1698,3.8,96.2,0,67,245,1453,245,1520,0,14.4,13.9,"50% - 75% P.O.C.","$55000 - $78000"
"36047043200","Census Tract 432, Kings County, New York",4341,63063,1490,36,0,1768,0,816,34.3,0.8,0,40.7,0,18.8,65.7,1436,446,990,31.06,68.94,104,342,152,838,256,1180,23.3,15.4,17.8,"50% - 75% P.O.C.","$55000 - $78000"
"36047043300","Census Tract 433, Kings County, New York",3628,24766,270,460,0,141,0,2757,7.4,12.7,0,3.9,0,76,92.6,1274,56,1218,4.4,95.6,27,29,129,1089,156,1118,48.2,10.6,12.2,"75% or more P.O.C.","Less than $55000"
"36047043400","Census Tract 434, Kings County, New York",3537,49013,1570,116,0,1387,0,446,44.4,3.3,0,39.2,0,12.6,55.6,1265,406,859,32.09,67.91,64,342,116,743,180,1085,15.8,13.5,14.2,"50% - 75% P.O.C.","Less than $55000"
"36047043500","Census Tract 435, Kings County, New York",5115,66923,390,788,0,153,0,3752,7.6,15.4,0,3,0,73.4,92.4,1502,372,1130,24.77,75.23,106,266,243,887,349,1153,28.5,21.5,23.2,"75% or more P.O.C.","$55000 - $78000"
"36047043600","Census Tract 436, Kings County, New York",5059,57901,2541,60,51,1269,0,793,50.2,1.2,1,25.1,0,15.7,49.8,1611,444,1167,27.56,72.44,94,350,196,971,290,1321,21.2,16.8,18,"25% - 50% P.O.C.","$55000 - $78000"
"36047043700","Census Tract 437, Kings County, New York",5696,59474,1078,784,0,98,0,3431,18.9,13.8,0,1.7,0,60.2,81.1,1874,225,1649,12.01,87.99,77,148,157,1492,234,1640,34.2,9.5,12.5,"75% or more P.O.C.","$55000 - $78000"
"36047043800","Census Tract 438, Kings County, New York",2620,46167,2041,53,0,253,0,132,77.9,2,0,9.7,0,5,22.1,960,217,743,22.6,77.4,55,162,107,636,162,798,25.3,14.4,16.9,"Less than 25% P.O.C.","Less than $55000"
"36047043900","Census Tract 439, Kings County, New York",3515,42148,278,704,66,161,0,2228,7.9,20,1.9,4.6,0,63.4,92.1,1268,357,911,28.15,71.85,71,286,90,821,161,1107,19.9,9.9,12.7,"75% or more P.O.C.","Less than $55000"
"36047044000","Census Tract 440, Kings County, New York",2809,51420,2218,69,0,111,0,337,79,2.5,0,4,0,12,21,879,392,487,44.6,55.4,145,247,66,421,211,668,37,13.6,24,"Less than 25% P.O.C.","Less than $55000"
"36047044100","Census Tract 441, Kings County, New York",5124,47754,854,319,0,728,0,3150,16.7,6.2,0,14.2,0,61.5,83.3,1948,232,1716,11.91,88.09,61,171,124,1592,185,1763,26.3,7.2,9.5,"75% or more P.O.C.","Less than $55000"
"36047044200","Census Tract 442, Kings County, New York",2945,76046,2507,2,282,31,0,44,85.1,0.1,9.6,1.1,0,1.5,14.9,867,448,419,51.67,48.33,147,301,96,323,243,624,32.8,22.9,28,"Less than 25% P.O.C.","$55000 - $78000"
"36047044300","Census Tract 443, Kings County, New York",4587,50263,1047,89,0,822,0,2556,22.8,1.9,0,17.9,0,55.7,77.2,1914,188,1726,9.82,90.18,14,174,80,1646,94,1820,7.4,4.6,4.9,"75% or more P.O.C.","Less than $55000"
"36047044400","Census Tract 444, Kings County, New York",3589,51975,3016,117,0,140,0,309,84,3.3,0,3.9,0,8.6,16,1209,406,803,33.58,66.42,98,308,183,620,281,928,24.1,22.8,23.2,"Less than 25% P.O.C.","Less than $55000"
"36047044500","Census Tract 445, Kings County, New York",4729,69414,850,230,25,359,0,3128,18,4.9,0.5,7.6,0,66.1,82,1667,213,1454,12.78,87.22,44,169,193,1261,237,1430,20.7,13.3,14.2,"75% or more P.O.C.","$55000 - $78000"
"36047044600","Census Tract 446, Kings County, New York",2092,63708,790,10,0,882,0,397,37.8,0.5,0,42.2,0,19,62.2,583,258,325,44.25,55.75,87,171,51,274,138,445,33.7,15.7,23.7,"50% - 75% P.O.C.","$55000 - $78000"
"36047044700","Census Tract 447, Kings County, New York",2545,46738,627,438,0,91,12,1319,24.6,17.2,0,3.6,0.5,51.8,75.4,831,73,758,8.78,91.22,0,73,30,728,30,801,0,4,3.6,"75% or more P.O.C.","Less than $55000"
"36047044800","Census Tract 448, Kings County, New York",1698,60921,1381,0,0,171,0,94,81.3,0,0,10.1,0,5.5,18.7,654,397,257,60.7,39.3,88,309,17,240,105,549,22.2,6.6,16.1,"Less than 25% P.O.C.","$55000 - $78000"
"36047044900","Census Tract 449, Kings County, New York",3210,22102,488,867,21,119,0,1715,15.2,27,0.7,3.7,0,53.4,84.8,1156,28,1128,2.42,97.58,0,28,100,1028,100,1056,0,8.9,8.7,"75% or more P.O.C.","Less than $55000"
"36047045000","Census Tract 450, Kings County, New York",566,NA,519,6,0,16,0,25,91.7,1.1,0,2.8,0,4.4,8.3,170,111,59,65.29,34.71,50,61,5,54,55,115,45,8.5,32.4,"Less than 25% P.O.C.","N/A"
"36047045200","Census Tract 452, Kings County, New York",2514,82532,2370,21,0,60,0,63,94.3,0.8,0,2.4,0,2.5,5.7,767,477,290,62.19,37.81,116,361,103,187,219,548,24.3,35.5,28.6,"Less than 25% P.O.C.","$78000 - $104000"
"36047045300","Census Tract 453, Kings County, New York",2578,51953,681,662,0,24,0,1162,26.4,25.7,0,0.9,0,45.1,73.6,683,0,683,0,100,0,0,22,661,22,661,NA,3.2,3.2,"50% - 75% P.O.C.","Less than $55000"
"36047045400","Census Tract 454, Kings County, New York",1681,66364,1359,28,0,87,0,80,80.8,1.7,0,5.2,0,4.8,19.2,534,250,284,46.82,53.18,63,187,65,219,128,406,25.2,22.9,24,"Less than 25% P.O.C.","$55000 - $78000"
"36047045600","Census Tract 456, Kings County, New York",2170,41806,1141,25,0,445,0,108,52.6,1.2,0,20.5,0,5,47.4,717,122,595,17.02,82.98,29,93,168,427,197,520,23.8,28.2,27.5,"25% - 50% P.O.C.","Less than $55000"
"36047045800","Census Tract 458, Kings County, New York",1324,86250,1113,32,25,0,0,154,84.1,2.4,1.9,0,0,11.6,15.9,490,349,141,71.22,28.78,80,269,0,141,80,410,22.9,0,16.3,"Less than 25% P.O.C.","$78000 - $104000"
"36047046000","Census Tract 460, Kings County, New York",3131,61023,1561,83,0,1064,0,321,49.9,2.7,0,34,0,10.3,50.1,1169,465,704,39.78,60.22,72,393,93,611,165,1004,15.5,13.2,14.1,"50% - 75% P.O.C.","$55000 - $78000"
"36047046201","Census Tract 462.01, Kings County, New York",2281,29830,1837,15,0,337,0,70,80.5,0.7,0,14.8,0,3.1,19.5,983,401,582,40.79,59.21,65,336,52,530,117,866,16.2,8.9,11.9,"Less than 25% P.O.C.","Less than $55000"
"36047046202","Census Tract 462.02, Kings County, New York",1942,61250,1665,24,0,58,0,177,85.7,1.2,0,3,0,9.1,14.3,596,321,275,53.86,46.14,73,248,86,189,159,437,22.7,31.3,26.7,"Less than 25% P.O.C.","$55000 - $78000"
"36047046400","Census Tract 464, Kings County, New York",2638,57283,2287,88,0,54,0,121,86.7,3.3,0,2,0,4.6,13.3,608,303,305,49.84,50.16,132,171,123,182,255,353,43.6,40.3,41.9,"Less than 25% P.O.C.","$55000 - $78000"
"36047046800","Census Tract 468, Kings County, New York",2168,72750,2072,6,0,49,0,41,95.6,0.3,0,2.3,0,1.9,4.4,457,238,219,52.08,47.92,122,116,128,91,250,207,51.3,58.4,54.7,"Less than 25% P.O.C.","$55000 - $78000"
"36047047000","Census Tract 470, Kings County, New York",2603,61033,2360,3,0,71,0,134,90.7,0.1,0,2.7,0,5.1,9.3,639,329,310,51.49,48.51,133,196,112,198,245,394,40.4,36.1,38.3,"Less than 25% P.O.C.","$55000 - $78000"
"36047047200","Census Tract 472, Kings County, New York",2769,60054,2711,31,0,19,0,8,97.9,1.1,0,0.7,0,0.3,2.1,605,226,379,37.36,62.64,91,135,206,173,297,308,40.3,54.4,49.1,"Less than 25% P.O.C.","$55000 - $78000"
"36047047400","Census Tract 474, Kings County, New York",2385,38813,2337,4,0,0,0,23,98,0.2,0,0,0,1,2,671,280,391,41.73,58.27,44,236,145,246,189,482,15.7,37.1,28.2,"Less than 25% P.O.C.","Less than $55000"
"36047047600","Census Tract 476, Kings County, New York",3385,35474,3224,78,0,26,0,38,95.2,2.3,0,0.8,0,1.1,4.8,931,479,452,51.45,48.55,125,354,185,267,310,621,26.1,40.9,33.3,"Less than 25% P.O.C.","Less than $55000"
"36047047700","Census Tract 477, Kings County, New York",3835,142250,3017,44,0,292,0,373,78.7,1.1,0,7.6,0,9.7,21.3,1775,518,1257,29.18,70.82,27,491,0,1257,27,1748,5.2,0,1.5,"Less than 25% P.O.C.","$104000 or more"
"36047047800","Census Tract 478, Kings County, New York",3666,48040,2831,0,0,263,0,500,77.2,0,0,7.2,0,13.6,22.8,1037,377,660,36.35,63.65,163,214,132,528,295,742,43.2,20,28.4,"Less than 25% P.O.C.","Less than $55000"
"36047048000","Census Tract 480, Kings County, New York",3675,32056,2062,113,0,381,0,1119,56.1,3.1,0,10.4,0,30.4,43.9,1025,180,845,17.56,82.44,82,98,217,628,299,726,45.6,25.7,29.2,"25% - 50% P.O.C.","Less than $55000"
"36047048100","Census Tract 481, Kings County, New York",2967,91528,1569,123,0,351,0,887,52.9,4.1,0,11.8,0,29.9,47.1,1391,160,1231,11.5,88.5,0,160,49,1182,49,1342,0,4,3.5,"25% - 50% P.O.C.","$78000 - $104000"
"36047048200","Census Tract 482, Kings County, New York",4885,47569,2206,210,0,1515,0,840,45.2,4.3,0,31,0,17.2,54.8,1770,494,1276,27.91,72.09,22,472,242,1034,264,1506,4.5,19,14.9,"50% - 75% P.O.C.","Less than $55000"
"36047048400","Census Tract 484, Kings County, New York",5574,50833,3527,411,0,709,0,524,63.3,7.4,0,12.7,0,9.4,36.7,1616,463,1153,28.65,71.35,193,270,278,875,471,1145,41.7,24.1,29.1,"25% - 50% P.O.C.","Less than $55000"
"36047048500","Census Tract 485, Kings County, New York",2289,103173,1262,77,0,52,0,792,55.1,3.4,0,2.3,0,34.6,44.9,905,106,799,11.71,88.29,23,83,37,762,60,845,21.7,4.6,6.6,"25% - 50% P.O.C.","$78000 - $104000"
"36047048600","Census Tract 486, Kings County, New York",3200,50250,974,49,0,1400,0,764,30.4,1.5,0,43.8,0,23.9,69.6,866,226,640,26.1,73.9,90,136,164,476,254,612,39.8,25.6,29.3,"50% - 75% P.O.C.","Less than $55000"
"36047048800","Census Tract 488, Kings County, New York",3896,54067,1954,268,0,932,0,458,50.2,6.9,0,23.9,0,11.8,49.8,1435,734,701,51.15,48.85,123,611,111,590,234,1201,16.8,15.8,16.3,"25% - 50% P.O.C.","Less than $55000"
"36047048900","Census Tract 489, Kings County, New York",3617,24808,94,1368,31,46,0,2078,2.6,37.8,0.9,1.3,0,57.5,97.4,1580,0,1580,0,100,0,0,133,1447,133,1447,NA,8.4,8.4,"75% or more P.O.C.","Less than $55000"
"36047049000","Census Tract 490, Kings County, New York",5601,59384,2716,475,85,1160,0,975,48.5,8.5,1.5,20.7,0,17.4,51.5,2271,678,1593,29.85,70.15,55,623,262,1331,317,1954,8.1,16.4,14,"50% - 75% P.O.C.","$55000 - $78000"
"36047049100","Census Tract 491, Kings County, New York",7069,48566,1383,636,0,2243,23,2784,19.6,9,0,31.7,0.3,39.4,80.4,2787,366,2421,13.13,86.87,51,315,131,2290,182,2605,13.9,5.4,6.5,"75% or more P.O.C.","Less than $55000"
"36047049200","Census Tract 492, Kings County, New York",2688,62604,1485,209,26,654,0,256,55.2,7.8,1,24.3,0,9.5,44.8,995,458,537,46.03,53.97,97,361,51,486,148,847,21.2,9.5,14.9,"25% - 50% P.O.C.","$55000 - $78000"
"36047049300","Census Tract 493, Kings County, New York",7292,28287,1220,1367,0,247,0,4074,16.7,18.7,0,3.4,0,55.9,83.3,3255,90,3165,2.76,97.24,0,90,163,3002,163,3092,0,5.2,5,"75% or more P.O.C.","Less than $55000"
"36047049400","Census Tract 494, Kings County, New York",5707,76513,2780,289,0,1352,0,855,48.7,5.1,0,23.7,0,15,51.3,2009,675,1334,33.6,66.4,108,567,155,1179,263,1746,16,11.6,13.1,"50% - 75% P.O.C.","$55000 - $78000"
"36047049500","Census Tract 495, Kings County, New York",2600,92120,1524,165,0,247,0,615,58.6,6.3,0,9.5,0,23.7,41.4,1229,235,994,19.12,80.88,24,211,11,983,35,1194,10.2,1.1,2.8,"25% - 50% P.O.C.","$78000 - $104000"
"36047049600","Census Tract 496, Kings County, New York",4093,77115,1499,112,0,1117,0,1257,36.6,2.7,0,27.3,0,30.7,63.4,1380,444,936,32.17,67.83,71,373,136,800,207,1173,16,14.5,15,"50% - 75% P.O.C.","$55000 - $78000"
"36047049700","Census Tract 497, Kings County, New York",2717,91557,1781,24,0,335,0,481,65.6,0.9,0,12.3,0,17.7,34.4,1444,298,1146,20.64,79.36,12,286,0,1146,12,1432,4,0,0.8,"25% - 50% P.O.C.","$78000 - $104000"
"36047049800","Census Tract 498, Kings County, New York",4139,79583,1762,148,0,1336,0,679,42.6,3.6,0,32.3,0,16.4,57.4,1507,536,971,35.57,64.43,122,414,71,900,193,1314,22.8,7.3,12.8,"50% - 75% P.O.C.","$78000 - $104000"
"36047049900","Census Tract 499, Kings County, New York",1785,76612,1393,20,0,105,0,185,78,1.1,0,5.9,0,10.4,22,893,207,686,23.18,76.82,19,188,0,686,19,874,9.2,0,2.1,"Less than 25% P.O.C.","$55000 - $78000"
"36047050000","Census Tract 500, Kings County, New York",3953,98421,2182,360,0,771,0,474,55.2,9.1,0,19.5,0,12,44.8,1460,795,665,54.45,45.55,93,702,46,619,139,1321,11.7,6.9,9.5,"25% - 50% P.O.C.","$78000 - $104000"
"36047050100","Census Tract 501, Kings County, New York",3177,112679,2252,30,51,196,0,560,70.9,0.9,1.6,6.2,0,17.6,29.1,1466,430,1036,29.33,70.67,73,357,0,1036,73,1393,17,0,5,"25% - 50% P.O.C.","$104000 or more"
"36047050202","Census Tract 502.02, Kings County, New York",2523,102656,1987,24,0,101,0,241,78.8,1,0,4,0,9.6,21.2,1083,757,326,69.9,30.1,0,757,0,326,0,1083,0,0,0,"Less than 25% P.O.C.","$78000 - $104000"
"36047050300","Census Tract 503, Kings County, New York",2670,96216,1594,59,128,187,0,530,59.7,2.2,4.8,7,0,19.9,40.3,1328,352,976,26.51,73.49,42,310,12,964,54,1274,11.9,1.2,4.1,"25% - 50% P.O.C.","$78000 - $104000"
"36047050400","Census Tract 504, Kings County, New York",4741,98525,2566,674,0,443,0,817,54.1,14.2,0,9.3,0,17.2,45.9,2077,703,1374,33.85,66.15,9,694,57,1317,66,2011,1.3,4.1,3.2,"25% - 50% P.O.C.","$78000 - $104000"
"36047050500","Census Tract 505, Kings County, New York",4009,41629,1023,533,0,558,0,1868,25.5,13.3,0,13.9,0,46.6,74.5,1933,226,1707,11.69,88.31,0,226,43,1664,43,1890,0,2.5,2.2,"50% - 75% P.O.C.","Less than $55000"
"36047050600","Census Tract 506, Kings County, New York",5205,59882,1013,2074,0,473,0,1533,19.5,39.8,0,9.1,0,29.5,80.5,2011,263,1748,13.08,86.92,23,240,174,1574,197,1814,8.7,10,9.8,"75% or more P.O.C.","$55000 - $78000"
"36047050700","Census Tract 507, Kings County, New York",3063,35469,2342,124,0,39,0,535,76.5,4,0,1.3,0,17.5,23.5,597,123,474,20.6,79.4,87,36,210,264,297,300,70.7,44.3,49.7,"Less than 25% P.O.C.","Less than $55000"
"36047050801","Census Tract 508.01, Kings County, New York",4075,50333,436,2496,0,92,0,1031,10.7,61.3,0,2.3,0,25.3,89.3,1428,28,1400,1.96,98.04,13,15,153,1247,166,1262,46.4,10.9,11.6,"75% or more P.O.C.","Less than $55000"
"36047050803","Census Tract 508.03, Kings County, New York",2522,55395,496,1550,2,93,0,332,19.7,61.5,0.1,3.7,0,13.2,80.3,956,30,926,3.14,96.86,12,18,101,825,113,843,40,10.9,11.8,"75% or more P.O.C.","$55000 - $78000"
"36047050804","Census Tract 508.04, Kings County, New York",6083,60563,1179,2715,0,161,0,1884,19.4,44.6,0,2.6,0,31,80.6,2486,184,2302,7.4,92.6,24,160,246,2056,270,2216,13,10.7,10.9,"75% or more P.O.C.","$55000 - $78000"
"36047050900","Census Tract 509, Kings County, New York",5440,37000,5101,8,0,0,22,266,93.8,0.1,0,0,0.4,4.9,6.2,822,199,623,24.21,75.79,147,52,440,183,587,235,73.9,70.6,71.4,"Less than 25% P.O.C.","Less than $55000"
"36047051001","Census Tract 510.01, Kings County, New York",4092,55435,300,3085,0,74,0,528,7.3,75.4,0,1.8,0,12.9,92.7,1470,0,1470,0,100,0,0,239,1231,239,1231,NA,16.3,16.3,"75% or more P.O.C.","$55000 - $78000"
"36047051002","Census Tract 510.02, Kings County, New York",4858,50625,549,2832,0,86,0,1087,11.3,58.3,0,1.8,0,22.4,88.7,1876,49,1827,2.61,97.39,18,31,196,1631,214,1662,36.7,10.7,11.4,"75% or more P.O.C.","Less than $55000"
"36047051100","Census Tract 511, Kings County, New York",4333,48476,1502,239,0,984,0,1472,34.7,5.5,0,22.7,0,34,65.3,1988,165,1823,8.3,91.7,8,157,58,1765,66,1922,4.8,3.2,3.3,"50% - 75% P.O.C.","Less than $55000"
"36047051200","Census Tract 512, Kings County, New York",5936,61292,1347,3111,0,111,0,1169,22.7,52.4,0,1.9,0,19.7,77.3,2393,191,2202,7.98,92.02,24,167,270,1932,294,2099,12.6,12.3,12.3,"75% or more P.O.C.","$55000 - $78000"
"36047051300","Census Tract 513, Kings County, New York",5397,110972,2763,157,0,340,0,1802,51.2,2.9,0,6.3,0,33.4,48.8,2306,283,2023,12.27,87.73,19,264,63,1960,82,2224,6.7,3.1,3.6,"25% - 50% P.O.C.","$104000 or more"
"36047051400","Census Tract 514, Kings County, New York",7834,64259,1180,3197,0,1045,0,2148,15.1,40.8,0,13.3,0,27.4,84.9,2770,224,2546,8.09,91.91,3,221,418,2128,421,2349,1.3,16.4,15.2,"75% or more P.O.C.","$55000 - $78000"
"36047051500","Census Tract 515, Kings County, New York",2443,158452,1614,150,0,228,0,411,66.1,6.1,0,9.3,0,16.8,33.9,1178,202,976,17.15,82.85,7,195,0,976,7,1171,3.5,0,0.6,"25% - 50% P.O.C.","$104000 or more"
"36047051601","Census Tract 516.01, Kings County, New York",5252,59223,403,3405,0,190,0,1195,7.7,64.8,0,3.6,0,22.8,92.3,1909,38,1871,1.99,98.01,16,22,246,1625,262,1647,42.1,13.1,13.7,"75% or more P.O.C.","$55000 - $78000"
"36047051602","Census Tract 516.02, Kings County, New York",3895,54879,315,2628,0,108,0,714,8.1,67.5,0,2.8,0,18.3,91.9,1439,82,1357,5.7,94.3,13,69,131,1226,144,1295,15.9,9.7,10,"75% or more P.O.C.","Less than $55000"
"36047051700","Census Tract 517, Kings County, New York",2581,126649,1915,42,0,262,0,276,74.2,1.6,0,10.2,0,10.7,25.8,1520,313,1207,20.59,79.41,10,303,0,1207,10,1510,3.2,0,0.7,"25% - 50% P.O.C.","$104000 or more"
"36047051800","Census Tract 518, Kings County, New York",3328,64211,943,1604,0,194,0,461,28.3,48.2,0,5.8,0,13.9,71.7,1392,454,938,32.61,67.39,23,431,29,909,52,1340,5.1,3.1,3.7,"50% - 75% P.O.C.","$55000 - $78000"
"36047051900","Census Tract 519, Kings County, New York",5066,143057,3640,252,0,435,0,608,71.9,5,0,8.6,0,12,28.1,2741,291,2450,10.62,89.38,0,291,14,2436,14,2727,0,0.6,0.5,"25% - 50% P.O.C.","$104000 or more"
"36047052000","Census Tract 520, Kings County, New York",3874,81875,1525,495,0,916,0,757,39.4,12.8,0,23.6,0,19.5,60.6,1360,478,882,35.15,64.85,69,409,160,722,229,1131,14.4,18.1,16.8,"50% - 75% P.O.C.","$78000 - $104000"
"36047052300","Census Tract 523, Kings County, New York",4854,69950,1895,29,0,303,22,2547,39,0.6,0,6.2,0.5,52.5,61,2205,231,1974,10.48,89.52,0,231,80,1894,80,2125,0,4.1,3.6,"50% - 75% P.O.C.","$55000 - $78000"
"36047052500","Census Tract 525, Kings County, New York",3270,35867,1810,158,0,145,0,1091,55.4,4.8,0,4.4,0,33.4,44.6,1231,22,1209,1.79,98.21,0,22,159,1050,159,1072,0,13.2,12.9,"25% - 50% P.O.C.","Less than $55000"
"36047052600","Census Tract 526, Kings County, New York",4491,68077,1843,758,0,613,0,1185,41,16.9,0,13.6,0,26.4,59,1816,285,1531,15.69,84.31,83,202,87,1444,170,1646,29.1,5.7,9.4,"50% - 75% P.O.C.","$55000 - $78000"
"36047052700","Census Tract 527, Kings County, New York",6490,64167,1642,153,0,283,0,4304,25.3,2.4,0,4.4,0,66.3,74.7,2336,106,2230,4.54,95.46,33,73,201,2029,234,2102,31.1,9,10,"50% - 75% P.O.C.","$55000 - $78000"
"36047052800","Census Tract 528, Kings County, New York",1799,87212,1074,108,0,370,0,223,59.7,6,0,20.6,0,12.4,40.3,647,386,261,59.66,40.34,42,344,42,219,84,563,10.9,16.1,13,"25% - 50% P.O.C.","$78000 - $104000"
"36047052900","Census Tract 529, Kings County, New York",3443,27229,3342,20,0,0,0,81,97.1,0.6,0,0,0,2.4,2.9,875,104,771,11.89,88.11,39,65,275,496,314,561,37.5,35.7,35.9,"Less than 25% P.O.C.","Less than $55000"
"36047053000","Census Tract 530, Kings County, New York",4060,53802,2327,68,0,1116,0,492,57.3,1.7,0,27.5,0,12.1,42.7,1075,312,763,29.02,70.98,151,161,204,559,355,720,48.4,26.7,33,"25% - 50% P.O.C.","Less than $55000"
"36047053100","Census Tract 531, Kings County, New York",8833,47868,8450,27,0,64,0,247,95.7,0.3,0,0.7,0,2.8,4.3,1678,307,1371,18.3,81.7,174,133,704,667,878,800,56.7,51.3,52.3,"Less than 25% P.O.C.","Less than $55000"
"36047053200","Census Tract 532, Kings County, New York",2789,65972,1659,218,0,620,0,202,59.5,7.8,0,22.2,0,7.2,40.5,975,592,383,60.72,39.28,86,506,38,345,124,851,14.5,9.9,12.7,"25% - 50% P.O.C.","$55000 - $78000"
"36047053300","Census Tract 533, Kings County, New York",6754,26976,6548,27,0,87,0,81,96.9,0.4,0,1.3,0,1.2,3.1,1633,356,1277,21.8,78.2,79,277,557,720,636,997,22.2,43.6,38.9,"Less than 25% P.O.C.","Less than $55000"
"36047053400","Census Tract 534, Kings County, New York",4232,39917,2437,302,0,907,27,296,57.6,7.1,0,21.4,0.6,7,42.4,1280,313,967,24.45,75.55,146,167,115,852,261,1019,46.6,11.9,20.4,"25% - 50% P.O.C.","Less than $55000"
"36047053500","Census Tract 535, Kings County, New York",3708,30699,3254,145,20,0,0,193,87.8,3.9,0.5,0,0,5.2,12.2,922,109,813,11.82,88.18,9,100,312,501,321,601,8.3,38.4,34.8,"Less than 25% P.O.C.","Less than $55000"
"36047053700","Census Tract 537, Kings County, New York",3862,40644,3740,56,0,32,0,28,96.8,1.5,0,0.8,0,0.7,3.2,685,95,590,13.87,86.13,48,47,323,267,371,314,50.5,54.7,54.2,"Less than 25% P.O.C.","Less than $55000"
"36047053800","Census Tract 538, Kings County, New York",5180,55027,3415,438,32,561,0,699,65.9,8.5,0.6,10.8,0,13.5,34.1,2084,257,1827,12.33,87.67,34,223,263,1564,297,1787,13.2,14.4,14.3,"25% - 50% P.O.C.","$55000 - $78000"
"36047053900","Census Tract 539, Kings County, New York",2483,20902,1942,84,0,0,0,457,78.2,3.4,0,0,0,18.4,21.8,825,99,726,12,88,0,99,159,567,159,666,0,21.9,19.3,"Less than 25% P.O.C.","Less than $55000"
"36047054200","Census Tract 542, Kings County, New York",4008,50694,3347,117,0,169,0,375,83.5,2.9,0,4.2,0,9.4,16.5,1531,383,1148,25.02,74.98,96,287,91,1057,187,1344,25.1,7.9,12.2,"Less than 25% P.O.C.","Less than $55000"
"36047054300","Census Tract 543, Kings County, New York",283,116875,178,38,0,30,0,27,62.9,13.4,0,10.6,0,9.5,37.1,147,10,137,6.8,93.2,0,10,0,137,0,147,0,0,0,"25% - 50% P.O.C.","$104000 or more"
"36047054400","Census Tract 544, Kings County, New York",3487,60707,2573,0,0,665,0,235,73.8,0,0,19.1,0,6.7,26.2,1226,548,678,44.7,55.3,58,490,74,604,132,1094,10.6,10.9,10.8,"25% - 50% P.O.C.","$55000 - $78000"
"36047054500","Census Tract 545, Kings County, New York",8138,23555,5530,824,0,36,0,1710,68,10.1,0,0.4,0,21,32,2382,154,2228,6.47,93.53,72,82,529,1699,601,1781,46.8,23.7,25.2,"25% - 50% P.O.C.","Less than $55000"
"36047054600","Census Tract 546, Kings County, New York",4782,47344,3519,185,0,374,0,338,73.6,3.9,0,7.8,0,7.1,26.4,1889,311,1578,16.46,83.54,97,214,172,1406,269,1620,31.2,10.9,14.2,"25% - 50% P.O.C.","Less than $55000"
"36047054700","Census Tract 547, Kings County, New York",5724,50272,4183,234,0,142,0,1046,73.1,4.1,0,2.5,0,18.3,26.9,1727,271,1456,15.69,84.31,96,175,303,1153,399,1328,35.4,20.8,23.1,"25% - 50% P.O.C.","Less than $55000"
"36047054800","Census Tract 548, Kings County, New York",2090,71250,1916,4,0,22,0,39,91.7,0.2,0,1.1,0,1.9,8.3,736,369,367,50.14,49.86,120,249,16,351,136,600,32.5,4.4,18.5,"Less than 25% P.O.C.","$55000 - $78000"
"36047054900","Census Tract 549, Kings County, New York",4171,111071,2692,25,0,241,0,945,64.5,0.6,0,5.8,0,22.7,35.5,1720,294,1426,17.09,82.91,38,256,100,1326,138,1582,12.9,7,8,"25% - 50% P.O.C.","$104000 or more"
"36047055000","Census Tract 550, Kings County, New York",3382,60851,2484,61,0,377,0,428,73.4,1.8,0,11.1,0,12.7,26.6,1424,372,1052,26.12,73.88,72,300,61,991,133,1291,19.4,5.8,9.3,"25% - 50% P.O.C.","$55000 - $78000"
"36047055100","Census Tract 551, Kings County, New York",5361,89073,2152,128,0,161,0,2821,40.1,2.4,0,3,0,52.6,59.9,2321,554,1767,23.87,76.13,37,517,137,1630,174,2147,6.7,7.8,7.5,"50% - 75% P.O.C.","$78000 - $104000"
"36047055200","Census Tract 552, Kings County, New York",3477,74395,2346,5,0,443,0,349,67.5,0.1,0,12.7,0,10,32.5,1399,485,914,34.67,65.33,100,385,34,880,134,1265,20.6,3.7,9.6,"25% - 50% P.O.C.","$55000 - $78000"
"36047055300","Census Tract 553, Kings County, New York",2740,120069,2040,3,0,125,0,507,74.5,0.1,0,4.6,0,18.5,25.5,1401,387,1014,27.62,72.38,8,379,25,989,33,1368,2.1,2.5,2.4,"25% - 50% P.O.C.","$104000 or more"
"36047055400","Census Tract 554, Kings County, New York",4328,45257,2981,10,0,476,0,629,68.9,0.2,0,11,0,14.5,31.1,1643,194,1449,11.81,88.19,24,170,186,1263,210,1433,12.4,12.8,12.8,"25% - 50% P.O.C.","Less than $55000"
"36047055500","Census Tract 555, Kings County, New York",7696,143833,4684,97,0,1201,0,1290,60.9,1.3,0,15.6,0,16.8,39.1,3780,1076,2704,28.47,71.53,0,1076,32,2672,32,3748,0,1.2,0.8,"25% - 50% P.O.C.","$104000 or more"
"36047055600","Census Tract 556, Kings County, New York",3397,55995,2689,17,0,263,0,344,79.2,0.5,0,7.7,0,10.1,20.8,1249,448,801,35.87,64.13,127,321,61,740,188,1061,28.3,7.6,15.1,"Less than 25% P.O.C.","$55000 - $78000"
"36047055700","Census Tract 557, Kings County, New York",1981,92674,1207,32,0,142,0,579,60.9,1.6,0,7.2,0,29.2,39.1,937,149,788,15.9,84.1,8,141,52,736,60,877,5.4,6.6,6.4,"25% - 50% P.O.C.","$78000 - $104000"
"36047055800","Census Tract 558, Kings County, New York",2492,76797,1531,50,0,397,0,420,61.4,2,0,15.9,0,16.9,38.6,889,292,597,32.85,67.15,83,209,59,538,142,747,28.4,9.9,16,"25% - 50% P.O.C.","$55000 - $78000"
"36047056000","Census Tract 560, Kings County, New York",3482,50833,3063,20,19,260,0,75,88,0.6,0.5,7.5,0,2.2,12,1372,532,840,38.78,61.22,116,416,38,802,154,1218,21.8,4.5,11.2,"Less than 25% P.O.C.","Less than $55000"
"36047056100","Census Tract 561, Kings County, New York",3538,108750,2654,209,40,228,0,223,75,5.9,1.1,6.4,0,6.3,25,1628,291,1337,17.87,82.13,28,263,71,1266,99,1529,9.6,5.3,6.1,"25% - 50% P.O.C.","$104000 or more"
"36047056200","Census Tract 562, Kings County, New York",1655,88221,1450,0,0,84,0,29,87.6,0,0,5.1,0,1.8,12.4,523,512,11,97.9,2.1,105,407,0,11,105,418,20.5,0,20.1,"Less than 25% P.O.C.","$78000 - $104000"
"36047056300","Census Tract 563, Kings County, New York",5390,90948,3040,279,0,347,0,1463,56.4,5.2,0,6.4,0,27.1,43.6,2328,232,2096,9.97,90.03,101,131,72,2024,173,2155,43.5,3.4,7.4,"25% - 50% P.O.C.","$78000 - $104000"
"36047056400","Census Tract 564, Kings County, New York",2523,82344,1809,29,0,457,43,185,71.7,1.1,0,18.1,1.7,7.3,28.3,950,752,198,79.16,20.84,110,642,35,163,145,805,14.6,17.7,15.3,"25% - 50% P.O.C.","$78000 - $104000"
"36047056500","Census Tract 565, Kings County, New York",3156,106157,2378,0,0,149,0,545,75.3,0,0,4.7,0,17.3,24.7,1582,237,1345,14.98,85.02,22,215,11,1334,33,1549,9.3,0.8,2.1,"Less than 25% P.O.C.","$104000 or more"
"36047056600","Census Tract 566, Kings County, New York",2749,83849,1436,361,0,647,0,110,52.2,13.1,0,23.5,0,4,47.8,987,398,589,40.32,59.68,94,304,64,525,158,829,23.6,10.9,16,"25% - 50% P.O.C.","$78000 - $104000"
"36047056800","Census Tract 568, Kings County, New York",1455,86250,874,0,0,401,0,70,60.1,0,0,27.6,0,4.8,39.9,553,410,143,74.14,25.86,26,384,14,129,40,513,6.3,9.8,7.2,"25% - 50% P.O.C.","$78000 - $104000"
"36047056900","Census Tract 569, Kings County, New York",1691,128036,1356,17,0,67,0,188,80.2,1,0,4,0,11.1,19.8,761,136,625,17.87,82.13,0,136,13,612,13,748,0,2.1,1.7,"Less than 25% P.O.C.","$104000 or more"
"36047057000","Census Tract 570, Kings County, New York",3529,75761,2000,95,0,977,0,426,56.7,2.7,0,27.7,0,12.1,43.3,1414,1261,153,89.18,10.82,87,1174,0,153,87,1327,6.9,0,6.2,"25% - 50% P.O.C.","$55000 - $78000"
"36047057100","Census Tract 571, Kings County, New York",4038,85510,3347,64,0,90,0,349,82.9,1.6,0,2.2,0,8.6,17.1,1897,393,1504,20.72,79.28,88,305,14,1490,102,1795,22.4,0.9,5.4,"Less than 25% P.O.C.","$78000 - $104000"
"36047057200","Census Tract 572, Kings County, New York",5522,24958,758,2642,0,515,0,1582,13.7,47.8,0,9.3,0,28.6,86.3,2269,0,2269,0,100,0,0,218,2051,218,2051,NA,9.6,9.6,"75% or more P.O.C.","Less than $55000"
"36047057300","Census Tract 573, Kings County, New York",2457,102656,1874,77,0,132,0,262,76.3,3.1,0,5.4,0,10.7,23.7,1092,233,859,21.34,78.66,8,225,15,844,23,1069,3.4,1.7,2.1,"Less than 25% P.O.C.","$78000 - $104000"
"36047057400","Census Tract 574, Kings County, New York",2858,85673,1240,2,0,1440,0,131,43.4,0.1,0,50.4,0,4.6,56.6,962,709,253,73.7,26.3,154,555,32,221,186,776,21.7,12.6,19.3,"50% - 75% P.O.C.","$78000 - $104000"
"36047057500","Census Tract 575, Kings County, New York",3983,87561,3144,11,0,112,0,685,78.9,0.3,0,2.8,0,17.2,21.1,2179,336,1843,15.42,84.58,24,312,27,1816,51,2128,7.1,1.5,2.3,"Less than 25% P.O.C.","$78000 - $104000"
"36047057600","Census Tract 576, Kings County, New York",3041,80625,1197,43,0,1491,0,243,39.4,1.4,0,49,0,8,60.6,1006,515,491,51.19,48.81,73,442,78,413,151,855,14.2,15.9,15,"50% - 75% P.O.C.","$78000 - $104000"
"36047057800","Census Tract 578, Kings County, New York",3260,47466,1519,36,0,975,0,592,46.6,1.1,0,29.9,0,18.2,53.4,1063,355,708,33.4,66.6,50,305,202,506,252,811,14.1,28.5,23.7,"50% - 75% P.O.C.","Less than $55000"
"36047057900","Census Tract 579, Kings County, New York",1165,93750,544,132,0,38,0,423,46.7,11.3,0,3.3,0,36.3,53.3,458,31,427,6.77,93.23,0,31,27,400,27,431,0,6.3,5.9,"50% - 75% P.O.C.","$78000 - $104000"
"36047058000","Census Tract 580, Kings County, New York",4402,61184,1593,284,0,1875,0,585,36.2,6.5,0,42.6,0,13.3,63.8,1306,378,928,28.94,71.06,189,189,148,780,337,969,50,15.9,25.8,"50% - 75% P.O.C.","$55000 - $78000"
"36047058200","Census Tract 582, Kings County, New York",2542,52644,1255,70,0,480,0,660,49.4,2.8,0,18.9,0,26,50.6,969,317,652,32.71,67.29,29,288,104,548,133,836,9.1,16,13.7,"50% - 75% P.O.C.","Less than $55000"
"36047058400","Census Tract 584, Kings County, New York",3479,68487,2262,138,0,705,0,326,65,4,0,20.3,0,9.4,35,1377,340,1037,24.69,75.31,48,292,59,978,107,1270,14.1,5.7,7.8,"25% - 50% P.O.C.","$55000 - $78000"
"36047058600","Census Tract 586, Kings County, New York",2772,71758,619,84,0,1705,0,364,22.3,3,0,61.5,0,13.1,77.7,843,517,326,61.33,38.67,136,381,51,275,187,656,26.3,15.6,22.2,"75% or more P.O.C.","$55000 - $78000"
"36047058800","Census Tract 588, Kings County, New York",3269,68125,2300,14,0,647,0,257,70.4,0.4,0,19.8,0,7.9,29.6,1368,748,620,54.68,45.32,54,694,55,565,109,1259,7.2,8.9,8,"25% - 50% P.O.C.","$55000 - $78000"
"36047058900","Census Tract 589, Kings County, New York",1691,85500,1410,0,0,37,0,205,83.4,0,0,2.2,0,12.1,16.6,754,250,504,33.16,66.84,36,214,0,504,36,718,14.4,0,4.8,"Less than 25% P.O.C.","$78000 - $104000"
"36047059000","Census Tract 590, Kings County, New York",1834,69250,793,52,0,644,0,311,43.2,2.8,0,35.1,0,17,56.8,589,262,327,44.48,55.52,45,217,34,293,79,510,17.2,10.4,13.4,"50% - 75% P.O.C.","$55000 - $78000"
"36047059100","Census Tract 591, Kings County, New York",3638,108447,2882,50,0,96,0,544,79.2,1.4,0,2.6,0,15,20.8,1755,352,1403,20.06,79.94,42,310,13,1390,55,1700,11.9,0.9,3.1,"Less than 25% P.O.C.","$104000 or more"
"36047059200","Census Tract 592, Kings County, New York",4152,53177,2216,263,0,787,0,483,53.4,6.3,0,19,0,11.6,46.6,1677,473,1204,28.21,71.79,46,427,66,1138,112,1565,9.7,5.5,6.7,"25% - 50% P.O.C.","Less than $55000"
"36047059300","Census Tract 593, Kings County, New York",2022,81319,1498,34,0,73,0,303,74.1,1.7,0,3.6,0,15,25.9,915,143,772,15.63,84.37,18,125,29,743,47,868,12.6,3.8,5.1,"25% - 50% P.O.C.","$78000 - $104000"
"36047059401","Census Tract 594.01, Kings County, New York",7396,61283,4045,49,0,2836,0,361,54.7,0.7,0,38.3,0,4.9,45.3,2917,1375,1542,47.14,52.86,82,1293,94,1448,176,2741,6,6.1,6,"25% - 50% P.O.C.","$55000 - $78000"
"36047059402","Census Tract 594.02, Kings County, New York",5399,97500,3812,0,0,1369,0,98,70.6,0,0,25.4,0,1.8,29.4,2002,1496,506,74.73,25.27,166,1330,12,494,178,1824,11.1,2.4,8.9,"25% - 50% P.O.C.","$78000 - $104000"
"36047059600","Census Tract 596, Kings County, New York",2442,47273,1827,173,0,179,0,10,74.8,7.1,0,7.3,0,0.4,25.2,1166,753,413,64.58,35.42,75,678,10,403,85,1081,10,2.4,7.3,"25% - 50% P.O.C.","Less than $55000"
"36047059800","Census Tract 598, Kings County, New York",3606,75612,2629,140,0,492,0,187,72.9,3.9,0,13.6,0,5.2,27.1,1330,683,647,51.35,48.65,123,560,80,567,203,1127,18,12.4,15.3,"25% - 50% P.O.C.","$55000 - $78000"
"36047060000","Census Tract 600, Kings County, New York",6277,72342,4962,63,0,660,0,310,79.1,1,0,10.5,0,4.9,20.9,2584,1266,1318,48.99,51.01,40,1226,89,1229,129,2455,3.2,6.8,5,"Less than 25% P.O.C.","$55000 - $78000"
"36047060600","Census Tract 606, Kings County, New York",2811,62000,1907,14,0,520,0,267,67.8,0.5,0,18.5,0,9.5,32.2,1166,485,681,41.6,58.4,55,430,35,646,90,1076,11.3,5.1,7.7,"25% - 50% P.O.C.","$55000 - $78000"
"36047060800","Census Tract 608, Kings County, New York",3545,54360,2534,56,0,596,0,313,71.5,1.6,0,16.8,0,8.8,28.5,1567,427,1140,27.25,72.75,34,393,59,1081,93,1474,8,5.2,5.9,"25% - 50% P.O.C.","Less than $55000"
"36047061002","Census Tract 610.02, Kings County, New York",4898,76378,4804,0,0,0,0,78,98.1,0,0,0,0,1.6,1.9,2339,1132,1207,48.4,51.6,0,1132,42,1165,42,2297,0,3.5,1.8,"Less than 25% P.O.C.","$55000 - $78000"
"36047061003","Census Tract 610.03, Kings County, New York",1669,50887,533,0,0,416,0,720,31.9,0,0,24.9,0,43.1,68.1,514,169,345,32.88,67.12,45,124,84,261,129,385,26.6,24.3,25.1,"50% - 75% P.O.C.","Less than $55000"
"36047061004","Census Tract 610.04, Kings County, New York",6221,34432,5011,1,0,380,0,458,80.5,0,0,6.1,0,7.4,19.5,2751,390,2361,14.18,85.82,5,385,175,2186,180,2571,1.3,7.4,6.5,"Less than 25% P.O.C.","Less than $55000"
"36047061200","Census Tract 612, Kings County, New York",1065,92143,1010,0,0,0,0,55,94.8,0,0,0,0,5.2,5.2,422,345,77,81.75,18.25,44,301,0,77,44,378,12.8,0,10.4,"Less than 25% P.O.C.","$78000 - $104000"
"36047061600","Census Tract 616, Kings County, New York",1465,110170,1317,80,0,0,0,68,89.9,5.5,0,0,0,4.6,10.1,469,416,53,88.7,11.3,6,410,0,53,6,463,1.4,0,1.3,"Less than 25% P.O.C.","$104000 or more"
"36047062000","Census Tract 620, Kings County, New York",1816,123500,1746,0,0,64,0,6,96.1,0,0,3.5,0,0.3,3.9,680,468,212,68.82,31.18,15,453,25,187,40,640,3.2,11.8,5.9,"Less than 25% P.O.C.","$104000 or more"
"36047062200","Census Tract 622, Kings County, New York",2715,74290,2094,261,0,156,0,145,77.1,9.6,0,5.7,0,5.3,22.9,1091,419,672,38.41,61.59,13,406,0,672,13,1078,3.1,0,1.2,"Less than 25% P.O.C.","$55000 - $78000"
"36047062600","Census Tract 626, Kings County, New York",2869,58102,1252,166,0,857,0,364,43.6,5.8,0,29.9,0,12.7,56.4,1045,673,372,64.4,35.6,121,552,19,353,140,905,18,5.1,13.4,"50% - 75% P.O.C.","$55000 - $78000"
"36047062800","Census Tract 628, Kings County, New York",4418,84091,3552,0,9,421,0,397,80.4,0,0.2,9.5,0,9,19.6,1628,1448,180,88.94,11.06,173,1275,0,180,173,1455,11.9,0,10.6,"Less than 25% P.O.C.","$78000 - $104000"
"36047063200","Census Tract 632, Kings County, New York",1534,68182,1177,26,29,213,0,89,76.7,1.7,1.9,13.9,0,5.8,23.3,624,488,136,78.21,21.79,50,438,0,136,50,574,10.2,0,8,"Less than 25% P.O.C.","$55000 - $78000"
"36047063600","Census Tract 636, Kings County, New York",1289,109479,788,0,0,296,0,205,61.1,0,0,23,0,15.9,38.9,412,389,23,94.42,5.58,86,303,0,23,86,326,22.1,0,20.9,"25% - 50% P.O.C.","$104000 or more"
"36047063800","Census Tract 638, Kings County, New York",2023,103438,1262,101,9,445,0,205,62.4,5,0.4,22,0,10.1,37.6,705,497,208,70.5,29.5,98,399,16,192,114,591,19.7,7.7,16.2,"25% - 50% P.O.C.","$78000 - $104000"
"36047064000","Census Tract 640, Kings County, New York",1742,120885,1289,0,0,180,0,273,74,0,0,10.3,0,15.7,26,569,533,36,93.67,6.33,131,402,2,34,133,436,24.6,5.6,23.4,"25% - 50% P.O.C.","$104000 or more"
"36047064200","Census Tract 642, Kings County, New York",2227,73583,1665,88,0,205,0,221,74.8,4,0,9.2,0,9.9,25.2,869,336,533,38.67,61.33,84,252,43,490,127,742,25,8.1,14.6,"25% - 50% P.O.C.","$55000 - $78000"
"36047064400","Census Tract 644, Kings County, New York",2855,89250,1820,61,0,625,0,317,63.7,2.1,0,21.9,0,11.1,36.3,817,545,272,66.71,33.29,203,342,21,251,224,593,37.2,7.7,27.4,"25% - 50% P.O.C.","$78000 - $104000"
"36047064600","Census Tract 646, Kings County, New York",2190,95391,1781,49,26,158,0,139,81.3,2.2,1.2,7.2,0,6.3,18.7,647,502,145,77.59,22.41,141,361,34,111,175,472,28.1,23.4,27,"Less than 25% P.O.C.","$78000 - $104000"
"36047064800","Census Tract 648, Kings County, New York",2194,108438,1403,594,0,72,0,100,63.9,27.1,0,3.3,0,4.6,36.1,611,476,135,77.91,22.09,141,335,48,87,189,422,29.6,35.6,30.9,"25% - 50% P.O.C.","$104000 or more"
"36047065000","Census Tract 650, Kings County, New York",1642,81875,381,533,0,298,0,419,23.2,32.5,0,18.1,0,25.5,76.8,489,302,187,61.76,38.24,89,213,32,155,121,368,29.5,17.1,24.7,"75% or more P.O.C.","$78000 - $104000"
"36047065200","Census Tract 652, Kings County, New York",1094,93050,924,38,0,27,0,97,84.5,3.5,0,2.5,0,8.9,15.5,469,373,96,79.53,20.47,20,353,0,96,20,449,5.4,0,4.3,"Less than 25% P.O.C.","$78000 - $104000"
"36047065400","Census Tract 654, Kings County, New York",1437,97250,1114,25,0,230,0,68,77.5,1.7,0,16,0,4.7,22.5,539,482,57,89.42,10.58,15,467,0,57,15,524,3.1,0,2.8,"Less than 25% P.O.C.","$78000 - $104000"
"36047065600","Census Tract 656, Kings County, New York",1725,86897,1195,16,0,298,0,201,69.3,0.9,0,17.3,0,11.7,30.7,604,508,96,84.11,15.89,85,423,0,96,85,519,16.7,0,14.1,"25% - 50% P.O.C.","$78000 - $104000"
"36047065800","Census Tract 658, Kings County, New York",1798,97188,1158,17,0,438,0,157,64.4,0.9,0,24.4,0,8.7,35.6,653,538,115,82.39,17.61,81,457,29,86,110,543,15.1,25.2,16.8,"25% - 50% P.O.C.","$78000 - $104000"
"36047066000","Census Tract 660, Kings County, New York",2050,124821,1528,15,0,276,0,101,74.5,0.7,0,13.5,0,4.9,25.5,679,645,34,94.99,5.01,113,532,0,34,113,566,17.5,0,16.6,"25% - 50% P.O.C.","$104000 or more"
"36047066200","Census Tract 662, Kings County, New York",1501,88490,1011,13,0,277,0,176,67.4,0.9,0,18.5,0,11.7,32.6,577,469,108,81.28,18.72,50,419,0,108,50,527,10.7,0,8.7,"25% - 50% P.O.C.","$78000 - $104000"
"36047066600","Census Tract 666, Kings County, New York",0,NA,0,0,0,0,0,0,NA,NA,NA,NA,NA,NA,NA,0,0,0,NA,NA,0,0,0,0,0,0,NA,NA,NA,"N/A","N/A"
"36047067000","Census Tract 670, Kings County, New York",2934,81250,550,1505,0,381,0,418,18.7,51.3,0,13,0,14.2,81.3,1016,600,416,59.06,40.94,81,519,63,353,144,872,13.5,15.1,14.2,"75% or more P.O.C.","$78000 - $104000"
"36047067200","Census Tract 672, Kings County, New York",1640,84438,214,1175,0,191,0,60,13,71.6,0,11.6,0,3.7,87,465,332,133,71.4,28.6,104,228,14,119,118,347,31.3,10.5,25.4,"75% or more P.O.C.","$78000 - $104000"
"36047067400","Census Tract 674, Kings County, New York",1920,100139,269,1193,0,143,0,244,14,62.1,0,7.4,0,12.7,86,560,416,144,74.29,25.71,45,371,79,65,124,436,10.8,54.9,22.1,"75% or more P.O.C.","$78000 - $104000"
"36047067600","Census Tract 676, Kings County, New York",1760,86129,114,1313,0,25,0,299,6.5,74.6,0,1.4,0,17,93.5,572,333,239,58.22,41.78,26,307,59,180,85,487,7.8,24.7,14.9,"75% or more P.O.C.","$78000 - $104000"
"36047067800","Census Tract 678, Kings County, New York",2852,96275,234,2506,0,0,0,84,8.2,87.9,0,0,0,2.9,91.8,945,621,324,65.71,34.29,60,561,38,286,98,847,9.7,11.7,10.4,"75% or more P.O.C.","$78000 - $104000"
"36047068000","Census Tract 680, Kings County, New York",2185,85769,136,1504,0,134,0,403,6.2,68.8,0,6.1,0,18.4,93.8,664,412,252,62.05,37.95,75,337,46,206,121,543,18.2,18.3,18.2,"75% or more P.O.C.","$78000 - $104000"
"36047068200","Census Tract 682, Kings County, New York",2832,124306,485,1794,0,267,0,222,17.1,63.3,0,9.4,0,7.8,82.9,863,689,174,79.84,20.16,174,515,26,148,200,663,25.3,14.9,23.2,"75% or more P.O.C.","$104000 or more"
"36047068600","Census Tract 686, Kings County, New York",1718,69167,846,607,0,86,0,174,49.2,35.3,0,5,0,10.1,50.8,630,455,175,72.22,27.78,83,372,12,163,95,535,18.2,6.9,15.1,"50% - 75% P.O.C.","$55000 - $78000"
"36047068800","Census Tract 688, Kings County, New York",1719,84276,393,857,0,184,0,267,22.9,49.9,0,10.7,0,15.5,77.1,587,466,121,79.39,20.61,86,380,12,109,98,489,18.5,9.9,16.7,"75% or more P.O.C.","$78000 - $104000"
"36047069000","Census Tract 690, Kings County, New York",2082,84856,307,1297,0,110,0,307,14.7,62.3,0,5.3,0,14.7,85.3,638,426,212,66.77,33.23,125,301,46,166,171,467,29.3,21.7,26.8,"75% or more P.O.C.","$78000 - $104000"
"36047069200","Census Tract 692, Kings County, New York",2734,118065,163,1863,0,189,0,396,6,68.1,0,6.9,0,14.5,94,834,555,279,66.55,33.45,91,464,101,178,192,642,16.4,36.2,23,"75% or more P.O.C.","$104000 or more"
"36047069601","Census Tract 696.01, Kings County, New York",3248,81106,1369,1446,0,64,0,306,42.1,44.5,0,2,0,9.4,57.9,1363,513,850,37.64,62.36,54,459,11,839,65,1298,10.5,1.3,4.8,"50% - 75% P.O.C.","$78000 - $104000"
"36047069602","Census Tract 696.02, Kings County, New York",5812,77682,3905,489,0,340,0,1019,67.2,8.4,0,5.8,0,17.5,32.8,2136,1578,558,73.88,26.12,213,1365,68,490,281,1855,13.5,12.2,13.2,"25% - 50% P.O.C.","$55000 - $78000"
"36047069800","Census Tract 698, Kings County, New York",1449,104141,862,58,0,363,0,104,59.5,4,0,25.1,0,7.2,40.5,449,402,47,89.53,10.47,53,349,19,28,72,377,13.2,40.4,16,"25% - 50% P.O.C.","$104000 or more"
"36047070000","Census Tract 700, Kings County, New York",1604,92778,1488,25,0,25,0,66,92.8,1.6,0,1.6,0,4.1,7.2,610,395,215,64.75,35.25,27,368,9,206,36,574,6.8,4.2,5.9,"Less than 25% P.O.C.","$78000 - $104000"
"36047070201","Census Tract 702.01, Kings County, New York",6402,108669,5446,288,46,69,0,527,85.1,4.5,0.7,1.1,0,8.2,14.9,2324,1992,332,85.71,14.29,363,1629,73,259,436,1888,18.2,22,18.8,"Less than 25% P.O.C.","$104000 or more"
"36047070202","Census Tract 702.02, Kings County, New York",8,NA,8,0,0,0,0,0,100,0,0,0,0,0,0,4,0,4,0,100,0,0,0,4,0,4,NA,0,0,"Less than 25% P.O.C.","N/A"
"36047070203","Census Tract 702.03, Kings County, New York",0,NA,0,0,0,0,0,0,NA,NA,NA,NA,NA,NA,NA,0,0,0,NA,NA,0,0,0,0,0,0,NA,NA,NA,"N/A","N/A"
"36047070600","Census Tract 706, Kings County, New York",3137,112557,2521,291,0,150,0,154,80.4,9.3,0,4.8,0,4.9,19.6,947,743,204,78.46,21.54,159,584,77,127,236,711,21.4,37.7,24.9,"Less than 25% P.O.C.","$104000 or more"
"36047072000","Census Tract 720, Kings County, New York",2019,78214,123,1576,0,126,0,163,6.1,78.1,0,6.2,0,8.1,93.9,644,182,462,28.26,71.74,36,146,81,381,117,527,19.8,17.5,18.2,"75% or more P.O.C.","$78000 - $104000"
"36047072200","Census Tract 722, Kings County, New York",2881,67401,90,2301,0,50,0,368,3.1,79.9,0,1.7,0,12.8,96.9,973,664,309,68.24,31.76,80,584,37,272,117,856,12,12,12,"75% or more P.O.C.","$55000 - $78000"
"36047072400","Census Tract 724, Kings County, New York",1979,76618,56,1837,0,1,0,68,2.8,92.8,0,0.1,0,3.4,97.2,706,472,234,66.86,33.14,42,430,25,209,67,639,8.9,10.7,9.5,"75% or more P.O.C.","$55000 - $78000"
"36047072600","Census Tract 726, Kings County, New York",2343,86500,56,1829,0,74,0,377,2.4,78.1,0,3.2,0,16.1,97.6,664,603,61,90.81,9.19,121,482,34,27,155,509,20.1,55.7,23.3,"75% or more P.O.C.","$78000 - $104000"
"36047072800","Census Tract 728, Kings County, New York",3946,80082,101,3686,0,19,0,112,2.6,93.4,0,0.5,0,2.8,97.4,1557,1144,413,73.47,26.53,116,1028,12,401,128,1429,10.1,2.9,8.2,"75% or more P.O.C.","$78000 - $104000"
"36047073000","Census Tract 730, Kings County, New York",2278,91477,97,1969,0,9,0,181,4.3,86.4,0,0.4,0,7.9,95.7,713,584,129,81.91,18.09,101,483,14,115,115,598,17.3,10.9,16.1,"75% or more P.O.C.","$78000 - $104000"
"36047073200","Census Tract 732, Kings County, New York",2195,70000,38,1852,0,135,0,114,1.7,84.4,0,6.2,0,5.2,98.3,784,434,350,55.36,44.64,71,363,37,313,108,676,16.4,10.6,13.8,"75% or more P.O.C.","$55000 - $78000"
"36047073400","Census Tract 734, Kings County, New York",1776,84750,38,1565,0,0,0,129,2.1,88.1,0,0,0,7.3,97.9,551,454,97,82.4,17.6,78,376,21,76,99,452,17.2,21.6,18,"75% or more P.O.C.","$78000 - $104000"
"36047073600","Census Tract 736, Kings County, New York",3198,75153,155,2176,0,345,0,408,4.8,68,0,10.8,0,12.8,95.2,1204,518,686,43.02,56.98,99,419,36,650,135,1069,19.1,5.2,11.2,"75% or more P.O.C.","$55000 - $78000"
"36047073800","Census Tract 738, Kings County, New York",3977,65417,1234,1740,0,216,0,779,31,43.8,0,5.4,0,19.6,69,1167,526,641,45.07,54.93,201,325,123,518,324,843,38.2,19.2,27.8,"50% - 75% P.O.C.","$55000 - $78000"
"36047074000","Census Tract 740, Kings County, New York",3598,71250,386,2391,0,505,0,129,10.7,66.5,0,14,0,3.6,89.3,1072,349,723,32.56,67.44,161,188,93,630,254,818,46.1,12.9,23.7,"75% or more P.O.C.","$55000 - $78000"
"36047074200","Census Tract 742, Kings County, New York",3136,62000,1451,1377,0,35,0,136,46.3,43.9,0,1.1,0,4.3,53.7,926,454,472,49.03,50.97,131,323,83,389,214,712,28.9,17.6,23.1,"50% - 75% P.O.C.","$55000 - $78000"
"36047074400","Census Tract 744, Kings County, New York",2777,119375,2295,271,0,74,0,105,82.6,9.8,0,2.7,0,3.8,17.4,659,561,98,85.13,14.87,223,338,43,55,266,393,39.8,43.9,40.4,"Less than 25% P.O.C.","$104000 or more"
"36047074600","Census Tract 746, Kings County, New York",2577,85417,1698,461,0,93,0,230,65.9,17.9,0,3.6,0,8.9,34.1,730,456,274,62.47,37.53,128,328,69,205,197,533,28.1,25.2,27,"25% - 50% P.O.C.","$78000 - $104000"
"36047074800","Census Tract 748, Kings County, New York",1957,89917,1477,308,0,124,0,48,75.5,15.7,0,6.3,0,2.5,24.5,629,369,260,58.66,41.34,164,205,6,254,170,459,44.4,2.3,27,"Less than 25% P.O.C.","$78000 - $104000"
"36047075000","Census Tract 750, Kings County, New York",2857,77433,2143,243,0,128,0,254,75,8.5,0,4.5,0,8.9,25,847,390,457,46.04,53.96,143,247,57,400,200,647,36.7,12.5,23.6,"25% - 50% P.O.C.","$55000 - $78000"
"36047075200","Census Tract 752, Kings County, New York",1031,165263,1013,10,0,8,0,0,98.3,1,0,0.8,0,0,1.7,314,290,24,92.36,7.64,92,198,0,24,92,222,31.7,0,29.3,"Less than 25% P.O.C.","$104000 or more"
"36047075400","Census Tract 754, Kings County, New York",1294,115139,1280,11,0,0,0,3,98.9,0.9,0,0,0,0.2,1.1,406,366,40,90.15,9.85,58,308,0,40,58,348,15.8,0,14.3,"Less than 25% P.O.C.","$104000 or more"
"36047075600","Census Tract 756, Kings County, New York",2150,110250,1708,66,0,228,0,142,79.4,3.1,0,10.6,0,6.6,20.6,698,502,196,71.92,28.08,104,398,35,161,139,559,20.7,17.9,19.9,"Less than 25% P.O.C.","$104000 or more"
"36047075800","Census Tract 758, Kings County, New York",1653,86250,1420,26,0,8,0,50,85.9,1.6,0,0.5,0,3,14.1,594,387,207,65.15,34.85,73,314,32,175,105,489,18.9,15.5,17.7,"Less than 25% P.O.C.","$78000 - $104000"
"36047076000","Census Tract 760, Kings County, New York",2930,67875,2582,105,0,120,0,66,88.1,3.6,0,4.1,0,2.3,11.9,1073,474,599,44.18,55.82,127,347,18,581,145,928,26.8,3,13.5,"Less than 25% P.O.C.","$55000 - $78000"
"36047076200","Census Tract 762, Kings County, New York",4285,54571,2592,724,0,590,0,379,60.5,16.9,0,13.8,0,8.8,39.5,1528,340,1188,22.25,77.75,60,280,181,1007,241,1287,17.6,15.2,15.8,"25% - 50% P.O.C.","Less than $55000"
"36047076400","Census Tract 764, Kings County, New York",3602,61250,1074,1592,0,284,0,558,29.8,44.2,0,7.9,0,15.5,70.2,1438,191,1247,13.28,86.72,31,160,117,1130,148,1290,16.2,9.4,10.3,"50% - 75% P.O.C.","$55000 - $78000"
"36047076600","Census Tract 766, Kings County, New York",2103,70156,257,1467,0,77,0,228,12.2,69.8,0,3.7,0,10.8,87.8,699,199,500,28.47,71.53,45,154,58,442,103,596,22.6,11.6,14.7,"75% or more P.O.C.","$55000 - $78000"
"36047076800","Census Tract 768, Kings County, New York",3219,51146,2568,72,0,286,0,207,79.8,2.2,0,8.9,0,6.4,20.2,1139,273,866,23.97,76.03,86,187,79,787,165,974,31.5,9.1,14.5,"Less than 25% P.O.C.","Less than $55000"
"36047077000","Census Tract 770, Kings County, New York",2820,59231,361,1754,0,231,0,382,12.8,62.2,0,8.2,0,13.5,87.2,1036,357,679,34.46,65.54,14,343,106,573,120,916,3.9,15.6,11.6,"75% or more P.O.C.","$55000 - $78000"
"36047077200","Census Tract 772, Kings County, New York",3114,64205,1209,1317,0,53,0,480,38.8,42.3,0,1.7,0,15.4,61.2,1215,467,748,38.44,61.56,77,390,59,689,136,1079,16.5,7.9,11.2,"50% - 75% P.O.C.","$55000 - $78000"
"36047077400","Census Tract 774, Kings County, New York",3250,71929,559,2060,0,280,0,252,17.2,63.4,0,8.6,0,7.8,82.8,1245,84,1161,6.75,93.25,28,56,88,1073,116,1129,33.3,7.6,9.3,"75% or more P.O.C.","$55000 - $78000"
"36047077600","Census Tract 776, Kings County, New York",3732,72568,234,2896,0,316,0,142,6.3,77.6,0,8.5,0,3.8,93.7,1713,958,755,55.93,44.07,74,884,33,722,107,1606,7.7,4.4,6.2,"75% or more P.O.C.","$55000 - $78000"
"36047078000","Census Tract 780, Kings County, New York",2161,82273,55,2000,0,4,0,96,2.5,92.5,0,0.2,0,4.4,97.5,692,494,198,71.39,28.61,74,420,38,160,112,580,15,19.2,16.2,"75% or more P.O.C.","$78000 - $104000"
"36047078200","Census Tract 782, Kings County, New York",4923,65294,43,4509,0,80,0,219,0.9,91.6,0,1.6,0,4.4,99.1,1688,425,1263,25.18,74.82,58,367,133,1130,191,1497,13.6,10.5,11.3,"75% or more P.O.C.","$55000 - $78000"
"36047078400","Census Tract 784, Kings County, New York",2386,76417,136,1884,0,60,0,173,5.7,79,0,2.5,0,7.3,94.3,777,461,316,59.33,40.67,47,414,67,249,114,663,10.2,21.2,14.7,"75% or more P.O.C.","$55000 - $78000"
"36047078600","Census Tract 786, Kings County, New York",4753,56781,439,3286,0,266,0,625,9.2,69.1,0,5.6,0,13.1,90.8,1899,540,1359,28.44,71.56,10,530,119,1240,129,1770,1.9,8.8,6.8,"75% or more P.O.C.","$55000 - $78000"
"36047078800","Census Tract 788, Kings County, New York",3528,46833,44,3056,0,24,0,220,1.2,86.6,0,0.7,0,6.2,98.8,1220,176,1044,14.43,85.57,28,148,145,899,173,1047,15.9,13.9,14.2,"75% or more P.O.C.","Less than $55000"
"36047079000","Census Tract 790, Kings County, New York",5096,61201,125,4434,136,24,0,287,2.5,87,2.7,0.5,0,5.6,97.5,1805,369,1436,20.44,79.56,30,339,159,1277,189,1616,8.1,11.1,10.5,"75% or more P.O.C.","$55000 - $78000"
"36047079200","Census Tract 792, Kings County, New York",3488,62011,376,2503,0,29,0,477,10.8,71.8,0,0.8,0,13.7,89.2,1223,315,908,25.76,74.24,85,230,131,777,216,1007,27,14.4,17.7,"75% or more P.O.C.","$55000 - $78000"
"36047079400","Census Tract 794, Kings County, New York",1716,43250,135,1214,0,24,0,304,7.9,70.7,0,1.4,0,17.7,92.1,547,172,375,31.44,68.56,44,128,89,286,133,414,25.6,23.7,24.3,"75% or more P.O.C.","Less than $55000"
"36047079601","Census Tract 796.01, Kings County, New York",4536,62775,1087,2913,0,75,0,341,24,64.2,0,1.7,0,7.5,76,1859,260,1599,13.99,86.01,20,240,213,1386,233,1626,7.7,13.3,12.5,"75% or more P.O.C.","$55000 - $78000"
"36047079602","Census Tract 796.02, Kings County, New York",4797,65714,620,3075,0,135,0,794,12.9,64.1,0,2.8,0,16.6,87.1,1912,306,1606,16,84,14,292,204,1402,218,1694,4.6,12.7,11.4,"75% or more P.O.C.","$55000 - $78000"
"36047079801","Census Tract 798.01, Kings County, New York",2869,76838,948,1422,0,47,0,270,33,49.6,0,1.6,0,9.4,67,1336,274,1062,20.51,79.49,0,274,7,1055,7,1329,0,0.7,0.5,"50% - 75% P.O.C.","$55000 - $78000"
"36047079802","Census Tract 798.02, Kings County, New York",5441,70769,1453,2396,0,389,0,1005,26.7,44,0,7.1,0,18.5,73.3,2500,55,2445,2.2,97.8,0,55,95,2350,95,2405,0,3.9,3.8,"50% - 75% P.O.C.","$55000 - $78000"
"36047080000","Census Tract 800, Kings County, New York",3689,83750,942,2176,0,90,0,308,25.5,59,0,2.4,0,8.3,74.5,1399,634,765,45.32,54.68,89,545,59,706,148,1251,14,7.7,10.6,"50% - 75% P.O.C.","$78000 - $104000"
"36047080200","Census Tract 802, Kings County, New York",4578,62050,662,3075,34,130,0,486,14.5,67.2,0.7,2.8,0,10.6,85.5,1900,505,1395,26.58,73.42,57,448,123,1272,180,1720,11.3,8.8,9.5,"75% or more P.O.C.","$55000 - $78000"
"36047080400","Census Tract 804, Kings County, New York",3191,53512,336,2553,26,52,0,205,10.5,80,0.8,1.6,0,6.4,89.5,1306,439,867,33.61,66.39,99,340,52,815,151,1155,22.6,6,11.6,"75% or more P.O.C.","Less than $55000"
"36047080600","Census Tract 806, Kings County, New York",3355,56339,1117,1860,0,187,0,170,33.3,55.4,0,5.6,0,5.1,66.7,1226,349,877,28.47,71.53,61,288,80,797,141,1085,17.5,9.1,11.5,"50% - 75% P.O.C.","$55000 - $78000"
"36047080800","Census Tract 808, Kings County, New York",1326,11167,117,864,0,118,0,211,8.8,65.2,0,8.9,0,15.9,91.2,498,3,495,0.6,99.4,0,3,8,487,8,490,0,1.6,1.6,"75% or more P.O.C.","Less than $55000"
"36047081000","Census Tract 810, Kings County, New York",2322,57500,419,1544,0,12,0,128,18,66.5,0,0.5,0,5.5,82,884,196,688,22.17,77.83,25,171,30,658,55,829,12.8,4.4,6.2,"75% or more P.O.C.","$55000 - $78000"
"36047081400","Census Tract 814, Kings County, New York",2770,43962,58,2473,0,98,0,136,2.1,89.3,0,3.5,0,4.9,97.9,1032,383,649,37.11,62.89,82,301,108,541,190,842,21.4,16.6,18.4,"75% or more P.O.C.","Less than $55000"
"36047081600","Census Tract 816, Kings County, New York",2653,42938,170,1940,0,143,0,336,6.4,73.1,0,5.4,0,12.7,93.6,967,273,694,28.23,71.77,48,225,109,585,157,810,17.6,15.7,16.2,"75% or more P.O.C.","Less than $55000"
"36047081800","Census Tract 818, Kings County, New York",4528,74375,401,3571,0,253,0,243,8.9,78.9,0,5.6,0,5.4,91.1,1684,290,1394,17.22,82.78,45,245,91,1303,136,1548,15.5,6.5,8.1,"75% or more P.O.C.","$55000 - $78000"
"36047082000","Census Tract 820, Kings County, New York",5175,46992,206,4133,0,69,0,532,4,79.9,0,1.3,0,10.3,96,1968,57,1911,2.9,97.1,26,31,266,1645,292,1676,45.6,13.9,14.8,"75% or more P.O.C.","Less than $55000"
"36047082200","Census Tract 822, Kings County, New York",7170,51197,884,5331,0,75,0,748,12.3,74.4,0,1,0,10.4,87.7,2774,192,2582,6.92,93.08,35,157,299,2283,334,2440,18.2,11.6,12,"75% or more P.O.C.","Less than $55000"
"36047082400","Census Tract 824, Kings County, New York",4910,59470,105,4313,0,128,0,339,2.1,87.8,0,2.6,0,6.9,97.9,1640,329,1311,20.06,79.94,119,210,138,1173,257,1383,36.2,10.5,15.7,"75% or more P.O.C.","$55000 - $78000"
"36047082600","Census Tract 826, Kings County, New York",4911,55000,416,4047,0,15,0,317,8.5,82.4,0,0.3,0,6.5,91.5,1854,536,1318,28.91,71.09,77,459,29,1289,106,1748,14.4,2.2,5.7,"75% or more P.O.C.","$55000 - $78000"
"36047082800","Census Tract 828, Kings County, New York",3706,55850,250,2933,11,71,0,366,6.7,79.1,0.3,1.9,0,9.9,93.3,1281,358,923,27.95,72.05,51,307,158,765,209,1072,14.2,17.1,16.3,"75% or more P.O.C.","$55000 - $78000"
"36047083000","Census Tract 830, Kings County, New York",6306,52083,77,5256,0,53,0,859,1.2,83.3,0,0.8,0,13.6,98.8,2301,305,1996,13.26,86.74,24,281,268,1728,292,2009,7.9,13.4,12.7,"75% or more P.O.C.","Less than $55000"
"36047083200","Census Tract 832, Kings County, New York",2127,65406,2,1939,0,85,0,39,0.1,91.2,0,4,0,1.8,99.9,707,428,279,60.54,39.46,77,351,6,273,83,624,18,2.2,11.7,"75% or more P.O.C.","$55000 - $78000"
"36047083400","Census Tract 834, Kings County, New York",1745,53578,0,1568,0,104,0,33,0,89.9,0,6,0,1.9,100,583,423,160,72.56,27.44,81,342,23,137,104,479,19.1,14.4,17.8,"75% or more P.O.C.","Less than $55000"
"36047083600","Census Tract 836, Kings County, New York",2017,68603,0,1899,32,32,0,48,0,94.1,1.6,1.6,0,2.4,100,727,426,301,58.6,41.4,39,387,40,261,79,648,9.2,13.3,10.9,"75% or more P.O.C.","$55000 - $78000"
"36047083800","Census Tract 838, Kings County, New York",2073,77549,2,1904,0,0,0,75,0.1,91.8,0,0,0,3.6,99.9,782,622,160,79.54,20.46,51,571,0,160,51,731,8.2,0,6.5,"75% or more P.O.C.","$55000 - $78000"
"36047084000","Census Tract 840, Kings County, New York",2520,60625,33,2310,0,14,0,137,1.3,91.7,0,0.6,0,5.4,98.7,823,524,299,63.67,36.33,109,415,36,263,145,678,20.8,12,17.6,"75% or more P.O.C.","$55000 - $78000"
"36047084600","Census Tract 846, Kings County, New York",2023,54153,82,1761,0,0,0,165,4.1,87,0,0,0,8.2,95.9,731,430,301,58.82,41.18,79,351,22,279,101,630,18.4,7.3,13.8,"75% or more P.O.C.","Less than $55000"
"36047084800","Census Tract 848, Kings County, New York",1701,78125,5,1538,0,50,0,90,0.3,90.4,0,2.9,0,5.3,99.7,550,362,188,65.82,34.18,63,299,0,188,63,487,17.4,0,11.5,"75% or more P.O.C.","$78000 - $104000"
"36047085000","Census Tract 850, Kings County, New York",1489,66333,0,1472,6,0,0,11,0,98.9,0.4,0,0,0.7,100,478,391,87,81.8,18.2,70,321,20,67,90,388,17.9,23,18.8,"75% or more P.O.C.","$55000 - $78000"
"36047085200","Census Tract 852, Kings County, New York",26,NA,0,5,0,0,0,21,0,19.2,0,0,0,80.8,100,5,5,0,100,0,5,0,0,0,5,0,100,NA,100,"75% or more P.O.C.","N/A"
"36047085400","Census Tract 854, Kings County, New York",1966,59531,60,1550,0,6,0,323,3.1,78.8,0,0.3,0,16.4,96.9,728,363,365,49.86,50.14,35,328,43,322,78,650,9.6,11.8,10.7,"75% or more P.O.C.","$55000 - $78000"
"36047085600","Census Tract 856, Kings County, New York",3384,61957,105,2878,0,46,0,249,3.1,85,0,1.4,0,7.4,96.9,1410,359,1051,25.46,74.54,10,349,60,991,70,1340,2.8,5.7,5,"75% or more P.O.C.","$55000 - $78000"
"36047085800","Census Tract 858, Kings County, New York",2107,61721,6,1951,0,0,0,150,0.3,92.6,0,0,0,7.1,99.7,813,407,406,50.06,49.94,52,355,2,404,54,759,12.8,0.5,6.6,"75% or more P.O.C.","$55000 - $78000"
"36047086000","Census Tract 860, Kings County, New York",3627,63241,11,3255,14,10,0,282,0.3,89.7,0.4,0.3,0,7.8,99.7,1318,435,883,33,67,98,337,54,829,152,1166,22.5,6.1,11.5,"75% or more P.O.C.","$55000 - $78000"
"36047086200","Census Tract 862, Kings County, New York",2821,46250,136,2464,0,0,0,189,4.8,87.3,0,0,0,6.7,95.2,1124,205,919,18.24,81.76,0,205,45,874,45,1079,0,4.9,4,"75% or more P.O.C.","Less than $55000"
"36047086400","Census Tract 864, Kings County, New York",2343,49265,12,2270,0,0,0,61,0.5,96.9,0,0,0,2.6,99.5,802,376,426,46.88,53.12,114,262,38,388,152,650,30.3,8.9,19,"75% or more P.O.C.","Less than $55000"
"36047086600","Census Tract 866, Kings County, New York",3145,53032,99,2605,43,38,0,284,3.1,82.8,1.4,1.2,0,9,96.9,1184,496,688,41.89,58.11,49,447,85,603,134,1050,9.9,12.4,11.3,"75% or more P.O.C.","Less than $55000"
"36047086800","Census Tract 868, Kings County, New York",3413,46318,73,2791,30,22,0,424,2.1,81.8,0.9,0.6,0,12.4,97.9,1271,312,959,24.55,75.45,30,282,90,869,120,1151,9.6,9.4,9.4,"75% or more P.O.C.","Less than $55000"
"36047087000","Census Tract 870, Kings County, New York",3125,43952,126,2770,0,0,0,193,4,88.6,0,0,0,6.2,96,1164,394,770,33.85,66.15,62,332,89,681,151,1013,15.7,11.6,13,"75% or more P.O.C.","Less than $55000"
"36047087200","Census Tract 872, Kings County, New York",3130,55902,175,2664,0,73,0,206,5.6,85.1,0,2.3,0,6.6,94.4,1124,476,648,42.35,57.65,51,425,11,637,62,1062,10.7,1.7,5.5,"75% or more P.O.C.","$55000 - $78000"
"36047087401","Census Tract 874.01, Kings County, New York",3759,44250,274,3083,0,0,0,248,7.3,82,0,0,0,6.6,92.7,1456,330,1126,22.66,77.34,68,262,116,1010,184,1272,20.6,10.3,12.6,"75% or more P.O.C.","Less than $55000"
"36047087600","Census Tract 876, Kings County, New York",1709,43625,349,1229,0,39,0,83,20.4,71.9,0,2.3,0,4.9,79.6,717,306,411,42.68,57.32,60,246,24,387,84,633,19.6,5.8,11.7,"75% or more P.O.C.","Less than $55000"
"36047087800","Census Tract 878, Kings County, New York",2647,43721,37,2512,10,0,0,75,1.4,94.9,0.4,0,0,2.8,98.6,994,107,887,10.76,89.24,24,83,20,867,44,950,22.4,2.3,4.4,"75% or more P.O.C.","Less than $55000"
"36047088000","Census Tract 880, Kings County, New York",2725,49000,217,2372,0,7,0,76,8,87,0,0.3,0,2.8,92,1138,415,723,36.47,63.53,79,336,47,676,126,1012,19,6.5,11.1,"75% or more P.O.C.","Less than $55000"
"36047088200","Census Tract 882, Kings County, New York",6353,44623,80,5487,0,0,0,786,1.3,86.4,0,0,0,12.4,98.7,2446,445,2001,18.19,81.81,132,313,253,1748,385,2061,29.7,12.6,15.7,"75% or more P.O.C.","Less than $55000"
"36047088400","Census Tract 884, Kings County, New York",4401,48664,83,4076,0,47,0,74,1.9,92.6,0,1.1,0,1.7,98.1,1822,335,1487,18.39,81.61,46,289,107,1380,153,1669,13.7,7.2,8.4,"75% or more P.O.C.","Less than $55000"
"36047088600","Census Tract 886, Kings County, New York",4089,35196,74,3480,0,67,0,326,1.8,85.1,0,1.6,0,8,98.2,1919,244,1675,12.71,87.29,41,203,94,1581,135,1784,16.8,5.6,7,"75% or more P.O.C.","Less than $55000"
"36047088800","Census Tract 888, Kings County, New York",4086,60435,9,3307,0,118,0,482,0.2,80.9,0,2.9,0,11.8,99.8,1478,429,1049,29.03,70.97,47,382,70,979,117,1361,11,6.7,7.9,"75% or more P.O.C.","$55000 - $78000"
"36047089000","Census Tract 890, Kings County, New York",5912,37746,135,5145,0,0,0,543,2.3,87,0,0,0,9.2,97.7,2262,288,1974,12.73,87.27,50,238,163,1811,213,2049,17.4,8.3,9.4,"75% or more P.O.C.","Less than $55000"
"36047089200","Census Tract 892, Kings County, New York",3265,27217,61,2650,0,0,0,385,1.9,81.2,0,0,0,11.8,98.1,1654,66,1588,3.99,96.01,0,66,23,1565,23,1631,0,1.4,1.4,"75% or more P.O.C.","Less than $55000"
"36047089400","Census Tract 894, Kings County, New York",3254,43795,124,2710,0,58,0,309,3.8,83.3,0,1.8,0,9.5,96.2,1074,383,691,35.66,64.34,90,293,127,564,217,857,23.5,18.4,20.2,"75% or more P.O.C.","Less than $55000"
"36047089600","Census Tract 896, Kings County, New York",3160,37955,16,2509,0,21,0,548,0.5,79.4,0,0.7,0,17.3,99.5,1558,246,1312,15.79,84.21,50,196,17,1295,67,1491,20.3,1.3,4.3,"75% or more P.O.C.","Less than $55000"
"36047089800","Census Tract 898, Kings County, New York",1820,52206,58,1560,0,11,39,152,3.2,85.7,0,0.6,2.1,8.4,96.8,698,175,523,25.07,74.93,22,153,62,461,84,614,12.6,11.9,12,"75% or more P.O.C.","Less than $55000"
"36047090000","Census Tract 900, Kings County, New York",3912,23685,9,2803,0,0,0,853,0.2,71.7,0,0,0,21.8,99.8,1829,210,1619,11.48,88.52,21,189,34,1585,55,1774,10,2.1,3,"75% or more P.O.C.","Less than $55000"
"36047090200","Census Tract 902, Kings County, New York",3309,36583,84,2234,5,202,4,722,2.5,67.5,0.2,6.1,0.1,21.8,97.5,921,349,572,37.89,62.11,28,321,45,527,73,848,8,7.9,7.9,"75% or more P.O.C.","Less than $55000"
"36047090600","Census Tract 906, Kings County, New York",3295,15017,25,1938,0,0,0,1302,0.8,58.8,0,0,0,39.5,99.2,1616,12,1604,0.74,99.26,0,12,79,1525,79,1537,0,4.9,4.9,"75% or more P.O.C.","Less than $55000"
"36047090800","Census Tract 908, Kings County, New York",5992,9740,110,3758,0,151,0,1889,1.8,62.7,0,2.5,0,31.5,98.2,1247,11,1236,0.88,99.12,11,0,46,1190,57,1190,100,3.7,4.6,"75% or more P.O.C.","Less than $55000"
"36047091000","Census Tract 910, Kings County, New York",4196,11585,0,2550,0,0,0,1629,0,60.8,0,0,0,38.8,100,2528,0,2528,0,100,0,0,79,2449,79,2449,NA,3.1,3.1,"75% or more P.O.C.","Less than $55000"
"36047091200","Census Tract 912, Kings County, New York",5589,15256,9,3959,0,119,0,1502,0.2,70.8,0,2.1,0,26.9,99.8,2496,23,2473,0.92,99.08,23,0,253,2220,276,2220,100,10.2,11.1,"75% or more P.O.C.","Less than $55000"
"36047091600","Census Tract 916, Kings County, New York",3481,18320,26,2718,0,0,0,704,0.7,78.1,0,0,0,20.2,99.3,1614,187,1427,11.59,88.41,42,145,86,1341,128,1486,22.5,6,7.9,"75% or more P.O.C.","Less than $55000"
"36047091800","Census Tract 918, Kings County, New York",2250,19634,4,1237,0,0,0,1009,0.2,55,0,0,0,44.8,99.8,1032,341,691,33.04,66.96,31,310,0,691,31,1001,9.1,0,3,"75% or more P.O.C.","Less than $55000"
"36047092000","Census Tract 920, Kings County, New York",2523,28424,11,1564,0,114,0,834,0.4,62,0,4.5,0,33.1,99.6,1171,399,772,34.07,65.93,22,377,47,725,69,1102,5.5,6.1,5.9,"75% or more P.O.C.","Less than $55000"
"36047092200","Census Tract 922, Kings County, New York",2537,42949,35,2216,0,0,0,249,1.4,87.3,0,0,0,9.8,98.6,1343,323,1020,24.05,75.95,0,323,55,965,55,1288,0,5.4,4.1,"75% or more P.O.C.","Less than $55000"
"36047092400","Census Tract 924, Kings County, New York",2653,28509,6,2164,0,0,0,478,0.2,81.6,0,0,0,18,99.8,990,136,854,13.74,86.26,21,115,77,777,98,892,15.4,9,9.9,"75% or more P.O.C.","Less than $55000"
"36047092800","Census Tract 928, Kings County, New York",3022,58171,66,2578,18,0,0,350,2.2,85.3,0.6,0,0,11.6,97.8,1172,448,724,38.23,61.77,74,374,45,679,119,1053,16.5,6.2,10.2,"75% or more P.O.C.","$55000 - $78000"
"36047093000","Census Tract 930, Kings County, New York",3068,75489,18,2911,0,14,0,66,0.6,94.9,0,0.5,0,2.2,99.4,1031,611,420,59.26,40.74,84,527,44,376,128,903,13.7,10.5,12.4,"75% or more P.O.C.","$55000 - $78000"
"36047093200","Census Tract 932, Kings County, New York",1124,66250,26,1029,0,31,0,38,2.3,91.5,0,2.8,0,3.4,97.7,453,353,100,77.92,22.08,57,296,0,100,57,396,16.1,0,12.6,"75% or more P.O.C.","$55000 - $78000"
"36047093400","Census Tract 934, Kings County, New York",2464,72727,57,2288,0,0,0,112,2.3,92.9,0,0,0,4.5,97.7,1028,597,431,58.07,41.93,71,526,19,412,90,938,11.9,4.4,8.8,"75% or more P.O.C.","$55000 - $78000"
"36047093600","Census Tract 936, Kings County, New York",1692,63929,13,1658,0,0,0,18,0.8,98,0,0,0,1.1,99.2,670,414,256,61.79,38.21,38,376,21,235,59,611,9.2,8.2,8.8,"75% or more P.O.C.","$55000 - $78000"
"36047093800","Census Tract 938, Kings County, New York",2476,75357,14,2331,0,8,0,97,0.6,94.1,0,0.3,0,3.9,99.4,962,450,512,46.78,53.22,32,418,37,475,69,893,7.1,7.2,7.2,"75% or more P.O.C.","$55000 - $78000"
"36047094401","Census Tract 944.01, Kings County, New York",3534,82986,77,3200,51,22,0,176,2.2,90.5,1.4,0.6,0,5,97.8,1169,655,514,56.03,43.97,120,535,83,431,203,966,18.3,16.1,17.4,"75% or more P.O.C.","$78000 - $104000"
"36047094402","Census Tract 944.02, Kings County, New York",3248,23920,58,2474,0,47,0,659,1.8,76.2,0,1.4,0,20.3,98.2,1342,0,1342,0,100,0,0,113,1229,113,1229,NA,8.4,8.4,"75% or more P.O.C.","Less than $55000"
"36047094600","Census Tract 946, Kings County, New York",1947,66750,30,1783,0,45,0,74,1.5,91.6,0,2.3,0,3.8,98.5,751,560,191,74.57,25.43,50,510,0,191,50,701,8.9,0,6.7,"75% or more P.O.C.","$55000 - $78000"
"36047095000","Census Tract 950, Kings County, New York",2751,79345,161,2403,0,0,0,165,5.9,87.4,0,0,0,6,94.1,973,482,491,49.54,50.46,95,387,50,441,145,828,19.7,10.2,14.9,"75% or more P.O.C.","$78000 - $104000"
"36047095400","Census Tract 954, Kings County, New York",4289,78386,24,3992,0,31,0,199,0.6,93.1,0,0.7,0,4.6,99.4,1483,768,715,51.79,48.21,131,637,108,607,239,1244,17.1,15.1,16.1,"75% or more P.O.C.","$78000 - $104000"
"36047095600","Census Tract 956, Kings County, New York",4507,67500,384,3884,0,76,0,144,8.5,86.2,0,1.7,0,3.2,91.5,1400,662,738,47.29,52.71,109,553,83,655,192,1208,16.5,11.2,13.7,"75% or more P.O.C.","$55000 - $78000"
"36047095800","Census Tract 958, Kings County, New York",3345,61128,157,2991,0,100,0,88,4.7,89.4,0,3,0,2.6,95.3,1161,706,455,60.81,39.19,103,603,51,404,154,1007,14.6,11.2,13.3,"75% or more P.O.C.","$55000 - $78000"
"36047096000","Census Tract 960, Kings County, New York",0,NA,0,0,0,0,0,0,NA,NA,NA,NA,NA,NA,NA,0,0,0,NA,NA,0,0,0,0,0,0,NA,NA,NA,"N/A","N/A"
"36047096200","Census Tract 962, Kings County, New York",1838,67024,93,1559,0,22,0,141,5.1,84.8,0,1.2,0,7.7,94.9,502,253,249,50.4,49.6,108,145,65,184,173,329,42.7,26.1,34.5,"75% or more P.O.C.","$55000 - $78000"
"36047096400","Census Tract 964, Kings County, New York",1978,64833,70,1541,0,140,0,34,3.5,77.9,0,7.1,0,1.7,96.5,702,388,314,55.27,44.73,95,293,19,295,114,588,24.5,6.1,16.2,"75% or more P.O.C.","$55000 - $78000"
"36047096600","Census Tract 966, Kings County, New York",2634,67667,77,2101,0,107,0,283,2.9,79.8,0,4.1,0,10.7,97.1,806,475,331,58.93,41.07,125,350,25,306,150,656,26.3,7.6,18.6,"75% or more P.O.C.","$55000 - $78000"
"36047096800","Census Tract 968, Kings County, New York",1713,93347,34,1416,0,28,0,135,2,82.7,0,1.6,0,7.9,98,427,271,156,63.47,36.53,51,220,59,97,110,317,18.8,37.8,25.8,"75% or more P.O.C.","$78000 - $104000"
"36047097000","Census Tract 970, Kings County, New York",2868,85221,211,2258,0,9,0,324,7.4,78.7,0,0.3,0,11.3,92.6,823,356,467,43.26,56.74,101,255,82,385,183,640,28.4,17.6,22.2,"75% or more P.O.C.","$78000 - $104000"
"36047097400","Census Tract 974, Kings County, New York",2743,64099,165,2052,25,77,0,393,6,74.8,0.9,2.8,0,14.3,94,699,316,383,45.21,54.79,79,237,36,347,115,584,25,9.4,16.5,"75% or more P.O.C.","$55000 - $78000"
"36047098200","Census Tract 982, Kings County, New York",4532,20751,0,3541,0,5,0,986,0,78.1,0,0.1,0,21.8,100,1735,8,1727,0.46,99.54,8,0,144,1583,152,1583,100,8.3,8.8,"75% or more P.O.C.","Less than $55000"
"36047098400","Census Tract 984, Kings County, New York",1998,71875,78,1833,0,7,0,80,3.9,91.7,0,0.4,0,4,96.1,660,397,263,60.15,39.85,72,325,20,243,92,568,18.1,7.6,13.9,"75% or more P.O.C.","$55000 - $78000"
"36047098600","Census Tract 986, Kings County, New York",2856,73654,64,2612,0,53,0,97,2.2,91.5,0,1.9,0,3.4,97.8,968,465,503,48.04,51.96,60,405,37,466,97,871,12.9,7.4,10,"75% or more P.O.C.","$55000 - $78000"
"36047098800","Census Tract 988, Kings County, New York",3365,75339,208,2332,0,281,0,518,6.2,69.3,0,8.4,0,15.4,93.8,1130,432,698,38.23,61.77,109,323,31,667,140,990,25.2,4.4,12.4,"75% or more P.O.C.","$55000 - $78000"
"36047099000","Census Tract 990, Kings County, New York",1744,91964,182,1345,0,95,0,78,10.4,77.1,0,5.4,0,4.5,89.6,500,310,190,62,38,117,193,49,141,166,334,37.7,25.8,33.2,"75% or more P.O.C.","$78000 - $104000"
"36047099200","Census Tract 992, Kings County, New York",2311,89423,53,2115,0,46,0,97,2.3,91.5,0,2,0,4.2,97.7,674,438,236,64.99,35.01,149,289,51,185,200,474,34,21.6,29.7,"75% or more P.O.C.","$78000 - $104000"
"36047099400","Census Tract 994, Kings County, New York",2126,80259,124,1700,0,134,0,92,5.8,80,0,6.3,0,4.3,94.2,684,341,343,49.85,50.15,68,273,44,299,112,572,19.9,12.8,16.4,"75% or more P.O.C.","$78000 - $104000"
"36047099600","Census Tract 996, Kings County, New York",3761,70093,168,3353,0,97,0,143,4.5,89.2,0,2.6,0,3.8,95.5,1134,559,575,49.29,50.71,140,419,114,461,254,880,25,19.8,22.4,"75% or more P.O.C.","$55000 - $78000"
"36047099800","Census Tract 998, Kings County, New York",3588,77066,267,3083,0,0,0,157,7.4,85.9,0,0,0,4.4,92.6,1245,644,601,51.73,48.27,106,538,62,539,168,1077,16.5,10.3,13.5,"75% or more P.O.C.","$55000 - $78000"
"36047100400","Census Tract 1004, Kings County, New York",2677,57813,119,2467,0,17,0,61,4.4,92.2,0,0.6,0,2.3,95.6,989,527,462,53.29,46.71,99,428,27,435,126,863,18.8,5.8,12.7,"75% or more P.O.C.","$55000 - $78000"
"36047100600","Census Tract 1006, Kings County, New York",2610,77241,196,2196,0,48,0,145,7.5,84.1,0,1.8,0,5.6,92.5,920,592,328,64.35,35.65,49,543,44,284,93,827,8.3,13.4,10.1,"75% or more P.O.C.","$55000 - $78000"
"36047100800","Census Tract 1008, Kings County, New York",2250,73889,243,1740,0,70,0,197,10.8,77.3,0,3.1,0,8.8,89.2,690,393,297,56.96,43.04,83,310,27,270,110,580,21.1,9.1,15.9,"75% or more P.O.C.","$55000 - $78000"
"36047101000","Census Tract 1010, Kings County, New York",2284,78583,85,1881,0,137,0,98,3.7,82.4,0,6,0,4.3,96.3,775,456,319,58.84,41.16,68,388,51,268,119,656,14.9,16,15.4,"75% or more P.O.C.","$78000 - $104000"
"36047101200","Census Tract 1012, Kings County, New York",2288,64569,59,1880,0,113,0,236,2.6,82.2,0,4.9,0,10.3,97.4,854,450,404,52.69,47.31,41,409,38,366,79,775,9.1,9.4,9.3,"75% or more P.O.C.","$55000 - $78000"
"36047101400","Census Tract 1014, Kings County, New York",2178,85250,68,1744,0,132,0,166,3.1,80.1,0,6.1,0,7.6,96.9,802,517,285,64.46,35.54,50,467,15,270,65,737,9.7,5.3,8.1,"75% or more P.O.C.","$78000 - $104000"
"36047101600","Census Tract 1016, Kings County, New York",1715,100391,75,1608,13,0,0,19,4.4,93.8,0.8,0,0,1.1,95.6,529,392,137,74.1,25.9,80,312,0,137,80,449,20.4,0,15.1,"75% or more P.O.C.","$78000 - $104000"
"36047101800","Census Tract 1018, Kings County, New York",2295,84850,44,1789,0,205,0,221,1.9,78,0,8.9,0,9.6,98.1,819,604,215,73.75,26.25,155,449,0,215,155,664,25.7,0,18.9,"75% or more P.O.C.","$78000 - $104000"
"36047102000","Census Tract 1020, Kings County, New York",2217,104148,80,1999,0,0,0,83,3.6,90.2,0,0,0,3.7,96.4,725,491,234,67.72,32.28,99,392,34,200,133,592,20.2,14.5,18.3,"75% or more P.O.C.","$104000 or more"
"36047102200","Census Tract 1022, Kings County, New York",2171,87604,173,1629,0,226,0,83,8,75,0,10.4,0,3.8,92,782,435,347,55.63,44.37,79,356,32,315,111,671,18.2,9.2,14.2,"75% or more P.O.C.","$78000 - $104000"
"36047102400","Census Tract 1024, Kings County, New York",2255,96875,94,2017,0,41,0,41,4.2,89.4,0,1.8,0,1.8,95.8,726,436,290,60.06,39.94,64,372,54,236,118,608,14.7,18.6,16.3,"75% or more P.O.C.","$78000 - $104000"
"36047102600","Census Tract 1026, Kings County, New York",3023,103229,109,2636,11,66,0,131,3.6,87.2,0.4,2.2,0,4.3,96.4,949,461,488,48.58,51.42,92,369,22,466,114,835,20,4.5,12,"75% or more P.O.C.","$78000 - $104000"
"36047102800","Census Tract 1028, Kings County, New York",1680,95486,36,1544,0,34,0,66,2.1,91.9,0,2,0,3.9,97.9,527,312,215,59.2,40.8,41,271,18,197,59,468,13.1,8.4,11.2,"75% or more P.O.C.","$78000 - $104000"
"36047103400","Census Tract 1034, Kings County, New York",4294,25691,85,3156,26,0,0,963,2,73.5,0.6,0,0,22.4,98,1748,0,1748,0,100,0,0,140,1608,140,1608,NA,8,8,"75% or more P.O.C.","Less than $55000"
"36047105801","Census Tract 1058.01, Kings County, New York",5809,26112,1236,3411,31,42,0,1089,21.3,58.7,0.5,0.7,0,18.7,78.7,3435,40,3395,1.16,98.84,0,40,27,3368,27,3408,0,0.8,0.8,"75% or more P.O.C.","Less than $55000"
"36047105804","Census Tract 1058.04, Kings County, New York",6744,32292,1357,3627,35,424,0,1220,20.1,53.8,0.5,6.3,0,18.1,79.9,3167,71,3096,2.24,97.76,12,59,187,2909,199,2968,16.9,6,6.3,"75% or more P.O.C.","Less than $55000"
"36047107000","Census Tract 1070, Kings County, New York",2330,51549,73,1532,0,92,0,620,3.1,65.8,0,3.9,0,26.6,96.9,1069,469,600,43.87,56.13,0,469,10,590,10,1059,0,1.7,0.9,"75% or more P.O.C.","Less than $55000"
"36047107800","Census Tract 1078, Kings County, New York",4662,63411,68,3861,0,0,0,454,1.5,82.8,0,0,0,9.7,98.5,1965,1277,688,64.99,35.01,142,1135,86,602,228,1737,11.1,12.5,11.6,"75% or more P.O.C.","$55000 - $78000"
"36047109800","Census Tract 1098, Kings County, New York",2359,49440,125,1751,0,68,0,388,5.3,74.2,0,2.9,0,16.4,94.7,646,176,470,27.24,72.76,59,117,87,383,146,500,33.5,18.5,22.6,"75% or more P.O.C.","Less than $55000"
"36047110400","Census Tract 1104, Kings County, New York",4407,36630,54,3606,0,1,0,709,1.2,81.8,0,0,0,16.1,98.8,1746,583,1163,33.39,66.61,131,452,109,1054,240,1506,22.5,9.4,13.7,"75% or more P.O.C.","Less than $55000"
"36047110600","Census Tract 1106, Kings County, New York",4191,19973,0,2726,0,9,0,1299,0,65,0,0.2,0,31,100,1815,13,1802,0.72,99.28,0,13,192,1610,192,1623,0,10.7,10.6,"75% or more P.O.C.","Less than $55000"
"36047111000","Census Tract 1110, Kings County, New York",2986,21060,133,2035,0,22,0,704,4.5,68.2,0,0.7,0,23.6,95.5,1453,0,1453,0,100,0,0,58,1395,58,1395,NA,4,4,"75% or more P.O.C.","Less than $55000"
"36047111600","Census Tract 1116, Kings County, New York",3624,34413,98,2616,0,7,0,903,2.7,72.2,0,0.2,0,24.9,97.3,1095,341,754,31.14,68.86,59,282,154,600,213,882,17.3,20.4,19.5,"75% or more P.O.C.","Less than $55000"
"36047111800","Census Tract 1118, Kings County, New York",3639,39390,134,2507,0,0,0,998,3.7,68.9,0,0,0,27.4,96.3,1218,398,820,32.68,67.32,58,340,117,703,175,1043,14.6,14.3,14.4,"75% or more P.O.C.","Less than $55000"
"36047112000","Census Tract 1120, Kings County, New York",3105,36447,10,1905,0,59,0,1131,0.3,61.4,0,1.9,0,36.4,99.7,1128,306,822,27.13,72.87,57,249,93,729,150,978,18.6,11.3,13.3,"75% or more P.O.C.","Less than $55000"
"36047112200","Census Tract 1122, Kings County, New York",3168,41442,25,2216,73,170,0,640,0.8,69.9,2.3,5.4,0,20.2,99.2,1240,401,839,32.34,67.66,54,347,43,796,97,1143,13.5,5.1,7.8,"75% or more P.O.C.","Less than $55000"
"36047112400","Census Tract 1124, Kings County, New York",3054,45213,47,2330,0,0,0,548,1.5,76.3,0,0,0,17.9,98.5,1155,400,755,34.63,65.37,50,350,96,659,146,1009,12.5,12.7,12.6,"75% or more P.O.C.","Less than $55000"
"36047112600","Census Tract 1126, Kings County, New York",3237,28149,35,2591,0,122,0,423,1.1,80,0,3.8,0,13.1,98.9,1468,280,1188,19.07,80.93,49,231,120,1068,169,1299,17.5,10.1,11.5,"75% or more P.O.C.","Less than $55000"
"36047112800","Census Tract 1128, Kings County, New York",3764,35398,306,2952,0,0,0,506,8.1,78.4,0,0,0,13.4,91.9,1497,482,1015,32.2,67.8,48,434,108,907,156,1341,10,10.6,10.4,"75% or more P.O.C.","Less than $55000"
"36047113000","Census Tract 1130, Kings County, New York",3699,44872,44,2746,27,0,0,709,1.2,74.2,0.7,0,0,19.2,98.8,1549,554,995,35.77,64.23,46,508,94,901,140,1409,8.3,9.4,9,"75% or more P.O.C.","Less than $55000"
"36047113200","Census Tract 1132, Kings County, New York",1973,59000,49,1705,0,14,0,205,2.5,86.4,0,0.7,0,10.4,97.5,624,377,247,60.42,39.58,93,284,52,195,145,479,24.7,21.1,23.2,"75% or more P.O.C.","$55000 - $78000"
"36047113400","Census Tract 1134, Kings County, New York",3105,25469,50,1853,0,32,0,1072,1.6,59.7,0,1,0,34.5,98.4,905,35,870,3.87,96.13,0,35,94,776,94,811,0,10.8,10.4,"75% or more P.O.C.","Less than $55000"
"36047114201","Census Tract 1142.01, Kings County, New York",1554,NA,39,413,0,43,0,1003,2.5,26.6,0,2.8,0,64.5,97.5,567,217,350,38.27,61.73,32,185,39,311,71,496,14.7,11.1,12.5,"75% or more P.O.C.","N/A"
"36047114202","Census Tract 1142.02, Kings County, New York",3011,67500,111,1129,0,0,1,1717,3.7,37.5,0,0,0,57,96.3,916,350,566,38.21,61.79,178,172,52,514,230,686,50.9,9.2,25.1,"75% or more P.O.C.","$55000 - $78000"
"36047114400","Census Tract 1144, Kings County, New York",2545,53646,117,1264,0,10,0,1154,4.6,49.7,0,0.4,0,45.3,95.4,749,115,634,15.35,84.65,18,97,125,509,143,606,15.7,19.7,19.1,"75% or more P.O.C.","Less than $55000"
"36047114600","Census Tract 1146, Kings County, New York",2852,35109,111,493,0,326,0,1864,3.9,17.3,0,11.4,0,65.4,96.1,962,329,633,34.2,65.8,67,262,96,537,163,799,20.4,15.2,16.9,"75% or more P.O.C.","Less than $55000"
"36047115000","Census Tract 1150, Kings County, New York",2557,45143,25,1327,0,67,0,1094,1,51.9,0,2.6,0,42.8,99,888,280,608,31.53,68.47,79,201,88,520,167,721,28.2,14.5,18.8,"75% or more P.O.C.","Less than $55000"
"36047115200","Census Tract 1152, Kings County, New York",3122,40884,160,1730,0,86,0,971,5.1,55.4,0,2.8,0,31.1,94.9,1057,248,809,23.46,76.54,54,194,102,707,156,901,21.8,12.6,14.8,"75% or more P.O.C.","Less than $55000"
"36047115600","Census Tract 1156, Kings County, New York",3924,21301,0,3137,28,20,0,731,0,79.9,0.7,0.5,0,18.6,100,1673,146,1527,8.73,91.27,27,119,106,1421,133,1540,18.5,6.9,7.9,"75% or more P.O.C.","Less than $55000"
"36047115800","Census Tract 1158, Kings County, New York",2878,35495,53,1810,0,1,0,851,1.8,62.9,0,0,0,29.6,98.2,971,391,580,40.27,59.73,110,281,60,520,170,801,28.1,10.3,17.5,"75% or more P.O.C.","Less than $55000"
"36047116000","Census Tract 1160, Kings County, New York",2324,37600,26,1565,0,0,0,733,1.1,67.3,0,0,0,31.5,98.9,926,274,652,29.59,70.41,61,213,34,618,95,831,22.3,5.2,10.3,"75% or more P.O.C.","Less than $55000"
"36047116200","Census Tract 1162, Kings County, New York",2429,41618,0,1768,15,67,62,325,0,72.8,0.6,2.8,2.6,13.4,100,814,327,487,40.17,59.83,43,284,77,410,120,694,13.1,15.8,14.7,"75% or more P.O.C.","Less than $55000"
"36047116400","Census Tract 1164, Kings County, New York",3596,50853,0,2285,0,36,0,1275,0,63.5,0,1,0,35.5,100,1097,404,693,36.83,63.17,106,298,228,465,334,763,26.2,32.9,30.4,"75% or more P.O.C.","Less than $55000"
"36047116600","Census Tract 1166, Kings County, New York",3128,58750,129,1639,0,82,0,1209,4.1,52.4,0,2.6,0,38.7,95.9,1017,260,757,25.57,74.43,60,200,108,649,168,849,23.1,14.3,16.5,"75% or more P.O.C.","$55000 - $78000"
"36047116800","Census Tract 1168, Kings County, New York",2028,62375,29,760,0,28,0,1202,1.4,37.5,0,1.4,0,59.3,98.6,646,169,477,26.16,73.84,51,118,59,418,110,536,30.2,12.4,17,"75% or more P.O.C.","$55000 - $78000"
"36047117000","Census Tract 1170, Kings County, New York",1791,42411,12,360,0,72,0,1347,0.7,20.1,0,4,0,75.2,99.3,487,73,414,14.99,85.01,26,47,109,305,135,352,35.6,26.3,27.7,"75% or more P.O.C.","Less than $55000"
"36047117201","Census Tract 1172.01, Kings County, New York",2745,62750,62,351,0,81,0,2147,2.3,12.8,0,3,0,78.2,97.7,795,342,453,43.02,56.98,95,247,91,362,186,609,27.8,20.1,23.4,"75% or more P.O.C.","$55000 - $78000"
"36047117202","Census Tract 1172.02, Kings County, New York",3756,49615,177,1014,0,104,4,2307,4.7,27,0,2.8,0.1,61.4,95.3,1322,456,866,34.49,65.51,69,387,68,798,137,1185,15.1,7.9,10.4,"75% or more P.O.C.","Less than $55000"
"36047117400","Census Tract 1174, Kings County, New York",4143,64149,37,811,0,291,0,2967,0.9,19.6,0,7,0,71.6,99.1,1133,341,792,30.1,69.9,95,246,189,603,284,849,27.9,23.9,25.1,"75% or more P.O.C.","$55000 - $78000"
"36047117601","Census Tract 1176.01, Kings County, New York",3203,51583,185,724,0,47,0,2239,5.8,22.6,0,1.5,0,69.9,94.2,961,250,711,26.01,73.99,68,182,124,587,192,769,27.2,17.4,20,"75% or more P.O.C.","Less than $55000"
"36047117602","Census Tract 1176.02, Kings County, New York",2841,45457,159,376,0,65,0,2082,5.6,13.2,0,2.3,0,73.3,94.4,975,327,648,33.54,66.46,41,286,86,562,127,848,12.5,13.3,13,"75% or more P.O.C.","Less than $55000"
"36047117800","Census Tract 1178, Kings County, New York",1694,45417,19,365,0,365,0,897,1.1,21.5,0,21.5,0,53,98.9,487,165,322,33.88,66.12,59,106,50,272,109,378,35.8,15.5,22.4,"75% or more P.O.C.","Less than $55000"
"36047118000","Census Tract 1180, Kings County, New York",0,NA,0,0,0,0,0,0,NA,NA,NA,NA,NA,NA,NA,0,0,0,NA,NA,0,0,0,0,0,0,NA,NA,NA,"N/A","N/A"
"36047118201","Census Tract 1182.01, Kings County, New York",2868,64094,141,643,16,124,0,1803,4.9,22.4,0.6,4.3,0,62.9,95.1,927,309,618,33.33,66.67,92,217,60,558,152,775,29.8,9.7,16.4,"75% or more P.O.C.","$55000 - $78000"
"36047118202","Census Tract 1182.02, Kings County, New York",3317,57500,55,571,0,152,0,2463,1.7,17.2,0,4.6,0,74.3,98.3,922,324,598,35.14,64.86,128,196,109,489,237,685,39.5,18.2,25.7,"75% or more P.O.C.","$55000 - $78000"
"36047118400","Census Tract 1184, Kings County, New York",5105,58703,170,794,0,451,0,3617,3.3,15.6,0,8.8,0,70.9,96.7,1544,569,975,36.85,63.15,181,388,190,785,371,1173,31.8,19.5,24,"75% or more P.O.C.","$55000 - $78000"
"36047118600","Census Tract 1186, Kings County, New York",2960,64132,121,921,0,568,0,1328,4.1,31.1,0,19.2,0,44.9,95.9,809,366,443,45.24,54.76,99,267,136,307,235,574,27,30.7,29,"75% or more P.O.C.","$55000 - $78000"
"36047118800","Census Tract 1188, Kings County, New York",4536,51190,338,1534,0,1117,0,1279,7.5,33.8,0,24.6,0,28.2,92.5,1362,379,983,27.83,72.17,140,239,239,744,379,983,36.9,24.3,27.8,"75% or more P.O.C.","Less than $55000"
"36047119000","Census Tract 1190, Kings County, New York",2220,44821,45,867,13,133,0,1021,2,39.1,0.6,6,0,46,98,688,205,483,29.8,70.2,44,161,107,376,151,537,21.5,22.2,21.9,"75% or more P.O.C.","Less than $55000"
"36047119200","Census Tract 1192, Kings County, New York",3090,48000,39,1393,0,110,0,1463,1.3,45.1,0,3.6,0,47.3,98.7,1120,302,818,26.96,73.04,73,229,86,732,159,961,24.2,10.5,14.2,"75% or more P.O.C.","Less than $55000"
"36047119400","Census Tract 1194, Kings County, New York",4892,44444,162,2893,0,63,0,1774,3.3,59.1,0,1.3,0,36.3,96.7,1338,417,921,31.17,68.83,56,361,343,578,399,939,13.4,37.2,29.8,"75% or more P.O.C.","Less than $55000"
"36047119600","Census Tract 1196, Kings County, New York",4993,39838,209,2711,0,615,0,1325,4.2,54.3,0,12.3,0,26.5,95.8,1813,475,1338,26.2,73.8,100,375,230,1108,330,1483,21.1,17.2,18.2,"75% or more P.O.C.","Less than $55000"
"36047119800","Census Tract 1198, Kings County, New York",3671,37025,215,1472,10,13,0,1961,5.9,40.1,0.3,0.4,0,53.4,94.1,1105,217,888,19.64,80.36,138,79,144,744,282,823,63.6,16.2,25.5,"75% or more P.O.C.","Less than $55000"
"36047120000","Census Tract 1200, Kings County, New York",2630,47566,45,1513,0,514,0,487,1.7,57.5,0,19.5,0,18.5,98.3,777,202,575,26,74,62,140,146,429,208,569,30.7,25.4,26.8,"75% or more P.O.C.","Less than $55000"
"36047120200","Census Tract 1202, Kings County, New York",1933,32321,41,898,0,696,0,280,2.1,46.5,0,36,0,14.5,97.9,585,179,406,30.6,69.4,66,113,113,293,179,406,36.9,27.8,30.6,"75% or more P.O.C.","Less than $55000"
"36047120800","Census Tract 1208, Kings County, New York",10413,39002,297,8140,0,251,0,1562,2.9,78.2,0,2.4,0,15,97.1,3581,818,2763,22.84,77.16,295,523,390,2373,685,2896,36.1,14.1,19.1,"75% or more P.O.C.","Less than $55000"
"36047121000","Census Tract 1210, Kings County, New York",4196,15833,0,2401,0,14,0,1751,0,57.2,0,0.3,0,41.7,100,1558,0,1558,0,100,0,0,223,1335,223,1335,NA,14.3,14.3,"75% or more P.O.C.","Less than $55000"
"36047121400","Census Tract 1214, Kings County, New York",4820,18457,0,2801,0,0,0,2004,0,58.1,0,0,0,41.6,100,1710,0,1710,0,100,0,0,253,1457,253,1457,NA,14.8,14.8,"75% or more P.O.C.","Less than $55000"
"36047122000","Census Tract 1220, Kings County, New York",5945,39674,50,5148,0,64,0,641,0.8,86.6,0,1.1,0,10.8,99.2,2230,341,1889,15.29,84.71,87,254,216,1673,303,1927,25.5,11.4,13.6,"75% or more P.O.C.","Less than $55000"
"36047123700","Census Tract 1237, Kings County, New York",6966,47798,6056,243,0,54,0,577,86.9,3.5,0,0.8,0,8.3,13.1,1249,288,961,23.06,76.94,213,75,485,476,698,551,74,50.5,55.9,"Less than 25% P.O.C.","Less than $55000"
"36047150200","Census Tract 1502, Kings County, New York",2651,117639,2094,48,0,189,0,287,79,1.8,0,7.1,0,10.8,21,998,486,512,48.7,51.3,58,428,0,512,58,940,11.9,0,5.8,"Less than 25% P.O.C.","$104000 or more"
"36047152200","Census Tract 1522, Kings County, New York",3717,135982,1534,639,0,649,0,575,41.3,17.2,0,17.5,0,15.5,58.7,1107,705,402,63.69,36.31,184,521,71,331,255,852,26.1,17.7,23,"50% - 75% P.O.C.","$104000 or more"
"36047990100","Census Tract 9901, Kings County, New York",0,NA,0,0,0,0,0,0,NA,NA,NA,NA,NA,NA,NA,0,0,0,NA,NA,0,0,0,0,0,0,NA,NA,NA,"N/A","N/A"
"36059300100","Census Tract 3001, Nassau County, New York",5223,145476,4646,28,0,140,0,294,89,0.5,0,2.7,0,5.6,11,1260,1238,22,98.25,1.75,366,872,8,14,374,886,29.6,36.4,29.7,"Less than 25% P.O.C.","$104000 or more"
"36059300300","Census Tract 3003, Nassau County, New York",4095,95104,3057,104,0,464,0,432,74.7,2.5,0,11.3,0,10.5,25.3,1335,907,428,67.94,32.06,192,715,73,355,265,1070,21.2,17.1,19.9,"25% - 50% P.O.C.","$78000 - $104000"
"36059300400","Census Tract 3004, Nassau County, New York",6110,108333,4825,0,0,643,0,595,79,0,0,10.5,0,9.7,21,1826,1553,273,85.05,14.95,326,1227,104,169,430,1396,21,38.1,23.5,"Less than 25% P.O.C.","$104000 or more"
"36059300500","Census Tract 3005, Nassau County, New York",5365,137159,4310,18,98,665,0,169,80.3,0.3,1.8,12.4,0,3.2,19.7,1791,1487,304,83.03,16.97,304,1183,53,251,357,1434,20.4,17.4,19.9,"Less than 25% P.O.C.","$104000 or more"
"36059300600","Census Tract 3006, Nassau County, New York",6492,152963,4182,35,0,2020,0,184,64.4,0.5,0,31.1,0,2.8,35.6,2262,1925,337,85.1,14.9,241,1684,57,280,298,1964,12.5,16.9,13.2,"25% - 50% P.O.C.","$104000 or more"
"36059300700","Census Tract 3007, Nassau County, New York",6098,92747,4116,226,47,1144,0,364,67.5,3.7,0.8,18.8,0,6,32.5,3337,2008,1329,60.17,39.83,0,2008,15,1314,15,3322,0,1.1,0.4,"25% - 50% P.O.C.","$78000 - $104000"
"36059300800","Census Tract 3008, Nassau County, New York",4182,116711,1980,43,0,1767,0,349,47.3,1,0,42.3,0,8.3,52.7,1612,1221,391,75.74,24.26,85,1136,0,391,85,1527,7,0,5.3,"50% - 75% P.O.C.","$104000 or more"
"36059300900","Census Tract 3009, Nassau County, New York",8915,159397,4897,326,14,3254,0,372,54.9,3.7,0.2,36.5,0,4.2,45.1,3387,2900,487,85.62,14.38,202,2698,0,487,202,3185,7,0,6,"25% - 50% P.O.C.","$104000 or more"
"36059301000","Census Tract 3010, Nassau County, New York",5606,200329,4722,24,2,568,0,215,84.2,0.4,0,10.1,0,3.8,15.8,2145,1878,267,87.55,12.45,177,1701,9,258,186,1959,9.4,3.4,8.7,"Less than 25% P.O.C.","$104000 or more"
"36059301101","Census Tract 3011.01, Nassau County, New York",6628,86484,3453,57,42,1034,6,1961,52.1,0.9,0.6,15.6,0.1,29.6,47.9,2391,921,1470,38.52,61.48,107,814,183,1287,290,2101,11.6,12.4,12.1,"25% - 50% P.O.C.","$78000 - $104000"
"36059301102","Census Tract 3011.02, Nassau County, New York",4580,116944,3561,18,0,292,0,648,77.8,0.4,0,6.4,0,14.1,22.2,1668,1143,525,68.53,31.47,114,1029,82,443,196,1472,10,15.6,11.8,"Less than 25% P.O.C.","$104000 or more"
"36059301200","Census Tract 3012, Nassau County, New York",5941,161750,5079,34,0,391,0,401,85.5,0.6,0,6.6,0,6.7,14.5,2191,1538,653,70.2,29.8,257,1281,0,653,257,1934,16.7,0,11.7,"Less than 25% P.O.C.","$104000 or more"
"36059301300","Census Tract 3013, Nassau County, New York",4711,114102,2426,312,0,782,0,1135,51.5,6.6,0,16.6,0,24.1,48.5,1583,982,601,62.03,37.97,86,896,82,519,168,1415,8.8,13.6,10.6,"25% - 50% P.O.C.","$104000 or more"
"36059301400","Census Tract 3014, Nassau County, New York",2063,186875,1572,0,0,244,0,212,76.2,0,0,11.8,0,10.3,23.8,716,653,63,91.2,8.8,50,603,6,57,56,660,7.7,9.5,7.8,"Less than 25% P.O.C.","$104000 or more"
"36059301500","Census Tract 3015, Nassau County, New York",2935,227083,2456,0,0,291,0,164,83.7,0,0,9.9,0,5.6,16.3,967,939,28,97.1,2.9,111,828,0,28,111,856,11.8,0,11.5,"Less than 25% P.O.C.","$104000 or more"
"36059301600","Census Tract 3016, Nassau County, New York",4832,192314,3509,74,0,909,0,256,72.6,1.5,0,18.8,0,5.3,27.4,1555,1383,172,88.94,11.06,217,1166,0,172,217,1338,15.7,0,14,"25% - 50% P.O.C.","$104000 or more"
"36059301700","Census Tract 3017, Nassau County, New York",2722,250001,2174,0,0,284,0,225,79.9,0,0,10.4,0,8.3,20.1,805,754,51,93.66,6.34,178,576,0,51,178,627,23.6,0,22.1,"Less than 25% P.O.C.","$104000 or more"
"36059301800","Census Tract 3018, Nassau County, New York",5015,116563,2599,718,0,826,0,713,51.8,14.3,0,16.5,0,14.2,48.2,1695,1166,529,68.79,31.21,117,1049,40,489,157,1538,10,7.6,9.3,"25% - 50% P.O.C.","$104000 or more"
"36059301900","Census Tract 3019, Nassau County, New York",2970,250001,2310,0,6,396,0,161,77.8,0,0.2,13.3,0,5.4,22.2,960,940,20,97.92,2.08,115,825,0,20,115,845,12.2,0,12,"Less than 25% P.O.C.","$104000 or more"
"36059302000","Census Tract 3020, Nassau County, New York",4907,128438,3965,51,0,497,0,253,80.8,1,0,10.1,0,5.2,19.2,2023,1600,423,79.09,20.91,133,1467,10,413,143,1880,8.3,2.4,7.1,"Less than 25% P.O.C.","$104000 or more"
"36059302101","Census Tract 3021.01, Nassau County, New York",4509,198929,3479,51,0,713,0,172,77.2,1.1,0,15.8,0,3.8,22.8,1442,1252,190,86.82,13.18,233,1019,0,190,233,1209,18.6,0,16.2,"Less than 25% P.O.C.","$104000 or more"
"36059302102","Census Tract 3021.02, Nassau County, New York",3702,245288,3088,4,0,338,0,264,83.4,0.1,0,9.1,0,7.1,16.6,1185,1185,0,100,0,124,1061,0,0,124,1061,10.5,NA,10.5,"Less than 25% P.O.C.","$104000 or more"
"36059302200","Census Tract 3022, Nassau County, New York",3818,104306,1896,210,0,807,0,846,49.7,5.5,0,21.1,0,22.2,50.3,1247,885,362,70.97,29.03,124,761,20,342,144,1103,14,5.5,11.5,"50% - 75% P.O.C.","$104000 or more"
"36059302300","Census Tract 3023, Nassau County, New York",4593,161188,2191,86,6,1867,0,81,47.7,1.9,0.1,40.6,0,1.8,52.3,1425,1409,16,98.88,1.12,265,1144,0,16,265,1160,18.8,0,18.6,"50% - 75% P.O.C.","$104000 or more"
"36059302400","Census Tract 3024, Nassau County, New York",5225,128116,3358,0,68,1225,0,471,64.3,0,1.3,23.4,0,9,35.7,1813,1751,62,96.58,3.42,198,1553,29,33,227,1586,11.3,46.8,12.5,"25% - 50% P.O.C.","$104000 or more"
"36059302501","Census Tract 3025.01, Nassau County, New York",2745,181806,1812,48,0,726,0,114,66,1.7,0,26.4,0,4.2,34,871,823,48,94.49,5.51,147,676,19,29,166,705,17.9,39.6,19.1,"25% - 50% P.O.C.","$104000 or more"
"36059302502","Census Tract 3025.02, Nassau County, New York",2724,169973,1716,129,0,654,0,139,63,4.7,0,24,0,5.1,37,855,806,49,94.27,5.73,169,637,17,32,186,669,21,34.7,21.8,"25% - 50% P.O.C.","$104000 or more"
"36059302600","Census Tract 3026, Nassau County, New York",2418,108565,1506,61,0,446,0,342,62.3,2.5,0,18.4,0,14.1,37.7,851,647,204,76.03,23.97,44,603,9,195,53,798,6.8,4.4,6.2,"25% - 50% P.O.C.","$104000 or more"
"36059302700","Census Tract 3027, Nassau County, New York",4464,122857,1747,13,0,2072,0,408,39.1,0.3,0,46.4,0,9.1,60.9,1360,1216,144,89.41,10.59,216,1000,78,66,294,1066,17.8,54.2,21.6,"50% - 75% P.O.C.","$104000 or more"
"36059302800","Census Tract 3028, Nassau County, New York",6513,127426,2869,0,27,2583,0,1002,44.1,0,0.4,39.7,0,15.4,55.9,1999,1869,130,93.5,6.5,427,1442,0,130,427,1572,22.8,0,21.4,"50% - 75% P.O.C.","$104000 or more"
"36059302900","Census Tract 3029, Nassau County, New York",4103,151597,2858,1,0,909,0,278,69.7,0,0,22.2,0,6.8,30.3,1376,1293,83,93.97,6.03,135,1158,0,83,135,1241,10.4,0,9.8,"25% - 50% P.O.C.","$104000 or more"
"36059303000","Census Tract 3030, Nassau County, New York",5790,133452,2134,12,0,2216,51,1213,36.9,0.2,0,38.3,0.9,20.9,63.1,1644,1276,368,77.62,22.38,244,1032,57,311,301,1343,19.1,15.5,18.3,"50% - 75% P.O.C.","$104000 or more"
"36059303101","Census Tract 3031.01, Nassau County, New York",3615,175139,1368,85,18,1857,0,197,37.8,2.4,0.5,51.4,0,5.4,62.2,1105,1065,40,96.38,3.62,190,875,9,31,199,906,17.8,22.5,18,"50% - 75% P.O.C.","$104000 or more"
"36059303102","Census Tract 3031.02, Nassau County, New York",4122,133472,1703,0,0,1824,52,136,41.3,0,0,44.3,1.3,3.3,58.7,1311,1276,35,97.33,2.67,143,1133,2,33,145,1166,11.2,5.7,11.1,"50% - 75% P.O.C.","$104000 or more"
"36059303201","Census Tract 3032.01, Nassau County, New York",3862,134375,1321,300,0,1573,0,390,34.2,7.8,0,40.7,0,10.1,65.8,1205,1173,32,97.34,2.66,184,989,13,19,197,1008,15.7,40.6,16.3,"50% - 75% P.O.C.","$104000 or more"
"36059303202","Census Tract 3032.02, Nassau County, New York",4473,96307,1615,47,0,1617,0,1107,36.1,1.1,0,36.2,0,24.7,63.9,1348,1045,303,77.52,22.48,170,875,7,296,177,1171,16.3,2.3,13.1,"50% - 75% P.O.C.","$78000 - $104000"
"36059303301","Census Tract 3033.01, Nassau County, New York",3046,110444,2186,0,14,642,0,154,71.8,0,0.5,21.1,0,5.1,28.2,1019,897,122,88.03,11.97,132,765,17,105,149,870,14.7,13.9,14.6,"25% - 50% P.O.C.","$104000 or more"
"36059303302","Census Tract 3033.02, Nassau County, New York",4231,113788,3079,130,0,313,0,624,72.8,3.1,0,7.4,0,14.7,27.2,1514,1100,414,72.66,27.34,103,997,46,368,149,1365,9.4,11.1,9.8,"25% - 50% P.O.C.","$104000 or more"
"36059303400","Census Tract 3034, Nassau County, New York",2572,196625,2032,25,0,236,0,187,79,1,0,9.2,0,7.3,21,809,797,12,98.52,1.48,143,654,7,5,150,659,17.9,58.3,18.5,"Less than 25% P.O.C.","$104000 or more"
"36059303500","Census Tract 3035, Nassau County, New York",4970,116806,3640,0,10,602,0,598,73.2,0,0.2,12.1,0,12,26.8,1727,1566,161,90.68,9.32,229,1337,0,161,229,1498,14.6,0,13.3,"25% - 50% P.O.C.","$104000 or more"
"36059303600","Census Tract 3036, Nassau County, New York",7297,93102,4044,281,0,750,0,2101,55.4,3.9,0,10.3,0,28.8,44.6,3281,1459,1822,44.47,55.53,217,1242,69,1753,286,2995,14.9,3.8,8.7,"25% - 50% P.O.C.","$78000 - $104000"
"36059303700","Census Tract 3037, Nassau County, New York",6919,103457,4596,208,0,1042,0,994,66.4,3,0,15.1,0,14.4,33.6,2584,1769,815,68.46,31.54,143,1626,181,634,324,2260,8.1,22.2,12.5,"25% - 50% P.O.C.","$78000 - $104000"
"36059303800","Census Tract 3038, Nassau County, New York",5131,90815,3438,134,0,453,0,808,67,2.6,0,8.8,0,15.7,33,1824,1296,528,71.05,28.95,136,1160,104,424,240,1584,10.5,19.7,13.2,"25% - 50% P.O.C.","$78000 - $104000"
"36059303900","Census Tract 3039, Nassau County, New York",3994,151033,1381,1919,0,241,0,389,34.6,48,0,6,0,9.7,65.4,1222,1153,69,94.35,5.65,204,949,23,46,227,995,17.7,33.3,18.6,"50% - 75% P.O.C.","$104000 or more"
"36059304001","Census Tract 3040.01, Nassau County, New York",2406,131667,1952,55,0,198,0,136,81.1,2.3,0,8.2,0,5.7,18.9,810,718,92,88.64,11.36,90,628,3,89,93,717,12.5,3.3,11.5,"Less than 25% P.O.C.","$104000 or more"
"36059304002","Census Tract 3040.02, Nassau County, New York",4528,79232,2225,471,0,460,0,1333,49.1,10.4,0,10.2,0,29.4,50.9,1705,991,714,58.12,41.88,154,837,59,655,213,1492,15.5,8.3,12.5,"50% - 75% P.O.C.","$78000 - $104000"
"36059304100","Census Tract 3041, Nassau County, New York",4504,96573,566,889,0,546,0,2375,12.6,19.7,0,12.1,0,52.7,87.4,1311,893,418,68.12,31.88,177,716,46,372,223,1088,19.8,11,17,"75% or more P.O.C.","$78000 - $104000"
"36059304202","Census Tract 3042.02, Nassau County, New York",3725,98886,599,1069,0,111,0,1790,16.1,28.7,0,3,0,48.1,83.9,993,768,225,77.34,22.66,176,592,97,128,273,720,22.9,43.1,27.5,"75% or more P.O.C.","$78000 - $104000"
"36059304203","Census Tract 3042.03, Nassau County, New York",6326,97885,196,3212,16,0,0,2902,3.1,50.8,0.3,0,0,45.9,96.9,1216,835,381,68.67,31.33,327,508,210,171,537,679,39.2,55.1,44.2,"75% or more P.O.C.","$78000 - $104000"
"36059304204","Census Tract 3042.04, Nassau County, New York",4816,56667,223,1443,0,0,0,2870,4.6,30,0,0,0,59.6,95.4,1160,437,723,37.67,62.33,215,222,238,485,453,707,49.2,32.9,39.1,"75% or more P.O.C.","$55000 - $78000"
"36059404300","Census Tract 4043, Nassau County, New York",3299,126579,1484,37,0,929,0,644,45,1.1,0,28.2,0,19.5,55,956,868,88,90.79,9.21,207,661,7,81,214,742,23.8,8,22.4,"50% - 75% P.O.C.","$104000 or more"
"36059404400","Census Tract 4044, Nassau County, New York",5266,132750,4359,0,0,171,0,641,82.8,0,0,3.2,0,12.2,17.2,1834,1492,342,81.35,18.65,261,1231,15,327,276,1558,17.5,4.4,15,"Less than 25% P.O.C.","$104000 or more"
"36059404500","Census Tract 4045, Nassau County, New York",3928,99773,2974,44,0,514,0,355,75.7,1.1,0,13.1,0,9,24.3,1566,1072,494,68.45,31.55,133,939,0,494,133,1433,12.4,0,8.5,"Less than 25% P.O.C.","$78000 - $104000"
"36059404600","Census Tract 4046, Nassau County, New York",4391,141386,3579,30,14,326,0,442,81.5,0.7,0.3,7.4,0,10.1,18.5,1401,1254,147,89.51,10.49,153,1101,11,136,164,1237,12.2,7.5,11.7,"Less than 25% P.O.C.","$104000 or more"
"36059404700","Census Tract 4047, Nassau County, New York",6250,136771,3695,85,44,934,0,1296,59.1,1.4,0.7,14.9,0,20.7,40.9,1995,1812,183,90.83,9.17,270,1542,28,155,298,1697,14.9,15.3,14.9,"25% - 50% P.O.C.","$104000 or more"
"36059404800","Census Tract 4048, Nassau County, New York",6065,94770,1165,2246,1,1110,0,1487,19.2,37,0,18.3,0,24.5,80.8,1715,1462,253,85.25,14.75,373,1089,64,189,437,1278,25.5,25.3,25.5,"75% or more P.O.C.","$78000 - $104000"
"36059404901","Census Tract 4049.01, Nassau County, New York",5238,109583,305,3303,0,602,0,718,5.8,63.1,0,11.5,0,13.7,94.2,1431,1363,68,95.25,4.75,324,1039,43,25,367,1064,23.8,63.2,25.6,"75% or more P.O.C.","$104000 or more"
"36059404902","Census Tract 4049.02, Nassau County, New York",5312,110224,389,3271,0,397,0,999,7.3,61.6,0,7.5,0,18.8,92.7,1354,950,404,70.16,29.84,375,575,105,299,480,874,39.5,26,35.5,"75% or more P.O.C.","$104000 or more"
"36059405000","Census Tract 4050, Nassau County, New York",5670,93063,884,1787,35,1062,13,1554,15.6,31.5,0.6,18.7,0.2,27.4,84.4,1529,1103,426,72.14,27.86,342,761,75,351,417,1112,31,17.6,27.3,"75% or more P.O.C.","$78000 - $104000"
"36059405100","Census Tract 4051, Nassau County, New York",8730,130600,1038,5102,0,725,0,1569,11.9,58.4,0,8.3,0,18,88.1,2310,1936,374,83.81,16.19,582,1354,129,245,711,1599,30.1,34.5,30.8,"75% or more P.O.C.","$104000 or more"
"36059405200","Census Tract 4052, Nassau County, New York",6808,95490,1469,2202,0,998,0,1779,21.6,32.3,0,14.7,0,26.1,78.4,1986,1401,585,70.54,29.46,316,1085,93,492,409,1577,22.6,15.9,20.6,"75% or more P.O.C.","$78000 - $104000"
"36059405301","Census Tract 4053.01, Nassau County, New York",3686,112909,2354,141,157,132,0,798,63.9,3.8,4.3,3.6,0,21.6,36.1,1199,998,201,83.24,16.76,136,862,32,169,168,1031,13.6,15.9,14,"25% - 50% P.O.C.","$104000 or more"
"36059405302","Census Tract 4053.02, Nassau County, New York",4608,102813,3063,113,0,347,0,1032,66.5,2.5,0,7.5,0,22.4,33.5,1416,1127,289,79.59,20.41,156,971,19,270,175,1241,13.8,6.6,12.4,"25% - 50% P.O.C.","$78000 - $104000"
"36059405400","Census Tract 4054, Nassau County, New York",9031,95526,3851,367,0,1634,0,2738,42.6,4.1,0,18.1,0,30.3,57.4,2664,1947,717,73.09,26.91,665,1282,84,633,749,1915,34.2,11.7,28.1,"50% - 75% P.O.C.","$78000 - $104000"
"36059405500","Census Tract 4055, Nassau County, New York",5313,105714,3715,148,0,466,0,947,69.9,2.8,0,8.8,0,17.8,30.1,1572,1347,225,85.69,14.31,232,1115,70,155,302,1270,17.2,31.1,19.2,"25% - 50% P.O.C.","$104000 or more"
"36059405600","Census Tract 4056, Nassau County, New York",4486,119583,3371,29,0,665,0,408,75.1,0.6,0,14.8,0,9.1,24.9,1362,1174,188,86.2,13.8,235,939,0,188,235,1127,20,0,17.3,"Less than 25% P.O.C.","$104000 or more"
"36059405700","Census Tract 4057, Nassau County, New York",4931,137113,3370,36,0,557,0,929,68.3,0.7,0,11.3,0,18.8,31.7,1545,1413,132,91.46,8.54,250,1163,33,99,283,1262,17.7,25,18.3,"25% - 50% P.O.C.","$104000 or more"
"36059405800","Census Tract 4058, Nassau County, New York",4250,146346,3609,0,0,296,0,321,84.9,0,0,7,0,7.6,15.1,1312,1219,93,92.91,7.09,149,1070,44,49,193,1119,12.2,47.3,14.7,"Less than 25% P.O.C.","$104000 or more"
"36059405900","Census Tract 4059, Nassau County, New York",5460,133200,3540,638,0,306,0,815,64.8,11.7,0,5.6,0,14.9,35.2,1546,1428,118,92.37,7.63,285,1143,86,32,371,1175,20,72.9,24,"25% - 50% P.O.C.","$104000 or more"
"36059406001","Census Tract 4060.01, Nassau County, New York",4685,114583,2970,325,0,389,0,933,63.4,6.9,0,8.3,0,19.9,36.6,1431,1250,181,87.35,12.65,213,1037,29,152,242,1189,17,16,16.9,"25% - 50% P.O.C.","$104000 or more"
"36059406002","Census Tract 4060.02, Nassau County, New York",3524,111420,2178,166,0,330,0,815,61.8,4.7,0,9.4,0,23.1,38.2,977,724,253,74.1,25.9,219,505,64,189,283,694,30.2,25.3,29,"25% - 50% P.O.C.","$104000 or more"
"36059406100","Census Tract 4061, Nassau County, New York",2983,142083,2011,260,24,40,0,610,67.4,8.7,0.8,1.3,0,20.4,32.6,887,853,34,96.17,3.83,132,721,15,19,147,740,15.5,44.1,16.6,"25% - 50% P.O.C.","$104000 or more"
"36059406201","Census Tract 4062.01, Nassau County, New York",3212,94397,980,722,0,182,0,1193,30.5,22.5,0,5.7,0,37.1,69.5,932,862,70,92.49,7.51,207,655,2,68,209,723,24,2.9,22.4,"50% - 75% P.O.C.","$78000 - $104000"
"36059406202","Census Tract 4062.02, Nassau County, New York",6131,146369,161,4532,0,370,0,916,2.6,73.9,0,6,0,14.9,97.4,1510,1416,94,93.77,6.23,373,1043,43,51,416,1094,26.3,45.7,27.5,"75% or more P.O.C.","$104000 or more"
"36059406300","Census Tract 4063, Nassau County, New York",3617,164844,3067,18,0,222,0,222,84.8,0.5,0,6.1,0,6.1,15.2,1221,1173,48,96.07,3.93,107,1066,0,48,107,1114,9.1,0,8.8,"Less than 25% P.O.C.","$104000 or more"
"36059406400","Census Tract 4064, Nassau County, New York",6639,205425,6088,0,0,61,0,456,91.7,0,0,0.9,0,6.9,8.3,2590,2276,314,87.88,12.12,299,1977,0,314,299,2291,13.1,0,11.5,"Less than 25% P.O.C.","$104000 or more"
"36059406501","Census Tract 4065.01, Nassau County, New York",7085,175789,6018,311,0,467,0,274,84.9,4.4,0,6.6,0,3.9,15.1,2268,2131,137,93.96,6.04,409,1722,12,125,421,1847,19.2,8.8,18.6,"Less than 25% P.O.C.","$104000 or more"
"36059406600","Census Tract 4066, Nassau County, New York",4149,150464,3591,0,0,287,0,167,86.6,0,0,6.9,0,4,13.4,1373,1314,59,95.7,4.3,246,1068,0,59,246,1127,18.7,0,17.9,"Less than 25% P.O.C.","$104000 or more"
"36059406701","Census Tract 4067.01, Nassau County, New York",2859,79107,403,758,0,83,0,1542,14.1,26.5,0,2.9,0,53.9,85.9,971,519,452,53.45,46.55,72,447,89,363,161,810,13.9,19.7,16.6,"75% or more P.O.C.","$78000 - $104000"
"36059406702","Census Tract 4067.02, Nassau County, New York",4424,41209,806,2200,39,68,0,1290,18.2,49.7,0.9,1.5,0,29.2,81.8,1713,499,1214,29.13,70.87,60,439,140,1074,200,1513,12,11.5,11.7,"75% or more P.O.C.","Less than $55000"
"36059406801","Census Tract 4068.01, Nassau County, New York",4855,56799,213,1571,16,184,0,2732,4.4,32.4,0.3,3.8,0,56.3,95.6,1517,141,1376,9.29,90.71,74,67,234,1142,308,1209,52.5,17,20.3,"75% or more P.O.C.","$55000 - $78000"
"36059406802","Census Tract 4068.02, Nassau County, New York",4823,54226,53,1187,0,0,0,3577,1.1,24.6,0,0,0,74.2,98.9,1523,179,1344,11.75,88.25,77,102,250,1094,327,1196,43,18.6,21.5,"75% or more P.O.C.","Less than $55000"
"36059406900","Census Tract 4069, Nassau County, New York",7205,59722,327,3025,20,142,0,3564,4.5,42,0.3,2,0,49.5,95.5,1924,1020,904,53.01,46.99,396,624,153,751,549,1375,38.8,16.9,28.5,"75% or more P.O.C.","$55000 - $78000"
"36059407000","Census Tract 4070, Nassau County, New York",7913,43306,178,4533,0,93,0,3109,2.2,57.3,0,1.2,0,39.3,97.8,2251,847,1404,37.63,62.37,298,549,294,1110,592,1659,35.2,20.9,26.3,"75% or more P.O.C.","Less than $55000"
"36059407101","Census Tract 4071.01, Nassau County, New York",5073,86154,341,2452,0,226,0,1817,6.7,48.3,0,4.5,0,35.8,93.3,1366,741,625,54.25,45.75,129,612,254,371,383,983,17.4,40.6,28,"75% or more P.O.C.","$78000 - $104000"
"36059407102","Census Tract 4071.02, Nassau County, New York",6819,103529,235,3865,0,0,0,2505,3.4,56.7,0,0,0,36.7,96.6,1494,1292,202,86.48,13.52,537,755,76,126,613,881,41.6,37.6,41,"75% or more P.O.C.","$78000 - $104000"
"36059407201","Census Tract 4072.01, Nassau County, New York",5527,52941,38,1446,0,35,0,3975,0.7,26.2,0,0.6,0,71.9,99.3,1494,228,1266,15.26,84.74,114,114,413,853,527,967,50,32.6,35.3,"75% or more P.O.C.","Less than $55000"
"36059407203","Census Tract 4072.03, Nassau County, New York",3241,77000,113,1706,0,37,0,1247,3.5,52.6,0,1.1,0,38.5,96.5,978,580,398,59.3,40.7,88,492,72,326,160,818,15.2,18.1,16.4,"75% or more P.O.C.","$55000 - $78000"
"36059407204","Census Tract 4072.04, Nassau County, New York",2561,79352,262,1338,75,66,0,685,10.2,52.2,2.9,2.6,0,26.7,89.8,646,437,209,67.65,32.35,113,324,49,160,162,484,25.9,23.4,25.1,"75% or more P.O.C.","$78000 - $104000"
"36059407301","Census Tract 4073.01, Nassau County, New York",7230,104787,4545,941,0,492,0,977,62.9,13,0,6.8,0,13.5,37.1,1838,1071,767,58.27,41.73,10,1061,34,733,44,1794,0.9,4.4,2.4,"25% - 50% P.O.C.","$104000 or more"
"36059407302","Census Tract 4073.02, Nassau County, New York",4795,78796,443,1903,0,74,0,2160,9.2,39.7,0,1.5,0,45,90.8,1322,1042,280,78.82,21.18,263,779,59,221,322,1000,25.2,21.1,24.4,"75% or more P.O.C.","$78000 - $104000"
"36059407401","Census Tract 4074.01, Nassau County, New York",5955,91977,683,2161,0,8,0,3081,11.5,36.3,0,0.1,0,51.7,88.5,1420,1107,313,77.96,22.04,384,723,107,206,491,929,34.7,34.2,34.6,"75% or more P.O.C.","$78000 - $104000"
"36059407402","Census Tract 4074.02, Nassau County, New York",3694,75781,322,1501,0,156,0,1575,8.7,40.6,0,4.2,0,42.6,91.3,829,589,240,71.05,28.95,203,386,42,198,245,584,34.5,17.5,29.6,"75% or more P.O.C.","$55000 - $78000"
"36059407501","Census Tract 4075.01, Nassau County, New York",5006,80109,205,2089,0,64,0,2606,4.1,41.7,0,1.3,0,52.1,95.9,1388,847,541,61.02,38.98,250,597,130,411,380,1008,29.5,24,27.4,"75% or more P.O.C.","$78000 - $104000"
"36059407502","Census Tract 4075.02, Nassau County, New York",5327,77440,270,2728,13,57,0,2154,5.1,51.2,0.2,1.1,0,40.4,94.9,1399,1031,368,73.7,26.3,350,681,91,277,441,958,33.9,24.7,31.5,"75% or more P.O.C.","$55000 - $78000"
"36059407600","Census Tract 4076, Nassau County, New York",5563,125799,3320,86,0,813,0,1261,59.7,1.5,0,14.6,0,22.7,40.3,1671,1626,45,97.31,2.69,270,1356,11,34,281,1390,16.6,24.4,16.8,"25% - 50% P.O.C.","$104000 or more"
"36059407700","Census Tract 4077, Nassau County, New York",5023,141071,3301,9,0,668,0,640,65.7,0.2,0,13.3,0,12.7,34.3,1496,1349,147,90.17,9.83,259,1090,74,73,333,1163,19.2,50.3,22.3,"25% - 50% P.O.C.","$104000 or more"
"36059407801","Census Tract 4078.01, Nassau County, New York",5555,119420,3569,203,0,953,0,774,64.2,3.7,0,17.2,0,13.9,35.8,1753,1576,177,89.9,10.1,368,1208,0,177,368,1385,23.4,0,21,"25% - 50% P.O.C.","$104000 or more"
"36059407802","Census Tract 4078.02, Nassau County, New York",1727,32250,682,610,0,88,0,347,39.5,35.3,0,5.1,0,20.1,60.5,328,281,47,85.67,14.33,0,281,8,39,8,320,0,17,2.4,"50% - 75% P.O.C.","Less than $55000"
"36059407900","Census Tract 4079, Nassau County, New York",5839,64846,4039,430,0,549,0,752,69.2,7.4,0,9.4,0,12.9,30.8,2393,1561,832,65.23,34.77,107,1454,36,796,143,2250,6.9,4.3,6,"25% - 50% P.O.C.","$55000 - $78000"
"36059408000","Census Tract 4080, Nassau County, New York",6347,117649,4281,377,0,970,0,705,67.4,5.9,0,15.3,0,11.1,32.6,2041,1854,187,90.84,9.16,247,1607,114,73,361,1680,13.3,61,17.7,"25% - 50% P.O.C.","$104000 or more"
"36059408100","Census Tract 4081, Nassau County, New York",6884,127670,4227,71,0,901,0,1482,61.4,1,0,13.1,0,21.5,38.6,2084,1920,164,92.13,7.87,315,1605,82,82,397,1687,16.4,50,19,"25% - 50% P.O.C.","$104000 or more"
"36059408200","Census Tract 4082, Nassau County, New York",6471,115550,3925,82,150,905,0,1299,60.7,1.3,2.3,14,0,20.1,39.3,2021,1888,133,93.42,6.58,319,1569,30,103,349,1672,16.9,22.6,17.3,"25% - 50% P.O.C.","$104000 or more"
"36059408300","Census Tract 4083, Nassau County, New York",6753,109712,3905,579,0,891,0,970,57.8,8.6,0,13.2,0,14.4,42.2,2303,2038,265,88.49,11.51,322,1716,0,265,322,1981,15.8,0,14,"25% - 50% P.O.C.","$104000 or more"
"36059408400","Census Tract 4084, Nassau County, New York",3900,135020,2825,253,0,264,0,435,72.4,6.5,0,6.8,0,11.2,27.6,1299,1222,77,94.07,5.93,131,1091,0,77,131,1168,10.7,0,10.1,"25% - 50% P.O.C.","$104000 or more"
"36059408500","Census Tract 4085, Nassau County, New York",6544,136264,5122,70,0,435,0,696,78.3,1.1,0,6.6,0,10.6,21.7,2003,1880,123,93.86,6.14,302,1578,12,111,314,1689,16.1,9.8,15.7,"Less than 25% P.O.C.","$104000 or more"
"36059408600","Census Tract 4086, Nassau County, New York",4651,114847,3068,183,0,553,0,766,66,3.9,0,11.9,0,16.5,34,1472,1326,146,90.08,9.92,336,990,21,125,357,1115,25.3,14.4,24.3,"25% - 50% P.O.C.","$104000 or more"
"36059408700","Census Tract 4087, Nassau County, New York",4908,131563,3259,1,0,579,0,719,66.4,0,0,11.8,0,14.6,33.6,1468,1359,109,92.57,7.43,229,1130,0,109,229,1239,16.9,0,15.6,"25% - 50% P.O.C.","$104000 or more"
"36059408800","Census Tract 4088, Nassau County, New York",6835,123091,5332,61,0,592,0,830,78,0.9,0,8.7,0,12.1,22,2131,1971,160,92.49,7.51,264,1707,40,120,304,1827,13.4,25,14.3,"Less than 25% P.O.C.","$104000 or more"
"36059408900","Census Tract 4089, Nassau County, New York",5997,130317,4147,86,0,526,0,1054,69.2,1.4,0,8.8,0,17.6,30.8,1845,1727,118,93.6,6.4,282,1445,0,118,282,1563,16.3,0,15.3,"25% - 50% P.O.C.","$104000 or more"
"36059409000","Census Tract 4090, Nassau County, New York",5842,127813,4022,93,0,512,0,1106,68.8,1.6,0,8.8,0,18.9,31.2,1795,1701,94,94.76,5.24,278,1423,0,94,278,1517,16.3,0,15.5,"25% - 50% P.O.C.","$104000 or more"
"36059409100","Census Tract 4091, Nassau County, New York",4977,121277,3596,22,0,375,0,846,72.3,0.4,0,7.5,0,17,27.7,1702,1623,79,95.36,4.64,222,1401,0,79,222,1480,13.7,0,13,"25% - 50% P.O.C.","$104000 or more"
"36059409200","Census Tract 4092, Nassau County, New York",6014,125885,4561,0,0,339,0,967,75.8,0,0,5.6,0,16.1,24.2,1936,1774,162,91.63,8.37,255,1519,26,136,281,1655,14.4,16,14.5,"Less than 25% P.O.C.","$104000 or more"
"36059409300","Census Tract 4093, Nassau County, New York",4258,103147,3296,29,0,188,0,703,77.4,0.7,0,4.4,0,16.5,22.6,1358,1310,48,96.47,3.53,169,1141,0,48,169,1189,12.9,0,12.4,"Less than 25% P.O.C.","$78000 - $104000"
"36059409400","Census Tract 4094, Nassau County, New York",4222,138284,3576,47,0,14,0,543,84.7,1.1,0,0.3,0,12.9,15.3,1389,1361,28,97.98,2.02,239,1122,0,28,239,1150,17.6,0,17.2,"Less than 25% P.O.C.","$104000 or more"
"36059409500","Census Tract 4095, Nassau County, New York",3930,137031,3227,0,0,205,0,458,82.1,0,0,5.2,0,11.7,17.9,1247,1204,43,96.55,3.45,157,1047,8,35,165,1082,13,18.6,13.2,"Less than 25% P.O.C.","$104000 or more"
"36059409600","Census Tract 4096, Nassau County, New York",5182,136108,4272,0,0,228,0,614,82.4,0,0,4.4,0,11.8,17.6,1655,1624,31,98.13,1.87,246,1378,0,31,246,1409,15.1,0,14.9,"Less than 25% P.O.C.","$104000 or more"
"36059409700","Census Tract 4097, Nassau County, New York",4084,122917,3492,11,6,43,0,460,85.5,0.3,0.1,1.1,0,11.3,14.5,1602,1438,164,89.76,10.24,157,1281,0,164,157,1445,10.9,0,9.8,"Less than 25% P.O.C.","$104000 or more"
"36059409800","Census Tract 4098, Nassau County, New York",5718,129065,318,4062,16,515,0,431,5.6,71,0.3,9,0,7.5,94.4,1588,1419,169,89.36,10.64,386,1033,27,142,413,1175,27.2,16,26,"75% or more P.O.C.","$104000 or more"
"36059409900","Census Tract 4099, Nassau County, New York",8617,114750,1179,4211,0,1031,16,1850,13.7,48.9,0,12,0.2,21.5,86.3,2605,2227,378,85.49,14.51,512,1715,0,378,512,2093,23,0,19.7,"75% or more P.O.C.","$104000 or more"
"36059410000","Census Tract 4100, Nassau County, New York",4326,106741,1338,1053,20,765,0,956,30.9,24.3,0.5,17.7,0,22.1,69.1,1441,1357,84,94.17,5.83,207,1150,0,84,207,1234,15.3,0,14.4,"50% - 75% P.O.C.","$104000 or more"
"36059410100","Census Tract 4101, Nassau County, New York",5683,129205,4585,283,0,232,0,341,80.7,5,0,4.1,0,6,19.3,1999,1942,57,97.15,2.85,231,1711,0,57,231,1768,11.9,0,11.6,"Less than 25% P.O.C.","$104000 or more"
"36059410200","Census Tract 4102, Nassau County, New York",3574,120781,2526,172,7,250,0,489,70.7,4.8,0.2,7,0,13.7,29.3,1322,1200,122,90.77,9.23,171,1029,0,122,171,1151,14.2,0,12.9,"25% - 50% P.O.C.","$104000 or more"
"36059410300","Census Tract 4103, Nassau County, New York",6756,117151,1248,2412,0,837,0,1784,18.5,35.7,0,12.4,0,26.4,81.5,1919,1718,201,89.53,10.47,358,1360,28,173,386,1533,20.8,13.9,20.1,"75% or more P.O.C.","$104000 or more"
"36059410400","Census Tract 4104, Nassau County, New York",4606,116231,826,1942,0,609,0,896,17.9,42.2,0,13.2,0,19.5,82.1,1385,1264,121,91.26,8.74,236,1028,19,102,255,1130,18.7,15.7,18.4,"75% or more P.O.C.","$104000 or more"
"36059410500","Census Tract 4105, Nassau County, New York",7306,97014,1757,2120,0,1146,0,1876,24,29,0,15.7,0,25.7,76,2488,1726,762,69.37,30.63,311,1415,118,644,429,2059,18,15.5,17.2,"75% or more P.O.C.","$78000 - $104000"
"36059410600","Census Tract 4106, Nassau County, New York",7489,115482,2113,1251,0,1179,0,2613,28.2,16.7,0,15.7,0,34.9,71.8,2366,2162,204,91.38,8.62,425,1737,22,182,447,1919,19.7,10.8,18.9,"50% - 75% P.O.C.","$104000 or more"
"36059410700","Census Tract 4107, Nassau County, New York",6755,115035,2609,1135,0,747,0,1688,38.6,16.8,0,11.1,0,25,61.4,2136,1607,529,75.23,24.77,226,1381,67,462,293,1843,14.1,12.7,13.7,"50% - 75% P.O.C.","$104000 or more"
"36059410800","Census Tract 4108, Nassau County, New York",4665,108333,2120,821,0,836,0,724,45.4,17.6,0,17.9,0,15.5,54.6,1510,1394,116,92.32,7.68,237,1157,24,92,261,1249,17,20.7,17.3,"50% - 75% P.O.C.","$104000 or more"
"36059410900","Census Tract 4109, Nassau County, New York",6775,121500,2133,2137,1,1193,10,1021,31.5,31.5,0,17.6,0.1,15.1,68.5,1992,1583,409,79.47,20.53,416,1167,102,307,518,1474,26.3,24.9,26,"50% - 75% P.O.C.","$104000 or more"
"36059411000","Census Tract 4110, Nassau County, New York",5579,71597,2130,570,0,253,0,2565,38.2,10.2,0,4.5,0,46,61.8,1570,946,624,60.25,39.75,261,685,144,480,405,1165,27.6,23.1,25.8,"50% - 75% P.O.C.","$55000 - $78000"
"36059411100","Census Tract 4111, Nassau County, New York",4377,51944,869,1139,0,207,0,2150,19.9,26,0,4.7,0,49.1,80.1,1458,530,928,36.35,63.65,69,461,144,784,213,1245,13,15.5,14.6,"75% or more P.O.C.","Less than $55000"
"36059411200","Census Tract 4112, Nassau County, New York",6642,103846,5931,105,0,133,0,445,89.3,1.6,0,2,0,6.7,10.7,2078,1442,636,69.39,30.61,497,945,17,619,514,1564,34.5,2.7,24.7,"Less than 25% P.O.C.","$78000 - $104000"
"36059411301","Census Tract 4113.01, Nassau County, New York",3717,149091,3063,252,0,167,0,178,82.4,6.8,0,4.5,0,4.8,17.6,1166,1018,148,87.31,12.69,275,743,9,139,284,882,27,6.1,24.4,"Less than 25% P.O.C.","$104000 or more"
"36059411302","Census Tract 4113.02, Nassau County, New York",7084,145435,6789,30,0,24,0,232,95.8,0.4,0,0.3,0,3.3,4.2,2004,1921,83,95.86,4.14,545,1376,36,47,581,1423,28.4,43.4,29,"Less than 25% P.O.C.","$104000 or more"
"36059411400","Census Tract 4114, Nassau County, New York",6669,134000,5387,659,0,68,0,554,80.8,9.9,0,1,0,8.3,19.2,1926,1583,343,82.19,17.81,522,1061,35,308,557,1369,33,10.2,28.9,"Less than 25% P.O.C.","$104000 or more"
"36059411500","Census Tract 4115, Nassau County, New York",2653,250001,2326,42,0,162,0,108,87.7,1.6,0,6.1,0,4.1,12.3,917,901,16,98.26,1.74,124,777,7,9,131,786,13.8,43.8,14.3,"Less than 25% P.O.C.","$104000 or more"
"36059411600","Census Tract 4116, Nassau County, New York",6480,124083,6229,18,0,125,0,108,96.1,0.3,0,1.9,0,1.7,3.9,2037,1713,324,84.09,15.91,539,1174,17,307,556,1481,31.5,5.2,27.3,"Less than 25% P.O.C.","$104000 or more"
"36059411700","Census Tract 4117, Nassau County, New York",6802,103177,4690,517,0,724,0,845,69,7.6,0,10.6,0,12.4,31,2490,1866,624,74.94,25.06,167,1699,41,583,208,2282,8.9,6.6,8.4,"25% - 50% P.O.C.","$78000 - $104000"
"36059411800","Census Tract 4118, Nassau County, New York",6051,103319,4942,187,0,73,0,758,81.7,3.1,0,1.2,0,12.5,18.3,2269,1710,559,75.36,24.64,203,1507,0,559,203,2066,11.9,0,8.9,"Less than 25% P.O.C.","$78000 - $104000"
"36059411901","Census Tract 4119.01, Nassau County, New York",3663,78958,2383,81,0,135,0,1033,65.1,2.2,0,3.7,0,28.2,34.9,1534,858,676,55.93,44.07,63,795,68,608,131,1403,7.3,10.1,8.5,"25% - 50% P.O.C.","$78000 - $104000"
"36059411902","Census Tract 4119.02, Nassau County, New York",3702,131389,2449,178,0,117,0,832,66.2,4.8,0,3.2,0,22.5,33.8,1202,992,210,82.53,17.47,154,838,13,197,167,1035,15.5,6.2,13.9,"25% - 50% P.O.C.","$104000 or more"
"36059412000","Census Tract 4120, Nassau County, New York",6108,96552,3512,167,0,219,0,2033,57.5,2.7,0,3.6,0,33.3,42.5,2186,1648,538,75.39,24.61,242,1406,8,530,250,1936,14.7,1.5,11.4,"25% - 50% P.O.C.","$78000 - $104000"
"36059412100","Census Tract 4121, Nassau County, New York",6358,97163,4968,336,0,382,0,595,78.1,5.3,0,6,0,9.4,21.9,2478,1879,599,75.83,24.17,177,1702,0,599,177,2301,9.4,0,7.1,"Less than 25% P.O.C.","$78000 - $104000"
"36059412200","Census Tract 4122, Nassau County, New York",5008,88125,4186,102,0,231,0,489,83.6,2,0,4.6,0,9.8,16.4,1972,1378,594,69.88,30.12,87,1291,79,515,166,1806,6.3,13.3,8.4,"Less than 25% P.O.C.","$78000 - $104000"
"36059412301","Census Tract 4123.01, Nassau County, New York",3514,82833,2372,63,0,224,0,837,67.5,1.8,0,6.4,0,23.8,32.5,1706,903,803,52.93,47.07,44,859,26,777,70,1636,4.9,3.2,4.1,"25% - 50% P.O.C.","$78000 - $104000"
"36059412302","Census Tract 4123.02, Nassau County, New York",3617,140764,2741,162,0,38,0,624,75.8,4.5,0,1.1,0,17.3,24.2,1291,957,334,74.13,25.87,171,786,0,334,171,1120,17.9,0,13.2,"Less than 25% P.O.C.","$104000 or more"
"36059412400","Census Tract 4124, Nassau County, New York",5590,68496,3543,1013,0,177,0,793,63.4,18.1,0,3.2,0,14.2,36.6,2853,1274,1579,44.65,55.35,12,1262,47,1532,59,2794,0.9,3,2.1,"25% - 50% P.O.C.","$55000 - $78000"
"36059412500","Census Tract 4125, Nassau County, New York",4003,166250,3787,50,0,0,0,166,94.6,1.2,0,0,0,4.1,5.4,1292,1254,38,97.06,2.94,170,1084,0,38,170,1122,13.6,0,13.2,"Less than 25% P.O.C.","$104000 or more"
"36059412600","Census Tract 4126, Nassau County, New York",3692,243526,3441,13,0,81,0,101,93.2,0.4,0,2.2,0,2.7,6.8,1132,1087,45,96.02,3.98,239,848,0,45,239,893,22,0,21.1,"Less than 25% P.O.C.","$104000 or more"
"36059412700","Census Tract 4127, Nassau County, New York",4076,182917,3551,157,0,112,0,157,87.1,3.9,0,2.7,0,3.9,12.9,1331,1297,34,97.45,2.55,185,1112,0,34,185,1146,14.3,0,13.9,"Less than 25% P.O.C.","$104000 or more"
"36059412800","Census Tract 4128, Nassau County, New York",3184,121597,1703,603,0,17,0,626,53.5,18.9,0,0.5,0,19.7,46.5,1027,911,116,88.7,11.3,158,753,0,116,158,869,17.3,0,15.4,"25% - 50% P.O.C.","$104000 or more"
"36059412900","Census Tract 4129, Nassau County, New York",6113,106875,885,3758,0,239,0,1052,14.5,61.5,0,3.9,0,17.2,85.5,1898,1701,197,89.62,10.38,323,1378,0,197,323,1575,19,0,17,"75% or more P.O.C.","$104000 or more"
"36059413001","Census Tract 4130.01, Nassau County, New York",3665,82344,2980,92,200,28,0,339,81.3,2.5,5.5,0.8,0,9.2,18.7,1327,925,402,69.71,30.29,100,825,0,402,100,1227,10.8,0,7.5,"Less than 25% P.O.C.","$78000 - $104000"
"36059413002","Census Tract 4130.02, Nassau County, New York",4193,125139,3268,35,0,21,0,869,77.9,0.8,0,0.5,0,20.7,22.1,1259,995,264,79.03,20.97,155,840,69,195,224,1035,15.6,26.1,17.8,"Less than 25% P.O.C.","$104000 or more"
"36059413100","Census Tract 4131, Nassau County, New York",5246,138269,3894,119,0,399,5,796,74.2,2.3,0,7.6,0.1,15.2,25.8,1628,1411,217,86.67,13.33,228,1183,50,167,278,1350,16.2,23,17.1,"25% - 50% P.O.C.","$104000 or more"
"36059413200","Census Tract 4132, Nassau County, New York",5745,112525,4423,2,0,160,0,1160,77,0,0,2.8,0,20.2,23,2351,2152,199,91.54,8.46,116,2036,48,151,164,2187,5.4,24.1,7,"Less than 25% P.O.C.","$104000 or more"
"36059413300","Census Tract 4133, Nassau County, New York",6257,114464,5461,0,0,186,0,610,87.3,0,0,3,0,9.7,12.7,2125,1990,135,93.65,6.35,208,1782,12,123,220,1905,10.5,8.9,10.4,"Less than 25% P.O.C.","$104000 or more"
"36059413400","Census Tract 4134, Nassau County, New York",5498,133333,4770,85,0,76,0,480,86.8,1.5,0,1.4,0,8.7,13.2,1776,1717,59,96.68,3.32,208,1509,24,35,232,1544,12.1,40.7,13.1,"Less than 25% P.O.C.","$104000 or more"
"36059413500","Census Tract 4135, Nassau County, New York",7566,124500,2543,2734,0,259,32,1866,33.6,36.1,0,3.4,0.4,24.7,66.4,2462,2191,271,88.99,11.01,260,1931,0,271,260,2202,11.9,0,10.6,"50% - 75% P.O.C.","$104000 or more"
"36059413600","Census Tract 4136, Nassau County, New York",5901,110742,2785,1140,0,303,0,1551,47.2,19.3,0,5.1,0,26.3,52.8,1877,1490,387,79.38,20.62,213,1277,47,340,260,1617,14.3,12.1,13.9,"50% - 75% P.O.C.","$104000 or more"
"36059413700","Census Tract 4137, Nassau County, New York",5147,111583,2447,1125,0,161,0,1277,47.5,21.9,0,3.1,0,24.8,52.5,1679,1361,318,81.06,18.94,202,1159,15,303,217,1462,14.8,4.7,12.9,"50% - 75% P.O.C.","$104000 or more"
"36059413803","Census Tract 4138.03, Nassau County, New York",3948,133438,1308,1382,0,166,0,905,33.1,35,0,4.2,0,22.9,66.9,1365,1292,73,94.65,5.35,79,1213,28,45,107,1258,6.1,38.4,7.8,"50% - 75% P.O.C.","$104000 or more"
"36059413804","Census Tract 4138.04, Nassau County, New York",3675,124656,1866,849,11,160,0,652,50.8,23.1,0.3,4.4,0,17.7,49.2,1147,1074,73,93.64,6.36,203,871,17,56,220,927,18.9,23.3,19.2,"25% - 50% P.O.C.","$104000 or more"
"36059413900","Census Tract 4139, Nassau County, New York",7480,85962,88,3805,0,0,0,3529,1.2,50.9,0,0,0,47.2,98.8,2040,1369,671,67.11,32.89,355,1014,125,546,480,1560,25.9,18.6,23.5,"75% or more P.O.C.","$78000 - $104000"
"36059414001","Census Tract 4140.01, Nassau County, New York",4219,94125,114,2828,0,30,0,1228,2.7,67,0,0.7,0,29.1,97.3,1084,882,202,81.37,18.63,262,620,23,179,285,799,29.7,11.4,26.3,"75% or more P.O.C.","$78000 - $104000"
"36059414002","Census Tract 4140.02, Nassau County, New York",5200,94559,30,2996,2,59,0,2011,0.6,57.6,0,1.1,0,38.7,99.4,1290,934,356,72.4,27.6,233,701,116,240,349,941,24.9,32.6,27.1,"75% or more P.O.C.","$78000 - $104000"
"36059414100","Census Tract 4141, Nassau County, New York",6818,94345,580,3085,0,74,0,2783,8.5,45.2,0,1.1,0,40.8,91.5,2005,1661,344,82.84,17.16,218,1443,209,135,427,1578,13.1,60.8,21.3,"75% or more P.O.C.","$78000 - $104000"
"36059414201","Census Tract 4142.01, Nassau County, New York",5180,70625,1061,1131,0,86,0,2749,20.5,21.8,0,1.7,0,53.1,79.5,1894,893,1001,47.15,52.85,115,778,177,824,292,1602,12.9,17.7,15.4,"75% or more P.O.C.","$55000 - $78000"
"36059414202","Census Tract 4142.02, Nassau County, New York",4110,78657,321,1517,0,12,0,2239,7.8,36.9,0,0.3,0,54.5,92.2,1285,911,374,70.89,29.11,136,775,109,265,245,1040,14.9,29.1,19.1,"75% or more P.O.C.","$78000 - $104000"
"36059414301","Census Tract 4143.01, Nassau County, New York",4123,75125,816,1265,0,160,0,1737,19.8,30.7,0,3.9,0,42.1,80.2,1274,611,663,47.96,52.04,80,531,105,558,185,1089,13.1,15.8,14.5,"75% or more P.O.C.","$55000 - $78000"
"36059414303","Census Tract 4143.03, Nassau County, New York",4862,107917,1601,1171,0,19,3,1924,32.9,24.1,0,0.4,0.1,39.6,67.1,1432,1228,204,85.75,14.25,258,970,47,157,305,1127,21,23,21.3,"50% - 75% P.O.C.","$104000 or more"
"36059414304","Census Tract 4143.04, Nassau County, New York",3444,41176,809,570,0,22,0,1937,23.5,16.6,0,0.6,0,56.2,76.5,1246,490,756,39.33,60.67,122,368,87,669,209,1037,24.9,11.5,16.8,"75% or more P.O.C.","Less than $55000"
"36059414400","Census Tract 4144, Nassau County, New York",5002,57277,491,1295,0,0,0,3134,9.8,25.9,0,0,0,62.7,90.2,1467,685,782,46.69,53.31,136,549,181,601,317,1150,19.9,23.1,21.6,"75% or more P.O.C.","$55000 - $78000"
"36059414501","Census Tract 4145.01, Nassau County, New York",5445,120357,2640,1312,0,17,0,1244,48.5,24.1,0,0.3,0,22.8,51.5,1908,1800,108,94.34,5.66,219,1581,30,78,249,1659,12.2,27.8,13.1,"50% - 75% P.O.C.","$104000 or more"
"36059414502","Census Tract 4145.02, Nassau County, New York",4094,103750,2284,566,0,159,0,923,55.8,13.8,0,3.9,0,22.5,44.2,1648,1348,300,81.8,18.2,79,1269,47,253,126,1522,5.9,15.7,7.6,"25% - 50% P.O.C.","$78000 - $104000"
"36059414600","Census Tract 4146, Nassau County, New York",3622,135688,2912,353,0,105,0,252,80.4,9.7,0,2.9,0,7,19.6,1085,1043,42,96.13,3.87,182,861,0,42,182,903,17.4,0,16.8,"Less than 25% P.O.C.","$104000 or more"
"36059414700","Census Tract 4147, Nassau County, New York",4648,135978,4011,42,0,220,0,297,86.3,0.9,0,4.7,0,6.4,13.7,1508,1482,26,98.28,1.72,205,1277,0,26,205,1303,13.8,0,13.6,"Less than 25% P.O.C.","$104000 or more"
"36059414800","Census Tract 4148, Nassau County, New York",6885,134671,5633,150,0,302,0,724,81.8,2.2,0,4.4,0,10.5,18.2,2147,1894,253,88.22,11.78,288,1606,0,253,288,1859,15.2,0,13.4,"Less than 25% P.O.C.","$104000 or more"
"36059414900","Census Tract 4149, Nassau County, New York",7289,141321,5530,213,0,425,0,1073,75.9,2.9,0,5.8,0,14.7,24.1,2362,2100,262,88.91,11.09,236,1864,63,199,299,2063,11.2,24,12.7,"Less than 25% P.O.C.","$104000 or more"
"36059415000","Census Tract 4150, Nassau County, New York",5622,126567,4843,39,0,258,0,447,86.1,0.7,0,4.6,0,8,13.9,1926,1725,201,89.56,10.44,231,1494,19,182,250,1676,13.4,9.5,13,"Less than 25% P.O.C.","$104000 or more"
"36059415101","Census Tract 4151.01, Nassau County, New York",2533,139474,2027,194,0,37,0,238,80,7.7,0,1.5,0,9.4,20,894,876,18,97.99,2.01,78,798,0,18,78,816,8.9,0,8.7,"Less than 25% P.O.C.","$104000 or more"
"36059415102","Census Tract 4151.02, Nassau County, New York",4751,179141,4202,33,26,77,0,395,88.4,0.7,0.5,1.6,0,8.3,11.6,1679,1610,69,95.89,4.11,112,1498,28,41,140,1539,7,40.6,8.3,"Less than 25% P.O.C.","$104000 or more"
"36059415201","Census Tract 4152.01, Nassau County, New York",3195,145774,2663,177,10,169,0,77,83.3,5.5,0.3,5.3,0,2.4,16.7,1141,1088,53,95.35,4.65,127,961,10,43,137,1004,11.7,18.9,12,"Less than 25% P.O.C.","$104000 or more"
"36059415202","Census Tract 4152.02, Nassau County, New York",4029,179375,3625,17,0,143,0,226,90,0.4,0,3.5,0,5.6,10,1413,1362,51,96.39,3.61,80,1282,0,51,80,1333,5.9,0,5.7,"Less than 25% P.O.C.","$104000 or more"
"36059415300","Census Tract 4153, Nassau County, New York",6016,128321,4894,165,0,339,0,442,81.3,2.7,0,5.6,0,7.3,18.7,2089,1672,417,80.04,19.96,238,1434,44,373,282,1807,14.2,10.6,13.5,"Less than 25% P.O.C.","$104000 or more"
"36059415401","Census Tract 4154.01, Nassau County, New York",5158,136488,4586,22,0,59,0,467,88.9,0.4,0,1.1,0,9.1,11.1,1765,1571,194,89.01,10.99,206,1365,0,194,206,1559,13.1,0,11.7,"Less than 25% P.O.C.","$104000 or more"
"36059415402","Census Tract 4154.02, Nassau County, New York",4194,165398,3858,8,0,106,0,212,92,0.2,0,2.5,0,5.1,8,1477,1442,35,97.63,2.37,142,1300,0,35,142,1335,9.8,0,9.6,"Less than 25% P.O.C.","$104000 or more"
"36059415500","Census Tract 4155, Nassau County, New York",2454,147083,2133,24,9,32,0,216,86.9,1,0.4,1.3,0,8.8,13.1,836,798,38,95.45,4.55,54,744,0,38,54,782,6.8,0,6.5,"Less than 25% P.O.C.","$104000 or more"
"36059415600","Census Tract 4156, Nassau County, New York",5413,139313,4887,18,0,95,0,362,90.3,0.3,0,1.8,0,6.7,9.7,1759,1694,65,96.3,3.7,282,1412,10,55,292,1467,16.6,15.4,16.6,"Less than 25% P.O.C.","$104000 or more"
"36059415700","Census Tract 4157, Nassau County, New York",5952,166080,5284,48,0,54,0,407,88.8,0.8,0,0.9,0,6.8,11.2,1916,1790,126,93.42,6.58,171,1619,8,118,179,1737,9.6,6.3,9.3,"Less than 25% P.O.C.","$104000 or more"
"36059415802","Census Tract 4158.02, Nassau County, New York",6550,150732,6041,4,0,77,0,343,92.2,0.1,0,1.2,0,5.2,7.8,2174,2025,149,93.15,6.85,300,1725,0,149,300,1874,14.8,0,13.8,"Less than 25% P.O.C.","$104000 or more"
"36059416000","Census Tract 4160, Nassau County, New York",4184,146382,3813,0,0,6,0,350,91.1,0,0,0.1,0,8.4,8.9,1314,1205,109,91.7,8.3,137,1068,0,109,137,1177,11.4,0,10.4,"Less than 25% P.O.C.","$104000 or more"
"36059416100","Census Tract 4161, Nassau County, New York",6124,117431,5431,3,0,200,0,437,88.7,0,0,3.3,0,7.1,11.3,2196,2002,194,91.17,8.83,189,1813,29,165,218,1978,9.4,14.9,9.9,"Less than 25% P.O.C.","$104000 or more"
"36059416201","Census Tract 4162.01, Nassau County, New York",3630,115208,2876,105,0,102,0,485,79.2,2.9,0,2.8,0,13.4,20.8,1305,1092,213,83.68,16.32,121,971,18,195,139,1166,11.1,8.5,10.7,"Less than 25% P.O.C.","$104000 or more"
"36059416202","Census Tract 4162.02, Nassau County, New York",4835,91841,2658,25,3,117,0,2013,55,0.5,0.1,2.4,0,41.6,45,1585,871,714,54.95,45.05,129,742,114,600,243,1342,14.8,16,15.3,"25% - 50% P.O.C.","$78000 - $104000"
"36059416300","Census Tract 4163, Nassau County, New York",3206,123583,2835,26,13,38,0,253,88.4,0.8,0.4,1.2,0,7.9,11.6,1321,1091,230,82.59,17.41,82,1009,13,217,95,1226,7.5,5.7,7.2,"Less than 25% P.O.C.","$104000 or more"
"36059416401","Census Tract 4164.01, Nassau County, New York",4148,104375,3771,7,23,0,0,239,90.9,0.2,0.6,0,0,5.8,9.1,1760,991,769,56.31,43.69,83,908,20,749,103,1657,8.4,2.6,5.9,"Less than 25% P.O.C.","$104000 or more"
"36059416402","Census Tract 4164.02, Nassau County, New York",2930,119861,2512,94,0,7,0,277,85.7,3.2,0,0.2,0,9.5,14.3,1083,802,281,74.05,25.95,35,767,0,281,35,1048,4.4,0,3.2,"Less than 25% P.O.C.","$104000 or more"
"36059416500","Census Tract 4165, Nassau County, New York",6139,77353,2351,1703,0,436,0,1482,38.3,27.7,0,7.1,0,24.1,61.7,1956,915,1041,46.78,53.22,140,775,136,905,276,1680,15.3,13.1,14.1,"50% - 75% P.O.C.","$55000 - $78000"
"36059416600","Census Tract 4166, Nassau County, New York",5567,119167,4632,154,0,328,0,373,83.2,2.8,0,5.9,0,6.7,16.8,2514,1449,1065,57.64,42.36,78,1371,14,1051,92,2422,5.4,1.3,3.7,"Less than 25% P.O.C.","$104000 or more"
"36059416701","Census Tract 4167.01, Nassau County, New York",4550,111779,3226,53,11,207,0,946,70.9,1.2,0.2,4.5,0,20.8,29.1,1497,920,577,61.46,38.54,60,860,109,468,169,1328,6.5,18.9,11.3,"25% - 50% P.O.C.","$104000 or more"
"36059416702","Census Tract 4167.02, Nassau County, New York",4363,78188,3280,267,0,69,0,585,75.2,6.1,0,1.6,0,13.4,24.8,2453,1097,1356,44.72,55.28,10,1087,0,1356,10,2443,0.9,0,0.4,"Less than 25% P.O.C.","$78000 - $104000"
"36059416801","Census Tract 4168.01, Nassau County, New York",2087,117222,1772,76,0,78,0,140,84.9,3.6,0,3.7,0,6.7,15.1,768,661,107,86.07,13.93,49,612,0,107,49,719,7.4,0,6.4,"Less than 25% P.O.C.","$104000 or more"
"36059416802","Census Tract 4168.02, Nassau County, New York",3723,82377,2978,47,39,56,0,603,80,1.3,1,1.5,0,16.2,20,1995,1227,768,61.5,38.5,71,1156,15,753,86,1909,5.8,2,4.3,"Less than 25% P.O.C.","$78000 - $104000"
"36059416900","Census Tract 4169, Nassau County, New York",4056,160842,3816,5,0,56,0,155,94.1,0.1,0,1.4,0,3.8,5.9,1627,1411,216,86.72,13.28,125,1286,24,192,149,1478,8.9,11.1,9.2,"Less than 25% P.O.C.","$104000 or more"
"36059517000","Census Tract 5170, Nassau County, New York",3543,138333,2359,176,0,225,0,657,66.6,5,0,6.4,0,18.5,33.4,1224,1005,219,82.11,17.89,51,954,0,219,51,1173,5.1,0,4.2,"25% - 50% P.O.C.","$104000 or more"
"36059517101","Census Tract 5171.01, Nassau County, New York",5092,73400,2908,386,7,225,0,1413,57.1,7.6,0.1,4.4,0,27.7,42.9,1844,889,955,48.21,51.79,96,793,121,834,217,1627,10.8,12.7,11.8,"25% - 50% P.O.C.","$55000 - $78000"
"36059517102","Census Tract 5171.02, Nassau County, New York",2412,116563,1485,102,0,165,0,622,61.6,4.2,0,6.8,0,25.8,38.4,773,737,36,95.34,4.66,63,674,0,36,63,710,8.5,0,8.2,"25% - 50% P.O.C.","$104000 or more"
"36059517200","Census Tract 5172, Nassau County, New York",7715,57973,2678,1278,24,349,0,2388,34.7,16.6,0.3,4.5,0,31,65.3,3070,894,2176,29.12,70.88,48,846,362,1814,410,2660,5.4,16.6,13.4,"50% - 75% P.O.C.","$55000 - $78000"
"36059517301","Census Tract 5173.01, Nassau County, New York",3213,87222,2177,169,0,218,0,570,67.8,5.3,0,6.8,0,17.7,32.2,1152,715,437,62.07,37.93,101,614,118,319,219,933,14.1,27,19,"25% - 50% P.O.C.","$78000 - $104000"
"36059517302","Census Tract 5173.02, Nassau County, New York",5257,88085,3299,55,35,248,0,1367,62.8,1,0.7,4.7,0,26,37.2,1748,913,835,52.23,47.77,68,845,161,674,229,1519,7.4,19.3,13.1,"25% - 50% P.O.C.","$78000 - $104000"
"36059517400","Census Tract 5174, Nassau County, New York",5038,132545,4340,61,0,78,0,477,86.1,1.2,0,1.5,0,9.5,13.9,1899,1451,448,76.41,23.59,78,1373,9,439,87,1812,5.4,2,4.6,"Less than 25% P.O.C.","$104000 or more"
"36059517500","Census Tract 5175, Nassau County, New York",3936,129063,3260,117,0,235,0,234,82.8,3,0,6,0,5.9,17.2,1389,1317,72,94.82,5.18,136,1181,9,63,145,1244,10.3,12.5,10.4,"Less than 25% P.O.C.","$104000 or more"
"36059517600","Census Tract 5176, Nassau County, New York",5053,123857,4080,123,0,108,0,677,80.7,2.4,0,2.1,0,13.4,19.3,1738,1467,271,84.41,15.59,203,1264,33,238,236,1502,13.8,12.2,13.6,"Less than 25% P.O.C.","$104000 or more"
"36059517701","Census Tract 5177.01, Nassau County, New York",7708,212902,5424,83,0,1719,0,348,70.4,1.1,0,22.3,0,4.5,29.6,2481,2278,203,91.82,8.18,382,1896,9,194,391,2090,16.8,4.4,15.8,"25% - 50% P.O.C.","$104000 or more"
"36059517705","Census Tract 5177.05, Nassau County, New York",3076,250001,2317,0,0,458,0,254,75.3,0,0,14.9,0,8.3,24.7,1047,975,72,93.12,6.88,89,886,14,58,103,944,9.1,19.4,9.8,"Less than 25% P.O.C.","$104000 or more"
"36059517801","Census Tract 5178.01, Nassau County, New York",3837,185313,3389,5,0,159,0,222,88.3,0.1,0,4.1,0,5.8,11.7,1297,1138,159,87.74,12.26,179,959,28,131,207,1090,15.7,17.6,16,"Less than 25% P.O.C.","$104000 or more"
"36059517802","Census Tract 5178.02, Nassau County, New York",3481,130521,2817,127,0,63,0,326,80.9,3.6,0,1.8,0,9.4,19.1,1227,884,343,72.05,27.95,91,793,43,300,134,1093,10.3,12.5,10.9,"Less than 25% P.O.C.","$104000 or more"
"36059517901","Census Tract 5179.01, Nassau County, New York",4795,108250,4475,4,0,100,0,141,93.3,0.1,0,2.1,0,2.9,6.7,1764,1488,276,84.35,15.65,139,1349,39,237,178,1586,9.3,14.1,10.1,"Less than 25% P.O.C.","$104000 or more"
"36059517902","Census Tract 5179.02, Nassau County, New York",2766,115417,2498,17,19,24,0,136,90.3,0.6,0.7,0.9,0,4.9,9.7,1131,879,252,77.72,22.28,73,806,30,222,103,1028,8.3,11.9,9.1,"Less than 25% P.O.C.","$104000 or more"
"36059518000","Census Tract 5180, Nassau County, New York",5836,96187,4556,201,0,149,0,849,78.1,3.4,0,2.6,0,14.5,21.9,2618,1545,1073,59.01,40.99,99,1446,105,968,204,2414,6.4,9.8,7.8,"Less than 25% P.O.C.","$78000 - $104000"
"36059518100","Census Tract 5181, Nassau County, New York",2959,157734,2504,64,0,45,0,228,84.6,2.2,0,1.5,0,7.7,15.4,983,932,51,94.81,5.19,95,837,8,43,103,880,10.2,15.7,10.5,"Less than 25% P.O.C.","$104000 or more"
"36059518201","Census Tract 5182.01, Nassau County, New York",4382,243833,3706,53,0,312,0,283,84.6,1.2,0,7.1,0,6.5,15.4,1396,1315,81,94.2,5.8,214,1101,3,78,217,1179,16.3,3.7,15.5,"Less than 25% P.O.C.","$104000 or more"
"36059518203","Census Tract 5182.03, Nassau County, New York",4572,194000,3503,123,0,724,0,207,76.6,2.7,0,15.8,0,4.5,23.4,1354,1089,265,80.43,19.57,123,966,0,265,123,1231,11.3,0,9.1,"Less than 25% P.O.C.","$104000 or more"
"36059518204","Census Tract 5182.04, Nassau County, New York",4280,177667,3488,78,0,613,0,81,81.5,1.8,0,14.3,0,1.9,18.5,1714,1577,137,92.01,7.99,87,1490,50,87,137,1577,5.5,36.5,8,"Less than 25% P.O.C.","$104000 or more"
"36059518300","Census Tract 5183, Nassau County, New York",5987,177500,3385,8,0,2044,0,391,56.5,0.1,0,34.1,0,6.5,43.5,1892,1553,339,82.08,17.92,288,1265,54,285,342,1550,18.5,15.9,18.1,"25% - 50% P.O.C.","$104000 or more"
"36059518400","Census Tract 5184, Nassau County, New York",4347,164219,2908,72,20,1136,0,133,66.9,1.7,0.5,26.1,0,3.1,33.1,1399,1310,89,93.64,6.36,175,1135,0,89,175,1224,13.4,0,12.5,"25% - 50% P.O.C.","$104000 or more"
"36059518501","Census Tract 5185.01, Nassau County, New York",6954,182106,4477,97,0,1880,0,247,64.4,1.4,0,27,0,3.6,35.6,2333,2100,233,90.01,9.99,219,1881,35,198,254,2079,10.4,15,10.9,"25% - 50% P.O.C.","$104000 or more"
"36059518502","Census Tract 5185.02, Nassau County, New York",2830,106000,1281,83,0,1128,0,135,45.3,2.9,0,39.9,0,4.8,54.7,1096,700,396,63.87,36.13,35,665,21,375,56,1040,5,5.3,5.1,"50% - 75% P.O.C.","$104000 or more"
"36059518600","Census Tract 5186, Nassau County, New York",4241,211594,2745,0,0,1354,0,95,64.7,0,0,31.9,0,2.2,35.3,1325,1320,5,99.62,0.38,120,1200,0,5,120,1205,9.1,0,9.1,"25% - 50% P.O.C.","$104000 or more"
"36059518700","Census Tract 5187, Nassau County, New York",5699,162371,3672,22,0,1824,0,147,64.4,0.4,0,32,0,2.6,35.6,1817,1763,54,97.03,2.97,228,1535,0,54,228,1589,12.9,0,12.5,"25% - 50% P.O.C.","$104000 or more"
"36059518800","Census Tract 5188, Nassau County, New York",3420,155431,2206,0,0,979,0,138,64.5,0,0,28.6,0,4,35.5,1062,1010,52,95.1,4.9,136,874,0,52,136,926,13.5,0,12.8,"25% - 50% P.O.C.","$104000 or more"
"36059518900","Census Tract 5189, Nassau County, New York",6850,96059,2716,812,0,2203,0,1119,39.6,11.9,0,32.2,0,16.3,60.4,2108,1725,383,81.83,18.17,428,1297,29,354,457,1651,24.8,7.6,21.7,"50% - 75% P.O.C.","$78000 - $104000"
"36059519000","Census Tract 5190, Nassau County, New York",6876,124626,3617,400,0,1385,0,1080,52.6,5.8,0,20.1,0,15.7,47.4,2073,1937,136,93.44,6.56,385,1552,3,133,388,1685,19.9,2.2,18.7,"25% - 50% P.O.C.","$104000 or more"
"36059519100","Census Tract 5191, Nassau County, New York",5781,87326,3153,106,0,1617,0,753,54.5,1.8,0,28,0,13,45.5,2015,1649,366,81.84,18.16,221,1428,126,240,347,1668,13.4,34.4,17.2,"25% - 50% P.O.C.","$78000 - $104000"
"36059519200","Census Tract 5192, Nassau County, New York",6395,124647,3416,0,14,2108,8,809,53.4,0,0.2,33,0.1,12.7,46.6,1985,1823,162,91.84,8.16,317,1506,49,113,366,1619,17.4,30.2,18.4,"25% - 50% P.O.C.","$104000 or more"
"36059519300","Census Tract 5193, Nassau County, New York",6035,98438,2879,111,0,2043,0,753,47.7,1.8,0,33.9,0,12.5,52.3,1954,1293,661,66.17,33.83,210,1083,21,640,231,1723,16.2,3.2,11.8,"50% - 75% P.O.C.","$78000 - $104000"
"36059519400","Census Tract 5194, Nassau County, New York",4359,124563,2812,28,0,668,0,707,64.5,0.6,0,15.3,0,16.2,35.5,1431,1290,141,90.15,9.85,136,1154,54,87,190,1241,10.5,38.3,13.3,"25% - 50% P.O.C.","$104000 or more"
"36059519500","Census Tract 5195, Nassau County, New York",6413,127390,3890,0,0,1827,0,665,60.7,0,0,28.5,0,10.4,39.3,1983,1849,134,93.24,6.76,280,1569,14,120,294,1689,15.1,10.4,14.8,"25% - 50% P.O.C.","$104000 or more"
"36059519601","Census Tract 5196.01, Nassau County, New York",4297,129779,3287,10,0,805,0,148,76.5,0.2,0,18.7,0,3.4,23.5,1532,1487,45,97.06,2.94,103,1384,0,45,103,1429,6.9,0,6.7,"Less than 25% P.O.C.","$104000 or more"
"36059519602","Census Tract 5196.02, Nassau County, New York",1962,174022,1512,0,0,387,0,30,77.1,0,0,19.7,0,1.5,22.9,686,666,20,97.08,2.92,40,626,0,20,40,646,6,0,5.8,"Less than 25% P.O.C.","$104000 or more"
"36059519702","Census Tract 5197.02, Nassau County, New York",5518,160128,4627,43,0,582,0,266,83.9,0.8,0,10.5,0,4.8,16.1,2012,1744,268,86.68,13.32,147,1597,0,268,147,1865,8.4,0,7.3,"Less than 25% P.O.C.","$104000 or more"
"36059519703","Census Tract 5197.03, Nassau County, New York",3674,159405,2664,10,0,668,0,217,72.5,0.3,0,18.2,0,5.9,27.5,1186,1138,48,95.95,4.05,156,982,0,48,156,1030,13.7,0,13.2,"25% - 50% P.O.C.","$104000 or more"
"36059519704","Census Tract 5197.04, Nassau County, New York",3092,133750,2210,0,0,631,0,181,71.5,0,0,20.4,0,5.9,28.5,1151,959,192,83.32,16.68,74,885,31,161,105,1046,7.7,16.1,9.1,"25% - 50% P.O.C.","$104000 or more"
"36059519801","Census Tract 5198.01, Nassau County, New York",2524,135536,1889,0,0,413,0,131,74.8,0,0,16.4,0,5.2,25.2,813,665,148,81.8,18.2,92,573,23,125,115,698,13.8,15.5,14.1,"25% - 50% P.O.C.","$104000 or more"
"36059519802","Census Tract 5198.02, Nassau County, New York",5386,149167,4281,66,16,762,0,182,79.5,1.2,0.3,14.1,0,3.4,20.5,1700,1529,171,89.94,10.06,249,1280,12,159,261,1439,16.3,7,15.4,"Less than 25% P.O.C.","$104000 or more"
"36059519900","Census Tract 5199, Nassau County, New York",5490,151324,4621,53,0,477,0,329,84.2,1,0,8.7,0,6,15.8,1826,1718,108,94.09,5.91,171,1547,0,108,171,1655,10,0,9.4,"Less than 25% P.O.C.","$104000 or more"
"36059520001","Census Tract 5200.01, Nassau County, New York",7471,107629,5868,19,132,628,0,801,78.5,0.3,1.8,8.4,0,10.7,21.5,2683,2424,259,90.35,9.65,243,2181,55,204,298,2385,10,21.2,11.1,"Less than 25% P.O.C.","$104000 or more"
"36059520002","Census Tract 5200.02, Nassau County, New York",4666,118310,3437,102,0,337,0,742,73.7,2.2,0,7.2,0,15.9,26.3,1524,1313,211,86.15,13.85,171,1142,34,177,205,1319,13,16.1,13.5,"25% - 50% P.O.C.","$104000 or more"
"36059520100","Census Tract 5201, Nassau County, New York",5283,117857,4507,22,0,468,0,222,85.3,0.4,0,8.9,0,4.2,14.7,1824,1653,171,90.62,9.38,185,1468,13,158,198,1626,11.2,7.6,10.9,"Less than 25% P.O.C.","$104000 or more"
"36059520200","Census Tract 5202, Nassau County, New York",3290,123239,2361,0,0,469,0,440,71.8,0,0,14.3,0,13.4,28.2,1039,942,97,90.66,9.34,91,851,0,97,91,948,9.7,0,8.8,"25% - 50% P.O.C.","$104000 or more"
"36059520300","Census Tract 5203, Nassau County, New York",5685,124219,4555,42,0,455,0,518,80.1,0.7,0,8,0,9.1,19.9,1911,1729,182,90.48,9.52,199,1530,0,182,199,1712,11.5,0,10.4,"Less than 25% P.O.C.","$104000 or more"
"36059520401","Census Tract 5204.01, Nassau County, New York",4448,97179,3286,158,7,406,0,553,73.9,3.6,0.2,9.1,0,12.4,26.1,1928,1352,576,70.12,29.88,109,1243,13,563,122,1806,8.1,2.3,6.3,"25% - 50% P.O.C.","$78000 - $104000"
"36059520402","Census Tract 5204.02, Nassau County, New York",4454,93750,3430,180,0,372,0,315,77,4,0,8.4,0,7.1,23,1845,1210,635,65.58,34.42,108,1102,57,578,165,1680,8.9,9,8.9,"Less than 25% P.O.C.","$78000 - $104000"
"36059520501","Census Tract 5205.01, Nassau County, New York",3775,115769,2885,73,0,367,0,426,76.4,1.9,0,9.7,0,11.3,23.6,1244,1096,148,88.1,11.9,168,928,47,101,215,1029,15.3,31.8,17.3,"Less than 25% P.O.C.","$104000 or more"
"36059520502","Census Tract 5205.02, Nassau County, New York",5489,127788,4905,25,0,237,0,257,89.4,0.5,0,4.3,0,4.7,10.6,1815,1694,121,93.33,6.67,188,1506,0,121,188,1627,11.1,0,10.4,"Less than 25% P.O.C.","$104000 or more"
"36059520600","Census Tract 5206, Nassau County, New York",5965,127567,4271,130,0,266,0,1146,71.6,2.2,0,4.5,0,19.2,28.4,1983,1822,161,91.88,8.12,276,1546,12,149,288,1695,15.1,7.5,14.5,"25% - 50% P.O.C.","$104000 or more"
"36059520700","Census Tract 5207, Nassau County, New York",4876,119516,4505,87,0,158,0,119,92.4,1.8,0,3.2,0,2.4,7.6,1606,1554,52,96.76,3.24,232,1322,0,52,232,1374,14.9,0,14.4,"Less than 25% P.O.C.","$104000 or more"
"36059520800","Census Tract 5208, Nassau County, New York",4092,116893,3768,33,0,56,0,225,92.1,0.8,0,1.4,0,5.5,7.9,1287,1257,30,97.67,2.33,202,1055,0,30,202,1085,16.1,0,15.7,"Less than 25% P.O.C.","$104000 or more"
"36059520900","Census Tract 5209, Nassau County, New York",4796,126827,4453,1,0,0,0,272,92.8,0,0,0,0,5.7,7.2,1591,1539,52,96.73,3.27,130,1409,0,52,130,1461,8.4,0,8.2,"Less than 25% P.O.C.","$104000 or more"
"36059521000","Census Tract 5210, Nassau County, New York",4741,116595,4320,0,0,102,0,225,91.1,0,0,2.2,0,4.7,8.9,1629,1546,83,94.9,5.1,215,1331,0,83,215,1414,13.9,0,13.2,"Less than 25% P.O.C.","$104000 or more"
"36059521100","Census Tract 5211, Nassau County, New York",4622,152961,4301,0,0,23,0,298,93.1,0,0,0.5,0,6.4,6.9,1477,1427,50,96.61,3.39,208,1219,9,41,217,1260,14.6,18,14.7,"Less than 25% P.O.C.","$104000 or more"
"36059521200","Census Tract 5212, Nassau County, New York",2935,127260,2746,53,0,19,0,93,93.6,1.8,0,0.6,0,3.2,6.4,981,900,81,91.74,8.26,90,810,20,61,110,871,10,24.7,11.2,"Less than 25% P.O.C.","$104000 or more"
"36059521301","Census Tract 5213.01, Nassau County, New York",2221,119444,2044,26,0,14,0,137,92,1.2,0,0.6,0,6.2,8,746,724,22,97.05,2.95,53,671,0,22,53,693,7.3,0,7.1,"Less than 25% P.O.C.","$104000 or more"
"36059521302","Census Tract 5213.02, Nassau County, New York",5493,137692,4813,0,51,51,0,544,87.6,0,0.9,0.9,0,9.9,12.4,1846,1787,59,96.8,3.2,221,1566,0,59,221,1625,12.4,0,12,"Less than 25% P.O.C.","$104000 or more"
"36059521400","Census Tract 5214, Nassau County, New York",6513,114766,6260,1,0,57,0,159,96.1,0,0,0.9,0,2.4,3.9,2209,2168,41,98.14,1.86,237,1931,0,41,237,1972,10.9,0,10.7,"Less than 25% P.O.C.","$104000 or more"
"36059521500","Census Tract 5215, Nassau County, New York",5063,129444,4156,0,0,153,0,573,82.1,0,0,3,0,11.3,17.9,1616,1542,74,95.42,4.58,189,1353,21,53,210,1406,12.3,28.4,13,"Less than 25% P.O.C.","$104000 or more"
"36059521601","Census Tract 5216.01, Nassau County, New York",4324,127250,4062,30,0,53,0,141,93.9,0.7,0,1.2,0,3.3,6.1,1400,1359,41,97.07,2.93,210,1149,0,41,210,1190,15.5,0,15,"Less than 25% P.O.C.","$104000 or more"
"36059521602","Census Tract 5216.02, Nassau County, New York",3291,137153,3037,0,0,136,0,103,92.3,0,0,4.1,0,3.1,7.7,1105,1099,6,99.46,0.54,118,981,0,6,118,987,10.7,0,10.7,"Less than 25% P.O.C.","$104000 or more"
"36059521700","Census Tract 5217, Nassau County, New York",4515,128438,4013,3,0,45,0,454,88.9,0.1,0,1,0,10.1,11.1,1629,1629,0,100,0,56,1573,0,0,56,1573,3.4,NA,3.4,"Less than 25% P.O.C.","$104000 or more"
"36059521801","Census Tract 5218.01, Nassau County, New York",3633,136471,3023,2,0,49,0,526,83.2,0.1,0,1.3,0,14.5,16.8,1246,1187,59,95.26,4.74,105,1082,52,7,157,1089,8.8,88.1,12.6,"Less than 25% P.O.C.","$104000 or more"
"36059521802","Census Tract 5218.02, Nassau County, New York",4141,131875,3639,30,0,71,0,386,87.9,0.7,0,1.7,0,9.3,12.1,1257,1210,47,96.26,3.74,196,1014,25,22,221,1036,16.2,53.2,17.6,"Less than 25% P.O.C.","$104000 or more"
"36059521902","Census Tract 5219.02, Nassau County, New York",4036,171250,3907,1,0,29,0,99,96.8,0,0,0.7,0,2.5,3.2,1490,1416,74,95.03,4.97,130,1286,0,74,130,1360,9.2,0,8.7,"Less than 25% P.O.C.","$104000 or more"
"36059522000","Census Tract 5220, Nassau County, New York",5812,73207,2647,2033,0,239,16,741,45.5,35,0,4.1,0.3,12.7,54.5,2876,2185,691,75.97,24.03,181,2004,24,667,205,2671,8.3,3.5,7.1,"50% - 75% P.O.C.","$55000 - $78000"
"36059522700","Census Tract 5227, Nassau County, New York",4732,142083,4439,0,0,109,0,131,93.8,0,0,2.3,0,2.8,6.2,1600,1475,125,92.19,7.81,183,1292,29,96,212,1388,12.4,23.2,13.2,"Less than 25% P.O.C.","$104000 or more"
"36059980100","Census Tract 9801, Nassau County, New York",1009,NA,664,53,0,71,0,119,65.8,5.3,0,7,0,11.8,34.2,0,0,0,NA,NA,0,0,0,0,0,0,NA,NA,NA,"25% - 50% P.O.C.","N/A"
"36059981100","Census Tract 9811, Nassau County, New York",1053,NA,577,183,0,65,0,162,54.8,17.4,0,6.2,0,15.4,45.2,5,5,0,100,0,0,5,0,0,0,5,0,NA,0,"25% - 50% P.O.C.","N/A"
"36059982100","Census Tract 9821, Nassau County, New York",1290,NA,588,255,3,104,0,204,45.6,19.8,0.2,8.1,0,15.8,54.4,7,0,7,0,100,0,0,0,7,0,7,NA,0,0,"50% - 75% P.O.C.","N/A"
"36059990100","Census Tract 9901, Nassau County, New York",0,NA,0,0,0,0,0,0,NA,NA,NA,NA,NA,NA,NA,0,0,0,NA,NA,0,0,0,0,0,0,NA,NA,NA,"N/A","N/A"
"36059990200","Census Tract 9902, Nassau County, New York",0,NA,0,0,0,0,0,0,NA,NA,NA,NA,NA,NA,NA,0,0,0,NA,NA,0,0,0,0,0,0,NA,NA,NA,"N/A","N/A"
"36059990301","Census Tract 9903.01, Nassau County, New York",0,NA,0,0,0,0,0,0,NA,NA,NA,NA,NA,NA,NA,0,0,0,NA,NA,0,0,0,0,0,0,NA,NA,NA,"N/A","N/A"
"36059990302","Census Tract 9903.02, Nassau County, New York",0,NA,0,0,0,0,0,0,NA,NA,NA,NA,NA,NA,NA,0,0,0,NA,NA,0,0,0,0,0,0,NA,NA,NA,"N/A","N/A"
"36059990400","Census Tract 9904, Nassau County, New York",0,NA,0,0,0,0,0,0,NA,NA,NA,NA,NA,NA,NA,0,0,0,NA,NA,0,0,0,0,0,0,NA,NA,NA,"N/A","N/A"
"36061000100","Census Tract 1, New York County, New York",0,NA,0,0,0,0,0,0,NA,NA,NA,NA,NA,NA,NA,0,0,0,NA,NA,0,0,0,0,0,0,NA,NA,NA,"N/A","N/A"
"36061000201","Census Tract 2.01, New York County, New York",2750,29500,288,182,0,1173,0,1105,10.5,6.6,0,42.7,0,40.2,89.5,1092,0,1092,0,100,0,0,126,966,126,966,NA,11.5,11.5,"75% or more P.O.C.","Less than $55000"
"36061000202","Census Tract 2.02, New York County, New York",7773,35466,1543,1550,47,1494,0,3038,19.9,19.9,0.6,19.2,0,39.1,80.1,3389,808,2581,23.84,76.16,19,789,41,2540,60,3329,2.4,1.6,1.8,"75% or more P.O.C.","Less than $55000"
"36061000500","Census Tract 5, New York County, New York",0,NA,0,0,0,0,0,0,NA,NA,NA,NA,NA,NA,NA,0,0,0,NA,NA,0,0,0,0,0,0,NA,NA,NA,"N/A","N/A"
"36061000600","Census Tract 6, New York County, New York",9838,16600,460,715,86,5789,0,2788,4.7,7.3,0.9,58.8,0,28.3,95.3,4049,168,3881,4.15,95.85,14,154,240,3641,254,3795,8.3,6.2,6.3,"75% or more P.O.C.","Less than $55000"
"36061000700","Census Tract 7, New York County, New York",8501,184609,6212,70,0,1623,0,441,73.1,0.8,0,19.1,0,5.2,26.9,4391,997,3394,22.71,77.29,0,997,0,3394,0,4391,0,0,0,"25% - 50% P.O.C.","$104000 or more"
"36061000800","Census Tract 8, New York County, New York",9315,33487,682,8,66,7994,22,412,7.3,0.1,0.7,85.8,0.2,4.4,92.7,3706,120,3586,3.24,96.76,12,108,248,3338,260,3446,10,6.9,7,"75% or more P.O.C.","Less than $55000"
"36061000900","Census Tract 9, New York County, New York",1796,206750,1144,78,0,328,17,166,63.7,4.3,0,18.3,0.9,9.2,36.3,809,146,663,18.05,81.95,9,137,4,659,13,796,6.2,0.6,1.6,"25% - 50% P.O.C.","$104000 or more"
"36061001001","Census Tract 10.01, New York County, New York",1546,81250,1075,18,0,176,0,260,69.5,1.2,0,11.4,0,16.8,30.5,842,506,336,60.1,39.9,20,486,0,336,20,822,4,0,2.4,"25% - 50% P.O.C.","$78000 - $104000"
"36061001002","Census Tract 10.02, New York County, New York",5157,23230,94,730,0,971,0,3303,1.8,14.2,0,18.8,0,64,98.2,2479,0,2479,0,100,0,0,140,2339,140,2339,NA,5.6,5.6,"75% or more P.O.C.","Less than $55000"
"36061001200","Census Tract 12, New York County, New York",4168,53669,2056,104,0,714,0,1210,49.3,2.5,0,17.1,0,29,50.7,1908,739,1169,38.73,61.27,56,683,8,1161,64,1844,7.6,0.7,3.4,"50% - 75% P.O.C.","Less than $55000"
"36061001300","Census Tract 13, New York County, New York",4455,171173,2789,175,0,785,0,420,62.6,3.9,0,17.6,0,9.4,37.4,2578,468,2110,18.15,81.85,0,468,27,2083,27,2551,0,1.3,1,"25% - 50% P.O.C.","$104000 or more"
"36061001401","Census Tract 14.01, New York County, New York",3024,103750,2063,98,0,474,0,266,68.2,3.2,0,15.7,0,8.8,31.8,1570,1195,375,76.11,23.89,19,1176,0,375,19,1551,1.6,0,1.2,"25% - 50% P.O.C.","$78000 - $104000"
"36061001402","Census Tract 14.02, New York County, New York",2941,27355,825,163,0,881,0,929,28.1,5.5,0,30,0,31.6,71.9,1509,50,1459,3.31,96.69,0,50,21,1438,21,1488,0,1.4,1.4,"50% - 75% P.O.C.","Less than $55000"
"36061001501","Census Tract 15.01, New York County, New York",7398,101037,4434,261,51,1888,0,529,59.9,3.5,0.7,25.5,0,7.2,40.1,3724,1696,2028,45.54,54.46,77,1619,0,2028,77,3647,4.5,0,2.1,"25% - 50% P.O.C.","$78000 - $104000"
"36061001502","Census Tract 15.02, New York County, New York",8309,162158,5990,153,0,1350,0,445,72.1,1.8,0,16.2,0,5.4,27.9,3526,612,2914,17.36,82.64,13,599,60,2854,73,3453,2.1,2.1,2.1,"25% - 50% P.O.C.","$104000 or more"
"36061001600","Census Tract 16, New York County, New York",6968,46729,1164,133,0,5438,0,126,16.7,1.9,0,78,0,1.8,83.3,2957,200,2757,6.76,93.24,0,200,218,2539,218,2739,0,7.9,7.4,"75% or more P.O.C.","Less than $55000"
"36061001800","Census Tract 18, New York County, New York",6788,50568,1953,367,256,3105,0,816,28.8,5.4,3.8,45.7,0,12,71.2,2940,178,2762,6.05,93.95,0,178,61,2701,61,2879,0,2.2,2.1,"50% - 75% P.O.C.","Less than $55000"
"36061002000","Census Tract 20, New York County, New York",4586,16653,97,861,0,996,0,2561,2.1,18.8,0,21.7,0,55.8,97.9,1964,7,1957,0.36,99.64,0,7,81,1876,81,1883,0,4.1,4.1,"75% or more P.O.C.","Less than $55000"
"36061002100","Census Tract 21, New York County, New York",6666,250001,4804,379,0,678,0,666,72.1,5.7,0,10.2,0,10,27.9,2629,1107,1522,42.11,57.89,159,948,65,1457,224,2405,14.4,4.3,8.5,"25% - 50% P.O.C.","$104000 or more"
"36061002201","Census Tract 22.01, New York County, New York",6565,30703,1385,758,0,1355,0,2898,21.1,11.5,0,20.6,0,44.1,78.9,3057,325,2732,10.63,89.37,22,303,21,2711,43,3014,6.8,0.8,1.4,"75% or more P.O.C.","Less than $55000"
"36061002202","Census Tract 22.02, New York County, New York",2099,92917,1300,159,0,260,0,340,61.9,7.6,0,12.4,0,16.2,38.1,1127,42,1085,3.73,96.27,0,42,33,1052,33,1094,0,3,2.9,"25% - 50% P.O.C.","$78000 - $104000"
"36061002400","Census Tract 24, New York County, New York",4192,14144,43,641,0,545,12,2815,1,15.3,0,13,0.3,67.2,99,1850,15,1835,0.81,99.19,0,15,64,1771,64,1786,0,3.5,3.5,"75% or more P.O.C.","Less than $55000"
"36061002500","Census Tract 25, New York County, New York",5483,20868,94,1217,8,2171,0,1699,1.7,22.2,0.1,39.6,0,31,98.3,2132,0,2132,0,100,0,0,183,1949,183,1949,NA,8.6,8.6,"75% or more P.O.C.","Less than $55000"
"36061002601","Census Tract 26.01, New York County, New York",3488,45410,874,467,0,834,0,1147,25.1,13.4,0,23.9,0,32.9,74.9,1555,125,1430,8.04,91.96,0,125,53,1377,53,1502,0,3.7,3.4,"50% - 75% P.O.C.","Less than $55000"
"36061002602","Census Tract 26.02, New York County, New York",3946,76028,2312,149,40,403,0,784,58.6,3.8,1,10.2,0,19.9,41.4,2048,363,1685,17.72,82.28,0,363,8,1677,8,2040,0,0.5,0.4,"25% - 50% P.O.C.","$55000 - $78000"
"36061002700","Census Tract 27, New York County, New York",1341,62083,225,0,0,1012,0,24,16.8,0,0,75.5,0,1.8,83.2,612,310,302,50.65,49.35,36,274,0,302,36,576,11.6,0,5.9,"75% or more P.O.C.","$55000 - $78000"
"36061002800","Census Tract 28, New York County, New York",6765,44199,2234,1080,0,1037,0,2289,33,16,0,15.3,0,33.8,67,3385,320,3065,9.45,90.55,0,320,97,2968,97,3288,0,3.2,2.9,"50% - 75% P.O.C.","Less than $55000"
"36061002900","Census Tract 29, New York County, New York",5924,27908,914,601,46,3473,0,583,15.4,10.1,0.8,58.6,0,9.8,84.6,2202,194,2008,8.81,91.19,0,194,70,1938,70,2132,0,3.5,3.2,"75% or more P.O.C.","Less than $55000"
"36061003001","Census Tract 30.01, New York County, New York",3815,70057,2084,214,0,530,0,747,54.6,5.6,0,13.9,0,19.6,45.4,2237,63,2174,2.82,97.18,0,63,0,2174,0,2237,0,0,0,"25% - 50% P.O.C.","$55000 - $78000"
"36061003002","Census Tract 30.02, New York County, New York",2939,63750,1608,150,0,368,0,760,54.7,5.1,0,12.5,0,25.9,45.3,1658,171,1487,10.31,89.69,6,165,0,1487,6,1652,3.5,0,0.4,"25% - 50% P.O.C.","$55000 - $78000"
"36061003100","Census Tract 31, New York County, New York",2525,166786,1370,238,0,602,0,247,54.3,9.4,0,23.8,0,9.8,45.7,730,218,512,29.86,70.14,0,218,0,512,0,730,0,0,0,"25% - 50% P.O.C.","$104000 or more"
"36061003200","Census Tract 32, New York County, New York",7814,66648,5618,392,0,917,0,812,71.9,5,0,11.7,0,10.4,28.1,4672,550,4122,11.77,88.23,17,533,0,4122,17,4655,3.1,0,0.4,"25% - 50% P.O.C.","$55000 - $78000"
"36061003300","Census Tract 33, New York County, New York",5224,223438,3996,107,0,698,0,228,76.5,2,0,13.4,0,4.4,23.5,2428,907,1521,37.36,62.64,51,856,48,1473,99,2329,5.6,3.2,4.1,"Less than 25% P.O.C.","$104000 or more"
"36061003400","Census Tract 34, New York County, New York",6569,81541,3894,210,0,771,0,1506,59.3,3.2,0,11.7,0,22.9,40.7,3700,251,3449,6.78,93.22,0,251,38,3411,38,3662,0,1.1,1,"25% - 50% P.O.C.","$78000 - $104000"
"36061003601","Census Tract 36.01, New York County, New York",3132,46500,716,198,0,842,0,1302,22.9,6.3,0,26.9,0,41.6,77.1,1440,167,1273,11.6,88.4,36,131,21,1252,57,1383,21.6,1.6,4,"75% or more P.O.C.","Less than $55000"
"36061003602","Census Tract 36.02, New York County, New York",3212,88594,1996,313,30,378,0,435,62.1,9.7,0.9,11.8,0,13.5,37.9,1421,179,1242,12.6,87.4,0,179,16,1226,16,1405,0,1.3,1.1,"25% - 50% P.O.C.","$78000 - $104000"
"36061003700","Census Tract 37, New York County, New York",2666,159514,2194,44,0,161,0,120,82.3,1.7,0,6,0,4.5,17.7,1385,631,754,45.56,54.44,7,624,12,742,19,1366,1.1,1.6,1.4,"Less than 25% P.O.C.","$104000 or more"
"36061003800","Census Tract 38, New York County, New York",8927,67036,5325,1263,4,1288,0,993,59.7,14.1,0,14.4,0,11.1,40.3,4891,261,4630,5.34,94.66,0,261,0,4630,0,4891,0,0,0,"25% - 50% P.O.C.","$55000 - $78000"
"36061003900","Census Tract 39, New York County, New York",6931,207064,5380,239,0,480,0,558,77.6,3.4,0,6.9,0,8.1,22.4,2889,1091,1798,37.76,62.24,73,1018,35,1763,108,2781,6.7,1.9,3.7,"Less than 25% P.O.C.","$104000 or more"
"36061004000","Census Tract 40, New York County, New York",8105,87574,5595,248,0,1071,10,786,69,3.1,0,13.2,0.1,9.7,31,4022,529,3493,13.15,86.85,0,529,0,3493,0,4022,0,0,0,"25% - 50% P.O.C.","$78000 - $104000"
"36061004100","Census Tract 41, New York County, New York",7997,85000,2721,55,44,4568,0,416,34,0.7,0.6,57.1,0,5.2,66,3380,196,3184,5.8,94.2,0,196,95,3089,95,3285,0,3,2.8,"50% - 75% P.O.C.","$78000 - $104000"
"36061004200","Census Tract 42, New York County, New York",5384,148839,3203,308,0,1200,0,525,59.5,5.7,0,22.3,0,9.8,40.5,1610,506,1104,31.43,68.57,0,506,0,1104,0,1610,0,0,0,"25% - 50% P.O.C.","$104000 or more"
"36061004300","Census Tract 43, New York County, New York",3968,74877,2170,20,0,984,0,705,54.7,0.5,0,24.8,0,17.8,45.3,2109,371,1738,17.59,82.41,0,371,0,1738,0,2109,0,0,0,"25% - 50% P.O.C.","$55000 - $78000"
"36061004400","Census Tract 44, New York County, New York",16594,104520,12087,744,0,2103,0,1207,72.8,4.5,0,12.7,0,7.3,27.2,8089,0,8089,0,100,0,0,0,8089,0,8089,NA,0,0,"25% - 50% P.O.C.","$104000 or more"
"36061004500","Census Tract 45, New York County, New York",980,107708,626,5,0,238,0,69,63.9,0.5,0,24.3,0,7,36.1,405,170,235,41.98,58.02,12,158,7,228,19,386,7.1,3,4.7,"25% - 50% P.O.C.","$104000 or more"
"36061004700","Census Tract 47, New York County, New York",2474,123707,1736,10,0,477,0,152,70.2,0.4,0,19.3,0,6.1,29.8,1342,448,894,33.38,66.62,10,438,15,879,25,1317,2.2,1.7,1.9,"25% - 50% P.O.C.","$104000 or more"
"36061004800","Census Tract 48, New York County, New York",6230,147500,4472,185,0,904,63,472,71.8,3,0,14.5,1,7.6,28.2,2964,1556,1408,52.5,47.5,36,1520,0,1408,36,2928,2.3,0,1.2,"25% - 50% P.O.C.","$104000 or more"
"36061004900","Census Tract 49, New York County, New York",4404,96287,3448,116,0,436,0,338,78.3,2.6,0,9.9,0,7.7,21.7,2665,546,2119,20.49,79.51,48,498,0,2119,48,2617,8.8,0,1.8,"Less than 25% P.O.C.","$78000 - $104000"
"36061005000","Census Tract 50, New York County, New York",4748,130938,3643,53,0,875,0,138,76.7,1.1,0,18.4,0,2.9,23.3,2837,1310,1527,46.18,53.82,0,1310,16,1511,16,2821,0,1,0.6,"Less than 25% P.O.C.","$104000 or more"
"36061005200","Census Tract 52, New York County, New York",3321,166094,2387,94,17,575,0,163,71.9,2.8,0.5,17.3,0,4.9,28.1,1369,790,579,57.71,42.29,16,774,9,570,25,1344,2,1.6,1.8,"25% - 50% P.O.C.","$104000 or more"
"36061005400","Census Tract 54, New York County, New York",4768,173309,3625,185,0,606,0,193,76,3.9,0,12.7,0,4,24,2674,1337,1337,50,50,24,1313,0,1337,24,2650,1.8,0,0.9,"Less than 25% P.O.C.","$104000 or more"
"36061005501","Census Tract 55.01, New York County, New York",4727,161004,3103,212,0,931,0,166,65.6,4.5,0,19.7,0,3.5,34.4,2113,535,1578,25.32,74.68,0,535,38,1540,38,2075,0,2.4,1.8,"25% - 50% P.O.C.","$104000 or more"
"36061005502","Census Tract 55.02, New York County, New York",1825,126332,1503,59,0,41,0,134,82.4,3.2,0,2.2,0,7.3,17.6,969,332,637,34.26,65.74,17,315,0,637,17,952,5.1,0,1.8,"Less than 25% P.O.C.","$104000 or more"
"36061005600","Census Tract 56, New York County, New York",4250,145000,3160,196,0,457,0,354,74.4,4.6,0,10.8,0,8.3,25.6,2246,860,1386,38.29,61.71,22,838,0,1386,22,2224,2.6,0,1,"25% - 50% P.O.C.","$104000 or more"
"36061005700","Census Tract 57, New York County, New York",2756,183810,2374,57,0,167,0,27,86.1,2.1,0,6.1,0,1,13.9,1556,729,827,46.85,53.15,0,729,0,827,0,1556,0,0,0,"Less than 25% P.O.C.","$104000 or more"
"36061005800","Census Tract 58, New York County, New York",4315,207708,2833,0,0,698,0,447,65.7,0,0,16.2,0,10.4,34.3,2407,233,2174,9.68,90.32,13,220,8,2166,21,2386,5.6,0.4,0.9,"25% - 50% P.O.C.","$104000 or more"
"36061005900","Census Tract 59, New York County, New York",5404,127917,4305,121,0,536,0,374,79.7,2.2,0,9.9,0,6.9,20.3,2773,1765,1008,63.65,36.35,0,1765,0,1008,0,2773,0,0,0,"Less than 25% P.O.C.","$104000 or more"
"36061006000","Census Tract 60, New York County, New York",5741,169778,4033,252,0,643,0,588,70.2,4.4,0,11.2,0,10.2,29.8,2412,0,2412,0,100,0,0,47,2365,47,2365,NA,1.9,1.9,"25% - 50% P.O.C.","$104000 or more"
"36061006100","Census Tract 61, New York County, New York",4747,210726,3180,274,0,716,0,506,67,5.8,0,15.1,0,10.7,33,2075,950,1125,45.78,54.22,0,950,0,1125,0,2075,0,0,0,"25% - 50% P.O.C.","$104000 or more"
"36061006200","Census Tract 62, New York County, New York",4444,87500,1874,941,6,890,0,538,42.2,21.2,0.1,20,0,12.1,57.8,1480,6,1474,0.41,99.59,0,6,43,1431,43,1437,0,2.9,2.9,"50% - 75% P.O.C.","$78000 - $104000"
"36061006300","Census Tract 63, New York County, New York",6393,156975,5359,67,0,435,0,300,83.8,1,0,6.8,0,4.7,16.2,3359,1753,1606,52.19,47.81,73,1680,16,1590,89,3270,4.2,1,2.6,"Less than 25% P.O.C.","$104000 or more"
"36061006400","Census Tract 64, New York County, New York",7643,111074,5553,102,0,1218,0,480,72.7,1.3,0,15.9,0,6.3,27.3,4403,1337,3066,30.37,69.63,0,1337,114,2952,114,4289,0,3.7,2.6,"25% - 50% P.O.C.","$104000 or more"
"36061006500","Census Tract 65, New York County, New York",6337,106944,4839,164,0,798,0,450,76.4,2.6,0,12.6,0,7.1,23.6,3122,344,2778,11.02,88.98,0,344,0,2778,0,3122,0,0,0,"Less than 25% P.O.C.","$104000 or more"
"36061006600","Census Tract 66, New York County, New York",11839,80797,6043,1377,0,2166,0,1924,51,11.6,0,18.3,0,16.3,49,6452,2057,4395,31.88,68.12,134,1923,321,4074,455,5997,6.5,7.3,7.1,"25% - 50% P.O.C.","$78000 - $104000"
"36061006700","Census Tract 67, New York County, New York",5431,107908,4532,55,0,217,0,400,83.4,1,0,4,0,7.4,16.6,3489,909,2580,26.05,73.95,0,909,20,2560,20,3469,0,0.8,0.6,"Less than 25% P.O.C.","$104000 or more"
"36061006800","Census Tract 68, New York County, New York",7876,128491,4793,777,0,1408,0,893,60.9,9.9,0,17.9,0,11.3,39.1,3591,1419,2172,39.52,60.48,0,1419,0,2172,0,3591,0,0,0,"25% - 50% P.O.C.","$104000 or more"
"36061006900","Census Tract 69, New York County, New York",2485,250001,1933,24,0,248,0,195,77.8,1,0,10,0,7.8,22.2,1117,455,662,40.73,59.27,31,424,0,662,31,1086,6.8,0,2.8,"Less than 25% P.O.C.","$104000 or more"
"36061007000","Census Tract 70, New York County, New York",8301,109470,5497,669,0,1528,0,488,66.2,8.1,0,18.4,0,5.9,33.8,4811,1031,3780,21.43,78.57,80,951,0,3780,80,4731,7.8,0,1.7,"25% - 50% P.O.C.","$104000 or more"
"36061007100","Census Tract 71, New York County, New York",5530,160614,4554,191,0,342,5,217,82.4,3.5,0,6.2,0.1,3.9,17.6,3111,1314,1797,42.24,57.76,48,1266,11,1786,59,3052,3.7,0.6,1.9,"Less than 25% P.O.C.","$104000 or more"
"36061007200","Census Tract 72, New York County, New York",7642,123066,5205,113,0,1965,0,300,68.1,1.5,0,25.7,0,3.9,31.9,4039,980,3059,24.26,75.74,20,960,32,3027,52,3987,2,1,1.3,"25% - 50% P.O.C.","$104000 or more"
"36061007300","Census Tract 73, New York County, New York",5759,119926,5036,56,0,231,0,436,87.4,1,0,4,0,7.6,12.6,3561,802,2759,22.52,77.48,0,802,51,2708,51,3510,0,1.8,1.4,"Less than 25% P.O.C.","$104000 or more"
"36061007400","Census Tract 74, New York County, New York",4528,156964,3186,104,0,715,0,292,70.4,2.3,0,15.8,0,6.4,29.6,2394,809,1585,33.79,66.21,16,793,0,1585,16,2378,2,0,0.7,"25% - 50% P.O.C.","$104000 or more"
"36061007500","Census Tract 75, New York County, New York",3603,137449,2782,88,0,184,0,243,77.2,2.4,0,5.1,0,6.7,22.8,2249,1079,1170,47.98,52.02,0,1079,0,1170,0,2249,0,0,0,"Less than 25% P.O.C.","$104000 or more"
"36061007600","Census Tract 76, New York County, New York",2092,100809,1053,57,0,797,0,155,50.3,2.7,0,38.1,0,7.4,49.7,1181,173,1008,14.65,85.35,0,173,0,1008,0,1181,0,0,0,"25% - 50% P.O.C.","$78000 - $104000"
"36061007700","Census Tract 77, New York County, New York",5971,139815,4901,77,0,244,0,450,82.1,1.3,0,4.1,0,7.5,17.9,3634,1094,2540,30.1,69.9,44,1050,0,2540,44,3590,4,0,1.2,"Less than 25% P.O.C.","$104000 or more"
"36061007800","Census Tract 78, New York County, New York",9422,133778,5573,320,0,2118,0,1012,59.1,3.4,0,22.5,0,10.7,40.9,4766,1406,3360,29.5,70.5,0,1406,92,3268,92,4674,0,2.7,1.9,"25% - 50% P.O.C.","$104000 or more"
"36061007900","Census Tract 79, New York County, New York",4425,92788,3724,15,0,223,0,302,84.2,0.3,0,5,0,6.8,15.8,2475,889,1586,35.92,64.08,95,794,0,1586,95,2380,10.7,0,3.8,"Less than 25% P.O.C.","$78000 - $104000"
"36061008000","Census Tract 80, New York County, New York",4964,133960,3764,61,14,683,0,312,75.8,1.2,0.3,13.8,0,6.3,24.2,2978,1665,1313,55.91,44.09,37,1628,0,1313,37,2941,2.2,0,1.2,"Less than 25% P.O.C.","$104000 or more"
"36061008100","Census Tract 81, New York County, New York",7481,137070,5306,257,0,562,0,1199,70.9,3.4,0,7.5,0,16,29.1,4551,1483,3068,32.59,67.41,0,1483,0,3068,0,4551,0,0,0,"25% - 50% P.O.C.","$104000 or more"
"36061008200","Census Tract 82, New York County, New York",3241,141141,2008,77,16,676,0,333,62,2.4,0.5,20.9,0,10.3,38,2011,858,1153,42.67,57.33,0,858,23,1130,23,1988,0,2,1.1,"25% - 50% P.O.C.","$104000 or more"
"36061008300","Census Tract 83, New York County, New York",3686,80221,1682,287,0,410,0,1197,45.6,7.8,0,11.1,0,32.5,54.4,2054,341,1713,16.6,83.4,15,326,8,1705,23,2031,4.4,0.5,1.1,"50% - 75% P.O.C.","$78000 - $104000"
"36061008400","Census Tract 84, New York County, New York",1746,158750,918,32,0,629,0,143,52.6,1.8,0,36,0,8.2,47.4,884,220,664,24.89,75.11,0,220,0,664,0,884,0,0,0,"25% - 50% P.O.C.","$104000 or more"
"36061008601","Census Tract 86.01, New York County, New York",2915,158125,1973,62,11,702,0,112,67.7,2.1,0.4,24.1,0,3.8,32.3,1313,362,951,27.57,72.43,9,353,28,923,37,1276,2.5,2.9,2.8,"25% - 50% P.O.C.","$104000 or more"
"36061008602","Census Tract 86.02, New York County, New York",0,NA,0,0,0,0,0,0,NA,NA,NA,NA,NA,NA,NA,0,0,0,NA,NA,0,0,0,0,0,0,NA,NA,NA,"N/A","N/A"
"36061008603","Census Tract 86.03, New York County, New York",4400,170781,3320,18,18,448,0,467,75.5,0.4,0.4,10.2,0,10.6,24.5,2444,1633,811,66.82,33.18,9,1624,32,779,41,2403,0.6,3.9,1.7,"Less than 25% P.O.C.","$104000 or more"
"36061008700","Census Tract 87, New York County, New York",6556,177188,4864,118,0,624,0,685,74.2,1.8,0,9.5,0,10.4,25.8,3987,1368,2619,34.31,65.69,0,1368,20,2599,20,3967,0,0.8,0.5,"25% - 50% P.O.C.","$104000 or more"
"36061008800","Census Tract 88, New York County, New York",7416,126788,4868,104,0,1842,0,286,65.6,1.4,0,24.8,0,3.9,34.4,4395,2169,2226,49.35,50.65,30,2139,61,2165,91,4304,1.4,2.7,2.1,"25% - 50% P.O.C.","$104000 or more"
"36061008900","Census Tract 89, New York County, New York",5413,106207,3334,168,0,533,0,1278,61.6,3.1,0,9.8,0,23.6,38.4,2878,879,1999,30.54,69.46,11,868,64,1935,75,2803,1.3,3.2,2.6,"25% - 50% P.O.C.","$104000 or more"
"36061009000","Census Tract 90, New York County, New York",7633,135734,5147,218,0,1701,0,482,67.4,2.9,0,22.3,0,6.3,32.6,4592,1591,3001,34.65,65.35,25,1566,43,2958,68,4524,1.6,1.4,1.5,"25% - 50% P.O.C.","$104000 or more"
"36061009100","Census Tract 91, New York County, New York",6298,150349,4610,338,0,937,0,343,73.2,5.4,0,14.9,0,5.4,26.8,3820,1194,2626,31.26,68.74,0,1194,28,2598,28,3792,0,1.1,0.7,"25% - 50% P.O.C.","$104000 or more"
"36061009200","Census Tract 92, New York County, New York",1474,138971,986,21,0,358,0,61,66.9,1.4,0,24.3,0,4.1,33.1,1012,161,851,15.91,84.09,0,161,0,851,0,1012,0,0,0,"25% - 50% P.O.C.","$104000 or more"
"36061009300","Census Tract 93, New York County, New York",9440,76933,5115,617,0,1585,0,1755,54.2,6.5,0,16.8,0,18.6,45.8,5226,2132,3094,40.8,59.2,96,2036,127,2967,223,5003,4.5,4.1,4.3,"25% - 50% P.O.C.","$55000 - $78000"
"36061009400","Census Tract 94, New York County, New York",71,150893,66,0,0,5,0,0,93,0,0,7,0,0,7,54,5,49,9.26,90.74,0,5,0,49,0,54,0,0,0,"Less than 25% P.O.C.","$104000 or more"
"36061009500","Census Tract 95, New York County, New York",3142,153264,2422,84,16,343,0,260,77.1,2.7,0.5,10.9,0,8.3,22.9,1229,470,759,38.24,61.76,0,470,12,747,12,1217,0,1.6,1,"Less than 25% P.O.C.","$104000 or more"
"36061009600","Census Tract 96, New York County, New York",177,130500,118,0,0,51,0,8,66.7,0,0,28.8,0,4.5,33.3,128,16,112,12.5,87.5,0,16,0,112,0,128,0,0,0,"25% - 50% P.O.C.","$104000 or more"
"36061009700","Census Tract 97, New York County, New York",4968,61534,2375,444,0,961,0,1154,47.8,8.9,0,19.3,0,23.2,52.2,2833,1499,1334,52.91,47.09,9,1490,43,1291,52,2781,0.6,3.2,1.8,"50% - 75% P.O.C.","$55000 - $78000"
"36061009800","Census Tract 98, New York County, New York",7302,129167,5510,153,10,791,0,718,75.5,2.1,0.1,10.8,0,9.8,24.5,4242,1635,2607,38.54,61.46,26,1609,21,2586,47,4195,1.6,0.8,1.1,"Less than 25% P.O.C.","$104000 or more"
"36061009900","Census Tract 99, New York County, New York",5981,141672,3818,327,0,933,0,727,63.8,5.5,0,15.6,0,12.2,36.2,3573,304,3269,8.51,91.49,19,285,56,3213,75,3498,6.2,1.7,2.1,"25% - 50% P.O.C.","$104000 or more"
"36061010000","Census Tract 100, New York County, New York",1741,95879,1150,28,0,394,0,103,66.1,1.6,0,22.6,0,5.9,33.9,1145,269,876,23.49,76.51,6,263,0,876,6,1139,2.2,0,0.5,"25% - 50% P.O.C.","$78000 - $104000"
"36061010100","Census Tract 101, New York County, New York",1373,133409,562,78,0,430,0,270,40.9,5.7,0,31.3,0,19.7,59.1,824,10,814,1.21,98.79,0,10,3,811,3,821,0,0.4,0.4,"50% - 75% P.O.C.","$104000 or more"
"36061010200","Census Tract 102, New York County, New York",122,NA,67,7,28,2,0,14,54.9,5.7,23,1.6,0,11.5,45.1,66,35,31,53.03,46.97,8,27,0,31,8,58,22.9,0,12.1,"25% - 50% P.O.C.","N/A"
"36061010300","Census Tract 103, New York County, New York",2065,96071,1252,123,0,475,21,118,60.6,6,0,23,1,5.7,39.4,1268,128,1140,10.09,89.91,0,128,0,1140,0,1268,0,0,0,"25% - 50% P.O.C.","$78000 - $104000"
"36061010400","Census Tract 104, New York County, New York",811,125882,511,12,0,156,16,73,63,1.5,0,19.2,2,9,37,522,282,240,54.02,45.98,0,282,4,236,4,518,0,1.7,0.8,"25% - 50% P.O.C.","$104000 or more"
"36061010601","Census Tract 106.01, New York County, New York",7091,173898,6132,0,21,722,0,154,86.5,0,0.3,10.2,0,2.2,13.5,4332,3027,1305,69.88,30.12,0,3027,0,1305,0,4332,0,0,0,"Less than 25% P.O.C.","$104000 or more"
"36061010602","Census Tract 106.02, New York County, New York",4859,166513,3549,171,0,647,0,376,73,3.5,0,13.3,0,7.7,27,2267,362,1905,15.97,84.03,8,354,30,1875,38,2229,2.2,1.6,1.7,"25% - 50% P.O.C.","$104000 or more"
"36061010800","Census Tract 108, New York County, New York",9046,163854,7313,100,0,917,0,594,80.8,1.1,0,10.1,0,6.6,19.2,4954,2012,2942,40.61,59.39,0,2012,38,2904,38,4916,0,1.3,0.8,"Less than 25% P.O.C.","$104000 or more"
"36061010900","Census Tract 109, New York County, New York",172,167750,115,11,0,28,0,13,66.9,6.4,0,16.3,0,7.6,33.1,78,25,53,32.05,67.95,5,20,0,53,5,73,20,0,6.4,"25% - 50% P.O.C.","$104000 or more"
"36061011000","Census Tract 110, New York County, New York",7499,149583,5132,264,0,1063,0,935,68.4,3.5,0,14.2,0,12.5,31.6,3995,964,3031,24.13,75.87,11,953,33,2998,44,3951,1.1,1.1,1.1,"25% - 50% P.O.C.","$104000 or more"
"36061011100","Census Tract 111, New York County, New York",4757,112917,2434,322,0,1184,0,725,51.2,6.8,0,24.9,0,15.2,48.8,2817,342,2475,12.14,87.86,0,342,17,2458,17,2800,0,0.7,0.6,"25% - 50% P.O.C.","$104000 or more"
"36061011201","Census Tract 112.01, New York County, New York",843,119750,644,21,0,114,0,58,76.4,2.5,0,13.5,0,6.9,23.6,498,108,390,21.69,78.31,0,108,6,384,6,492,0,1.5,1.2,"Less than 25% P.O.C.","$104000 or more"
"36061011202","Census Tract 112.02, New York County, New York",415,141563,341,0,0,44,0,30,82.2,0,0,10.6,0,7.2,17.8,222,162,60,72.97,27.03,0,162,0,60,0,222,0,0,0,"Less than 25% P.O.C.","$104000 or more"
"36061011203","Census Tract 112.03, New York County, New York",1103,159792,786,26,0,234,0,17,71.3,2.4,0,21.2,0,1.5,28.7,593,292,301,49.24,50.76,7,285,0,301,7,586,2.4,0,1.2,"25% - 50% P.O.C.","$104000 or more"
"36061011300","Census Tract 113, New York County, New York",98,95313,15,38,0,33,0,0,15.3,38.8,0,33.7,0,0,84.7,53,25,28,47.17,52.83,0,25,0,28,0,53,0,0,0,"75% or more P.O.C.","$78000 - $104000"
"36061011401","Census Tract 114.01, New York County, New York",1173,250001,996,7,0,51,0,81,84.9,0.6,0,4.3,0,6.9,15.1,643,402,241,62.52,37.48,0,402,6,235,6,637,0,2.5,0.9,"Less than 25% P.O.C.","$104000 or more"
"36061011402","Census Tract 114.02, New York County, New York",1880,152171,1488,11,0,154,0,117,79.1,0.6,0,8.2,0,6.2,20.9,1062,769,293,72.41,27.59,18,751,8,285,26,1036,2.3,2.7,2.4,"Less than 25% P.O.C.","$104000 or more"
"36061011500","Census Tract 115, New York County, New York",3663,110845,1203,212,31,1253,0,864,32.8,5.8,0.8,34.2,0,23.6,67.2,1886,323,1563,17.13,82.87,0,323,31,1532,31,1855,0,2,1.6,"50% - 75% P.O.C.","$104000 or more"
"36061011600","Census Tract 116, New York County, New York",3540,92426,2507,61,0,584,0,310,70.8,1.7,0,16.5,0,8.8,29.2,1751,372,1379,21.25,78.75,0,372,106,1273,106,1645,0,7.7,6.1,"25% - 50% P.O.C.","$78000 - $104000"
"36061011700","Census Tract 117, New York County, New York",4191,159671,2252,385,0,809,0,703,53.7,9.2,0,19.3,0,16.8,46.3,2723,0,2723,0,100,0,0,15,2708,15,2708,NA,0.6,0.6,"25% - 50% P.O.C.","$104000 or more"
"36061011800","Census Tract 118, New York County, New York",8986,141667,7195,31,0,1180,0,542,80.1,0.3,0,13.1,0,6,19.9,4838,1595,3243,32.97,67.03,69,1526,0,3243,69,4769,4.3,0,1.4,"Less than 25% P.O.C.","$104000 or more"
"36061011900","Census Tract 119, New York County, New York",1071,17568,357,441,0,76,0,197,33.3,41.2,0,7.1,0,18.4,66.7,933,0,933,0,100,0,0,11,922,11,922,NA,1.2,1.2,"50% - 75% P.O.C.","Less than $55000"
"36061012000","Census Tract 120, New York County, New York",3144,199201,2655,205,0,111,0,173,84.4,6.5,0,3.5,0,5.5,15.6,1657,1162,495,70.13,29.87,19,1143,0,495,19,1638,1.6,0,1.1,"Less than 25% P.O.C.","$104000 or more"
"36061012100","Census Tract 121, New York County, New York",7763,62209,4629,490,0,798,0,1711,59.6,6.3,0,10.3,0,22,40.4,4699,147,4552,3.13,96.87,0,147,46,4506,46,4653,0,1,1,"25% - 50% P.O.C.","$55000 - $78000"
"36061012200","Census Tract 122, New York County, New York",2473,211705,2213,0,0,20,0,210,89.5,0,0,0.8,0,8.5,10.5,1411,1038,373,73.56,26.44,12,1026,0,373,12,1399,1.2,0,0.9,"Less than 25% P.O.C.","$104000 or more"
"36061012400","Census Tract 124, New York County, New York",9782,128415,7402,84,19,1221,7,833,75.7,0.9,0.2,12.5,0.1,8.5,24.3,5132,915,4217,17.83,82.17,68,847,33,4184,101,5031,7.4,0.8,2,"Less than 25% P.O.C.","$104000 or more"
"36061012500","Census Tract 125, New York County, New York",2311,120240,1238,61,0,648,0,318,53.6,2.6,0,28,0,13.8,46.4,1533,103,1430,6.72,93.28,0,103,14,1416,14,1519,0,1,0.9,"25% - 50% P.O.C.","$104000 or more"
"36061012600","Census Tract 126, New York County, New York",12620,101494,10485,5,148,991,56,628,83.1,0,1.2,7.9,0.4,5,16.9,6980,2923,4057,41.88,58.12,75,2848,66,3991,141,6839,2.6,1.6,2,"Less than 25% P.O.C.","$78000 - $104000"
"36061012700","Census Tract 127, New York County, New York",6707,91143,3635,273,0,775,0,1559,54.2,4.1,0,11.6,0,23.2,45.8,3929,943,2986,24,76,28,915,15,2971,43,3886,3,0.5,1.1,"25% - 50% P.O.C.","$78000 - $104000"
"36061012800","Census Tract 128, New York County, New York",5384,174167,4528,12,0,155,0,556,84.1,0.2,0,2.9,0,10.3,15.9,2488,2134,354,85.77,14.23,98,2036,0,354,98,2390,4.6,0,3.9,"Less than 25% P.O.C.","$104000 or more"
"36061012900","Census Tract 129, New York County, New York",8351,99798,4569,263,18,1740,0,1612,54.7,3.1,0.2,20.8,0,19.3,45.3,5035,654,4381,12.99,87.01,0,654,151,4230,151,4884,0,3.4,3,"25% - 50% P.O.C.","$78000 - $104000"
"36061013000","Census Tract 130, New York County, New York",3314,196964,2894,20,0,144,0,181,87.3,0.6,0,4.3,0,5.5,12.7,1789,1234,555,68.98,31.02,40,1194,0,555,40,1749,3.2,0,2.2,"Less than 25% P.O.C.","$104000 or more"
"36061013100","Census Tract 131, New York County, New York",2788,119345,1625,62,0,678,0,414,58.3,2.2,0,24.3,0,14.8,41.7,1777,225,1552,12.66,87.34,0,225,11,1541,11,1766,0,0.7,0.6,"25% - 50% P.O.C.","$104000 or more"
"36061013200","Census Tract 132, New York County, New York",10999,108275,6125,0,118,550,0,3728,55.7,0,1.1,5,0,33.9,44.3,5577,1204,4373,21.59,78.41,0,1204,0,4373,0,5577,0,0,0,"25% - 50% P.O.C.","$104000 or more"
"36061013300","Census Tract 133, New York County, New York",6228,81239,2594,289,16,1670,0,1381,41.7,4.6,0.3,26.8,0,22.2,58.3,3396,578,2818,17.02,82.98,0,578,12,2806,12,3384,0,0.4,0.4,"50% - 75% P.O.C.","$78000 - $104000"
"36061013400","Census Tract 134, New York County, New York",11360,107295,9301,535,0,1073,0,386,81.9,4.7,0,9.4,0,3.4,18.1,6748,2627,4121,38.93,61.07,0,2627,57,4064,57,6691,0,1.4,0.8,"Less than 25% P.O.C.","$104000 or more"
"36061013500","Census Tract 135, New York County, New York",9705,76489,3923,917,0,1673,0,3025,40.4,9.4,0,17.2,0,31.2,59.6,4960,250,4710,5.04,94.96,36,214,118,4592,154,4806,14.4,2.5,3.1,"50% - 75% P.O.C.","$55000 - $78000"
"36061013600","Census Tract 136, New York County, New York",15487,108333,12628,186,0,1008,0,1503,81.5,1.2,0,6.5,0,9.7,18.5,8134,2649,5485,32.57,67.43,158,2491,187,5298,345,7789,6,3.4,4.2,"Less than 25% P.O.C.","$104000 or more"
"36061013700","Census Tract 137, New York County, New York",5994,180172,4240,119,16,748,30,532,70.7,2,0.3,12.5,0.5,8.9,29.3,3264,1157,2107,35.45,64.55,0,1157,0,2107,0,3264,0,0,0,"25% - 50% P.O.C.","$104000 or more"
"36061013800","Census Tract 138, New York County, New York",12213,137196,9606,225,0,1619,0,367,78.7,1.8,0,13.3,0,3,21.3,6609,1623,4986,24.56,75.44,64,1559,93,4893,157,6452,3.9,1.9,2.4,"Less than 25% P.O.C.","$104000 or more"
"36061013900","Census Tract 139, New York County, New York",10524,101941,6354,600,43,1861,0,1102,60.4,5.7,0.4,17.7,0,10.5,39.6,6607,1847,4760,27.96,72.04,0,1847,64,4696,64,6543,0,1.3,1,"25% - 50% P.O.C.","$78000 - $104000"
"36061014000","Census Tract 140, New York County, New York",7194,137109,6232,100,0,405,0,357,86.6,1.4,0,5.6,0,5,13.4,3811,1959,1852,51.4,48.6,88,1871,55,1797,143,3668,4.5,3,3.8,"Less than 25% P.O.C.","$104000 or more"
"36061014200","Census Tract 142, New York County, New York",5110,191417,4414,12,0,526,0,44,86.4,0.2,0,10.3,0,0.9,13.6,2199,1452,747,66.03,33.97,183,1269,28,719,211,1988,12.6,3.7,9.6,"Less than 25% P.O.C.","$104000 or more"
"36061014300","Census Tract 143, New York County, New York",2,NA,0,1,0,0,0,1,0,50,0,0,0,50,100,0,0,0,NA,NA,0,0,0,0,0,0,NA,NA,NA,"75% or more P.O.C.","N/A"
"36061014401","Census Tract 144.01, New York County, New York",4720,124803,3852,0,0,457,0,306,81.6,0,0,9.7,0,6.5,18.4,2475,1153,1322,46.59,53.41,104,1049,0,1322,104,2371,9,0,4.2,"Less than 25% P.O.C.","$104000 or more"
"36061014402","Census Tract 144.02, New York County, New York",6946,131884,5733,85,0,555,0,368,82.5,1.2,0,8,0,5.3,17.5,3765,1220,2545,32.4,67.6,64,1156,18,2527,82,3683,5.2,0.7,2.2,"Less than 25% P.O.C.","$104000 or more"
"36061014500","Census Tract 145, New York County, New York",6153,182083,3839,385,0,1164,0,660,62.4,6.3,0,18.9,0,10.7,37.6,2952,1019,1933,34.52,65.48,15,1004,18,1915,33,2919,1.5,0.9,1.1,"25% - 50% P.O.C.","$104000 or more"
"36061014601","Census Tract 146.01, New York County, New York",4182,139952,2757,78,0,762,0,532,65.9,1.9,0,18.2,0,12.7,34.1,2325,161,2164,6.92,93.08,0,161,27,2137,27,2298,0,1.2,1.2,"25% - 50% P.O.C.","$104000 or more"
"36061014602","Census Tract 146.02, New York County, New York",7831,108623,6440,0,0,609,0,687,82.2,0,0,7.8,0,8.8,17.8,4469,1246,3223,27.88,72.12,0,1246,79,3144,79,4390,0,2.5,1.8,"Less than 25% P.O.C.","$104000 or more"
"36061014700","Census Tract 147, New York County, New York",3475,207857,1819,49,0,1017,0,480,52.3,1.4,0,29.3,0,13.8,47.7,1666,215,1451,12.91,87.09,23,192,51,1400,74,1592,10.7,3.5,4.4,"25% - 50% P.O.C.","$104000 or more"
"36061014801","Census Tract 148.01, New York County, New York",2810,162857,2243,10,0,191,0,191,79.8,0.4,0,6.8,0,6.8,20.2,1414,591,823,41.8,58.2,0,591,22,801,22,1392,0,2.7,1.6,"Less than 25% P.O.C.","$104000 or more"
"36061014802","Census Tract 148.02, New York County, New York",6504,137679,4737,17,0,674,0,805,72.8,0.3,0,10.4,0,12.4,27.2,3231,1226,2005,37.94,62.06,15,1211,38,1967,53,3178,1.2,1.9,1.6,"25% - 50% P.O.C.","$104000 or more"
"36061014900","Census Tract 149, New York County, New York",4992,149212,3795,73,0,472,0,568,76,1.5,0,9.5,0,11.4,24,2885,1075,1810,37.26,62.74,18,1057,24,1786,42,2843,1.7,1.3,1.5,"Less than 25% P.O.C.","$104000 or more"
"36061015001","Census Tract 150.01, New York County, New York",2285,161776,1941,0,0,203,0,115,84.9,0,0,8.9,0,5,15.1,1047,596,451,56.92,43.08,29,567,19,432,48,999,4.9,4.2,4.6,"Less than 25% P.O.C.","$104000 or more"
"36061015002","Census Tract 150.02, New York County, New York",4578,214831,3855,49,0,271,0,338,84.2,1.1,0,5.9,0,7.4,15.8,2230,1820,410,81.61,18.39,78,1742,0,410,78,2152,4.3,0,3.5,"Less than 25% P.O.C.","$104000 or more"
"36061015100","Census Tract 151, New York County, New York",10143,77547,3507,1740,0,1651,0,2810,34.6,17.2,0,16.3,0,27.7,65.4,5094,569,4525,11.17,88.83,0,569,27,4498,27,5067,0,0.6,0.5,"50% - 75% P.O.C.","$55000 - $78000"
"36061015200","Census Tract 152, New York County, New York",7816,89868,4008,556,0,830,0,2050,51.3,7.1,0,10.6,0,26.2,48.7,3816,676,3140,17.71,82.29,62,614,78,3062,140,3676,9.2,2.5,3.7,"25% - 50% P.O.C.","$78000 - $104000"
"36061015300","Census Tract 153, New York County, New York",9764,156435,7742,59,26,999,0,626,79.3,0.6,0.3,10.2,0,6.4,20.7,5221,2141,3080,41.01,58.99,108,2033,39,3041,147,5074,5,1.3,2.8,"Less than 25% P.O.C.","$104000 or more"
"36061015400","Census Tract 154, New York County, New York",14134,100152,9982,677,0,1124,0,1520,70.6,4.8,0,8,0,10.8,29.4,7264,2483,4781,34.18,65.82,53,2430,0,4781,53,7211,2.1,0,0.7,"25% - 50% P.O.C.","$78000 - $104000"
"36061015500","Census Tract 155, New York County, New York",10290,129779,8183,151,0,1427,0,345,79.5,1.5,0,13.9,0,3.4,20.5,6145,3448,2697,56.11,43.89,22,3426,14,2683,36,6109,0.6,0.5,0.6,"Less than 25% P.O.C.","$104000 or more"
"36061015601","Census Tract 156.01, New York County, New York",5130,98766,3193,228,0,754,0,809,62.2,4.4,0,14.7,0,15.8,37.8,2582,86,2496,3.33,96.67,12,74,0,2496,12,2570,14,0,0.5,"25% - 50% P.O.C.","$78000 - $104000"
"36061015602","Census Tract 156.02, New York County, New York",2433,72643,492,545,0,268,0,1068,20.2,22.4,0,11,0,43.9,79.8,1070,79,991,7.38,92.62,0,79,43,948,43,1027,0,4.3,4,"75% or more P.O.C.","$55000 - $78000"
"36061015700","Census Tract 157, New York County, New York",9586,137703,7518,347,41,704,0,747,78.4,3.6,0.4,7.3,0,7.8,21.6,5325,1760,3565,33.05,66.95,67,1693,0,3565,67,5258,3.8,0,1.3,"Less than 25% P.O.C.","$104000 or more"
"36061015801","Census Tract 158.01, New York County, New York",5099,161259,4078,18,8,581,0,274,80,0.4,0.2,11.4,0,5.4,20,2529,1347,1182,53.26,46.74,13,1334,0,1182,13,2516,1,0,0.5,"Less than 25% P.O.C.","$104000 or more"
"36061015802","Census Tract 158.02, New York County, New York",4353,97455,2241,360,0,839,0,735,51.5,8.3,0,19.3,0,16.9,48.5,1743,53,1690,3.04,96.96,0,53,74,1616,74,1669,0,4.4,4.2,"25% - 50% P.O.C.","$78000 - $104000"
"36061015900","Census Tract 159, New York County, New York",9517,127969,7218,299,0,1027,0,643,75.8,3.1,0,10.8,0,6.8,24.2,5505,2937,2568,53.35,46.65,91,2846,0,2568,91,5414,3.1,0,1.7,"Less than 25% P.O.C.","$104000 or more"
"36061016001","Census Tract 160.01, New York County, New York",3465,250001,2841,14,0,212,0,293,82,0.4,0,6.1,0,8.5,18,1554,1278,276,82.24,17.76,52,1226,11,265,63,1491,4.1,4,4.1,"Less than 25% P.O.C.","$104000 or more"
"36061016002","Census Tract 160.02, New York County, New York",3421,123370,2249,78,17,526,0,485,65.7,2.3,0.5,15.4,0,14.2,34.3,1256,518,738,41.24,58.76,41,477,28,710,69,1187,7.9,3.8,5.5,"25% - 50% P.O.C.","$104000 or more"
"36061016100","Census Tract 161, New York County, New York",6281,120136,4666,196,0,666,0,597,74.3,3.1,0,10.6,0,9.5,25.7,3511,1117,2394,31.81,68.19,6,1111,16,2378,22,3489,0.5,0.7,0.6,"25% - 50% P.O.C.","$104000 or more"
"36061016200","Census Tract 162, New York County, New York",9412,32530,695,4104,0,886,0,3656,7.4,43.6,0,9.4,0,38.8,92.6,4195,424,3771,10.11,89.89,0,424,217,3554,217,3978,0,5.8,5.2,"75% or more P.O.C.","Less than $55000"
"36061016300","Census Tract 163, New York County, New York",7267,125388,6259,27,0,578,0,403,86.1,0.4,0,8,0,5.5,13.9,3716,1438,2278,38.7,61.3,40,1398,32,2246,72,3644,2.8,1.4,1.9,"Less than 25% P.O.C.","$104000 or more"
"36061016400","Census Tract 164, New York County, New York",7474,28726,829,1685,19,1379,0,3525,11.1,22.5,0.3,18.5,0,47.2,88.9,3083,11,3072,0.36,99.64,0,11,182,2890,182,2901,0,5.9,5.9,"75% or more P.O.C.","Less than $55000"
"36061016500","Census Tract 165, New York County, New York",6512,183346,5230,187,0,454,0,539,80.3,2.9,0,7,0,8.3,19.7,3156,1205,1951,38.18,61.82,53,1152,64,1887,117,3039,4.4,3.3,3.7,"Less than 25% P.O.C.","$104000 or more"
"36061016600","Census Tract 166, New York County, New York",6377,40402,1571,739,32,308,0,3666,24.6,11.6,0.5,4.8,0,57.5,75.4,2819,134,2685,4.75,95.25,0,134,175,2510,175,2644,0,6.5,6.2,"75% or more P.O.C.","Less than $55000"
"36061016700","Census Tract 167, New York County, New York",6189,201250,4648,36,0,770,0,411,75.1,0.6,0,12.4,0,6.6,24.9,3067,1246,1821,40.63,59.37,112,1134,28,1793,140,2927,9,1.5,4.6,"Less than 25% P.O.C.","$104000 or more"
"36061016800","Census Tract 168, New York County, New York",5115,22475,811,1624,0,325,0,2239,15.9,31.7,0,6.4,0,43.8,84.1,1826,129,1697,7.06,92.94,22,107,186,1511,208,1618,17.1,11,11.4,"75% or more P.O.C.","Less than $55000"
"36061016900","Census Tract 169, New York County, New York",8375,128250,6408,57,0,852,0,1012,76.5,0.7,0,10.2,0,12.1,23.5,4051,1420,2631,35.05,64.95,143,1277,18,2613,161,3890,10.1,0.7,4,"Less than 25% P.O.C.","$104000 or more"
"36061017000","Census Tract 170, New York County, New York",7829,36032,811,1243,0,1287,0,4341,10.4,15.9,0,16.4,0,55.4,89.6,3403,249,3154,7.32,92.68,0,249,232,2922,232,3171,0,7.4,6.8,"75% or more P.O.C.","Less than $55000"
"36061017100","Census Tract 171, New York County, New York",8694,161979,7329,143,0,257,0,748,84.3,1.6,0,3,0,8.6,15.7,4017,1937,2080,48.22,51.78,122,1815,40,2040,162,3855,6.3,1.9,4,"Less than 25% P.O.C.","$104000 or more"
"36061017200","Census Tract 172, New York County, New York",5130,33601,668,1162,0,190,0,2910,13,22.7,0,3.7,0,56.7,87,2201,114,2087,5.18,94.82,0,114,178,1909,178,2023,0,8.5,8.1,"75% or more P.O.C.","Less than $55000"
"36061017300","Census Tract 173, New York County, New York",7580,135233,5318,318,0,1007,0,798,70.2,4.2,0,13.3,0,10.5,29.8,3998,1339,2659,33.49,66.51,144,1195,27,2632,171,3827,10.8,1,4.3,"25% - 50% P.O.C.","$104000 or more"
"36061017401","Census Tract 174.01, New York County, New York",4634,22217,538,1789,0,199,0,1934,11.6,38.6,0,4.3,0,41.7,88.4,2048,286,1762,13.96,86.04,0,286,77,1685,77,1971,0,4.4,3.8,"75% or more P.O.C.","Less than $55000"
"36061017402","Census Tract 174.02, New York County, New York",2375,47411,388,926,0,208,0,802,16.3,39,0,8.8,0,33.8,83.7,1015,131,884,12.91,87.09,0,131,24,860,24,991,0,2.7,2.4,"75% or more P.O.C.","Less than $55000"
"36061017500","Census Tract 175, New York County, New York",10558,165234,8390,522,0,645,0,887,79.5,4.9,0,6.1,0,8.4,20.5,4947,2478,2469,50.09,49.91,238,2240,45,2424,283,4664,9.6,1.8,5.7,"Less than 25% P.O.C.","$104000 or more"
"36061017700","Census Tract 177, New York County, New York",9265,74897,4525,1155,0,396,0,2835,48.8,12.5,0,4.3,0,30.6,51.2,4620,1809,2811,39.16,60.84,13,1796,71,2740,84,4536,0.7,2.5,1.8,"50% - 75% P.O.C.","$55000 - $78000"
"36061017800","Census Tract 178, New York County, New York",3987,50972,659,949,0,116,14,2144,16.5,23.8,0,2.9,0.4,53.8,83.5,1778,59,1719,3.32,96.68,0,59,125,1594,125,1653,0,7.3,7,"75% or more P.O.C.","Less than $55000"
"36061017900","Census Tract 179, New York County, New York",8267,95921,5302,109,0,768,0,1958,64.1,1.3,0,9.3,0,23.7,35.9,4260,1284,2976,30.14,69.86,0,1284,109,2867,109,4151,0,3.7,2.6,"25% - 50% P.O.C.","$78000 - $104000"
"36061018000","Census Tract 180, New York County, New York",7422,32194,678,2159,0,176,0,4380,9.1,29.1,0,2.4,0,59,90.9,3026,24,3002,0.79,99.21,0,24,254,2748,254,2772,0,8.5,8.4,"75% or more P.O.C.","Less than $55000"
"36061018100","Census Tract 181, New York County, New York",8496,96429,5307,958,0,526,0,1400,62.5,11.3,0,6.2,0,16.5,37.5,4264,1402,2862,32.88,67.12,43,1359,45,2817,88,4176,3.1,1.6,2.1,"25% - 50% P.O.C.","$78000 - $104000"
"36061018200","Census Tract 182, New York County, New York",7902,28235,528,2491,0,555,0,3865,6.7,31.5,0,7,0,48.9,93.3,3072,118,2954,3.84,96.16,16,102,278,2676,294,2778,13.6,9.4,9.6,"75% or more P.O.C.","Less than $55000"
"36061018300","Census Tract 183, New York County, New York",7827,117679,5877,317,38,389,0,1090,75.1,4.1,0.5,5,0,13.9,24.9,3920,1176,2744,30,70,78,1098,57,2687,135,3785,6.6,2.1,3.4,"Less than 25% P.O.C.","$104000 or more"
"36061018400","Census Tract 184, New York County, New York",7116,22738,825,2411,0,478,0,3360,11.6,33.9,0,6.7,0,47.2,88.4,3280,220,3060,6.71,93.29,0,220,47,3013,47,3233,0,1.5,1.4,"75% or more P.O.C.","Less than $55000"
"36061018500","Census Tract 185, New York County, New York",4893,129194,3432,447,0,570,0,277,70.1,9.1,0,11.6,0,5.7,29.9,2597,842,1755,32.42,67.58,0,842,58,1697,58,2539,0,3.3,2.2,"25% - 50% P.O.C.","$104000 or more"
"36061018600","Census Tract 186, New York County, New York",6909,34600,448,3188,0,220,0,2687,6.5,46.1,0,3.2,0,38.9,93.5,2136,78,2058,3.65,96.35,0,78,172,1886,172,1964,0,8.4,8.1,"75% or more P.O.C.","Less than $55000"
"36061018700","Census Tract 187, New York County, New York",8608,136146,5986,693,0,1093,0,639,69.5,8.1,0,12.7,0,7.4,30.5,4046,1159,2887,28.65,71.35,103,1056,65,2822,168,3878,8.9,2.3,4.2,"25% - 50% P.O.C.","$104000 or more"
"36061018800","Census Tract 188, New York County, New York",5437,41160,826,1191,0,111,0,3200,15.2,21.9,0,2,0,58.9,84.8,2205,116,2089,5.26,94.74,0,116,227,1862,227,1978,0,10.9,10.3,"75% or more P.O.C.","Less than $55000"
"36061018900","Census Tract 189, New York County, New York",11654,36250,2749,1766,0,747,0,5881,23.6,15.2,0,6.4,0,50.5,76.4,4690,627,4063,13.37,86.63,0,627,79,3984,79,4611,0,1.9,1.7,"75% or more P.O.C.","Less than $55000"
"36061019000","Census Tract 190, New York County, New York",3734,58333,690,1941,0,494,0,574,18.5,52,0,13.2,0,15.4,81.5,1670,633,1037,37.9,62.1,42,591,103,934,145,1525,6.6,9.9,8.7,"75% or more P.O.C.","$55000 - $78000"
"36061019100","Census Tract 191, New York County, New York",9757,113125,5586,919,0,975,0,1869,57.3,9.4,0,10,0,19.2,42.7,4445,1783,2662,40.11,59.89,12,1771,145,2517,157,4288,0.7,5.4,3.5,"25% - 50% P.O.C.","$104000 or more"
"36061019200","Census Tract 192, New York County, New York",3802,20117,145,1537,0,259,0,1747,3.8,40.4,0,6.8,0,45.9,96.2,1387,18,1369,1.3,98.7,0,18,126,1243,126,1261,0,9.2,9.1,"75% or more P.O.C.","Less than $55000"
"36061019300","Census Tract 193, New York County, New York",10255,55476,3485,2069,0,850,0,3719,34,20.2,0,8.3,0,36.3,66,3990,629,3361,15.76,84.24,21,608,135,3226,156,3834,3.3,4,3.9,"50% - 75% P.O.C.","$55000 - $78000"
"36061019400","Census Tract 194, New York County, New York",6166,20373,382,1752,0,45,0,3897,6.2,28.4,0,0.7,0,63.2,93.8,2608,82,2526,3.14,96.86,0,82,195,2331,195,2413,0,7.7,7.5,"75% or more P.O.C.","Less than $55000"
"36061019500","Census Tract 195, New York County, New York",7167,88785,4029,220,22,1016,0,1759,56.2,3.1,0.3,14.2,0,24.5,43.8,3341,1107,2234,33.13,66.87,33,1074,66,2168,99,3242,3,3,3,"25% - 50% P.O.C.","$78000 - $104000"
"36061019600","Census Tract 196, New York County, New York",4310,17455,347,1663,0,107,3,2190,8.1,38.6,0,2.5,0.1,50.8,91.9,1669,0,1669,0,100,0,0,149,1520,149,1520,NA,8.9,8.9,"75% or more P.O.C.","Less than $55000"
"36061019701","Census Tract 197.01, New York County, New York",639,52656,241,92,0,185,0,105,37.7,14.4,0,29,0,16.4,62.3,365,0,365,0,100,0,0,0,365,0,365,NA,0,0,"50% - 75% P.O.C.","Less than $55000"
"36061019702","Census Tract 197.02, New York County, New York",2478,60647,640,794,5,294,0,617,25.8,32,0.2,11.9,0,24.9,74.2,1125,275,850,24.44,75.56,9,266,22,828,31,1094,3.3,2.6,2.8,"50% - 75% P.O.C.","$55000 - $78000"
"36061019800","Census Tract 198, New York County, New York",2645,76912,522,1238,47,221,0,490,19.7,46.8,1.8,8.4,0,18.5,80.3,1178,503,675,42.7,57.3,24,479,82,593,106,1072,4.8,12.1,9,"75% or more P.O.C.","$55000 - $78000"
"36061019900","Census Tract 199, New York County, New York",8786,96282,5334,679,17,1304,13,1240,60.7,7.7,0.2,14.8,0.1,14.1,39.3,3016,941,2075,31.2,68.8,78,863,29,2046,107,2909,8.3,1.4,3.5,"25% - 50% P.O.C.","$78000 - $104000"
"36061020000","Census Tract 200, New York County, New York",3606,72833,713,1973,0,97,0,693,19.8,54.7,0,2.7,0,19.2,80.2,1356,251,1105,18.51,81.49,42,209,134,971,176,1180,16.7,12.1,13,"75% or more P.O.C.","$55000 - $78000"
"36061020101","Census Tract 201.01, New York County, New York",1854,138750,1110,158,40,320,0,185,59.9,8.5,2.2,17.3,0,10,40.1,284,81,203,28.52,71.48,3,78,1,202,4,280,3.7,0.5,1.4,"25% - 50% P.O.C.","$104000 or more"
"36061020102","Census Tract 201.02, New York County, New York",4137,77750,1135,2008,0,280,0,617,27.4,48.5,0,6.8,0,14.9,72.6,1678,351,1327,20.92,79.08,29,322,13,1314,42,1636,8.3,1,2.5,"50% - 75% P.O.C.","$55000 - $78000"
"36061020300","Census Tract 203, New York County, New York",3607,52813,1709,312,47,764,5,676,47.4,8.6,1.3,21.2,0.1,18.7,52.6,343,23,320,6.71,93.29,1,22,3,317,4,339,4.3,0.9,1.2,"50% - 75% P.O.C.","Less than $55000"
"36061020500","Census Tract 205, New York County, New York",5117,121250,3256,387,17,780,0,569,63.6,7.6,0.3,15.2,0,11.1,36.4,1219,202,1017,16.57,83.43,0,202,23,994,23,1196,0,2.3,1.9,"25% - 50% P.O.C.","$104000 or more"
"36061020600","Census Tract 206, New York County, New York",3432,31625,521,1876,0,82,0,848,15.2,54.7,0,2.4,0,24.7,84.8,1560,182,1378,11.67,88.33,11,171,66,1312,77,1483,6,4.8,4.9,"75% or more P.O.C.","Less than $55000"
"36061020701","Census Tract 207.01, New York County, New York",3041,62802,1369,261,0,728,0,557,45,8.6,0,23.9,0,18.3,55,1191,39,1152,3.27,96.73,0,39,0,1152,0,1191,0,0,0,"50% - 75% P.O.C.","$55000 - $78000"
"36061020800","Census Tract 208, New York County, New York",5432,88091,761,3411,0,177,0,839,14,62.8,0,3.3,0,15.4,86,2261,482,1779,21.32,78.68,20,462,83,1696,103,2158,4.1,4.7,4.6,"75% or more P.O.C.","$78000 - $104000"
"36061020901","Census Tract 209.01, New York County, New York",3511,30208,218,1184,0,161,0,1630,6.2,33.7,0,4.6,0,46.4,93.8,1472,80,1392,5.43,94.57,6,74,49,1343,55,1417,7.5,3.5,3.7,"75% or more P.O.C.","Less than $55000"
"36061021000","Census Tract 210, New York County, New York",7540,32396,51,5236,0,196,0,1938,0.7,69.4,0,2.6,0,25.7,99.3,3075,249,2826,8.1,91.9,0,249,80,2746,80,2995,0,2.8,2.6,"75% or more P.O.C.","Less than $55000"
"36061021100","Census Tract 211, New York County, New York",10824,52716,4020,1458,58,1989,0,2829,37.1,13.5,0.5,18.4,0,26.1,62.9,4378,1132,3246,25.86,74.14,22,1110,108,3138,130,4248,1.9,3.3,3,"50% - 75% P.O.C.","Less than $55000"
"36061021200","Census Tract 212, New York County, New York",4112,53819,374,2829,0,152,0,631,9.1,68.8,0,3.7,0,15.3,90.9,2409,99,2310,4.11,95.89,0,99,21,2289,21,2388,0,0.9,0.9,"75% or more P.O.C.","Less than $55000"
"36061021303","Census Tract 213.03, New York County, New York",6283,43983,961,2639,0,422,0,2014,15.3,42,0,6.7,0,32.1,84.7,2329,89,2240,3.82,96.18,0,89,152,2088,152,2177,0,6.8,6.5,"75% or more P.O.C.","Less than $55000"
"36061021400","Census Tract 214, New York County, New York",3373,60863,286,2477,9,122,0,431,8.5,73.4,0.3,3.6,0,12.8,91.5,1949,19,1930,0.97,99.03,19,0,83,1847,102,1847,100,4.3,5.2,"75% or more P.O.C.","$55000 - $78000"
"36061021500","Census Tract 215, New York County, New York",4396,51719,414,2417,0,87,0,1414,9.4,55,0,2,0,32.2,90.6,1701,26,1675,1.53,98.47,0,26,121,1554,121,1580,0,7.2,7.1,"75% or more P.O.C.","Less than $55000"
"36061021600","Census Tract 216, New York County, New York",8773,70399,2172,4139,0,522,0,1552,24.8,47.2,0,6,0,17.7,75.2,3471,555,2916,15.99,84.01,95,460,145,2771,240,3231,17.1,5,6.9,"75% or more P.O.C.","$55000 - $78000"
"36061021703","Census Tract 217.03, New York County, New York",11,NA,5,0,0,0,0,6,45.5,0,0,0,0,54.5,54.5,6,6,0,100,0,0,6,0,0,0,6,0,NA,0,"50% - 75% P.O.C.","N/A"
"36061021800","Census Tract 218, New York County, New York",6236,49482,1280,3655,0,116,0,1131,20.5,58.6,0,1.9,0,18.1,79.5,2877,175,2702,6.08,93.92,18,157,108,2594,126,2751,10.3,4,4.4,"75% or more P.O.C.","Less than $55000"
"36061021900","Census Tract 219, New York County, New York",6008,19907,433,2181,0,162,0,3232,7.2,36.3,0,2.7,0,53.8,92.8,2193,83,2110,3.78,96.22,0,83,153,1957,153,2040,0,7.3,7,"75% or more P.O.C.","Less than $55000"
"36061022000","Census Tract 220, New York County, New York",6078,69926,1347,2974,0,466,0,1141,22.2,48.9,0,7.7,0,18.8,77.8,2519,321,2198,12.74,87.26,59,262,106,2092,165,2354,18.4,4.8,6.6,"75% or more P.O.C.","$55000 - $78000"
"36061022102","Census Tract 221.02, New York County, New York",2605,96154,552,1280,0,133,0,345,21.2,49.1,0,5.1,0,13.2,78.8,1166,441,725,37.82,62.18,21,420,41,684,62,1104,4.8,5.7,5.3,"75% or more P.O.C.","$78000 - $104000"
"36061022200","Census Tract 222, New York County, New York",3369,41250,1084,1518,7,228,0,362,32.2,45.1,0.2,6.8,0,10.7,67.8,1459,255,1204,17.48,82.52,31,224,52,1152,83,1376,12.2,4.3,5.7,"50% - 75% P.O.C.","Less than $55000"
"36061022301","Census Tract 223.01, New York County, New York",8292,56393,1412,552,0,185,0,6069,17,6.7,0,2.2,0,73.2,83,2472,234,2238,9.47,90.53,52,182,262,1976,314,2158,22.2,11.7,12.7,"75% or more P.O.C.","$55000 - $78000"
"36061022302","Census Tract 223.02, New York County, New York",3175,23527,256,512,35,520,0,1727,8.1,16.1,1.1,16.4,0,54.4,91.9,1512,37,1475,2.45,97.55,0,37,35,1440,35,1477,0,2.4,2.3,"75% or more P.O.C.","Less than $55000"
"36061022400","Census Tract 224, New York County, New York",7586,34263,929,4333,0,161,0,2126,12.2,57.1,0,2.1,0,28,87.8,2833,169,2664,5.97,94.03,35,134,181,2483,216,2617,20.7,6.8,7.6,"75% or more P.O.C.","Less than $55000"
"36061022500","Census Tract 225, New York County, New York",10334,60585,1966,2164,0,404,0,5385,19,20.9,0,3.9,0,52.1,81,3623,816,2807,22.52,77.48,145,671,217,2590,362,3261,17.8,7.7,10,"75% or more P.O.C.","$55000 - $78000"
"36061022600","Census Tract 226, New York County, New York",4954,51074,855,2667,0,152,0,983,17.3,53.8,0,3.1,0,19.8,82.7,2024,243,1781,12.01,87.99,42,201,72,1709,114,1910,17.3,4,5.6,"75% or more P.O.C.","Less than $55000"
"36061022700","Census Tract 227, New York County, New York",5218,56818,1088,1713,0,276,0,1894,20.9,32.8,0,5.3,0,36.3,79.1,2182,306,1876,14.02,85.98,14,292,79,1797,93,2089,4.6,4.2,4.3,"75% or more P.O.C.","$55000 - $78000"
"36061022800","Census Tract 228, New York County, New York",6162,70650,922,4054,5,135,0,886,15,65.8,0.1,2.2,0,14.4,85,2649,531,2118,20.05,79.95,10,521,95,2023,105,2544,1.9,4.5,4,"75% or more P.O.C.","$55000 - $78000"
"36061022900","Census Tract 229, New York County, New York",9205,52907,1815,1761,14,250,0,5087,19.7,19.1,0.2,2.7,0,55.3,80.3,3206,259,2947,8.08,91.92,0,259,302,2645,302,2904,0,10.2,9.4,"75% or more P.O.C.","Less than $55000"
"36061023000","Census Tract 230, New York County, New York",8717,36124,734,5413,0,118,101,2157,8.4,62.1,0,1.4,1.2,24.7,91.6,3696,185,3511,5.01,94.99,0,185,293,3218,293,3403,0,8.3,7.9,"75% or more P.O.C.","Less than $55000"
"36061023100","Census Tract 231, New York County, New York",6807,50149,1030,2588,0,182,0,2857,15.1,38,0,2.7,0,42,84.9,2642,323,2319,12.23,87.77,37,286,111,2208,148,2494,11.5,4.8,5.6,"75% or more P.O.C.","Less than $55000"
"36061023200","Census Tract 232, New York County, New York",9069,36804,681,5206,0,148,10,2944,7.5,57.4,0,1.6,0.1,32.5,92.5,3222,70,3152,2.17,97.83,0,70,366,2786,366,2856,0,11.6,11.4,"75% or more P.O.C.","Less than $55000"
"36061023300","Census Tract 233, New York County, New York",7220,57389,1670,1503,0,369,0,3462,23.1,20.8,0,5.1,0,48,76.9,2484,458,2026,18.44,81.56,101,357,189,1837,290,2194,22.1,9.3,11.7,"75% or more P.O.C.","$55000 - $78000"
"36061023400","Census Tract 234, New York County, New York",5072,49012,534,3124,0,45,0,1268,10.5,61.6,0,0.9,0,25,89.5,2413,223,2190,9.24,90.76,0,223,44,2146,44,2369,0,2,1.8,"75% or more P.O.C.","Less than $55000"
"36061023501","Census Tract 235.01, New York County, New York",7044,59405,1317,2551,0,165,0,2849,18.7,36.2,0,2.3,0,40.4,81.3,2596,370,2226,14.25,85.75,6,364,190,2036,196,2400,1.6,8.5,7.6,"75% or more P.O.C.","$55000 - $78000"
"36061023502","Census Tract 235.02, New York County, New York",1986,39911,246,1186,0,64,0,484,12.4,59.7,0,3.2,0,24.4,87.6,855,42,813,4.91,95.09,5,37,80,733,85,770,11.9,9.8,9.9,"75% or more P.O.C.","Less than $55000"
"36061023600","Census Tract 236, New York County, New York",7761,46761,156,5884,56,39,0,1342,2,75.8,0.7,0.5,0,17.3,98,3250,704,2546,21.66,78.34,0,704,132,2414,132,3118,0,5.2,4.1,"75% or more P.O.C.","Less than $55000"
"36061023700","Census Tract 237, New York County, New York",6682,45167,1246,1362,0,248,0,3516,18.6,20.4,0,3.7,0,52.6,81.4,2658,256,2402,9.63,90.37,0,256,276,2126,276,2382,0,11.5,10.4,"75% or more P.O.C.","Less than $55000"
"36061023801","Census Tract 238.01, New York County, New York",6354,98636,2406,504,0,2679,0,515,37.9,7.9,0,42.2,0,8.1,62.1,2998,1011,1987,33.72,66.28,28,983,98,1889,126,2872,2.8,4.9,4.2,"50% - 75% P.O.C.","$78000 - $104000"
"36061023802","Census Tract 238.02, New York County, New York",6086,108889,2267,983,0,1585,0,1088,37.2,16.2,0,26,0,17.9,62.8,1776,88,1688,4.95,95.05,0,88,165,1523,165,1611,0,9.8,9.3,"50% - 75% P.O.C.","$104000 or more"
"36061023900","Census Tract 239, New York County, New York",2781,39095,390,772,0,137,0,1375,14,27.8,0,4.9,0,49.4,86,1079,172,907,15.94,84.06,0,172,46,861,46,1033,0,5.1,4.3,"75% or more P.O.C.","Less than $55000"
"36061024000","Census Tract 240, New York County, New York",2009,NA,376,1045,11,63,22,482,18.7,52,0.5,3.1,1.1,24,81.3,0,0,0,NA,NA,0,0,0,0,0,0,NA,NA,NA,"75% or more P.O.C.","N/A"
"36061024100","Census Tract 241, New York County, New York",8680,55734,1617,1742,42,146,65,4894,18.6,20.1,0.5,1.7,0.7,56.4,81.4,3432,979,2453,28.53,71.47,0,979,203,2250,203,3229,0,8.3,5.9,"75% or more P.O.C.","$55000 - $78000"
"36061024200","Census Tract 242, New York County, New York",5003,25773,230,2759,0,115,0,1899,4.6,55.1,0,2.3,0,38,95.4,1903,12,1891,0.63,99.37,0,12,178,1713,178,1725,0,9.4,9.4,"75% or more P.O.C.","Less than $55000"
"36061024301","Census Tract 243.01, New York County, New York",4658,58077,512,1424,4,173,0,2487,11,30.6,0.1,3.7,0,53.4,89,1518,27,1491,1.78,98.22,13,14,150,1341,163,1355,48.1,10.1,10.7,"75% or more P.O.C.","$55000 - $78000"
"36061024302","Census Tract 243.02, New York County, New York",7756,24286,30,2893,0,95,0,4573,0.4,37.3,0,1.2,0,59,99.6,2688,26,2662,0.97,99.03,0,26,200,2462,200,2488,0,7.5,7.4,"75% or more P.O.C.","Less than $55000"
"36061024500","Census Tract 245, New York County, New York",14717,49118,1264,1537,0,339,0,11507,8.6,10.4,0,2.3,0,78.2,91.4,4960,140,4820,2.82,97.18,0,140,672,4148,672,4288,0,13.9,13.5,"75% or more P.O.C.","Less than $55000"
"36061024700","Census Tract 247, New York County, New York",7303,62031,1345,772,0,385,0,4644,18.4,10.6,0,5.3,0,63.6,81.6,2603,441,2162,16.94,83.06,62,379,187,1975,249,2354,14.1,8.6,9.6,"75% or more P.O.C.","$55000 - $78000"
"36061024900","Census Tract 249, New York County, New York",1047,43182,153,133,0,64,0,637,14.6,12.7,0,6.1,0,60.8,85.4,434,43,391,9.91,90.09,0,43,19,372,19,415,0,4.9,4.4,"75% or more P.O.C.","Less than $55000"
"36061025100","Census Tract 251, New York County, New York",2835,42157,305,320,0,112,0,2054,10.8,11.3,0,4,0,72.5,89.2,820,12,808,1.46,98.54,0,12,63,745,63,757,0,7.8,7.7,"75% or more P.O.C.","Less than $55000"
"36061025300","Census Tract 253, New York County, New York",13572,55786,1744,443,0,222,0,11049,12.8,3.3,0,1.6,0,81.4,87.2,3922,90,3832,2.29,97.71,0,90,657,3175,657,3265,0,17.1,16.8,"75% or more P.O.C.","$55000 - $78000"
"36061025500","Census Tract 255, New York County, New York",5999,66466,1602,219,13,1005,0,2949,26.7,3.7,0.2,16.8,0,49.2,73.3,2030,59,1971,2.91,97.09,0,59,80,1891,80,1950,0,4.1,3.9,"50% - 75% P.O.C.","$55000 - $78000"
"36061025700","Census Tract 257, New York County, New York",4625,79722,1603,1849,0,285,0,742,34.7,40,0,6.2,0,16,65.3,1852,472,1380,25.49,74.51,28,444,137,1243,165,1687,5.9,9.9,8.9,"50% - 75% P.O.C.","$78000 - $104000"
"36061025900","Census Tract 259, New York County, New York",3731,63807,628,1609,0,169,0,1189,16.8,43.1,0,4.5,0,31.9,83.2,1759,626,1133,35.59,64.41,11,615,28,1105,39,1720,1.8,2.5,2.2,"75% or more P.O.C.","$55000 - $78000"
"36061026100","Census Tract 261, New York County, New York",13145,46853,455,654,0,87,0,11679,3.5,5,0,0.7,0,88.8,96.5,3863,107,3756,2.77,97.23,0,107,597,3159,597,3266,0,15.9,15.5,"75% or more P.O.C.","Less than $55000"
"36061026300","Census Tract 263, New York County, New York",9177,42045,924,507,0,231,0,7437,10.1,5.5,0,2.5,0,81,89.9,3084,47,3037,1.52,98.48,0,47,428,2609,428,2656,0,14.1,13.9,"75% or more P.O.C.","Less than $55000"
"36061026500","Census Tract 265, New York County, New York",7951,91004,2510,342,0,111,0,4891,31.6,4.3,0,1.4,0,61.5,68.4,2771,489,2282,17.65,82.35,26,463,364,1918,390,2381,5.3,16,14.1,"50% - 75% P.O.C.","$78000 - $104000"
"36061026700","Census Tract 267, New York County, New York",1994,43542,1086,38,0,66,0,804,54.5,1.9,0,3.3,0,40.3,45.5,538,0,538,0,100,0,0,48,490,48,490,NA,8.9,8.9,"25% - 50% P.O.C.","Less than $55000"
"36061026900","Census Tract 269, New York County, New York",8986,42917,710,420,16,269,0,7481,7.9,4.7,0.2,3,0,83.3,92.1,2835,80,2755,2.82,97.18,0,80,391,2364,391,2444,0,14.2,13.8,"75% or more P.O.C.","Less than $55000"
"36061027100","Census Tract 271, New York County, New York",8806,72596,2970,179,0,256,0,5401,33.7,2,0,2.9,0,61.3,66.3,2956,325,2631,10.99,89.01,87,238,313,2318,400,2556,26.8,11.9,13.5,"50% - 75% P.O.C.","$55000 - $78000"
"36061027300","Census Tract 273, New York County, New York",6925,89882,4448,273,0,163,0,1731,64.2,3.9,0,2.4,0,25,35.8,3187,725,2462,22.75,77.25,31,694,104,2358,135,3052,4.3,4.2,4.2,"25% - 50% P.O.C.","$78000 - $104000"
"36061027500","Census Tract 275, New York County, New York",3370,106908,2329,51,0,118,0,719,69.1,1.5,0,3.5,0,21.3,30.9,1518,820,698,54.02,45.98,25,795,64,634,89,1429,3,9.2,5.9,"25% - 50% P.O.C.","$104000 or more"
"36061027700","Census Tract 277, New York County, New York",6538,28864,997,572,0,122,0,4754,15.2,8.7,0,1.9,0,72.7,84.8,2160,0,2160,0,100,0,0,175,1985,175,1985,NA,8.1,8.1,"75% or more P.O.C.","Less than $55000"
"36061027900","Census Tract 279, New York County, New York",12053,48245,2175,291,0,228,0,9205,18,2.4,0,1.9,0,76.4,82,4032,276,3756,6.85,93.15,0,276,484,3272,484,3548,0,12.9,12,"75% or more P.O.C.","Less than $55000"
"36061028100","Census Tract 281, New York County, New York",3416,98125,2354,214,0,276,0,448,68.9,6.3,0,8.1,0,13.1,31.1,1458,397,1061,27.23,72.77,0,397,43,1018,43,1415,0,4.1,2.9,"25% - 50% P.O.C.","$78000 - $104000"
"36061028300","Census Tract 283, New York County, New York",7949,56855,1537,440,17,396,0,5482,19.3,5.5,0.2,5,0,69,80.7,3246,607,2639,18.7,81.3,0,607,384,2255,384,2862,0,14.6,11.8,"75% or more P.O.C.","$55000 - $78000"
"36061028500","Census Tract 285, New York County, New York",7907,48504,687,387,0,83,0,6487,8.7,4.9,0,1,0,82,91.3,2745,0,2745,0,100,0,0,288,2457,288,2457,NA,10.5,10.5,"75% or more P.O.C.","Less than $55000"
"36061028700","Census Tract 287, New York County, New York",4231,60128,1360,53,0,68,0,2713,32.1,1.3,0,1.6,0,64.1,67.9,1641,56,1585,3.41,96.59,0,56,90,1495,90,1551,0,5.7,5.5,"50% - 75% P.O.C.","$55000 - $78000"
"36061029100","Census Tract 291, New York County, New York",12165,47054,769,647,0,495,0,10077,6.3,5.3,0,4.1,0,82.8,93.7,4126,206,3920,4.99,95.01,0,206,431,3489,431,3695,0,11,10.4,"75% or more P.O.C.","Less than $55000"
"36061029300","Census Tract 293, New York County, New York",9397,42525,655,376,0,90,0,8219,7,4,0,1,0,87.5,93,3193,26,3167,0.81,99.19,0,26,312,2855,312,2881,0,9.9,9.8,"75% or more P.O.C.","Less than $55000"
"36061029500","Census Tract 295, New York County, New York",8182,73514,2848,245,0,271,0,4608,34.8,3,0,3.3,0,56.3,65.2,3354,358,2996,10.67,89.33,0,358,335,2661,335,3019,0,11.2,10,"50% - 75% P.O.C.","$55000 - $78000"
"36061029700","Census Tract 297, New York County, New York",22,NA,4,13,0,2,0,3,18.2,59.1,0,9.1,0,13.6,81.8,0,0,0,NA,NA,0,0,0,0,0,0,NA,NA,NA,"75% or more P.O.C.","N/A"
"36061029900","Census Tract 299, New York County, New York",3737,19189,100,754,5,9,0,2847,2.7,20.2,0.1,0.2,0,76.2,97.3,1579,16,1563,1.01,98.99,0,16,118,1445,118,1461,0,7.5,7.5,"75% or more P.O.C.","Less than $55000"
"36061030300","Census Tract 303, New York County, New York",4535,70223,1624,229,0,184,0,2387,35.8,5,0,4.1,0,52.6,64.2,1839,109,1730,5.93,94.07,0,109,187,1543,187,1652,0,10.8,10.2,"50% - 75% P.O.C.","$55000 - $78000"
"36061030700","Census Tract 307, New York County, New York",3920,90714,2116,383,10,147,14,1156,54,9.8,0.3,3.8,0.4,29.5,46,1832,778,1054,42.47,57.53,9,769,108,946,117,1715,1.2,10.2,6.4,"25% - 50% P.O.C.","$78000 - $104000"
"36061030900","Census Tract 309, New York County, New York",10593,32295,515,1895,0,75,0,7905,4.9,17.9,0,0.7,0,74.6,95.1,3905,136,3769,3.48,96.52,53,83,321,3448,374,3531,39,8.5,9.6,"75% or more P.O.C.","Less than $55000"
"36061031100","Census Tract 311, New York County, New York",0,NA,0,0,0,0,0,0,NA,NA,NA,NA,NA,NA,NA,0,0,0,NA,NA,0,0,0,0,0,0,NA,NA,NA,"N/A","N/A"
"36061031703","Census Tract 317.03, New York County, New York",5783,250001,3985,57,0,1150,0,383,68.9,1,0,19.9,0,6.6,31.1,2291,214,2077,9.34,90.66,34,180,104,1973,138,2153,15.9,5,6,"25% - 50% P.O.C.","$104000 or more"
"36061031704","Census Tract 317.04, New York County, New York",10224,194153,6633,236,0,1876,0,1079,64.9,2.3,0,18.3,0,10.6,35.1,4875,1706,3169,34.99,65.01,23,1683,94,3075,117,4758,1.3,3,2.4,"25% - 50% P.O.C.","$104000 or more"
"36061031900","Census Tract 319, New York County, New York",0,NA,0,0,0,0,0,0,NA,NA,NA,NA,NA,NA,NA,0,0,0,NA,NA,0,0,0,0,0,0,NA,NA,NA,"N/A","N/A"
"36071000100","Census Tract 1, Orange County, New York",3437,53125,1653,935,11,41,0,689,48.1,27.2,0.3,1.2,0,20,51.9,1177,561,616,47.66,52.34,28,533,63,553,91,1086,5,10.2,7.7,"50% - 75% P.O.C.","Less than $55000"
"36071000200","Census Tract 2, Orange County, New York",2974,57589,1041,344,0,105,0,1363,35,11.6,0,3.5,0,45.8,65,975,606,369,62.15,37.85,117,489,87,282,204,771,19.3,23.6,20.9,"50% - 75% P.O.C.","$55000 - $78000"
"36071000300","Census Tract 3, Orange County, New York",6903,48664,852,972,0,178,0,4573,12.3,14.1,0,2.6,0,66.2,87.7,2136,779,1357,36.47,63.53,95,684,366,991,461,1675,12.2,27,21.6,"75% or more P.O.C.","Less than $55000"
"36071000400","Census Tract 4, Orange County, New York",4392,30184,939,2282,0,0,0,969,21.4,52,0,0,0,22.1,78.6,1877,343,1534,18.27,81.73,26,317,174,1360,200,1677,7.6,11.3,10.7,"75% or more P.O.C.","Less than $55000"
"36071000501","Census Tract 5.01, Orange County, New York",2842,35345,494,299,0,44,0,1799,17.4,10.5,0,1.5,0,63.3,82.6,1186,153,1033,12.9,87.1,47,106,93,940,140,1046,30.7,9,11.8,"75% or more P.O.C.","Less than $55000"
"36071000502","Census Tract 5.02, Orange County, New York",3763,47500,599,708,10,27,0,2419,15.9,18.8,0.3,0.7,0,64.3,84.1,1204,327,877,27.16,72.84,44,283,286,591,330,874,13.5,32.6,27.4,"75% or more P.O.C.","Less than $55000"
"36071000600","Census Tract 6, Orange County, New York",4022,29730,551,1011,47,12,0,2401,13.7,25.1,1.2,0.3,0,59.7,86.3,1436,400,1036,27.86,72.14,85,315,238,798,323,1113,21.2,23,22.5,"75% or more P.O.C.","Less than $55000"
"36071001100","Census Tract 11, Orange County, New York",4242,54553,1390,746,0,168,0,1853,32.8,17.6,0,4,0,43.7,67.2,1542,756,786,49.03,50.97,48,708,54,732,102,1440,6.3,6.9,6.6,"50% - 75% P.O.C.","Less than $55000"
"36071001200","Census Tract 12, Orange County, New York",2251,47963,478,545,0,0,0,1069,21.2,24.2,0,0,0,47.5,78.8,730,303,427,41.51,58.49,54,249,47,380,101,629,17.8,11,13.8,"75% or more P.O.C.","Less than $55000"
"36071001300","Census Tract 13, Orange County, New York",3255,98229,1800,559,34,79,0,716,55.3,17.2,1,2.4,0,22,44.7,1195,1031,164,86.28,13.72,133,898,0,164,133,1062,12.9,0,11.1,"25% - 50% P.O.C.","$78000 - $104000"
"36071001500","Census Tract 15, Orange County, New York",4537,50598,1178,836,0,265,0,2060,26,18.4,0,5.8,0,45.4,74,1826,858,968,46.99,53.01,43,815,46,922,89,1737,5,4.8,4.9,"50% - 75% P.O.C.","Less than $55000"
"36071001600","Census Tract 16, Orange County, New York",7377,61964,2516,1560,0,302,0,2918,34.1,21.1,0,4.1,0,39.6,65.9,2963,1534,1429,51.77,48.23,244,1290,80,1349,324,2639,15.9,5.6,10.9,"50% - 75% P.O.C.","$55000 - $78000"
"36071002100","Census Tract 21, Orange County, New York",3437,48214,2382,255,10,213,0,463,69.3,7.4,0.3,6.2,0,13.5,30.7,1500,821,679,54.73,45.27,53,768,16,663,69,1431,6.5,2.4,4.6,"25% - 50% P.O.C.","Less than $55000"
"36071002200","Census Tract 22, Orange County, New York",2757,34646,2129,195,15,22,0,357,77.2,7.1,0.5,0.8,0,12.9,22.8,1455,435,1020,29.9,70.1,75,360,6,1014,81,1374,17.2,0.6,5.6,"Less than 25% P.O.C.","Less than $55000"
"36071002300","Census Tract 23, Orange County, New York",2401,58056,1885,34,14,27,0,322,78.5,1.4,0.6,1.1,0,13.4,21.5,758,526,232,69.39,30.61,81,445,64,168,145,613,15.4,27.6,19.1,"Less than 25% P.O.C.","$55000 - $78000"
"36071010101","Census Tract 101.01, Orange County, New York",4711,104596,3537,192,0,81,0,828,75.1,4.1,0,1.7,0,17.6,24.9,1529,1387,142,90.71,9.29,220,1167,0,142,220,1309,15.9,0,14.4,"Less than 25% P.O.C.","$104000 or more"
"36071010102","Census Tract 101.02, Orange County, New York",5520,104901,3367,961,0,66,0,977,61,17.4,0,1.2,0,17.7,39,1915,1510,405,78.85,21.15,180,1330,0,405,180,1735,11.9,0,9.4,"25% - 50% P.O.C.","$104000 or more"
"36071010200","Census Tract 102, Orange County, New York",5104,81233,3546,711,0,95,0,679,69.5,13.9,0,1.9,0,13.3,30.5,1924,1541,383,80.09,19.91,164,1377,17,366,181,1743,10.6,4.4,9.4,"25% - 50% P.O.C.","$78000 - $104000"
"36071010300","Census Tract 103, Orange County, New York",3585,82566,2375,532,0,33,0,610,66.2,14.8,0,0.9,0,17,33.8,1201,1011,190,84.18,15.82,130,881,30,160,160,1041,12.9,15.8,13.3,"25% - 50% P.O.C.","$78000 - $104000"
"36071010400","Census Tract 104, Orange County, New York",3795,74148,2215,467,0,171,0,786,58.4,12.3,0,4.5,0,20.7,41.6,1489,1036,453,69.58,30.42,101,935,27,426,128,1361,9.7,6,8.6,"25% - 50% P.O.C.","$55000 - $78000"
"36071010500","Census Tract 105, Orange County, New York",8112,92727,4112,1414,26,329,0,1942,50.7,17.4,0.3,4.1,0,23.9,49.3,3029,2530,499,83.53,16.47,97,2433,51,448,148,2881,3.8,10.2,4.9,"25% - 50% P.O.C.","$78000 - $104000"
"36071010600","Census Tract 106, Orange County, New York",7183,96672,5398,66,0,94,0,1540,75.1,0.9,0,1.3,0,21.4,24.9,2409,1943,466,80.66,19.34,219,1724,33,433,252,2157,11.3,7.1,10.5,"Less than 25% P.O.C.","$78000 - $104000"
"36071010700","Census Tract 107, Orange County, New York",6724,74107,4665,979,0,24,8,983,69.4,14.6,0,0.4,0.1,14.6,30.6,2219,1465,754,66.02,33.98,232,1233,35,719,267,1952,15.8,4.6,12,"25% - 50% P.O.C.","$55000 - $78000"
"36071010801","Census Tract 108.01, Orange County, New York",4285,74276,2960,496,16,51,0,747,69.1,11.6,0.4,1.2,0,17.4,30.9,1661,1054,607,63.46,36.54,177,877,30,577,207,1454,16.8,4.9,12.5,"25% - 50% P.O.C.","$55000 - $78000"
"36071010802","Census Tract 108.02, Orange County, New York",5684,78714,4423,622,0,42,0,423,77.8,10.9,0,0.7,0,7.4,22.2,1946,1277,669,65.62,34.38,224,1053,32,637,256,1690,17.5,4.8,13.2,"Less than 25% P.O.C.","$78000 - $104000"
"36071010901","Census Tract 109.01, Orange County, New York",3303,76696,2450,273,0,0,0,527,74.2,8.3,0,0,0,16,25.8,1288,791,497,61.41,38.59,42,749,53,444,95,1193,5.3,10.7,7.4,"25% - 50% P.O.C.","$55000 - $78000"
"36071010902","Census Tract 109.02, Orange County, New York",5899,96709,4928,102,0,65,0,699,83.5,1.7,0,1.1,0,11.8,16.5,1933,1654,279,85.57,14.43,261,1393,23,256,284,1649,15.8,8.2,14.7,"Less than 25% P.O.C.","$78000 - $104000"
"36071011000","Census Tract 110, Orange County, New York",4901,83275,3349,570,172,14,0,662,68.3,11.6,3.5,0.3,0,13.5,31.7,1717,1257,460,73.21,26.79,39,1218,122,338,161,1556,3.1,26.5,9.4,"25% - 50% P.O.C.","$78000 - $104000"
"36071011101","Census Tract 111.01, Orange County, New York",2608,96471,1059,439,0,247,0,677,40.6,16.8,0,9.5,0,26,59.4,842,762,80,90.5,9.5,90,672,11,69,101,741,11.8,13.8,12,"50% - 75% P.O.C.","$78000 - $104000"
"36071011102","Census Tract 111.02, Orange County, New York",4217,71972,1919,1037,0,326,0,877,45.5,24.6,0,7.7,0,20.8,54.5,1537,770,767,50.1,49.9,67,703,32,735,99,1438,8.7,4.2,6.4,"50% - 75% P.O.C.","$55000 - $78000"
"36071011200","Census Tract 112, Orange County, New York",4122,66771,2085,828,0,16,0,1085,50.6,20.1,0,0.4,0,26.3,49.4,1811,1172,639,64.72,35.28,48,1124,0,639,48,1763,4.1,0,2.7,"25% - 50% P.O.C.","$55000 - $78000"
"36071011300","Census Tract 113, Orange County, New York",8383,60783,2831,1998,0,376,0,2948,33.8,23.8,0,4.5,0,35.2,66.2,3330,1410,1920,42.34,57.66,181,1229,56,1864,237,3093,12.8,2.9,7.1,"50% - 75% P.O.C.","$55000 - $78000"
"36071011400","Census Tract 114, Orange County, New York",4090,78030,2883,334,25,50,0,766,70.5,8.2,0.6,1.2,0,18.7,29.5,1468,1305,163,88.9,11.1,89,1216,20,143,109,1359,6.8,12.3,7.4,"25% - 50% P.O.C.","$78000 - $104000"
"36071011500","Census Tract 115, Orange County, New York",6731,89153,4440,709,0,115,0,1283,66,10.5,0,1.7,0,19.1,34,1714,1387,327,80.92,19.08,212,1175,76,251,288,1426,15.3,23.2,16.8,"25% - 50% P.O.C.","$78000 - $104000"
"36071011601","Census Tract 116.01, Orange County, New York",4187,60924,3421,10,23,157,0,494,81.7,0.2,0.5,3.7,0,11.8,18.3,1575,1281,294,81.33,18.67,58,1223,28,266,86,1489,4.5,9.5,5.5,"Less than 25% P.O.C.","$55000 - $78000"
"36071011602","Census Tract 116.02, Orange County, New York",3555,52917,2858,491,0,12,0,101,80.4,13.8,0,0.3,0,2.8,19.6,1366,1121,245,82.06,17.94,91,1030,41,204,132,1234,8.1,16.7,9.7,"Less than 25% P.O.C.","Less than $55000"
"36071011701","Census Tract 117.01, Orange County, New York",4689,113087,3764,82,0,210,0,428,80.3,1.7,0,4.5,0,9.1,19.7,1471,1280,191,87.02,12.98,156,1124,1,190,157,1314,12.2,0.5,10.7,"Less than 25% P.O.C.","$104000 or more"
"36071011702","Census Tract 117.02, Orange County, New York",4492,89615,3518,34,0,25,0,831,78.3,0.8,0,0.6,0,18.5,21.7,1378,1145,233,83.09,16.91,264,881,13,220,277,1101,23.1,5.6,20.1,"Less than 25% P.O.C.","$78000 - $104000"
"36071011801","Census Tract 118.01, Orange County, New York",4642,77794,3167,423,0,126,0,804,68.2,9.1,0,2.7,0,17.3,31.8,1640,1138,502,69.39,30.61,120,1018,10,492,130,1510,10.5,2,7.9,"25% - 50% P.O.C.","$55000 - $78000"
"36071011802","Census Tract 118.02, Orange County, New York",2626,110795,2223,205,0,33,0,137,84.7,7.8,0,1.3,0,5.2,15.3,847,727,120,85.83,14.17,116,611,0,120,116,731,16,0,13.7,"Less than 25% P.O.C.","$104000 or more"
"36071011900","Census Tract 119, Orange County, New York",6558,109622,4799,616,0,173,0,887,73.2,9.4,0,2.6,0,13.5,26.8,1640,1356,284,82.68,17.32,249,1107,0,284,249,1391,18.4,0,15.2,"25% - 50% P.O.C.","$104000 or more"
"36071012100","Census Tract 121, Orange County, New York",3755,65085,2394,159,0,107,0,1067,63.8,4.2,0,2.8,0,28.4,36.2,1458,713,745,48.9,51.1,43,670,47,698,90,1368,6,6.3,6.2,"25% - 50% P.O.C.","$55000 - $78000"
"36071012200","Census Tract 122, Orange County, New York",3678,124063,2853,46,0,115,0,613,77.6,1.3,0,3.1,0,16.7,22.4,1225,934,291,76.24,23.76,191,743,27,264,218,1007,20.4,9.3,17.8,"Less than 25% P.O.C.","$104000 or more"
"36071012300","Census Tract 123, Orange County, New York",5467,112399,4569,38,0,56,0,752,83.6,0.7,0,1,0,13.8,16.4,1551,1520,31,98,2,319,1201,14,17,333,1218,21,45.2,21.5,"Less than 25% P.O.C.","$104000 or more"
"36071012601","Census Tract 126.01, Orange County, New York",4503,91438,2271,919,0,157,0,959,50.4,20.4,0,3.5,0,21.3,49.6,1511,1193,318,78.95,21.05,160,1033,34,284,194,1317,13.4,10.7,12.8,"25% - 50% P.O.C.","$78000 - $104000"
"36071012602","Census Tract 126.02, Orange County, New York",3031,46953,1306,690,0,163,0,792,43.1,22.8,0,5.4,0,26.1,56.9,1461,711,750,48.67,51.33,8,703,61,689,69,1392,1.1,8.1,4.7,"50% - 75% P.O.C.","Less than $55000"
"36071012700","Census Tract 127, Orange County, New York",4135,64071,2018,539,0,71,23,1437,48.8,13,0,1.7,0.6,34.8,51.2,1642,924,718,56.27,43.73,125,799,37,681,162,1480,13.5,5.2,9.9,"50% - 75% P.O.C.","$55000 - $78000"
"36071012800","Census Tract 128, Orange County, New York",4905,84375,3177,624,12,224,0,814,64.8,12.7,0.2,4.6,0,16.6,35.2,1880,1467,413,78.03,21.97,93,1374,36,377,129,1751,6.3,8.7,6.9,"25% - 50% P.O.C.","$78000 - $104000"
"36071012900","Census Tract 129, Orange County, New York",2858,96520,2557,13,0,63,19,206,89.5,0.5,0,2.2,0.7,7.2,10.5,1095,713,382,65.11,34.89,90,623,11,371,101,994,12.6,2.9,9.2,"Less than 25% P.O.C.","$78000 - $104000"
"36071013000","Census Tract 130, Orange County, New York",4559,82930,3465,123,0,209,0,713,76,2.7,0,4.6,0,15.6,24,1649,1063,586,64.46,35.54,115,948,33,553,148,1501,10.8,5.6,9,"Less than 25% P.O.C.","$78000 - $104000"
"36071013100","Census Tract 131, Orange County, New York",5028,141860,4325,42,0,154,0,444,86,0.8,0,3.1,0,8.8,14,1857,1475,382,79.43,20.57,167,1308,0,382,167,1690,11.3,0,9,"Less than 25% P.O.C.","$104000 or more"
"36071013201","Census Tract 132.01, Orange County, New York",5228,94208,3771,414,0,84,0,870,72.1,7.9,0,1.6,0,16.6,27.9,1822,1357,465,74.48,25.52,190,1167,32,433,222,1600,14,6.9,12.2,"25% - 50% P.O.C.","$78000 - $104000"
"36071013202","Census Tract 132.02, Orange County, New York",2217,93375,1432,162,0,45,0,555,64.6,7.3,0,2,0,25,35.4,837,681,156,81.36,18.64,47,634,32,124,79,758,6.9,20.5,9.4,"25% - 50% P.O.C.","$78000 - $104000"
"36071013300","Census Tract 133, Orange County, New York",6868,109359,5518,406,34,66,0,809,80.3,5.9,0.5,1,0,11.8,19.7,2319,1939,380,83.61,16.39,208,1731,35,345,243,2076,10.7,9.2,10.5,"Less than 25% P.O.C.","$104000 or more"
"36071013400","Census Tract 134, Orange County, New York",3293,84440,2216,347,0,96,0,602,67.3,10.5,0,2.9,0,18.3,32.7,1085,854,231,78.71,21.29,166,688,30,201,196,889,19.4,13,18.1,"25% - 50% P.O.C.","$78000 - $104000"
"36071013500","Census Tract 135, Orange County, New York",6147,131015,3802,599,0,427,0,1304,61.9,9.7,0,6.9,0,21.2,38.1,1965,1710,255,87.02,12.98,247,1463,27,228,274,1691,14.4,10.6,13.9,"25% - 50% P.O.C.","$104000 or more"
"36071013600","Census Tract 136, Orange County, New York",6383,115217,4462,419,26,318,10,698,69.9,6.6,0.4,5,0.2,10.9,30.1,875,9,866,1.03,98.97,0,9,239,627,239,636,0,27.6,27.3,"25% - 50% P.O.C.","$104000 or more"
"36071013700","Census Tract 137, Orange County, New York",2614,90154,1326,587,12,182,0,328,50.7,22.5,0.5,7,0,12.5,49.3,1079,544,535,50.42,49.58,76,468,30,505,106,973,14,5.6,9.8,"25% - 50% P.O.C.","$78000 - $104000"
"36071013800","Census Tract 138, Orange County, New York",3168,81250,2136,204,0,267,0,420,67.4,6.4,0,8.4,0,13.3,32.6,1263,836,427,66.19,33.81,65,771,34,393,99,1164,7.8,8,7.8,"25% - 50% P.O.C.","$78000 - $104000"
"36071013900","Census Tract 139, Orange County, New York",4663,128702,3209,185,0,233,0,906,68.8,4,0,5,0,19.4,31.2,1363,1228,135,90.1,9.9,246,982,27,108,273,1090,20,20,20,"25% - 50% P.O.C.","$104000 or more"
"36071014101","Census Tract 141.01, Orange County, New York",4405,86995,1977,413,9,195,0,1698,44.9,9.4,0.2,4.4,0,38.5,55.1,1349,933,416,69.16,30.84,181,752,126,290,307,1042,19.4,30.3,22.8,"50% - 75% P.O.C.","$78000 - $104000"
"36071014102","Census Tract 141.02, Orange County, New York",5945,87500,2474,850,8,806,0,1728,41.6,14.3,0.1,13.6,0,29.1,58.4,1850,1066,784,57.62,42.38,194,872,84,700,278,1572,18.2,10.7,15,"50% - 75% P.O.C.","$78000 - $104000"
"36071014201","Census Tract 142.01, Orange County, New York",3682,103553,2765,122,0,118,0,634,75.1,3.3,0,3.2,0,17.2,24.9,1208,1091,117,90.31,9.69,193,898,16,101,209,999,17.7,13.7,17.3,"Less than 25% P.O.C.","$78000 - $104000"
"36071014202","Census Tract 142.02, Orange County, New York",5928,150040,4009,315,102,158,0,970,67.6,5.3,1.7,2.7,0,16.4,32.4,1873,1661,212,88.68,11.32,226,1435,21,191,247,1626,13.6,9.9,13.2,"25% - 50% P.O.C.","$104000 or more"
"36071014301","Census Tract 143.01, Orange County, New York",5006,90353,2744,501,0,208,0,1466,54.8,10,0,4.2,0,29.3,45.2,1935,1237,698,63.93,36.07,98,1139,51,647,149,1786,7.9,7.3,7.7,"25% - 50% P.O.C.","$78000 - $104000"
"36071014302","Census Tract 143.02, Orange County, New York",7017,120875,5176,340,2,223,0,1097,73.8,4.8,0,3.2,0,15.6,26.2,2076,1996,80,96.15,3.85,319,1677,0,80,319,1757,16,0,15.4,"25% - 50% P.O.C.","$104000 or more"
"36071014400","Census Tract 144, Orange County, New York",4517,99063,3476,76,80,37,0,711,77,1.7,1.8,0.8,0,15.7,23,1637,1335,302,81.55,18.45,138,1197,29,273,167,1470,10.3,9.6,10.2,"Less than 25% P.O.C.","$78000 - $104000"
"36071014501","Census Tract 145.01, Orange County, New York",4159,118214,3587,107,0,104,0,260,86.2,2.6,0,2.5,0,6.3,13.8,1420,1229,191,86.55,13.45,224,1005,0,191,224,1196,18.2,0,15.8,"Less than 25% P.O.C.","$104000 or more"
"36071014502","Census Tract 145.02, Orange County, New York",5450,116103,5122,98,0,78,0,0,94,1.8,0,1.4,0,0,6,1969,1532,437,77.81,22.19,270,1262,28,409,298,1671,17.6,6.4,15.1,"Less than 25% P.O.C.","$104000 or more"
"36071014600","Census Tract 146, Orange County, New York",7082,81458,6025,74,101,140,45,670,85.1,1,1.4,2,0.6,9.5,14.9,2967,1814,1153,61.14,38.86,148,1666,77,1076,225,2742,8.2,6.7,7.6,"Less than 25% P.O.C.","$78000 - $104000"
"36071014700","Census Tract 147, Orange County, New York",4220,111458,3291,321,0,69,0,420,78,7.6,0,1.6,0,10,22,1288,1147,141,89.05,10.95,82,1065,16,125,98,1190,7.1,11.3,7.6,"Less than 25% P.O.C.","$104000 or more"
"36071014800","Census Tract 148, Orange County, New York",5789,81281,4743,72,98,25,0,814,81.9,1.2,1.7,0.4,0,14.1,18.1,2341,1794,547,76.63,23.37,187,1607,0,547,187,2154,10.4,0,8,"Less than 25% P.O.C.","$78000 - $104000"
"36071014900","Census Tract 149, Orange County, New York",3534,124808,2739,174,0,31,0,484,77.5,4.9,0,0.9,0,13.7,22.5,1398,1131,267,80.9,19.1,65,1066,10,257,75,1323,5.7,3.7,5.4,"Less than 25% P.O.C.","$104000 or more"
"36071015003","Census Tract 150.03, Orange County, New York",6396,31901,6195,5,0,0,0,151,96.9,0.1,0,0,0,2.4,3.1,1075,320,755,29.77,70.23,257,63,356,399,613,462,80.3,47.2,57,"Less than 25% P.O.C.","Less than $55000"
"36071015004","Census Tract 150.04, Orange County, New York",7389,34554,7291,0,0,0,0,98,98.7,0,0,0,0,1.3,1.3,1280,335,945,26.17,73.83,229,106,480,465,709,571,68.4,50.8,55.4,"Less than 25% P.O.C.","Less than $55000"
"36071015005","Census Tract 150.05, Orange County, New York",5127,32416,4902,14,0,0,0,204,95.6,0.3,0,0,0,4,4.4,903,198,705,21.93,78.07,168,30,374,331,542,361,84.8,53,60,"Less than 25% P.O.C.","Less than $55000"
"36071015006","Census Tract 150.06, Orange County, New York",6353,28441,6279,2,0,0,0,72,98.8,0,0,0,0,1.1,1.2,1025,383,642,37.37,62.63,252,131,291,351,543,482,65.8,45.3,53,"Less than 25% P.O.C.","Less than $55000"
"36071015100","Census Tract 151, Orange County, New York",6568,42168,1825,1094,0,78,0,2976,27.8,16.7,0,1.2,0,45.3,72.2,2247,906,1341,40.32,59.68,181,725,308,1033,489,1758,20,23,21.8,"50% - 75% P.O.C.","Less than $55000"
"36071015200","Census Tract 152, Orange County, New York",10722,117925,6573,1023,0,446,6,2448,61.3,9.5,0,4.2,0.1,22.8,38.7,3399,2862,537,84.2,15.8,409,2453,44,493,453,2946,14.3,8.2,13.3,"25% - 50% P.O.C.","$104000 or more"
"36079010100","Census Tract 101, Putnam County, New York",3455,91793,2251,137,0,69,0,957,65.2,4,0,2,0,27.7,34.8,1226,1031,195,84.09,15.91,97,934,32,163,129,1097,9.4,16.4,10.5,"25% - 50% P.O.C.","$78000 - $104000"
"36079010200","Census Tract 102, Putnam County, New York",8411,105281,6538,661,47,154,18,925,77.7,7.9,0.6,1.8,0.2,11,22.3,2504,2063,441,82.39,17.61,132,1931,11,430,143,2361,6.4,2.5,5.7,"Less than 25% P.O.C.","$104000 or more"
"36079010300","Census Tract 103, Putnam County, New York",4804,88375,3315,149,27,121,0,1034,69,3.1,0.6,2.5,0,21.5,31,1783,1641,142,92.04,7.96,129,1512,4,138,133,1650,7.9,2.8,7.5,"25% - 50% P.O.C.","$78000 - $104000"
"36079010400","Census Tract 104, Putnam County, New York",3263,95063,2426,266,0,75,0,488,74.3,8.2,0,2.3,0,15,25.7,1259,1087,172,86.34,13.66,137,950,51,121,188,1071,12.6,29.7,14.9,"25% - 50% P.O.C.","$78000 - $104000"
"36079010500","Census Tract 105, Putnam County, New York",5179,116890,4223,57,0,15,0,832,81.5,1.1,0,0.3,0,16.1,18.5,1808,1498,310,82.85,17.15,177,1321,4,306,181,1627,11.8,1.3,10,"Less than 25% P.O.C.","$104000 or more"
"36079010600","Census Tract 106, Putnam County, New York",3825,127857,3522,9,0,34,0,240,92.1,0.2,0,0.9,0,6.3,7.9,1374,1223,151,89.01,10.99,108,1115,7,144,115,1259,8.8,4.6,8.4,"Less than 25% P.O.C.","$104000 or more"
"36079010700","Census Tract 107, Putnam County, New York",2433,102143,2147,12,17,45,0,188,88.2,0.5,0.7,1.8,0,7.7,11.8,1058,698,360,65.97,34.03,35,663,10,350,45,1013,5,2.8,4.3,"Less than 25% P.O.C.","$78000 - $104000"
"36079010800","Census Tract 108, Putnam County, New York",3457,114766,2755,103,0,93,0,413,79.7,3,0,2.7,0,11.9,20.3,1111,1016,95,91.45,8.55,84,932,4,91,88,1023,8.3,4.2,7.9,"Less than 25% P.O.C.","$104000 or more"
"36079010900","Census Tract 109, Putnam County, New York",7531,102333,5736,544,0,172,0,838,76.2,7.2,0,2.3,0,11.1,23.8,2700,2294,406,84.96,15.04,155,2139,124,282,279,2421,6.8,30.5,10.3,"Less than 25% P.O.C.","$78000 - $104000"
"36079011000","Census Tract 110, Putnam County, New York",4066,117647,3308,132,0,13,0,548,81.4,3.2,0,0.3,0,13.5,18.6,1458,1305,153,89.51,10.49,81,1224,12,141,93,1365,6.2,7.8,6.4,"Less than 25% P.O.C.","$104000 or more"
"36079011100","Census Tract 111, Putnam County, New York",5152,118047,4367,30,0,90,0,616,84.8,0.6,0,1.7,0,12,15.2,1683,1583,100,94.06,5.94,221,1362,28,72,249,1434,14,28,14.8,"Less than 25% P.O.C.","$104000 or more"
"36079011200","Census Tract 112, Putnam County, New York",7290,96760,6042,0,0,317,0,887,82.9,0,0,4.3,0,12.2,17.1,2522,2036,486,80.73,19.27,281,1755,44,442,325,2197,13.8,9.1,12.9,"Less than 25% P.O.C.","$78000 - $104000"
"36079011300","Census Tract 113, Putnam County, New York",4069,102533,3526,1,0,74,0,364,86.7,0,0,1.8,0,8.9,13.3,1399,1180,219,84.35,15.65,71,1109,40,179,111,1288,6,18.3,7.9,"Less than 25% P.O.C.","$78000 - $104000"
"36079011400","Census Tract 114, Putnam County, New York",5225,99524,4469,42,0,22,0,570,85.5,0.8,0,0.4,0,10.9,14.5,1964,1463,501,74.49,25.51,163,1300,12,489,175,1789,11.1,2.4,8.9,"Less than 25% P.O.C.","$78000 - $104000"
"36079011500","Census Tract 115, Putnam County, New York",6345,91772,5183,188,0,9,0,913,81.7,3,0,0.1,0,14.4,18.3,2489,1767,722,70.99,29.01,149,1618,16,706,165,2324,8.4,2.2,6.6,"Less than 25% P.O.C.","$78000 - $104000"
"36079011600","Census Tract 116, Putnam County, New York",6129,119386,5342,72,0,51,0,664,87.2,1.2,0,0.8,0,10.8,12.8,2045,1688,357,82.54,17.46,159,1529,0,357,159,1886,9.4,0,7.8,"Less than 25% P.O.C.","$104000 or more"
"36079011700","Census Tract 117, Putnam County, New York",4930,128839,4107,104,0,120,0,500,83.3,2.1,0,2.4,0,10.1,16.7,1727,1478,249,85.58,14.42,143,1335,36,213,179,1548,9.7,14.5,10.4,"Less than 25% P.O.C.","$104000 or more"
"36079011800","Census Tract 118, Putnam County, New York",8139,85433,4764,139,0,372,0,2731,58.5,1.7,0,4.6,0,33.6,41.5,2942,1962,980,66.69,33.31,210,1752,110,870,320,2622,10.7,11.2,10.9,"25% - 50% P.O.C.","$78000 - $104000"
"36079011900","Census Tract 119, Putnam County, New York",5084,115250,3739,52,0,170,5,1079,73.5,1,0,3.3,0.1,21.2,26.5,1802,1500,302,83.24,16.76,99,1401,53,249,152,1650,6.6,17.5,8.4,"25% - 50% P.O.C.","$104000 or more"
"36081000100","Census Tract 1, Queens County, New York",9505,150421,5187,364,0,2505,0,966,54.6,3.8,0,26.4,0,10.2,45.4,4367,476,3891,10.9,89.1,26,450,24,3867,50,4317,5.5,0.6,1.1,"25% - 50% P.O.C.","$104000 or more"
"36081000200","Census Tract 2, Queens County, New York",3019,70655,397,76,0,510,0,2006,13.2,2.5,0,16.9,0,66.4,86.8,897,473,424,52.73,47.27,71,402,99,325,170,727,15,23.3,19,"75% or more P.O.C.","$55000 - $78000"
"36081000400","Census Tract 4, Queens County, New York",4476,63462,183,206,0,994,0,3018,4.1,4.6,0,22.2,0,67.4,95.9,1166,526,640,45.11,54.89,179,347,215,425,394,772,34,33.6,33.8,"75% or more P.O.C.","$55000 - $78000"
"36081000600","Census Tract 6, Queens County, New York",4107,83150,284,143,0,817,0,2765,6.9,3.5,0,19.9,0,67.3,93.1,1021,539,482,52.79,47.21,230,309,159,323,389,632,42.7,33,38.1,"75% or more P.O.C.","$78000 - $104000"
"36081000700","Census Tract 7, Queens County, New York",6336,134519,3327,105,0,1495,0,1146,52.5,1.7,0,23.6,0,18.1,47.5,2907,1092,1815,37.56,62.44,37,1055,30,1785,67,2840,3.4,1.7,2.3,"25% - 50% P.O.C.","$104000 or more"
"36081000800","Census Tract 8, Queens County, New York",3193,66439,365,124,40,676,0,1912,11.4,3.9,1.3,21.2,0,59.9,88.6,930,620,310,66.67,33.33,127,493,40,270,167,763,20.5,12.9,18,"75% or more P.O.C.","$55000 - $78000"
"36081001000","Census Tract 10, Queens County, New York",4618,97702,558,50,0,878,0,3088,12.1,1.1,0,19,0,66.9,87.9,985,477,508,48.43,51.57,174,303,148,360,322,663,36.5,29.1,32.7,"75% or more P.O.C.","$78000 - $104000"
"36081001200","Census Tract 12, Queens County, New York",3578,68529,736,70,0,773,0,1999,20.6,2,0,21.6,0,55.9,79.4,1156,400,756,34.6,65.4,100,300,57,699,157,999,25,7.5,13.6,"75% or more P.O.C.","$55000 - $78000"
"36081001400","Census Tract 14, Queens County, New York",4308,71620,800,43,0,784,0,2543,18.6,1,0,18.2,0,59,81.4,1044,528,516,50.57,49.43,224,304,124,392,348,696,42.4,24,33.3,"75% or more P.O.C.","$55000 - $78000"
"36081001600","Census Tract 16, Queens County, New York",2420,83816,252,103,0,514,0,1356,10.4,4.3,0,21.2,0,56,89.6,736,504,232,68.48,31.52,37,467,51,181,88,648,7.3,22,12,"75% or more P.O.C.","$78000 - $104000"
"36081001800","Census Tract 18, Queens County, New York",2796,69479,388,85,24,513,0,1654,13.9,3,0.9,18.3,0,59.2,86.1,843,439,404,52.08,47.92,103,336,7,397,110,733,23.5,1.7,13,"75% or more P.O.C.","$55000 - $78000"
"36081001900","Census Tract 19, Queens County, New York",4358,141914,1743,146,0,1837,0,465,40,3.4,0,42.2,0,10.7,60,2193,420,1773,19.15,80.85,24,396,9,1764,33,2160,5.7,0.5,1.5,"50% - 75% P.O.C.","$104000 or more"
"36081002000","Census Tract 20, Queens County, New York",1721,86938,224,3,0,570,0,916,13,0.2,0,33.1,0,53.2,87,465,255,210,54.84,45.16,58,197,35,175,93,372,22.7,16.7,20,"75% or more P.O.C.","$78000 - $104000"
"36081002200","Census Tract 22, Queens County, New York",2314,77813,430,47,0,292,0,1435,18.6,2,0,12.6,0,62,81.4,723,309,414,42.74,57.26,65,244,55,359,120,603,21,13.3,16.6,"75% or more P.O.C.","$55000 - $78000"
"36081002400","Census Tract 24, Queens County, New York",2382,73250,207,107,1,555,0,1364,8.7,4.5,0,23.3,0,57.3,91.3,689,389,300,56.46,43.54,85,304,26,274,111,578,21.9,8.7,16.1,"75% or more P.O.C.","$55000 - $78000"
"36081002500","Census Tract 25, Queens County, New York",6802,19178,221,3192,0,767,0,2454,3.2,46.9,0,11.3,0,36.1,96.8,3057,38,3019,1.24,98.76,0,38,203,2816,203,2854,0,6.7,6.6,"75% or more P.O.C.","Less than $55000"
"36081002600","Census Tract 26, Queens County, New York",2272,87019,356,113,0,420,0,1250,15.7,5,0,18.5,0,55,84.3,617,400,217,64.83,35.17,62,338,62,155,124,493,15.5,28.6,20.1,"75% or more P.O.C.","$78000 - $104000"
"36081002800","Census Tract 28, Queens County, New York",3573,59398,494,159,0,792,0,1880,13.8,4.5,0,22.2,0,52.6,86.2,941,345,596,36.66,63.34,84,261,108,488,192,749,24.3,18.1,20.4,"75% or more P.O.C.","$55000 - $78000"
"36081003000","Census Tract 30, Queens County, New York",1524,60278,390,42,0,242,0,756,25.6,2.8,0,15.9,0,49.6,74.4,412,236,176,57.28,42.72,51,185,63,113,114,298,21.6,35.8,27.7,"50% - 75% P.O.C.","$55000 - $78000"
"36081003100","Census Tract 31, Queens County, New York",1144,81635,346,38,0,190,0,559,30.2,3.3,0,16.6,0,48.9,69.8,465,82,383,17.63,82.37,0,82,17,366,17,448,0,4.4,3.7,"50% - 75% P.O.C.","$78000 - $104000"
"36081003200","Census Tract 32, Queens County, New York",1764,53600,198,118,0,442,0,906,11.2,6.7,0,25.1,0,51.4,88.8,514,288,226,56.03,43.97,92,196,17,209,109,405,31.9,7.5,21.2,"75% or more P.O.C.","Less than $55000"
"36081003300","Census Tract 33, Queens County, New York",3569,89669,1111,78,0,1181,49,1026,31.1,2.2,0,33.1,1.4,28.7,68.9,1632,220,1412,13.48,86.52,59,161,43,1369,102,1530,26.8,3,6.2,"50% - 75% P.O.C.","$78000 - $104000"
"36081003400","Census Tract 34, Queens County, New York",2612,76923,299,73,0,489,0,1665,11.4,2.8,0,18.7,0,63.7,88.6,662,445,217,67.22,32.78,137,308,56,161,193,469,30.8,25.8,29.2,"75% or more P.O.C.","$55000 - $78000"
"36081003600","Census Tract 36, Queens County, New York",3584,80868,287,26,0,1339,0,1830,8,0.7,0,37.4,0,51.1,92,881,372,509,42.22,57.78,123,249,188,321,311,570,33.1,36.9,35.3,"75% or more P.O.C.","$78000 - $104000"
"36081003700","Census Tract 37, Queens County, New York",0,NA,0,0,0,0,0,0,NA,NA,NA,NA,NA,NA,NA,0,0,0,NA,NA,0,0,0,0,0,0,NA,NA,NA,"N/A","N/A"
"36081003800","Census Tract 38, Queens County, New York",2757,71111,221,245,0,479,0,1705,8,8.9,0,17.4,0,61.8,92,724,207,517,28.59,71.41,79,128,74,443,153,571,38.2,14.3,21.1,"75% or more P.O.C.","$55000 - $78000"
"36081003900","Census Tract 39, Queens County, New York",1439,48269,458,60,0,140,0,739,31.8,4.2,0,9.7,0,51.4,68.2,416,42,374,10.1,89.9,3,39,45,329,48,368,7.1,12,11.5,"50% - 75% P.O.C.","Less than $55000"
"36081004001","Census Tract 40.01, Queens County, New York",2365,80192,661,90,0,519,29,1012,27.9,3.8,0,21.9,1.2,42.8,72.1,656,282,374,42.99,57.01,75,207,81,293,156,500,26.6,21.7,23.8,"50% - 75% P.O.C.","$78000 - $104000"
"36081004002","Census Tract 40.02, Queens County, New York",1459,64196,163,119,0,492,0,599,11.2,8.2,0,33.7,0,41.1,88.8,403,125,278,31.02,68.98,6,119,103,175,109,294,4.8,37.1,27,"75% or more P.O.C.","$55000 - $78000"
"36081004200","Census Tract 42, Queens County, New York",4016,57554,431,158,0,1675,0,1588,10.7,3.9,0,41.7,0,39.5,89.3,1182,480,702,40.61,59.39,111,369,97,605,208,974,23.1,13.8,17.6,"75% or more P.O.C.","$55000 - $78000"
"36081004300","Census Tract 43, Queens County, New York",2283,22939,86,931,0,255,0,948,3.8,40.8,0,11.2,0,41.5,96.2,1027,0,1027,0,100,0,0,76,951,76,951,NA,7.4,7.4,"75% or more P.O.C.","Less than $55000"
"36081004401","Census Tract 44.01, Queens County, New York",3732,69583,293,183,0,2205,0,938,7.9,4.9,0,59.1,0,25.1,92.1,887,385,502,43.4,56.6,173,212,148,354,321,566,44.9,29.5,36.2,"75% or more P.O.C.","$55000 - $78000"
"36081004500","Census Tract 45, Queens County, New York",3194,76328,1768,91,0,698,0,565,55.4,2.8,0,21.9,0,17.7,44.6,1470,1119,351,76.12,23.88,72,1047,8,343,80,1390,6.4,2.3,5.4,"25% - 50% P.O.C.","$55000 - $78000"
"36081004700","Census Tract 47, Queens County, New York",3665,38542,957,908,0,527,0,1136,26.1,24.8,0,14.4,0,31,73.9,1727,158,1569,9.15,90.85,34,124,33,1536,67,1660,21.5,2.1,3.9,"50% - 75% P.O.C.","Less than $55000"
"36081005000","Census Tract 50, Queens County, New York",49,NA,9,0,0,0,0,40,18.4,0,0,0,0,81.6,81.6,31,10,21,32.26,67.74,0,10,0,21,0,31,0,0,0,"75% or more P.O.C.","N/A"
"36081005100","Census Tract 51, Queens County, New York",1866,50868,507,54,18,1001,8,247,27.2,2.9,1,53.6,0.4,13.2,72.8,717,88,629,12.27,87.73,13,75,39,590,52,665,14.8,6.2,7.3,"50% - 75% P.O.C.","Less than $55000"
"36081005200","Census Tract 52, Queens County, New York",2817,62250,293,195,0,1376,0,773,10.4,6.9,0,48.8,0,27.4,89.6,727,294,433,40.44,59.56,89,205,130,303,219,508,30.3,30,30.1,"75% or more P.O.C.","$55000 - $78000"
"36081005300","Census Tract 53, Queens County, New York",5092,86677,2257,123,24,1304,0,885,44.3,2.4,0.5,25.6,0,17.4,55.7,2372,382,1990,16.1,83.9,45,337,93,1897,138,2234,11.8,4.7,5.8,"50% - 75% P.O.C.","$78000 - $104000"
"36081005400","Census Tract 54, Queens County, New York",5862,77854,935,426,0,1798,0,2187,16,7.3,0,30.7,0,37.3,84,1645,1050,595,63.83,36.17,273,777,31,564,304,1341,26,5.2,18.5,"75% or more P.O.C.","$55000 - $78000"
"36081005500","Census Tract 55, Queens County, New York",952,71628,236,9,0,222,0,454,24.8,0.9,0,23.3,0,47.7,75.2,388,58,330,14.95,85.05,22,36,18,312,40,348,37.9,5.5,10.3,"75% or more P.O.C.","$55000 - $78000"
"36081005700","Census Tract 57, Queens County, New York",4212,68156,1533,103,0,1045,0,1417,36.4,2.4,0,24.8,0,33.6,63.6,1649,78,1571,4.73,95.27,18,60,156,1415,174,1475,23.1,9.9,10.6,"50% - 75% P.O.C.","$55000 - $78000"
"36081005800","Census Tract 58, Queens County, New York",6355,90230,1599,560,0,848,0,3074,25.2,8.8,0,13.3,0,48.4,74.8,1927,1222,705,63.41,36.59,224,998,71,634,295,1632,18.3,10.1,15.3,"50% - 75% P.O.C.","$78000 - $104000"
"36081005900","Census Tract 59, Queens County, New York",4057,82208,2392,69,0,554,0,928,59,1.7,0,13.7,0,22.9,41,1729,283,1446,16.37,83.63,18,265,141,1305,159,1570,6.4,9.8,9.2,"25% - 50% P.O.C.","$78000 - $104000"
"36081006100","Census Tract 61, Queens County, New York",5548,77941,3020,104,0,1023,0,1234,54.4,1.9,0,18.4,0,22.2,45.6,2760,240,2520,8.7,91.3,0,240,97,2423,97,2663,0,3.8,3.5,"25% - 50% P.O.C.","$55000 - $78000"
"36081006201","Census Tract 62.01, Queens County, New York",5593,61514,3367,91,0,410,0,1624,60.2,1.6,0,7.3,0,29,39.8,2882,2577,305,89.42,10.58,48,2529,0,305,48,2834,1.9,0,1.7,"25% - 50% P.O.C.","$55000 - $78000"
"36081006202","Census Tract 62.02, Queens County, New York",6459,53676,2930,295,0,412,0,2322,45.4,4.6,0,6.4,0,35.9,54.6,2400,954,1446,39.75,60.25,59,895,116,1330,175,2225,6.2,8,7.3,"50% - 75% P.O.C.","Less than $55000"
"36081006300","Census Tract 63, Queens County, New York",5690,87719,3157,135,0,1042,0,1256,55.5,2.4,0,18.3,0,22.1,44.5,2538,245,2293,9.65,90.35,32,213,56,2237,88,2450,13.1,2.4,3.5,"25% - 50% P.O.C.","$78000 - $104000"
"36081006501","Census Tract 65.01, Queens County, New York",3450,77372,2006,99,0,462,0,814,58.1,2.9,0,13.4,0,23.6,41.9,1680,133,1547,7.92,92.08,0,133,54,1493,54,1626,0,3.5,3.2,"25% - 50% P.O.C.","$55000 - $78000"
"36081006502","Census Tract 65.02, Queens County, New York",3494,84070,2060,120,0,324,0,938,59,3.4,0,9.3,0,26.8,41,1754,255,1499,14.54,85.46,13,242,48,1451,61,1693,5.1,3.2,3.5,"25% - 50% P.O.C.","$78000 - $104000"
"36081006900","Census Tract 69, Queens County, New York",3699,79953,1777,128,0,750,0,968,48,3.5,0,20.3,0,26.2,52,1648,232,1416,14.08,85.92,48,184,33,1383,81,1567,20.7,2.3,4.9,"50% - 75% P.O.C.","$78000 - $104000"
"36081007100","Census Tract 71, Queens County, New York",3344,76420,1877,110,0,488,0,598,56.1,3.3,0,14.6,0,17.9,43.9,1702,140,1562,8.23,91.77,10,130,28,1534,38,1664,7.1,1.8,2.2,"25% - 50% P.O.C.","$55000 - $78000"
"36081007300","Census Tract 73, Queens County, New York",3933,81963,2060,78,23,940,0,757,52.4,2,0.6,23.9,0,19.2,47.6,1963,291,1672,14.82,85.18,0,291,43,1629,43,1920,0,2.6,2.2,"25% - 50% P.O.C.","$78000 - $104000"
"36081007500","Census Tract 75, Queens County, New York",3959,75982,2240,55,0,969,0,580,56.6,1.4,0,24.5,0,14.7,43.4,2015,368,1647,18.26,81.74,49,319,105,1542,154,1861,13.3,6.4,7.6,"25% - 50% P.O.C.","$55000 - $78000"
"36081007700","Census Tract 77, Queens County, New York",1856,92500,750,17,0,437,0,572,40.4,0.9,0,23.5,0,30.8,59.6,730,162,568,22.19,77.81,10,152,67,501,77,653,6.2,11.8,10.5,"50% - 75% P.O.C.","$78000 - $104000"
"36081007900","Census Tract 79, Queens County, New York",2685,68463,1263,0,0,684,0,643,47,0,0,25.5,0,23.9,53,1183,244,939,20.63,79.37,55,189,60,879,115,1068,22.5,6.4,9.7,"50% - 75% P.O.C.","$55000 - $78000"
"36081008100","Census Tract 81, Queens County, New York",1269,84375,486,37,0,156,0,544,38.3,2.9,0,12.3,0,42.9,61.7,590,145,445,24.58,75.42,16,129,26,419,42,548,11,5.8,7.1,"50% - 75% P.O.C.","$78000 - $104000"
"36081008300","Census Tract 83, Queens County, New York",2409,60951,792,85,0,461,0,925,32.9,3.5,0,19.1,0,38.4,67.1,963,165,798,17.13,82.87,49,116,59,739,108,855,29.7,7.4,11.2,"50% - 75% P.O.C.","$55000 - $78000"
"36081008500","Census Tract 85, Queens County, New York",883,48203,332,53,0,143,0,353,37.6,6,0,16.2,0,40,62.4,335,52,283,15.52,84.48,10,42,21,262,31,304,19.2,7.4,9.3,"50% - 75% P.O.C.","Less than $55000"
"36081008600","Census Tract 86, Queens County, New York",2846,77545,806,22,0,501,6,1336,28.3,0.8,0,17.6,0.2,46.9,71.7,895,598,297,66.82,33.18,97,501,53,244,150,745,16.2,17.8,16.8,"50% - 75% P.O.C.","$55000 - $78000"
"36081008700","Census Tract 87, Queens County, New York",4052,26750,395,1695,0,127,0,1791,9.7,41.8,0,3.1,0,44.2,90.3,1391,0,1391,0,100,0,0,208,1183,208,1183,NA,15,15,"75% or more P.O.C.","Less than $55000"
"36081008800","Census Tract 88, Queens County, New York",3663,76875,1336,85,0,389,0,1853,36.5,2.3,0,10.6,0,50.6,63.5,1167,835,332,71.55,28.45,140,695,0,332,140,1027,16.8,0,12,"50% - 75% P.O.C.","$55000 - $78000"
"36081009100","Census Tract 91, Queens County, New York",2303,71767,1147,82,0,274,0,793,49.8,3.6,0,11.9,0,34.4,50.2,1087,406,681,37.35,62.65,12,394,12,669,24,1063,3,1.8,2.2,"50% - 75% P.O.C.","$55000 - $78000"
"36081009400","Census Tract 94, Queens County, New York",2769,62308,246,227,0,1368,0,768,8.9,8.2,0,49.4,0,27.7,91.1,716,380,336,53.07,46.93,124,256,71,265,195,521,32.6,21.1,27.2,"75% or more P.O.C.","$55000 - $78000"
"36081009500","Census Tract 95, Queens County, New York",2276,82500,1450,85,0,361,0,320,63.7,3.7,0,15.9,0,14.1,36.3,850,232,618,27.29,72.71,36,196,37,581,73,777,15.5,6,8.6,"25% - 50% P.O.C.","$78000 - $104000"
"36081009600","Census Tract 96, Queens County, New York",3522,91125,322,317,11,911,0,810,9.1,9,0.3,25.9,0,23,90.9,925,688,237,74.38,25.62,178,510,35,202,213,712,25.9,14.8,23,"75% or more P.O.C.","$78000 - $104000"
"36081009700","Census Tract 97, Queens County, New York",3693,91675,2543,57,0,557,0,412,68.9,1.5,0,15.1,0,11.2,31.1,1471,373,1098,25.36,74.64,39,334,38,1060,77,1394,10.5,3.5,5.2,"25% - 50% P.O.C.","$78000 - $104000"
"36081009800","Census Tract 98, Queens County, New York",2705,76917,23,360,0,991,0,435,0.9,13.3,0,36.6,0,16.1,99.1,673,281,392,41.75,58.25,129,152,73,319,202,471,45.9,18.6,30,"75% or more P.O.C.","$55000 - $78000"
"36081009900","Census Tract 99, Queens County, New York",0,NA,0,0,0,0,0,0,NA,NA,NA,NA,NA,NA,NA,0,0,0,NA,NA,0,0,0,0,0,0,NA,NA,NA,"N/A","N/A"
"36081010000","Census Tract 100, Queens County, New York",3686,109583,371,454,0,1095,0,1104,10.1,12.3,0,29.7,0,30,89.9,963,740,223,76.84,23.16,142,598,68,155,210,753,19.2,30.5,21.8,"75% or more P.O.C.","$104000 or more"
"36081010100","Census Tract 101, Queens County, New York",2382,67273,1785,103,0,218,0,221,74.9,4.3,0,9.2,0,9.3,25.1,1008,337,671,33.43,66.57,19,318,43,628,62,946,5.6,6.4,6.2,"25% - 50% P.O.C.","$55000 - $78000"
"36081010200","Census Tract 102, Queens County, New York",2817,67404,206,380,0,1252,0,614,7.3,13.5,0,44.4,0,21.8,92.7,725,490,235,67.59,32.41,125,365,69,166,194,531,25.5,29.4,26.8,"75% or more P.O.C.","$55000 - $78000"
"36081010300","Census Tract 103, Queens County, New York",4136,72941,2463,113,0,605,0,846,59.6,2.7,0,14.6,0,20.5,40.4,1828,435,1393,23.8,76.2,71,364,26,1367,97,1731,16.3,1.9,5.3,"25% - 50% P.O.C.","$55000 - $78000"
"36081010400","Census Tract 104, Queens County, New York",3014,67083,190,740,0,747,0,377,6.3,24.6,0,24.8,0,12.5,93.7,848,610,238,71.93,28.07,152,458,24,214,176,672,24.9,10.1,20.8,"75% or more P.O.C.","$55000 - $78000"
"36081010500","Census Tract 105, Queens County, New York",4522,65551,2134,109,0,846,0,1316,47.2,2.4,0,18.7,0,29.1,52.8,1687,245,1442,14.52,85.48,45,200,102,1340,147,1540,18.4,7.1,8.7,"50% - 75% P.O.C.","$55000 - $78000"
"36081010600","Census Tract 106, Queens County, New York",3733,66094,89,447,0,1771,0,422,2.4,12,0,47.4,0,11.3,97.6,843,492,351,58.36,41.64,194,298,111,240,305,538,39.4,31.6,36.2,"75% or more P.O.C.","$55000 - $78000"
"36081010701","Census Tract 107.01, Queens County, New York",0,NA,0,0,0,0,0,0,NA,NA,NA,NA,NA,NA,NA,0,0,0,NA,NA,0,0,0,0,0,0,NA,NA,NA,"N/A","N/A"
"36081010800","Census Tract 108, Queens County, New York",3364,67617,136,228,0,1509,0,638,4,6.8,0,44.9,0,19,96,785,364,421,46.37,53.63,123,241,87,334,210,575,33.8,20.7,26.8,"75% or more P.O.C.","$55000 - $78000"
"36081011000","Census Tract 110, Queens County, New York",3234,81667,386,268,70,884,0,1076,11.9,8.3,2.2,27.3,0,33.3,88.1,828,392,436,47.34,52.66,101,291,54,382,155,673,25.8,12.4,18.7,"75% or more P.O.C.","$78000 - $104000"
"36081011100","Census Tract 111, Queens County, New York",3116,81250,1795,69,0,364,0,787,57.6,2.2,0,11.7,0,25.3,42.4,1242,319,923,25.68,74.32,37,282,118,805,155,1087,11.6,12.8,12.5,"25% - 50% P.O.C.","$78000 - $104000"
"36081011200","Census Tract 112, Queens County, New York",2279,63472,533,81,0,905,0,531,23.4,3.6,0,39.7,0,23.3,76.6,632,327,305,51.74,48.26,84,243,37,268,121,511,25.7,12.1,19.1,"75% or more P.O.C.","$55000 - $78000"
"36081011300","Census Tract 113, Queens County, New York",4463,83146,2343,91,0,554,0,1343,52.5,2,0,12.4,0,30.1,47.5,1789,498,1291,27.84,72.16,83,415,77,1214,160,1629,16.7,6,8.9,"25% - 50% P.O.C.","$78000 - $104000"
"36081011400","Census Tract 114, Queens County, New York",1303,49223,262,79,0,370,0,512,20.1,6.1,0,28.4,0,39.3,79.9,351,154,197,43.87,56.13,12,142,49,148,61,290,7.8,24.9,17.4,"75% or more P.O.C.","Less than $55000"
"36081011500","Census Tract 115, Queens County, New York",2438,81458,1648,7,0,223,0,476,67.6,0.3,0,9.1,0,19.5,32.4,1090,311,779,28.53,71.47,46,265,9,770,55,1035,14.8,1.2,5,"25% - 50% P.O.C.","$78000 - $104000"
"36081011600","Census Tract 116, Queens County, New York",1980,80313,195,107,0,876,0,713,9.8,5.4,0,44.2,0,36,90.2,557,272,285,48.83,51.17,61,211,55,230,116,441,22.4,19.3,20.8,"75% or more P.O.C.","$78000 - $104000"
"36081011700","Census Tract 117, Queens County, New York",3574,85833,2646,41,0,301,0,545,74,1.1,0,8.4,0,15.2,26,1458,402,1056,27.57,72.43,25,377,53,1003,78,1380,6.2,5,5.3,"25% - 50% P.O.C.","$78000 - $104000"
"36081011800","Census Tract 118, Queens County, New York",2522,70333,50,118,0,988,0,943,2,4.7,0,39.2,0,37.4,98,628,306,322,48.73,51.27,111,195,113,209,224,404,36.3,35.1,35.7,"75% or more P.O.C.","$55000 - $78000"
"36081011900","Census Tract 119, Queens County, New York",1409,68897,859,0,7,83,0,346,61,0,0.5,5.9,0,24.6,39,669,138,531,20.63,79.37,4,134,29,502,33,636,2.9,5.5,4.9,"25% - 50% P.O.C.","$55000 - $78000"
"36081012000","Census Tract 120, Queens County, New York",2365,62105,114,134,0,1122,0,769,4.8,5.7,0,47.4,0,32.5,95.2,632,345,287,54.59,45.41,154,191,25,262,179,453,44.6,8.7,28.3,"75% or more P.O.C.","$55000 - $78000"
"36081012100","Census Tract 121, Queens County, New York",2034,83056,1453,78,5,114,0,347,71.4,3.8,0.2,5.6,0,17.1,28.6,858,281,577,32.75,67.25,23,258,11,566,34,824,8.2,1.9,4,"25% - 50% P.O.C.","$78000 - $104000"
"36081012200","Census Tract 122, Queens County, New York",3128,72552,117,135,9,1491,0,1015,3.7,4.3,0.3,47.7,0,32.4,96.3,721,355,366,49.24,50.76,156,199,76,290,232,489,43.9,20.8,32.2,"75% or more P.O.C.","$55000 - $78000"
"36081012301","Census Tract 123.01, Queens County, New York",2782,96086,1831,99,0,203,0,611,65.8,3.6,0,7.3,0,22,34.2,1129,491,638,43.49,56.51,54,437,12,626,66,1063,11,1.9,5.8,"25% - 50% P.O.C.","$78000 - $104000"
"36081012400","Census Tract 124, Queens County, New York",3374,76758,287,424,105,621,0,1586,8.5,12.6,3.1,18.4,0,47,91.5,841,357,484,42.45,57.55,131,226,74,410,205,636,36.7,15.3,24.4,"75% or more P.O.C.","$55000 - $78000"
"36081012500","Census Tract 125, Queens County, New York",1762,83984,1019,85,0,206,0,398,57.8,4.8,0,11.7,0,22.6,42.2,709,106,603,14.95,85.05,0,106,40,563,40,669,0,6.6,5.6,"25% - 50% P.O.C.","$78000 - $104000"
"36081012601","Census Tract 126.01, Queens County, New York",2750,73634,175,185,0,459,0,1545,6.4,6.7,0,16.7,0,56.2,93.6,731,303,428,41.45,58.55,51,252,183,245,234,497,16.8,42.8,32,"75% or more P.O.C.","$55000 - $78000"
"36081012602","Census Tract 126.02, Queens County, New York",2792,54899,387,33,0,640,0,1669,13.9,1.2,0,22.9,0,59.8,86.1,735,381,354,51.84,48.16,96,285,126,228,222,513,25.2,35.6,30.2,"75% or more P.O.C.","Less than $55000"
"36081012800","Census Tract 128, Queens County, New York",2380,66250,598,68,0,352,0,1308,25.1,2.9,0,14.8,0,55,74.9,739,376,363,50.88,49.12,83,293,47,316,130,609,22.1,12.9,17.6,"50% - 75% P.O.C.","$55000 - $78000"
"36081013000","Census Tract 130, Queens County, New York",1688,73147,640,166,0,452,0,324,37.9,9.8,0,26.8,0,19.2,62.1,541,201,340,37.15,62.85,30,171,31,309,61,480,14.9,9.1,11.3,"50% - 75% P.O.C.","$55000 - $78000"
"36081013200","Census Tract 132, Queens County, New York",2265,68359,824,56,80,274,0,973,36.4,2.5,3.5,12.1,0,43,63.6,625,239,386,38.24,61.76,70,169,128,258,198,427,29.3,33.2,31.7,"50% - 75% P.O.C.","$55000 - $78000"
"36081013400","Census Tract 134, Queens County, New York",4678,57891,2029,593,20,607,0,1349,43.4,12.7,0.4,13,0,28.8,56.6,2521,650,1871,25.78,74.22,0,650,63,1808,63,2458,0,3.4,2.5,"50% - 75% P.O.C.","$55000 - $78000"
"36081013500","Census Tract 135, Queens County, New York",1306,78681,1103,5,0,58,0,140,84.5,0.4,0,4.4,0,10.7,15.5,513,262,251,51.07,48.93,10,252,24,227,34,479,3.8,9.6,6.6,"Less than 25% P.O.C.","$78000 - $104000"
"36081013600","Census Tract 136, Queens County, New York",1874,76538,1164,106,0,123,15,434,62.1,5.7,0,6.6,0.8,23.2,37.9,822,366,456,44.53,55.47,61,305,13,443,74,748,16.7,2.9,9,"25% - 50% P.O.C.","$55000 - $78000"
"36081013700","Census Tract 137, Queens County, New York",1773,97100,1336,14,0,113,0,258,75.4,0.8,0,6.4,0,14.6,24.6,740,213,527,28.78,71.22,0,213,24,503,24,716,0,4.6,3.2,"Less than 25% P.O.C.","$78000 - $104000"
"36081013800","Census Tract 138, Queens County, New York",3608,68125,1296,191,110,920,0,991,35.9,5.3,3,25.5,0,27.5,64.1,1488,536,952,36.02,63.98,19,517,49,903,68,1420,3.5,5.1,4.6,"50% - 75% P.O.C.","$55000 - $78000"
"36081014000","Census Tract 140, Queens County, New York",3766,71439,1816,186,0,605,0,962,48.2,4.9,0,16.1,0,25.5,51.8,1324,581,743,43.88,56.12,110,471,102,641,212,1112,18.9,13.7,16,"50% - 75% P.O.C.","$55000 - $78000"
"36081014100","Census Tract 141, Queens County, New York",1636,66923,760,27,0,110,0,562,46.5,1.7,0,6.7,0,34.4,53.5,654,73,581,11.16,88.84,15,58,37,544,52,602,20.5,6.4,8,"50% - 75% P.O.C.","$55000 - $78000"
"36081014201","Census Tract 142.01, Queens County, New York",4334,68657,255,494,20,1445,0,1815,5.9,11.4,0.5,33.3,0,41.9,94.1,1227,335,892,27.3,72.7,48,287,165,727,213,1014,14.3,18.5,17.4,"75% or more P.O.C.","$55000 - $78000"
"36081014202","Census Tract 142.02, Queens County, New York",2856,67614,173,220,17,721,0,1343,6.1,7.7,0.6,25.2,0,47,93.9,625,256,369,40.96,59.04,57,199,119,250,176,449,22.3,32.2,28.2,"75% or more P.O.C.","$55000 - $78000"
"36081014300","Census Tract 143, Queens County, New York",3772,70197,2086,56,16,556,0,950,55.3,1.5,0.4,14.7,0,25.2,44.7,1610,206,1404,12.8,87.2,0,206,42,1362,42,1568,0,3,2.6,"25% - 50% P.O.C.","$55000 - $78000"
"36081014400","Census Tract 144, Queens County, New York",1915,56875,113,185,10,569,0,807,5.9,9.7,0.5,29.7,0,42.1,94.1,541,207,334,38.26,61.74,57,150,87,247,144,397,27.5,26,26.6,"75% or more P.O.C.","$55000 - $78000"
"36081014500","Census Tract 145, Queens County, New York",2412,74926,1551,68,0,132,0,626,64.3,2.8,0,5.5,0,26,35.7,876,283,593,32.31,67.69,31,252,65,528,96,780,11,11,11,"25% - 50% P.O.C.","$55000 - $78000"
"36081014700","Census Tract 147, Queens County, New York",2768,83333,1943,21,0,422,0,357,70.2,0.8,0,15.2,0,12.9,29.8,1190,268,922,22.52,77.48,19,249,19,903,38,1152,7.1,2.1,3.2,"25% - 50% P.O.C.","$78000 - $104000"
"36081014800","Census Tract 148, Queens County, New York",1719,64901,45,244,0,751,0,416,2.6,14.2,0,43.7,0,24.2,97.4,471,310,161,65.82,34.18,110,200,3,158,113,358,35.5,1.9,24,"75% or more P.O.C.","$55000 - $78000"
"36081014900","Census Tract 149, Queens County, New York",1842,69659,1138,3,0,152,0,549,61.8,0.2,0,8.3,0,29.8,38.2,873,83,790,9.51,90.49,14,69,20,770,34,839,16.9,2.5,3.9,"25% - 50% P.O.C.","$55000 - $78000"
"36081015000","Census Tract 150, Queens County, New York",2899,92438,39,373,0,1044,20,495,1.3,12.9,0,36,0.7,17.1,98.7,661,492,169,74.43,25.57,182,310,36,133,218,443,37,21.3,33,"75% or more P.O.C.","$78000 - $104000"
"36081015100","Census Tract 151, Queens County, New York",2613,69083,1691,56,0,260,0,568,64.7,2.1,0,10,0,21.7,35.3,1201,238,963,19.82,80.18,5,233,48,915,53,1148,2.1,5,4.4,"25% - 50% P.O.C.","$55000 - $78000"
"36081015200","Census Tract 152, Queens County, New York",2822,64643,105,489,0,910,0,813,3.7,17.3,0,32.2,0,28.8,96.3,712,350,362,49.16,50.84,101,249,119,243,220,492,28.9,32.9,30.9,"75% or more P.O.C.","$55000 - $78000"
"36081015300","Census Tract 153, Queens County, New York",1933,80161,883,86,0,425,40,411,45.7,4.4,0,22,2.1,21.3,54.3,814,128,686,15.72,84.28,20,108,9,677,29,785,15.6,1.3,3.6,"50% - 75% P.O.C.","$78000 - $104000"
"36081015400","Census Tract 154, Queens County, New York",2170,75118,67,258,0,859,0,249,3.1,11.9,0,39.6,0,11.5,96.9,593,289,304,48.74,51.26,93,196,25,279,118,475,32.2,8.2,19.9,"75% or more P.O.C.","$55000 - $78000"
"36081015500","Census Tract 155, Queens County, New York",2358,95208,1377,30,0,420,0,459,58.4,1.3,0,17.8,0,19.5,41.6,847,184,663,21.72,78.28,16,168,37,626,53,794,8.7,5.6,6.3,"25% - 50% P.O.C.","$78000 - $104000"
"36081015600","Census Tract 156, Queens County, New York",2908,69152,103,495,115,1095,13,400,3.5,17,4,37.7,0.4,13.8,96.5,811,495,316,61.04,38.96,97,398,48,268,145,666,19.6,15.2,17.9,"75% or more P.O.C.","$55000 - $78000"
"36081015700","Census Tract 157, Queens County, New York",1305,62500,396,47,0,326,0,477,30.3,3.6,0,25,0,36.6,69.7,582,16,566,2.75,97.25,0,16,25,541,25,557,0,4.4,4.3,"50% - 75% P.O.C.","$55000 - $78000"
"36081015801","Census Tract 158.01, Queens County, New York",3746,80507,10,937,0,1240,0,360,0.3,25,0,33.1,0,9.6,99.7,973,620,353,63.72,36.28,193,427,53,300,246,727,31.1,15,25.3,"75% or more P.O.C.","$78000 - $104000"
"36081015802","Census Tract 158.02, Queens County, New York",4872,85494,158,1176,75,1071,0,797,3.2,24.1,1.5,22,0,16.4,96.8,1200,755,445,62.92,37.08,197,558,144,301,341,859,26.1,32.4,28.4,"75% or more P.O.C.","$78000 - $104000"
"36081015900","Census Tract 159, Queens County, New York",3422,63818,2203,11,0,415,0,710,64.4,0.3,0,12.1,0,20.7,35.6,1641,156,1485,9.51,90.49,0,156,37,1448,37,1604,0,2.5,2.3,"25% - 50% P.O.C.","$55000 - $78000"
"36081016100","Census Tract 161, Queens County, New York",2297,74453,872,23,0,412,0,933,38,1,0,17.9,0,40.6,62,761,187,574,24.57,75.43,20,167,58,516,78,683,10.7,10.1,10.2,"50% - 75% P.O.C.","$55000 - $78000"
"36081016300","Census Tract 163, Queens County, New York",3519,22317,565,789,0,492,0,1673,16.1,22.4,0,14,0,47.5,83.9,1708,126,1582,7.38,92.62,7,119,43,1539,50,1658,5.6,2.7,2.9,"75% or more P.O.C.","Less than $55000"
"36081016400","Census Tract 164, Queens County, New York",3786,79938,64,636,13,1296,0,687,1.7,16.8,0.3,34.2,0,18.1,98.3,887,675,212,76.1,23.9,256,419,73,139,329,558,37.9,34.4,37.1,"75% or more P.O.C.","$78000 - $104000"
"36081016600","Census Tract 166, Queens County, New York",3984,68229,129,454,84,1378,0,1285,3.2,11.4,2.1,34.6,0,32.3,96.8,1043,647,396,62.03,37.97,222,425,94,302,316,727,34.3,23.7,30.3,"75% or more P.O.C.","$55000 - $78000"
"36081016800","Census Tract 168, Queens County, New York",3257,96607,81,627,0,1033,0,782,2.5,19.3,0,31.7,0,24,97.5,829,594,235,71.65,28.35,131,463,60,175,191,638,22.1,25.5,23,"75% or more P.O.C.","$78000 - $104000"
"36081016900","Census Tract 169, Queens County, New York",5683,58066,2304,161,0,1282,0,1723,40.5,2.8,0,22.6,0,30.3,59.5,2559,955,1604,37.32,62.68,51,904,157,1447,208,2351,5.3,9.8,8.1,"50% - 75% P.O.C.","$55000 - $78000"
"36081017000","Census Tract 170, Queens County, New York",2622,70147,37,634,81,1134,0,215,1.4,24.2,3.1,43.2,0,8.2,98.6,740,554,186,74.86,25.14,133,421,8,178,141,599,24,4.3,19.1,"75% or more P.O.C.","$55000 - $78000"
"36081017100","Census Tract 171, Queens County, New York",51,NA,27,10,0,13,0,0,52.9,19.6,0,25.5,0,0,47.1,27,0,27,0,100,0,0,0,27,0,27,NA,0,0,"25% - 50% P.O.C.","N/A"
"36081017200","Census Tract 172, Queens County, New York",1913,70804,29,690,12,487,0,338,1.5,36.1,0.6,25.5,0,17.7,98.5,587,469,118,79.9,20.1,87,382,20,98,107,480,18.6,16.9,18.2,"75% or more P.O.C.","$55000 - $78000"
"36081017400","Census Tract 174, Queens County, New York",2285,77875,24,853,12,500,0,501,1.1,37.3,0.5,21.9,0,21.9,98.9,667,545,122,81.71,18.29,94,451,21,101,115,552,17.2,17.2,17.2,"75% or more P.O.C.","$55000 - $78000"
"36081017600","Census Tract 176, Queens County, New York",2135,68167,122,999,0,379,0,354,5.7,46.8,0,17.8,0,16.6,94.3,606,436,170,71.95,28.05,83,353,32,138,115,491,19,18.8,19,"75% or more P.O.C.","$55000 - $78000"
"36081017800","Census Tract 178, Queens County, New York",2257,72708,44,714,17,341,118,653,1.9,31.6,0.8,15.1,5.2,28.9,98.1,624,486,138,77.88,22.12,102,384,41,97,143,481,21,29.7,22.9,"75% or more P.O.C.","$55000 - $78000"
"36081017900","Census Tract 179, Queens County, New York",1019,48950,265,46,0,378,0,308,26,4.5,0,37.1,0,30.2,74,447,69,378,15.44,84.56,5,64,32,346,37,410,7.2,8.5,8.3,"50% - 75% P.O.C.","Less than $55000"
"36081018000","Census Tract 180, Queens County, New York",1328,73500,123,422,192,164,0,234,9.3,31.8,14.5,12.3,0,17.6,90.7,334,192,142,57.49,42.51,64,128,40,102,104,230,33.3,28.2,31.1,"75% or more P.O.C.","$55000 - $78000"
"36081018101","Census Tract 181.01, Queens County, New York",3497,63068,1200,50,0,866,0,1312,34.3,1.4,0,24.8,0,37.5,65.7,1728,159,1569,9.2,90.8,0,159,37,1532,37,1691,0,2.4,2.1,"50% - 75% P.O.C.","$55000 - $78000"
"36081018102","Census Tract 181.02, Queens County, New York",3311,70135,1650,56,0,661,0,872,49.8,1.7,0,20,0,26.3,50.2,1858,304,1554,16.36,83.64,0,304,21,1533,21,1837,0,1.4,1.1,"50% - 75% P.O.C.","$55000 - $78000"
"36081018200","Census Tract 182, Queens County, New York",2499,63958,48,1286,0,315,0,472,1.9,51.5,0,12.6,0,18.9,98.1,709,534,175,75.32,24.68,39,495,29,146,68,641,7.3,16.6,9.6,"75% or more P.O.C.","$55000 - $78000"
"36081018300","Census Tract 183, Queens County, New York",6064,75453,2659,19,0,1387,0,1795,43.8,0.3,0,22.9,0,29.6,56.2,2618,643,1975,24.56,75.44,15,628,68,1907,83,2535,2.3,3.4,3.2,"50% - 75% P.O.C.","$55000 - $78000"
"36081018401","Census Tract 184.01, Queens County, New York",2114,66806,0,1606,0,53,0,293,0,76,0,2.5,0,13.9,100,681,379,302,55.65,44.35,79,300,21,281,100,581,20.8,7,14.7,"75% or more P.O.C.","$55000 - $78000"
"36081018402","Census Tract 184.02, Queens County, New York",2431,72137,96,1683,0,157,0,317,3.9,69.2,0,6.5,0,13,96.1,613,446,167,72.76,27.24,84,362,20,147,104,509,18.8,12,17,"75% or more P.O.C.","$55000 - $78000"
"36081018501","Census Tract 185.01, Queens County, New York",3182,58500,1263,152,17,613,0,1047,39.7,4.8,0.5,19.3,0,32.9,60.3,1546,619,927,40.04,59.96,12,607,10,917,22,1524,1.9,1.1,1.4,"50% - 75% P.O.C.","$55000 - $78000"
"36081018502","Census Tract 185.02, Queens County, New York",3367,74799,1570,84,0,714,0,969,46.6,2.5,0,21.2,0,28.8,53.4,1517,315,1202,20.76,79.24,20,295,25,1177,45,1472,6.3,2.1,3,"50% - 75% P.O.C.","$55000 - $78000"
"36081018600","Census Tract 186, Queens County, New York",1869,65875,32,1244,0,169,0,196,1.7,66.6,0,9,0,10.5,98.3,502,384,118,76.49,23.51,88,296,16,102,104,398,22.9,13.6,20.7,"75% or more P.O.C.","$55000 - $78000"
"36081018700","Census Tract 187, Queens County, New York",3069,70326,962,76,0,1148,0,868,31.3,2.5,0,37.4,0,28.3,68.7,1054,405,649,38.43,61.57,84,321,116,533,200,854,20.7,17.9,19,"50% - 75% P.O.C.","$55000 - $78000"
"36081018800","Census Tract 188, Queens County, New York",1449,81579,18,893,0,156,0,246,1.2,61.6,0,10.8,0,17,98.8,398,264,134,66.33,33.67,97,167,7,127,104,294,36.7,5.2,26.1,"75% or more P.O.C.","$78000 - $104000"
"36081018900","Census Tract 189, Queens County, New York",3136,72453,910,8,31,1203,0,940,29,0.3,1,38.4,0,30,71,1206,317,889,26.29,73.71,68,249,56,833,124,1082,21.5,6.3,10.3,"50% - 75% P.O.C.","$55000 - $78000"
"36081019000","Census Tract 190, Queens County, New York",2455,88365,58,1378,0,140,0,457,2.4,56.1,0,5.7,0,18.6,97.6,653,494,159,75.65,24.35,138,356,54,105,192,461,27.9,34,29.4,"75% or more P.O.C.","$78000 - $104000"
"36081019200","Census Tract 192, Queens County, New York",1969,64627,26,1337,0,154,0,338,1.3,67.9,0,7.8,0,17.2,98.7,639,434,205,67.92,32.08,84,350,9,196,93,546,19.4,4.4,14.6,"75% or more P.O.C.","$55000 - $78000"
"36081019400","Census Tract 194, Queens County, New York",2892,75069,38,1376,0,508,0,325,1.3,47.6,0,17.6,0,11.2,98.7,820,626,194,76.34,23.66,168,458,22,172,190,630,26.8,11.3,23.2,"75% or more P.O.C.","$55000 - $78000"
"36081019600","Census Tract 196, Queens County, New York",3050,71548,30,1652,54,251,0,370,1,54.2,1.8,8.2,0,12.1,99,802,369,433,46.01,53.99,118,251,75,358,193,609,32,17.3,24.1,"75% or more P.O.C.","$55000 - $78000"
"36081019800","Census Tract 198, Queens County, New York",2917,67938,35,1450,0,597,0,546,1.2,49.7,0,20.5,0,18.7,98.8,747,350,397,46.85,53.15,124,226,101,296,225,522,35.4,25.4,30.1,"75% or more P.O.C.","$55000 - $78000"
"36081019900","Census Tract 199, Queens County, New York",697,41250,114,223,0,145,0,215,16.4,32,0,20.8,0,30.8,83.6,162,21,141,12.96,87.04,0,21,0,141,0,162,0,0,0,"75% or more P.O.C.","Less than $55000"
"36081020200","Census Tract 202, Queens County, New York",1762,81667,11,885,0,311,0,174,0.6,50.2,0,17.7,0,9.9,99.4,408,330,78,80.88,19.12,179,151,0,78,179,229,54.2,0,43.9,"75% or more P.O.C.","$78000 - $104000"
"36081020400","Census Tract 204, Queens County, New York",2350,68147,98,930,0,460,0,689,4.2,39.6,0,19.6,0,29.3,95.8,601,165,436,27.45,72.55,62,103,113,323,175,426,37.6,25.9,29.1,"75% or more P.O.C.","$55000 - $78000"
"36081020500","Census Tract 205, Queens County, New York",1176,56389,96,12,0,126,0,942,8.2,1,0,10.7,0,80.1,91.8,378,114,264,30.16,69.84,20,94,35,229,55,323,17.5,13.3,14.6,"75% or more P.O.C.","$55000 - $78000"
"36081020600","Census Tract 206, Queens County, New York",1855,67298,169,390,0,394,0,739,9.1,21,0,21.2,0,39.8,90.9,475,185,290,38.95,61.05,44,141,78,212,122,353,23.8,26.9,25.7,"75% or more P.O.C.","$55000 - $78000"
"36081020800","Census Tract 208, Queens County, New York",3136,84653,367,561,99,289,0,1055,11.7,17.9,3.2,9.2,0,33.6,88.3,761,385,376,50.59,49.41,166,219,43,333,209,552,43.1,11.4,27.5,"75% or more P.O.C.","$78000 - $104000"
"36081021200","Census Tract 212, Queens County, New York",2434,43889,194,265,0,102,0,1650,8,10.9,0,4.2,0,67.8,92,628,115,513,18.31,81.69,29,86,76,437,105,523,25.2,14.8,16.7,"75% or more P.O.C.","Less than $55000"
"36081021400","Census Tract 214, Queens County, New York",6984,56194,533,779,0,3222,0,1943,7.6,11.2,0,46.1,0,27.8,92.4,2179,807,1372,37.04,62.96,117,690,251,1121,368,1811,14.5,18.3,16.9,"75% or more P.O.C.","$55000 - $78000"
"36081021600","Census Tract 216, Queens County, New York",4123,77579,1417,407,0,761,0,1361,34.4,9.9,0,18.5,0,33,65.6,1850,661,1189,35.73,64.27,16,645,103,1086,119,1731,2.4,8.7,6.4,"50% - 75% P.O.C.","$55000 - $78000"
"36081021900","Census Tract 219, Queens County, New York",0,NA,0,0,0,0,0,0,NA,NA,NA,NA,NA,NA,NA,0,0,0,NA,NA,0,0,0,0,0,0,NA,NA,NA,"N/A","N/A"
"36081022001","Census Tract 220.01, Queens County, New York",6272,76330,1876,785,0,1353,0,2113,29.9,12.5,0,21.6,0,33.7,70.1,2942,535,2407,18.18,81.82,64,471,44,2363,108,2834,12,1.8,3.7,"50% - 75% P.O.C.","$55000 - $78000"
"36081022002","Census Tract 220.02, Queens County, New York",7128,71643,2140,1301,0,1339,0,2133,30,18.3,0,18.8,0,29.9,70,2734,1193,1541,43.64,56.36,58,1135,268,1273,326,2408,4.9,17.4,11.9,"50% - 75% P.O.C.","$55000 - $78000"
"36081022900","Census Tract 229, Queens County, New York",0,NA,0,0,0,0,0,0,NA,NA,NA,NA,NA,NA,NA,0,0,0,NA,NA,0,0,0,0,0,0,NA,NA,NA,"N/A","N/A"
"36081023000","Census Tract 230, Queens County, New York",2054,94667,577,115,0,714,0,632,28.1,5.6,0,34.8,0,30.8,71.9,532,334,198,62.78,37.22,145,189,48,150,193,339,43.4,24.2,36.3,"50% - 75% P.O.C.","$78000 - $104000"
"36081023200","Census Tract 232, Queens County, New York",5644,70268,940,859,0,1886,6,1235,16.7,15.2,0,33.4,0.1,21.9,83.3,1755,797,958,45.41,54.59,71,726,148,810,219,1536,8.9,15.4,12.5,"75% or more P.O.C.","$55000 - $78000"
"36081023500","Census Tract 235, Queens County, New York",7766,49544,929,76,0,2172,0,4379,12,1,0,28,0,56.4,88,2669,270,2399,10.12,89.88,47,223,356,2043,403,2266,17.4,14.8,15.1,"75% or more P.O.C.","Less than $55000"
"36081023600","Census Tract 236, Queens County, New York",3143,69046,312,290,9,1295,0,1110,9.9,9.2,0.3,41.2,0,35.3,90.1,823,123,700,14.95,85.05,39,84,180,520,219,604,31.7,25.7,26.6,"75% or more P.O.C.","$55000 - $78000"
"36081023800","Census Tract 238, Queens County, New York",4516,51823,92,607,0,1273,0,2143,2,13.4,0,28.2,0,47.5,98,1491,150,1341,10.06,89.94,40,110,106,1235,146,1345,26.7,7.9,9.8,"75% or more P.O.C.","Less than $55000"
"36081024000","Census Tract 240, Queens County, New York",6826,45400,149,1100,0,2101,0,3231,2.2,16.1,0,30.8,0,47.3,97.8,2066,227,1839,10.99,89.01,92,135,242,1597,334,1732,40.5,13.2,16.2,"75% or more P.O.C.","Less than $55000"
"36081024300","Census Tract 243, Queens County, New York",5088,69583,1342,62,0,1673,0,1891,26.4,1.2,0,32.9,0,37.2,73.6,1629,774,855,47.51,52.49,157,617,113,742,270,1359,20.3,13.2,16.6,"50% - 75% P.O.C.","$55000 - $78000"
"36081024500","Census Tract 245, Queens County, New York",4422,57817,2078,36,0,976,0,1148,47,0.8,0,22.1,0,26,53,2038,958,1080,47.01,52.99,20,938,46,1034,66,1972,2.1,4.3,3.2,"50% - 75% P.O.C.","$55000 - $78000"
"36081024600","Census Tract 246, Queens County, New York",0,NA,0,0,0,0,0,0,NA,NA,NA,NA,NA,NA,NA,0,0,0,NA,NA,0,0,0,0,0,0,NA,NA,NA,"N/A","N/A"
"36081024700","Census Tract 247, Queens County, New York",1466,71591,214,0,11,728,0,513,14.6,0,0.8,49.7,0,35,85.4,488,101,387,20.7,79.3,6,95,96,291,102,386,5.9,24.8,20.9,"75% or more P.O.C.","$55000 - $78000"
"36081024900","Census Tract 249, Queens County, New York",4838,56853,893,61,0,2599,0,1285,18.5,1.3,0,53.7,0,26.6,81.5,1893,565,1328,29.85,70.15,13,552,62,1266,75,1818,2.3,4.7,4,"75% or more P.O.C.","$55000 - $78000"
"36081025100","Census Tract 251, Queens County, New York",5611,64763,1900,123,0,1595,0,1930,33.9,2.2,0,28.4,0,34.4,66.1,2359,1210,1149,51.29,48.71,45,1165,104,1045,149,2210,3.7,9.1,6.3,"50% - 75% P.O.C.","$55000 - $78000"
"36081025301","Census Tract 253.01, Queens County, New York",4386,63864,1624,33,0,1092,0,1537,37,0.8,0,24.9,0,35,63,1888,187,1701,9.9,90.1,30,157,89,1612,119,1769,16,5.2,6.3,"50% - 75% P.O.C.","$55000 - $78000"
"36081025302","Census Tract 253.02, Queens County, New York",3046,64743,764,0,67,555,0,1579,25.1,0,2.2,18.2,0,51.8,74.9,1191,191,1000,16.04,83.96,0,191,109,891,109,1082,0,10.9,9.2,"50% - 75% P.O.C.","$55000 - $78000"
"36081025400","Census Tract 254, Queens County, New York",10118,37897,261,5534,0,1132,0,1970,2.6,54.7,0,11.2,0,19.5,97.4,2953,742,2211,25.13,74.87,257,485,384,1827,641,2312,34.6,17.4,21.7,"75% or more P.O.C.","Less than $55000"
"36081025500","Census Tract 255, Queens County, New York",1524,78088,312,0,0,589,0,554,20.5,0,0,38.6,0,36.4,79.5,496,174,322,35.08,64.92,34,140,71,251,105,391,19.5,22,21.2,"75% or more P.O.C.","$78000 - $104000"
"36081025700","Census Tract 257, Queens County, New York",1500,71875,319,48,0,621,0,468,21.3,3.2,0,41.4,0,31.2,78.7,534,286,248,53.56,46.44,22,264,21,227,43,491,7.7,8.5,8.1,"75% or more P.O.C.","$55000 - $78000"
"36081025800","Census Tract 258, Queens County, New York",2261,67875,8,1701,9,54,0,176,0.4,75.2,0.4,2.4,0,7.8,99.6,527,326,201,61.86,38.14,123,203,67,134,190,337,37.7,33.3,36.1,"75% or more P.O.C.","$55000 - $78000"
"36081025900","Census Tract 259, Queens County, New York",3486,70337,579,0,0,1330,0,1484,16.6,0,0,38.2,0,42.6,83.4,1131,308,823,27.23,72.77,76,232,125,698,201,930,24.7,15.2,17.8,"75% or more P.O.C.","$55000 - $78000"
"36081026000","Census Tract 260, Queens County, New York",2757,62585,38,1741,8,302,0,489,1.4,63.1,0.3,11,0,17.7,98.6,733,141,592,19.24,80.76,18,123,153,439,171,562,12.8,25.8,23.3,"75% or more P.O.C.","$55000 - $78000"
"36081026100","Census Tract 261, Queens County, New York",6508,54200,448,82,0,3036,0,2775,6.9,1.3,0,46.7,0,42.6,93.1,2236,303,1933,13.55,86.45,48,255,401,1532,449,1787,15.8,20.7,20.1,"75% or more P.O.C.","Less than $55000"
"36081026200","Census Tract 262, Queens County, New York",1270,72344,9,943,0,69,0,229,0.7,74.3,0,5.4,0,18,99.3,374,259,115,69.25,30.75,70,189,0,115,70,304,27,0,18.7,"75% or more P.O.C.","$55000 - $78000"
"36081026300","Census Tract 263, Queens County, New York",5857,52015,770,0,0,3223,0,1648,13.1,0,0,55,0,28.1,86.9,1964,580,1384,29.53,70.47,88,492,353,1031,441,1523,15.2,25.5,22.5,"75% or more P.O.C.","Less than $55000"
"36081026400","Census Tract 264, Queens County, New York",2501,55590,12,1590,0,231,0,544,0.5,63.6,0,9.2,0,21.8,99.5,789,347,442,43.98,56.02,64,283,21,421,85,704,18.4,4.8,10.8,"75% or more P.O.C.","$55000 - $78000"
"36081026500","Census Tract 265, Queens County, New York",3722,54091,285,34,0,2480,0,832,7.7,0.9,0,66.6,0,22.4,92.3,1362,253,1109,18.58,81.42,0,253,99,1010,99,1263,0,8.9,7.3,"75% or more P.O.C.","Less than $55000"
"36081026600","Census Tract 266, Queens County, New York",1745,28969,24,1411,0,104,0,176,1.4,80.9,0,6,0,10.1,98.6,753,237,516,31.47,68.53,25,212,36,480,61,692,10.5,7,8.1,"75% or more P.O.C.","Less than $55000"
"36081026700","Census Tract 267, Queens County, New York",5353,50613,395,82,27,2469,0,2296,7.4,1.5,0.5,46.1,0,42.9,92.6,1960,354,1606,18.06,81.94,19,335,147,1459,166,1794,5.4,9.2,8.5,"75% or more P.O.C.","Less than $55000"
"36081026901","Census Tract 269.01, Queens County, New York",4965,57359,219,21,0,1671,0,2994,4.4,0.4,0,33.7,0,60.3,95.6,1622,270,1352,16.65,83.35,50,220,182,1170,232,1390,18.5,13.5,14.3,"75% or more P.O.C.","$55000 - $78000"
"36081026902","Census Tract 269.02, Queens County, New York",3603,51406,197,35,0,1758,0,1586,5.5,1,0,48.8,0,44,94.5,1216,300,916,24.67,75.33,33,267,111,805,144,1072,11,12.1,11.8,"75% or more P.O.C.","Less than $55000"
"36081027000","Census Tract 270, Queens County, New York",2190,96920,85,1621,0,84,0,341,3.9,74,0,3.8,0,15.6,96.1,471,331,140,70.28,29.72,110,221,62,78,172,299,33.2,44.3,36.5,"75% or more P.O.C.","$78000 - $104000"
"36081027100","Census Tract 271, Queens County, New York",8428,54665,353,64,0,3441,0,4385,4.2,0.8,0,40.8,0,52,95.8,2610,645,1965,24.71,75.29,106,539,356,1609,462,2148,16.4,18.1,17.7,"75% or more P.O.C.","Less than $55000"
"36081027200","Census Tract 272, Queens County, New York",1970,63917,17,1324,0,162,0,329,0.9,67.2,0,8.2,0,16.7,99.1,596,396,200,66.44,33.56,52,344,19,181,71,525,13.1,9.5,11.9,"75% or more P.O.C.","$55000 - $78000"
"36081027300","Census Tract 273, Queens County, New York",7116,47943,150,486,0,1047,0,5397,2.1,6.8,0,14.7,0,75.8,97.9,2322,311,2011,13.39,86.61,78,233,340,1671,418,1904,25.1,16.9,18,"75% or more P.O.C.","Less than $55000"
"36081027400","Census Tract 274, Queens County, New York",1718,75380,0,1213,0,95,0,234,0,70.6,0,5.5,0,13.6,100,583,477,106,81.82,18.18,74,403,0,106,74,509,15.5,0,12.7,"75% or more P.O.C.","$55000 - $78000"
"36081027500","Census Tract 275, Queens County, New York",6820,53764,346,241,0,581,0,5652,5.1,3.5,0,8.5,0,82.9,94.9,2017,872,1145,43.23,56.77,102,770,343,802,445,1572,11.7,30,22.1,"75% or more P.O.C.","Less than $55000"
"36081027600","Census Tract 276, Queens County, New York",1342,57368,46,1103,0,59,0,82,3.4,82.2,0,4.4,0,6.1,96.6,420,302,118,71.9,28.1,67,235,0,118,67,353,22.2,0,16,"75% or more P.O.C.","$55000 - $78000"
"36081027700","Census Tract 277, Queens County, New York",7747,51901,589,147,0,1274,0,5584,7.6,1.9,0,16.4,0,72.1,92.4,2912,831,2081,28.54,71.46,42,789,173,1908,215,2697,5.1,8.3,7.4,"75% or more P.O.C.","Less than $55000"
"36081027800","Census Tract 278, Queens County, New York",2339,42857,11,1755,0,17,0,419,0.5,75,0,0.7,0,17.9,99.5,872,238,634,27.29,72.71,36,202,71,563,107,765,15.1,11.2,12.3,"75% or more P.O.C.","Less than $55000"
"36081027900","Census Tract 279, Queens County, New York",6220,60911,1090,120,0,743,0,4216,17.5,1.9,0,11.9,0,67.8,82.5,2425,829,1596,34.19,65.81,65,764,139,1457,204,2221,7.8,8.7,8.4,"75% or more P.O.C.","$55000 - $78000"
"36081028000","Census Tract 280, Queens County, New York",1670,64911,14,1520,0,0,0,56,0.8,91,0,0,0,3.4,99.2,499,319,180,63.93,36.07,136,183,30,150,166,333,42.6,16.7,33.3,"75% or more P.O.C.","$55000 - $78000"
"36081028100","Census Tract 281, Queens County, New York",5013,60720,1579,40,0,717,0,2525,31.5,0.8,0,14.3,0,50.4,68.5,2175,781,1394,35.91,64.09,10,771,72,1322,82,2093,1.3,5.2,3.8,"50% - 75% P.O.C.","$55000 - $78000"
"36081028200","Census Tract 282, Queens County, New York",1894,76434,29,1444,0,87,0,92,1.5,76.2,0,4.6,0,4.9,98.5,528,342,186,64.77,35.23,125,217,44,142,169,359,36.5,23.7,32,"75% or more P.O.C.","$55000 - $78000"
"36081028300","Census Tract 283, Queens County, New York",7508,65929,1585,69,18,948,0,4751,21.1,0.9,0.2,12.6,0,63.3,78.9,3161,1031,2130,32.62,67.38,17,1014,116,2014,133,3028,1.6,5.4,4.2,"75% or more P.O.C.","$55000 - $78000"
"36081028400","Census Tract 284, Queens County, New York",4166,90257,18,3515,0,94,0,179,0.4,84.4,0,2.3,0,4.3,99.6,1189,866,323,72.83,27.17,215,651,21,302,236,953,24.8,6.5,19.8,"75% or more P.O.C.","$78000 - $104000"
"36081028500","Census Tract 285, Queens County, New York",4987,78508,1827,74,0,839,0,2101,36.6,1.5,0,16.8,0,42.1,63.4,2045,938,1107,45.87,54.13,26,912,45,1062,71,1974,2.8,4.1,3.5,"50% - 75% P.O.C.","$78000 - $104000"
"36081028700","Census Tract 287, Queens County, New York",6293,66016,1870,37,0,1656,0,2668,29.7,0.6,0,26.3,0,42.4,70.3,2696,883,1813,32.75,67.25,27,856,150,1663,177,2519,3.1,8.3,6.6,"50% - 75% P.O.C.","$55000 - $78000"
"36081028800","Census Tract 288, Queens County, New York",4616,71518,40,3076,0,564,0,613,0.9,66.6,0,12.2,0,13.3,99.1,1393,993,400,71.28,28.72,176,817,47,353,223,1170,17.7,11.8,16,"75% or more P.O.C.","$55000 - $78000"
"36081028900","Census Tract 289, Queens County, New York",5158,68089,1339,71,0,1790,0,1728,26,1.4,0,34.7,0,33.5,74,2011,636,1375,31.63,68.37,16,620,162,1213,178,1833,2.5,11.8,8.9,"50% - 75% P.O.C.","$55000 - $78000"
"36081029100","Census Tract 291, Queens County, New York",6368,57989,681,105,36,3735,0,1591,10.7,1.6,0.6,58.7,0,25,89.3,2201,733,1468,33.3,66.7,81,652,217,1251,298,1903,11.1,14.8,13.5,"75% or more P.O.C.","$55000 - $78000"
"36081029300","Census Tract 293, Queens County, New York",1090,65982,106,0,0,779,0,184,9.7,0,0,71.5,0,16.9,90.3,317,139,178,43.85,56.15,32,107,43,135,75,242,23,24.2,23.7,"75% or more P.O.C.","$55000 - $78000"
"36081029400","Census Tract 294, Queens County, New York",7000,78199,104,5780,0,377,0,694,1.5,82.6,0,5.4,0,9.9,98.5,2283,1104,1179,48.36,51.64,330,774,86,1093,416,1867,29.9,7.3,18.2,"75% or more P.O.C.","$78000 - $104000"
"36081029500","Census Tract 295, Queens County, New York",3602,69534,1301,67,0,1144,0,869,36.1,1.9,0,31.8,0,24.1,63.9,1624,1005,619,61.88,38.12,33,972,8,611,41,1583,3.3,1.3,2.5,"50% - 75% P.O.C.","$55000 - $78000"
"36081029700","Census Tract 297, Queens County, New York",2038,64135,560,12,0,465,0,970,27.5,0.6,0,22.8,0,47.6,72.5,669,346,323,51.72,48.28,32,314,36,287,68,601,9.2,11.1,10.2,"50% - 75% P.O.C.","$55000 - $78000"
"36081029900","Census Tract 299, Queens County, New York",0,NA,0,0,0,0,0,0,NA,NA,NA,NA,NA,NA,NA,0,0,0,NA,NA,0,0,0,0,0,0,NA,NA,NA,"N/A","N/A"
"36081030600","Census Tract 306, Queens County, New York",4760,76755,157,3972,0,172,0,314,3.3,83.4,0,3.6,0,6.6,96.7,1341,955,386,71.22,28.78,175,780,74,312,249,1092,18.3,19.2,18.6,"75% or more P.O.C.","$55000 - $78000"
"36081030902","Census Tract 309.02, Queens County, New York",6590,49451,1203,255,27,2600,0,2266,18.3,3.9,0.4,39.5,0,34.4,81.7,2342,854,1488,36.46,63.54,80,774,95,1393,175,2167,9.4,6.4,7.5,"75% or more P.O.C.","Less than $55000"
"36081030903","Census Tract 309.03, Queens County, New York",5722,78590,559,115,38,2216,0,2688,9.8,2,0.7,38.7,0,47,90.2,1623,841,782,51.82,48.18,251,590,99,683,350,1273,29.8,12.7,21.6,"75% or more P.O.C.","$78000 - $104000"
"36081030904","Census Tract 309.04, Queens County, New York",3179,70481,960,16,0,779,0,1335,30.2,0.5,0,24.5,0,42,69.8,969,414,555,42.72,57.28,130,284,62,493,192,777,31.4,11.2,19.8,"50% - 75% P.O.C.","$55000 - $78000"
"36081031700","Census Tract 317, Queens County, New York",5568,62021,4073,282,0,346,0,867,73.2,5.1,0,6.2,0,15.6,26.8,2222,1387,835,62.42,37.58,99,1288,30,805,129,2093,7.1,3.6,5.8,"25% - 50% P.O.C.","$55000 - $78000"
"36081032000","Census Tract 320, Queens County, New York",4930,78355,105,4024,49,104,0,572,2.1,81.6,1,2.1,0,11.6,97.9,1080,535,545,49.54,50.46,79,456,124,421,203,877,14.8,22.8,18.8,"75% or more P.O.C.","$78000 - $104000"
"36081032700","Census Tract 327, Queens County, New York",3702,58145,371,54,0,968,0,2296,10,1.5,0,26.1,0,62,90,998,430,568,43.09,56.91,135,295,170,398,305,693,31.4,29.9,30.6,"75% or more P.O.C.","$55000 - $78000"
"36081032800","Census Tract 328, Queens County, New York",2769,99167,27,2307,0,131,0,147,1,83.3,0,4.7,0,5.3,99,720,442,278,61.39,38.61,123,319,54,224,177,543,27.8,19.4,24.6,"75% or more P.O.C.","$78000 - $104000"
"36081032900","Census Tract 329, Queens County, New York",3244,55395,415,224,0,910,0,1673,12.8,6.9,0,28.1,0,51.6,87.2,832,613,219,73.68,26.32,175,438,30,189,205,627,28.5,13.7,24.6,"75% or more P.O.C.","$55000 - $78000"
"36081033000","Census Tract 330, Queens County, New York",7192,80833,73,6475,0,43,0,425,1,90,0,0.6,0,5.9,99,2006,1468,538,73.18,26.82,307,1161,120,418,427,1579,20.9,22.3,21.3,"75% or more P.O.C.","$78000 - $104000"
"36081033100","Census Tract 331, Queens County, New York",0,NA,0,0,0,0,0,0,NA,NA,NA,NA,NA,NA,NA,0,0,0,NA,NA,0,0,0,0,0,0,NA,NA,NA,"N/A","N/A"
"36081033401","Census Tract 334.01, Queens County, New York",3767,81311,24,3037,8,134,0,490,0.6,80.6,0.2,3.6,0,13,99.4,1153,706,447,61.23,38.77,156,550,32,415,188,965,22.1,7.2,16.3,"75% or more P.O.C.","$78000 - $104000"
"36081033402","Census Tract 334.02, Queens County, New York",12854,55594,71,12092,0,62,0,501,0.6,94.1,0,0.5,0,3.9,99.4,6317,836,5481,13.23,86.77,36,800,187,5294,223,6094,4.3,3.4,3.5,"75% or more P.O.C.","$55000 - $78000"
"36081033700","Census Tract 337, Queens County, New York",2999,73231,163,0,0,721,0,2101,5.4,0,0,24,0,70.1,94.6,811,554,257,68.31,31.69,136,418,54,203,190,621,24.5,21,23.4,"75% or more P.O.C.","$55000 - $78000"
"36081033900","Census Tract 339, Queens County, New York",2677,48182,530,24,0,655,0,1457,19.8,0.9,0,24.5,0,54.4,80.2,1030,599,431,58.16,41.84,71,528,31,400,102,928,11.9,7.2,9.9,"75% or more P.O.C.","Less than $55000"
"36081034700","Census Tract 347, Queens County, New York",2966,55492,270,339,55,463,0,1818,9.1,11.4,1.9,15.6,0,61.3,90.9,933,484,449,51.88,48.12,75,409,19,430,94,839,15.5,4.2,10.1,"75% or more P.O.C.","$55000 - $78000"
"36081035100","Census Tract 351, Queens County, New York",3737,46920,500,239,0,505,0,2467,13.4,6.4,0,13.5,0,66,86.6,1530,1070,460,69.93,30.07,86,984,0,460,86,1444,8,0,5.6,"75% or more P.O.C.","Less than $55000"
"36081035200","Census Tract 352, Queens County, New York",2780,93750,176,2227,0,80,0,199,6.3,80.1,0,2.9,0,7.2,93.7,815,601,214,73.74,26.26,84,517,49,165,133,682,14,22.9,16.3,"75% or more P.O.C.","$78000 - $104000"
"36081035300","Census Tract 353, Queens County, New York",2273,49750,120,267,0,139,0,1742,5.3,11.7,0,6.1,0,76.6,94.7,651,316,335,48.54,51.46,69,247,69,266,138,513,21.8,20.6,21.2,"75% or more P.O.C.","Less than $55000"
"36081035700","Census Tract 357, Queens County, New York",3710,64167,535,1372,0,415,6,1336,14.4,37,0,11.2,0.2,36,85.6,988,590,398,59.72,40.28,90,500,74,324,164,824,15.3,18.6,16.6,"75% or more P.O.C.","$55000 - $78000"
"36081035800","Census Tract 358, Queens County, New York",4179,95000,69,3604,0,23,0,464,1.7,86.2,0,0.6,0,11.1,98.3,1292,803,489,62.15,37.85,132,671,114,375,246,1046,16.4,23.3,19,"75% or more P.O.C.","$78000 - $104000"
"36081036100","Census Tract 361, Queens County, New York",2238,47419,73,378,0,323,0,1449,3.3,16.9,0,14.4,0,64.7,96.7,618,216,402,34.95,65.05,53,163,118,284,171,447,24.5,29.4,27.7,"75% or more P.O.C.","Less than $55000"
"36081036300","Census Tract 363, Queens County, New York",1771,57802,66,263,0,115,0,1290,3.7,14.9,0,6.5,0,72.8,96.3,497,195,302,39.24,60.76,39,156,72,230,111,386,20,23.8,22.3,"75% or more P.O.C.","$55000 - $78000"
"36081036500","Census Tract 365, Queens County, New York",2992,51250,71,314,0,198,0,2389,2.4,10.5,0,6.6,0,79.8,97.6,739,213,526,28.82,71.18,102,111,190,336,292,447,47.9,36.1,39.5,"75% or more P.O.C.","Less than $55000"
"36081036600","Census Tract 366, Queens County, New York",2731,68264,17,2373,0,101,0,193,0.6,86.9,0,3.7,0,7.1,99.4,999,601,398,60.16,39.84,124,477,0,398,124,875,20.6,0,12.4,"75% or more P.O.C.","$55000 - $78000"
"36081036700","Census Tract 367, Queens County, New York",2178,52955,80,927,0,230,0,891,3.7,42.6,0,10.6,0,40.9,96.3,680,398,282,58.53,41.47,98,300,19,263,117,563,24.6,6.7,17.2,"75% or more P.O.C.","Less than $55000"
"36081036800","Census Tract 368, Queens County, New York",2495,72000,22,2182,0,0,0,231,0.9,87.5,0,0,0,9.3,99.1,808,587,221,72.65,27.35,88,499,12,209,100,708,15,5.4,12.4,"75% or more P.O.C.","$55000 - $78000"
"36081037100","Census Tract 371, Queens County, New York",1335,67419,19,309,0,200,0,724,1.4,23.1,0,15,0,54.2,98.6,402,303,99,75.37,24.63,88,215,22,77,110,292,29,22.2,27.4,"75% or more P.O.C.","$55000 - $78000"
"36081037300","Census Tract 373, Queens County, New York",2255,48913,64,312,0,318,0,1497,2.8,13.8,0,14.1,0,66.4,97.2,646,267,379,41.33,58.67,39,228,98,281,137,509,14.6,25.9,21.2,"75% or more P.O.C.","Less than $55000"
"36081037500","Census Tract 375, Queens County, New York",4116,56875,93,239,0,222,0,3530,2.3,5.8,0,5.4,0,85.8,97.7,923,240,683,26,74,100,140,253,430,353,570,41.7,37,38.2,"75% or more P.O.C.","$55000 - $78000"
"36081037600","Census Tract 376, Queens County, New York",6121,81625,40,5565,13,75,0,226,0.7,90.9,0.2,1.2,0,3.7,99.3,1918,1414,504,73.72,26.28,252,1162,36,468,288,1630,17.8,7.1,15,"75% or more P.O.C.","$78000 - $104000"
"36081037700","Census Tract 377, Queens County, New York",3620,71728,17,191,0,152,0,3260,0.5,5.3,0,4.2,0,90.1,99.5,775,233,542,30.06,69.94,86,147,228,314,314,461,36.9,42.1,40.5,"75% or more P.O.C.","$55000 - $78000"
"36081037900","Census Tract 379, Queens County, New York",6851,72799,63,271,0,535,0,5962,0.9,4,0,7.8,0,87,99.1,1383,348,1035,25.16,74.84,160,188,367,668,527,856,46,35.5,38.1,"75% or more P.O.C.","$55000 - $78000"
"36081038100","Census Tract 381, Queens County, New York",7216,61635,179,611,0,367,0,5918,2.5,8.5,0,5.1,0,82,97.5,1774,717,1057,40.42,59.58,143,574,373,684,516,1258,19.9,35.3,29.1,"75% or more P.O.C.","$55000 - $78000"
"36081038301","Census Tract 383.01, Queens County, New York",0,NA,0,0,0,0,0,0,NA,NA,NA,NA,NA,NA,NA,0,0,0,NA,NA,0,0,0,0,0,0,NA,NA,NA,"N/A","N/A"
"36081038302","Census Tract 383.02, Queens County, New York",0,NA,0,0,0,0,0,0,NA,NA,NA,NA,NA,NA,NA,0,0,0,NA,NA,0,0,0,0,0,0,NA,NA,NA,"N/A","N/A"
"36081038400","Census Tract 384, Queens County, New York",2411,75114,13,2285,0,15,0,98,0.5,94.8,0,0.6,0,4.1,99.5,684,484,200,70.76,29.24,126,358,12,188,138,546,26,6,20.2,"75% or more P.O.C.","$55000 - $78000"
"36081039400","Census Tract 394, Queens County, New York",2986,79650,17,2581,0,63,0,254,0.6,86.4,0,2.1,0,8.5,99.4,937,650,287,69.37,30.63,126,524,69,218,195,742,19.4,24,20.8,"75% or more P.O.C.","$78000 - $104000"
"36081039800","Census Tract 398, Queens County, New York",1675,100063,24,1498,0,44,0,109,1.4,89.4,0,2.6,0,6.5,98.6,505,420,85,83.17,16.83,76,344,16,69,92,413,18.1,18.8,18.2,"75% or more P.O.C.","$78000 - $104000"
"36081039900","Census Tract 399, Queens County, New York",3862,70282,46,399,0,126,0,3225,1.2,10.3,0,3.3,0,83.5,98.8,895,186,709,20.78,79.22,50,136,290,419,340,555,26.9,40.9,38,"75% or more P.O.C.","$55000 - $78000"
"36081040000","Census Tract 400, Queens County, New York",1529,100813,12,1265,0,0,0,150,0.8,82.7,0,0,0,9.8,99.2,433,331,102,76.44,23.56,85,246,13,89,98,335,25.7,12.7,22.6,"75% or more P.O.C.","$78000 - $104000"
"36081040100","Census Tract 401, Queens County, New York",7686,59214,24,73,0,970,0,6619,0.3,0.9,0,12.6,0,86.1,99.7,1764,312,1452,17.69,82.31,95,217,474,978,569,1195,30.4,32.6,32.3,"75% or more P.O.C.","$55000 - $78000"
"36081040200","Census Tract 402, Queens County, New York",1640,101538,9,1473,0,40,70,48,0.5,89.8,0,2.4,4.3,2.9,99.5,474,422,52,89.03,10.97,108,314,4,48,112,362,25.6,7.7,23.6,"75% or more P.O.C.","$78000 - $104000"
"36081040300","Census Tract 403, Queens County, New York",7324,60550,41,0,0,1118,0,6150,0.6,0,0,15.3,0,84,99.4,1665,345,1320,20.72,79.28,116,229,515,805,631,1034,33.6,39,37.9,"75% or more P.O.C.","$55000 - $78000"
"36081040400","Census Tract 404, Queens County, New York",4138,71066,39,3360,0,279,0,360,0.9,81.2,0,6.7,0,8.7,99.1,1257,761,496,60.54,39.46,164,597,32,464,196,1061,21.6,6.5,15.6,"75% or more P.O.C.","$55000 - $78000"
"36081040500","Census Tract 405, Queens County, New York",3377,60833,30,24,0,317,0,3001,0.9,0.7,0,9.4,0,88.9,99.1,742,65,677,8.76,91.24,20,45,269,408,289,453,30.8,39.7,38.9,"75% or more P.O.C.","$55000 - $78000"
"36081040700","Census Tract 407, Queens County, New York",9109,53211,240,151,13,361,0,8317,2.6,1.7,0.1,4,0,91.3,97.4,1990,279,1711,14.02,85.98,41,238,600,1111,641,1349,14.7,35.1,32.2,"75% or more P.O.C.","Less than $55000"
"36081040900","Census Tract 409, Queens County, New York",5560,56101,68,174,0,386,0,4932,1.2,3.1,0,6.9,0,88.7,98.8,1171,198,973,16.91,83.09,51,147,378,595,429,742,25.8,38.8,36.6,"75% or more P.O.C.","$55000 - $78000"
"36081041100","Census Tract 411, Queens County, New York",3775,68629,32,16,0,708,0,3005,0.8,0.4,0,18.8,0,79.6,99.2,870,276,594,31.72,68.28,83,193,223,371,306,564,30.1,37.5,35.2,"75% or more P.O.C.","$55000 - $78000"
"36081041300","Census Tract 413, Queens County, New York",4696,55046,70,0,0,957,0,3650,1.5,0,0,20.4,0,77.7,98.5,1001,320,681,31.97,68.03,153,167,234,447,387,614,47.8,34.4,38.7,"75% or more P.O.C.","$55000 - $78000"
"36081041400","Census Tract 414, Queens County, New York",4551,58885,135,3164,0,274,0,646,3,69.5,0,6,0,14.2,97,1341,778,563,58.02,41.98,246,532,36,527,282,1059,31.6,6.4,21,"75% or more P.O.C.","$55000 - $78000"
"36081041500","Census Tract 415, Queens County, New York",4358,51203,298,11,0,455,0,3594,6.8,0.3,0,10.4,0,82.5,93.2,1076,240,836,22.3,77.7,64,176,200,636,264,812,26.7,23.9,24.5,"75% or more P.O.C.","Less than $55000"
"36081042400","Census Tract 424, Queens County, New York",2414,90125,11,2178,0,37,0,43,0.5,90.2,0,1.5,0,1.8,99.5,743,630,113,84.79,15.21,117,513,0,113,117,626,18.6,0,15.7,"75% or more P.O.C.","$78000 - $104000"
"36081042600","Census Tract 426, Queens County, New York",477,NA,170,247,0,29,0,31,35.6,51.8,0,6.1,0,6.5,64.4,0,0,0,NA,NA,0,0,0,0,0,0,NA,NA,NA,"50% - 75% P.O.C.","N/A"
"36081042700","Census Tract 427, Queens County, New York",4955,63781,192,0,0,376,0,4387,3.9,0,0,7.6,0,88.5,96.1,1241,250,991,20.15,79.85,72,178,217,774,289,952,28.8,21.9,23.3,"75% or more P.O.C.","$55000 - $78000"
"36081043200","Census Tract 432, Queens County, New York",1244,77734,0,1123,0,78,0,33,0,90.3,0,6.3,0,2.7,100,395,320,75,81.01,18.99,61,259,12,63,73,322,19.1,16,18.5,"75% or more P.O.C.","$55000 - $78000"
"36081043400","Census Tract 434, Queens County, New York",1795,104063,66,1467,0,0,12,158,3.7,81.7,0,0,0.7,8.8,96.3,503,430,73,85.49,14.51,118,312,14,59,132,371,27.4,19.2,26.2,"75% or more P.O.C.","$104000 or more"
"36081043701","Census Tract 437.01, Queens County, New York",2686,64946,342,214,0,158,0,1794,12.7,8,0,5.9,0,66.8,87.3,691,200,491,28.94,71.06,30,170,68,423,98,593,15,13.8,14.2,"75% or more P.O.C.","$55000 - $78000"
"36081043702","Census Tract 437.02, Queens County, New York",7125,44085,569,310,85,903,0,5258,8,4.4,1.2,12.7,0,73.8,92,2299,929,1370,40.41,59.59,22,907,348,1022,370,1929,2.4,25.4,16.1,"75% or more P.O.C.","Less than $55000"
"36081043900","Census Tract 439, Queens County, New York",3610,35771,156,30,0,442,0,2982,4.3,0.8,0,12.2,0,82.6,95.7,1109,299,810,26.96,73.04,18,281,107,703,125,984,6,13.2,11.3,"75% or more P.O.C.","Less than $55000"
"36081044000","Census Tract 440, Queens County, New York",3980,68633,58,2782,0,341,0,616,1.5,69.9,0,8.6,0,15.5,98.5,1114,587,527,52.69,47.31,113,474,126,401,239,875,19.3,23.9,21.5,"75% or more P.O.C.","$55000 - $78000"
"36081044301","Census Tract 443.01, Queens County, New York",3719,21699,148,213,0,397,0,2903,4,5.7,0,10.7,0,78.1,96,1269,89,1180,7.01,92.99,31,58,101,1079,132,1137,34.8,8.6,10.4,"75% or more P.O.C.","Less than $55000"
"36081044302","Census Tract 443.02, Queens County, New York",4076,47411,115,375,0,1832,0,1754,2.8,9.2,0,44.9,0,43,97.2,1267,465,802,36.7,63.3,135,330,99,703,234,1033,29,12.3,18.5,"75% or more P.O.C.","Less than $55000"
"36081044400","Census Tract 444, Queens County, New York",3529,50320,136,506,0,1097,0,1307,3.9,14.3,0,31.1,0,37,96.1,935,258,677,27.59,72.41,89,169,147,530,236,699,34.5,21.7,25.2,"75% or more P.O.C.","Less than $55000"
"36081044601","Census Tract 446.01, Queens County, New York",3361,38229,26,991,144,562,60,1543,0.8,29.5,4.3,16.7,1.8,45.9,99.2,1239,240,999,19.37,80.63,20,220,196,803,216,1023,8.3,19.6,17.4,"75% or more P.O.C.","Less than $55000"
"36081044602","Census Tract 446.02, Queens County, New York",4961,41415,106,977,0,2438,0,1209,2.1,19.7,0,49.1,0,24.4,97.9,1391,192,1199,13.8,86.2,35,157,228,971,263,1128,18.2,19,18.9,"75% or more P.O.C.","Less than $55000"
"36081044800","Census Tract 448, Queens County, New York",2809,64500,168,75,47,1421,0,739,6,2.7,1.7,50.6,0,26.3,94,730,314,416,43.01,56.99,95,219,170,246,265,465,30.3,40.9,36.3,"75% or more P.O.C.","$55000 - $78000"
"36081045000","Census Tract 450, Queens County, New York",2167,84435,405,238,0,1012,0,429,18.7,11,0,46.7,0,19.8,81.3,560,390,170,69.64,30.36,114,276,30,140,144,416,29.2,17.6,25.7,"75% or more P.O.C.","$78000 - $104000"
"36081045200","Census Tract 452, Queens County, New York",1335,70625,200,124,24,665,0,258,15,9.3,1.8,49.8,0,19.3,85,218,130,88,59.63,40.37,49,81,25,63,74,144,37.7,28.4,33.9,"75% or more P.O.C.","$55000 - $78000"
"36081045400","Census Tract 454, Queens County, New York",4779,49968,269,606,13,3201,0,478,5.6,12.7,0.3,67,0,10,94.4,1413,642,771,45.44,54.56,152,490,200,571,352,1061,23.7,25.9,24.9,"75% or more P.O.C.","Less than $55000"
"36081045500","Census Tract 455, Queens County, New York",14284,48889,1490,4734,0,2211,0,5332,10.4,33.1,0,15.5,0,37.3,89.6,4700,0,4700,0,100,0,0,655,4045,655,4045,NA,13.9,13.9,"75% or more P.O.C.","Less than $55000"
"36081045600","Census Tract 456, Queens County, New York",1446,91346,58,19,0,1062,0,213,4,1.3,0,73.4,0,14.7,96,350,253,97,72.29,27.71,84,169,34,63,118,232,33.2,35.1,33.7,"75% or more P.O.C.","$78000 - $104000"
"36081045700","Census Tract 457, Queens County, New York",3281,59318,239,0,0,2052,0,990,7.3,0,0,62.5,0,30.2,92.7,998,445,553,44.59,55.41,129,316,93,460,222,776,29,16.8,22.2,"75% or more P.O.C.","$55000 - $78000"
"36081045800","Census Tract 458, Queens County, New York",2348,72772,282,297,40,1480,0,192,12,12.6,1.7,63,0,8.2,88,693,319,374,46.03,53.97,90,229,74,300,164,529,28.2,19.8,23.7,"75% or more P.O.C.","$55000 - $78000"
"36081045900","Census Tract 459, Queens County, New York",3719,74375,94,2,0,1901,0,1703,2.5,0.1,0,51.1,0,45.8,97.5,976,422,554,43.24,56.76,159,263,83,471,242,734,37.7,15,24.8,"75% or more P.O.C.","$55000 - $78000"
"36081046000","Census Tract 460, Queens County, New York",6049,50346,80,818,48,2801,0,2045,1.3,13.5,0.8,46.3,0,33.8,98.7,1913,227,1686,11.87,88.13,53,174,225,1461,278,1635,23.3,13.3,14.5,"75% or more P.O.C.","Less than $55000"
"36081046100","Census Tract 461, Queens County, New York",2464,65547,190,36,4,849,0,1268,7.7,1.5,0.2,34.5,0,51.5,92.3,690,203,487,29.42,70.58,35,168,105,382,140,550,17.2,21.6,20.3,"75% or more P.O.C.","$55000 - $78000"
"36081046200","Census Tract 462, Queens County, New York",6907,50670,137,858,0,2915,0,2319,2,12.4,0,42.2,0,33.6,98,2079,556,1523,26.74,73.26,58,498,284,1239,342,1737,10.4,18.6,16.5,"75% or more P.O.C.","Less than $55000"
"36081046300","Census Tract 463, Queens County, New York",3836,58621,67,28,0,1414,0,2121,1.7,0.7,0,36.9,0,55.3,98.3,1036,407,629,39.29,60.71,116,291,59,570,175,861,28.5,9.4,16.9,"75% or more P.O.C.","$55000 - $78000"
"36081046400","Census Tract 464, Queens County, New York",1999,90227,276,434,0,661,0,499,13.8,21.7,0,33.1,0,25,86.2,528,218,310,41.29,58.71,64,154,45,265,109,419,29.4,14.5,20.6,"75% or more P.O.C.","$78000 - $104000"
"36081046500","Census Tract 465, Queens County, New York",4172,59318,36,0,0,1062,0,3074,0.9,0,0,25.5,0,73.7,99.1,972,234,738,24.07,75.93,127,107,174,564,301,671,54.3,23.6,31,"75% or more P.O.C.","$55000 - $78000"
"36081046600","Census Tract 466, Queens County, New York",3882,63284,400,962,0,1560,0,846,10.3,24.8,0,40.2,0,21.8,89.7,1356,503,853,37.09,62.91,77,426,183,670,260,1096,15.3,21.5,19.2,"75% or more P.O.C.","$55000 - $78000"
"36081046700","Census Tract 467, Queens County, New York",5895,40152,157,64,0,1476,0,4150,2.7,1.1,0,25,0,70.4,97.3,1972,173,1799,8.77,91.23,12,161,138,1661,150,1822,6.9,7.7,7.6,"75% or more P.O.C.","Less than $55000"
"36081046800","Census Tract 468, Queens County, New York",3340,73512,38,429,0,2238,0,200,1.1,12.8,0,67,0,6,98.9,968,508,460,52.48,47.52,106,402,54,406,160,808,20.9,11.7,16.5,"75% or more P.O.C.","$55000 - $78000"
"36081046900","Census Tract 469, Queens County, New York",8207,44450,87,218,67,2794,0,4746,1.1,2.7,0.8,34,0,57.8,98.9,2682,459,2223,17.11,82.89,107,352,337,1886,444,2238,23.3,15.2,16.6,"75% or more P.O.C.","Less than $55000"
"36081047000","Census Tract 470, Queens County, New York",3197,65000,34,291,21,1604,0,809,1.1,9.1,0.7,50.2,0,25.3,98.9,864,477,387,55.21,44.79,162,315,52,335,214,650,34,13.4,24.8,"75% or more P.O.C.","$55000 - $78000"
"36081047100","Census Tract 471, Queens County, New York",4320,47083,90,11,0,3127,0,1083,2.1,0.3,0,72.4,0,25.1,97.9,1339,328,1011,24.5,75.5,25,303,217,794,242,1097,7.6,21.5,18.1,"75% or more P.O.C.","Less than $55000"
"36081047200","Census Tract 472, Queens County, New York",3664,70462,819,974,0,1256,0,502,22.4,26.6,0,34.3,0,13.7,77.6,1362,685,677,50.29,49.71,58,627,17,660,75,1287,8.5,2.5,5.5,"75% or more P.O.C.","$55000 - $78000"
"36081047300","Census Tract 473, Queens County, New York",4328,56605,703,44,0,2978,0,603,16.2,1,0,68.8,0,13.9,83.8,1637,625,1012,38.18,61.82,50,575,22,990,72,1565,8,2.2,4.4,"75% or more P.O.C.","$55000 - $78000"
"36081047500","Census Tract 475, Queens County, New York",4301,59076,287,45,0,2572,0,1305,6.7,1,0,59.8,0,30.3,93.3,1427,454,973,31.81,68.19,79,375,119,854,198,1229,17.4,12.2,13.9,"75% or more P.O.C.","$55000 - $78000"
"36081047600","Census Tract 476, Queens County, New York",1419,126053,441,184,13,593,0,188,31.1,13,0.9,41.8,0,13.2,68.9,454,371,83,81.72,18.28,79,292,4,79,83,371,21.3,4.8,18.3,"50% - 75% P.O.C.","$104000 or more"
"36081047800","Census Tract 478, Queens County, New York",4925,69965,820,1472,0,1657,0,660,16.6,29.9,0,33.6,0,13.4,83.4,2079,1408,671,67.72,32.28,106,1302,0,671,106,1973,7.5,0,5.1,"75% or more P.O.C.","$55000 - $78000"
"36081047900","Census Tract 479, Queens County, New York",5115,58690,451,65,0,3523,0,996,8.8,1.3,0,68.9,0,19.5,91.2,1655,671,984,40.54,59.46,127,544,125,859,252,1403,18.9,12.7,15.2,"75% or more P.O.C.","$55000 - $78000"
"36081048000","Census Tract 480, Queens County, New York",2293,71481,61,301,51,937,0,536,2.7,13.1,2.2,40.9,0,23.4,97.3,634,497,137,78.39,21.61,116,381,16,121,132,502,23.3,11.7,20.8,"75% or more P.O.C.","$55000 - $78000"
"36081048100","Census Tract 481, Queens County, New York",6434,45864,438,244,0,3163,0,2419,6.8,3.8,0,49.2,0,37.6,93.2,1908,529,1379,27.73,72.27,85,444,253,1126,338,1570,16.1,18.3,17.7,"75% or more P.O.C.","Less than $55000"
"36081048200","Census Tract 482, Queens County, New York",1427,70978,71,500,0,374,0,128,5,35,0,26.2,0,9,95,384,249,135,64.84,35.16,74,175,15,120,89,295,29.7,11.1,23.2,"75% or more P.O.C.","$55000 - $78000"
"36081048300","Census Tract 483, Queens County, New York",3888,63811,248,42,66,2342,10,1160,6.4,1.1,1.7,60.2,0.3,29.8,93.6,1167,404,763,34.62,65.38,76,328,149,614,225,942,18.8,19.5,19.3,"75% or more P.O.C.","$55000 - $78000"
"36081048400","Census Tract 484, Queens County, New York",5140,87014,88,1727,0,1866,0,549,1.7,33.6,0,36.3,0,10.7,98.3,1461,991,470,67.83,32.17,244,747,24,446,268,1193,24.6,5.1,18.3,"75% or more P.O.C.","$78000 - $104000"
"36081048500","Census Tract 485, Queens County, New York",4366,65284,338,42,0,2890,0,1082,7.7,1,0,66.2,0,24.8,92.3,1433,624,809,43.55,56.45,74,550,135,674,209,1224,11.9,16.7,14.6,"75% or more P.O.C.","$55000 - $78000"
"36081048900","Census Tract 489, Queens County, New York",1610,64708,141,12,0,736,0,721,8.8,0.7,0,45.7,0,44.8,91.2,440,189,251,42.95,57.05,48,141,51,200,99,341,25.4,20.3,22.5,"75% or more P.O.C.","$55000 - $78000"
"36081049200","Census Tract 492, Queens County, New York",5444,74150,364,2347,0,1709,0,773,6.7,43.1,0,31.4,0,14.2,93.3,1831,481,1350,26.27,73.73,169,312,173,1177,342,1489,35.1,12.8,18.7,"75% or more P.O.C.","$55000 - $78000"
"36081049301","Census Tract 493.01, Queens County, New York",2209,66071,768,13,0,738,0,672,34.8,0.6,0,33.4,0,30.4,65.2,686,406,280,59.18,40.82,60,346,47,233,107,579,14.8,16.8,15.6,"50% - 75% P.O.C.","$55000 - $78000"
"36081049302","Census Tract 493.02, Queens County, New York",3068,73523,1108,70,0,501,0,1305,36.1,2.3,0,16.3,0,42.5,63.9,893,373,520,41.77,58.23,58,315,95,425,153,740,15.5,18.3,17.1,"50% - 75% P.O.C.","$55000 - $78000"
"36081049500","Census Tract 495, Queens County, New York",1515,75500,1006,88,9,114,0,298,66.4,5.8,0.6,7.5,0,19.7,33.6,482,216,266,44.81,55.19,34,182,25,241,59,423,15.7,9.4,12.2,"25% - 50% P.O.C.","$55000 - $78000"
"36081049600","Census Tract 496, Queens County, New York",3146,93295,93,798,16,921,0,660,3,25.4,0.5,29.3,0,21,97,865,671,194,77.57,22.43,175,496,12,182,187,678,26.1,6.2,21.6,"75% or more P.O.C.","$78000 - $104000"
"36081049700","Census Tract 497, Queens County, New York",3131,83355,1071,27,0,1190,0,799,34.2,0.9,0,38,0,25.5,65.8,959,526,433,54.85,45.15,99,427,45,388,144,815,18.8,10.4,15,"50% - 75% P.O.C.","$78000 - $104000"
"36081049900","Census Tract 499, Queens County, New York",5260,61534,737,53,153,3436,0,795,14,1,2.9,65.3,0,15.1,86,1613,748,865,46.37,53.63,266,482,110,755,376,1237,35.6,12.7,23.3,"75% or more P.O.C.","$55000 - $78000"
"36081050000","Census Tract 500, Queens County, New York",4279,56150,142,2986,0,381,0,566,3.3,69.8,0,8.9,0,13.2,96.7,1503,177,1326,11.78,88.22,64,113,101,1225,165,1338,36.2,7.6,11,"75% or more P.O.C.","$55000 - $78000"
"36081050201","Census Tract 502.01, Queens County, New York",1384,71250,0,994,0,83,0,243,0,71.8,0,6,0,17.6,100,372,267,105,71.77,28.23,63,204,34,71,97,275,23.6,32.4,26.1,"75% or more P.O.C.","$55000 - $78000"
"36081050202","Census Tract 502.02, Queens County, New York",1421,76313,20,1002,0,127,0,146,1.4,70.5,0,8.9,0,10.3,98.6,387,313,74,80.88,19.12,72,241,10,64,82,305,23,13.5,21.2,"75% or more P.O.C.","$55000 - $78000"
"36081050400","Census Tract 504, Queens County, New York",1818,77794,51,1573,38,30,0,67,2.8,86.5,2.1,1.7,0,3.7,97.2,508,342,166,67.32,32.68,74,268,25,141,99,409,21.6,15.1,19.5,"75% or more P.O.C.","$55000 - $78000"
"36081050500","Census Tract 505, Queens County, New York",1529,72000,673,50,0,563,0,221,44,3.3,0,36.8,0,14.5,56,562,264,298,46.98,53.02,36,228,24,274,60,502,13.6,8.1,10.7,"50% - 75% P.O.C.","$55000 - $78000"
"36081050600","Census Tract 506, Queens County, New York",1421,85370,0,1077,0,196,0,148,0,75.8,0,13.8,0,10.4,100,446,352,94,78.92,21.08,52,300,14,80,66,380,14.8,14.9,14.8,"75% or more P.O.C.","$78000 - $104000"
"36081050700","Census Tract 507, Queens County, New York",4102,57153,1839,76,0,1299,0,830,44.8,1.9,0,31.7,0,20.2,55.2,1324,735,589,55.51,44.49,112,623,24,565,136,1188,15.2,4.1,10.3,"50% - 75% P.O.C.","$55000 - $78000"
"36081050800","Census Tract 508, Queens County, New York",2008,64920,50,1658,0,52,0,85,2.5,82.6,0,2.6,0,4.2,97.5,641,367,274,57.25,42.75,94,273,6,268,100,541,25.6,2.2,15.6,"75% or more P.O.C.","$55000 - $78000"
"36081051000","Census Tract 510, Queens County, New York",1816,90104,47,1608,0,52,0,79,2.6,88.5,0,2.9,0,4.4,97.4,503,412,91,81.91,18.09,81,331,51,40,132,371,19.7,56,26.2,"75% or more P.O.C.","$78000 - $104000"
"36081051100","Census Tract 511, Queens County, New York",2290,95333,1269,18,0,252,0,667,55.4,0.8,0,11,0,29.1,44.6,760,385,375,50.66,49.34,56,329,40,335,96,664,14.5,10.7,12.6,"25% - 50% P.O.C.","$78000 - $104000"
"36081051200","Census Tract 512, Queens County, New York",2512,85000,9,1831,0,149,0,284,0.4,72.9,0,5.9,0,11.3,99.6,636,478,158,75.16,24.84,165,313,0,158,165,471,34.5,0,25.9,"75% or more P.O.C.","$78000 - $104000"
"36081051300","Census Tract 513, Queens County, New York",2439,91218,1447,79,0,389,0,517,59.3,3.2,0,15.9,0,21.2,40.7,746,430,316,57.64,42.36,97,333,55,261,152,594,22.6,17.4,20.4,"25% - 50% P.O.C.","$78000 - $104000"
"36081051500","Census Tract 515, Queens County, New York",3446,82487,2171,17,0,275,0,912,63,0.5,0,8,0,26.5,37,1183,785,398,66.36,33.64,106,679,75,323,181,1002,13.5,18.8,15.3,"25% - 50% P.O.C.","$78000 - $104000"
"36081051600","Census Tract 516, Queens County, New York",2183,87773,12,1772,4,0,0,298,0.5,81.2,0.2,0,0,13.7,99.5,583,401,182,68.78,31.22,128,273,46,136,174,409,31.9,25.3,29.8,"75% or more P.O.C.","$78000 - $104000"
"36081051700","Census Tract 517, Queens County, New York",2007,86513,1309,0,0,80,0,618,65.2,0,0,4,0,30.8,34.8,733,372,361,50.75,49.25,16,356,33,328,49,684,4.3,9.1,6.7,"25% - 50% P.O.C.","$78000 - $104000"
"36081051800","Census Tract 518, Queens County, New York",2181,77462,1,2081,0,7,0,54,0,95.4,0,0.3,0,2.5,100,631,517,114,81.93,18.07,103,414,17,97,120,511,19.9,14.9,19,"75% or more P.O.C.","$55000 - $78000"
"36081052000","Census Tract 520, Queens County, New York",1410,76576,17,1170,0,5,0,68,1.2,83,0,0.4,0,4.8,98.8,447,341,106,76.29,23.71,59,282,0,106,59,388,17.3,0,13.2,"75% or more P.O.C.","$55000 - $78000"
"36081052100","Census Tract 521, Queens County, New York",2253,93500,1508,29,0,138,0,559,66.9,1.3,0,6.1,0,24.8,33.1,694,470,224,67.72,32.28,74,396,32,192,106,588,15.7,14.3,15.3,"25% - 50% P.O.C.","$78000 - $104000"
"36081052200","Census Tract 522, Queens County, New York",1760,91313,0,1532,56,58,0,114,0,87,3.2,3.3,0,6.5,100,495,466,29,94.14,5.86,82,384,23,6,105,390,17.6,79.3,21.2,"75% or more P.O.C.","$78000 - $104000"
"36081052400","Census Tract 524, Queens County, New York",1988,91172,0,1729,0,41,0,198,0,87,0,2.1,0,10,100,541,466,75,86.14,13.86,94,372,3,72,97,444,20.2,4,17.9,"75% or more P.O.C.","$78000 - $104000"
"36081052500","Census Tract 525, Queens County, New York",2543,73333,1407,45,0,140,0,896,55.3,1.8,0,5.5,0,35.2,44.7,790,486,304,61.52,38.48,136,350,39,265,175,615,28,12.8,22.2,"25% - 50% P.O.C.","$55000 - $78000"
"36081052600","Census Tract 526, Queens County, New York",1933,76731,142,1448,0,45,0,159,7.3,74.9,0,2.3,0,8.2,92.7,564,427,137,75.71,24.29,84,343,12,125,96,468,19.7,8.8,17,"75% or more P.O.C.","$55000 - $78000"
"36081052800","Census Tract 528, Queens County, New York",1434,83250,0,1146,0,19,14,111,0,79.9,0,1.3,1,7.7,100,425,305,120,71.76,28.24,54,251,7,113,61,364,17.7,5.8,14.4,"75% or more P.O.C.","$78000 - $104000"
"36081053000","Census Tract 530, Queens County, New York",2473,81848,32,2380,0,0,0,42,1.3,96.2,0,0,0,1.7,98.7,640,517,123,80.78,19.22,165,352,16,107,181,459,31.9,13,28.3,"75% or more P.O.C.","$78000 - $104000"
"36081053100","Census Tract 531, Queens County, New York",3417,63447,1964,70,64,189,0,980,57.5,2,1.9,5.5,0,28.7,42.5,1281,493,788,38.49,61.51,94,399,52,736,146,1135,19.1,6.6,11.4,"25% - 50% P.O.C.","$55000 - $78000"
"36081053200","Census Tract 532, Queens County, New York",1996,84946,11,1613,160,1,7,158,0.6,80.8,8,0.1,0.4,7.9,99.4,567,404,163,71.25,28.75,54,350,13,150,67,500,13.4,8,11.8,"75% or more P.O.C.","$78000 - $104000"
"36081053401","Census Tract 534.01, Queens County, New York",2125,92961,35,1782,0,0,0,303,1.6,83.9,0,0,0,14.3,98.4,605,476,129,78.68,21.32,99,377,24,105,123,482,20.8,18.6,20.3,"75% or more P.O.C.","$78000 - $104000"
"36081053500","Census Tract 535, Queens County, New York",1432,65208,424,0,9,0,0,999,29.6,0,0.6,0,0,69.8,70.4,414,120,294,28.99,71.01,3,117,83,211,86,328,2.5,28.2,20.8,"50% - 75% P.O.C.","$55000 - $78000"
"36081053601","Census Tract 536.01, Queens County, New York",2099,101136,26,1510,0,94,0,339,1.2,71.9,0,4.5,0,16.2,98.8,528,404,124,76.52,23.48,108,296,31,93,139,389,26.7,25,26.3,"75% or more P.O.C.","$78000 - $104000"
"36081053800","Census Tract 538, Queens County, New York",1781,101741,7,1424,0,75,0,184,0.4,80,0,4.2,0,10.3,99.6,447,341,106,76.29,23.71,118,223,13,93,131,316,34.6,12.3,29.3,"75% or more P.O.C.","$78000 - $104000"
"36081053900","Census Tract 539, Queens County, New York",4433,83566,1401,93,0,844,0,2022,31.6,2.1,0,19,0,45.6,68.4,1388,623,765,44.88,55.12,126,497,111,654,237,1151,20.2,14.5,17.1,"50% - 75% P.O.C.","$78000 - $104000"
"36081054000","Census Tract 540, Queens County, New York",4290,69191,30,2502,42,236,0,913,0.7,58.3,1,5.5,0,21.3,99.3,1181,720,461,60.97,39.03,224,496,63,398,287,894,31.1,13.7,24.3,"75% or more P.O.C.","$55000 - $78000"
"36081054200","Census Tract 542, Queens County, New York",4737,72966,389,1191,0,1047,0,1112,8.2,25.1,0,22.1,0,23.5,91.8,1394,1039,355,74.53,25.47,297,742,47,308,344,1050,28.6,13.2,24.7,"75% or more P.O.C.","$55000 - $78000"
"36081054500","Census Tract 545, Queens County, New York",4039,59187,962,133,0,88,0,2788,23.8,3.3,0,2.2,0,69,76.2,1323,113,1210,8.54,91.46,31,82,195,1015,226,1097,27.4,16.1,17.1,"75% or more P.O.C.","$55000 - $78000"
"36081054700","Census Tract 547, Queens County, New York",5048,76493,1085,132,0,562,0,3184,21.5,2.6,0,11.1,0,63.1,78.5,1463,354,1109,24.2,75.8,129,225,248,861,377,1086,36.4,22.4,25.8,"75% or more P.O.C.","$55000 - $78000"
"36081054800","Census Tract 548, Queens County, New York",2354,74167,30,259,53,1282,0,398,1.3,11,2.3,54.5,0,16.9,98.7,638,549,89,86.05,13.95,136,413,0,89,136,502,24.8,0,21.3,"75% or more P.O.C.","$55000 - $78000"
"36081054900","Census Tract 549, Queens County, New York",6437,75500,1399,75,0,915,0,4011,21.7,1.2,0,14.2,0,62.3,78.3,1732,130,1602,7.51,92.49,40,90,286,1316,326,1406,30.8,17.9,18.8,"75% or more P.O.C.","$55000 - $78000"
"36081055100","Census Tract 551, Queens County, New York",4244,75280,1722,165,0,471,0,1838,40.6,3.9,0,11.1,0,43.3,59.4,1555,142,1413,9.13,90.87,0,142,145,1268,145,1410,0,10.3,9.3,"50% - 75% P.O.C.","$55000 - $78000"
"36081055200","Census Tract 552, Queens County, New York",2955,63261,155,775,0,532,0,977,5.2,26.2,0,18,0,33.1,94.8,1020,389,631,38.14,61.86,126,263,15,616,141,879,32.4,2.4,13.8,"75% or more P.O.C.","$55000 - $78000"
"36081055300","Census Tract 553, Queens County, New York",2786,59907,512,87,0,452,0,1562,18.4,3.1,0,16.2,0,56.1,81.6,938,130,808,13.86,86.14,40,90,87,721,127,811,30.8,10.8,13.5,"75% or more P.O.C.","$55000 - $78000"
"36081055400","Census Tract 554, Queens County, New York",2530,74821,402,343,11,1131,0,550,15.9,13.6,0.4,44.7,0,21.7,84.1,741,418,323,56.41,43.59,126,292,34,289,160,581,30.1,10.5,21.6,"75% or more P.O.C.","$55000 - $78000"
"36081055500","Census Tract 555, Queens County, New York",2335,64423,498,91,0,140,0,1514,21.3,3.9,0,6,0,64.8,78.7,688,227,461,32.99,67.01,62,165,73,388,135,553,27.3,15.8,19.6,"75% or more P.O.C.","$55000 - $78000"
"36081055600","Census Tract 556, Queens County, New York",2282,77829,179,383,0,758,0,488,7.8,16.8,0,33.2,0,21.4,92.2,657,520,137,79.15,20.85,129,391,7,130,136,521,24.8,5.1,20.7,"75% or more P.O.C.","$55000 - $78000"
"36081055700","Census Tract 557, Queens County, New York",4275,65799,1245,114,0,193,0,2704,29.1,2.7,0,4.5,0,63.3,70.9,1355,251,1104,18.52,81.48,112,139,99,1005,211,1144,44.6,9,15.6,"50% - 75% P.O.C.","$55000 - $78000"
"36081055800","Census Tract 558, Queens County, New York",1702,95735,221,295,0,496,0,379,13,17.3,0,29.1,0,22.3,87,494,414,80,83.81,16.19,59,355,18,62,77,417,14.3,22.5,15.6,"75% or more P.O.C.","$78000 - $104000"
"36081055900","Census Tract 559, Queens County, New York",1184,70000,210,30,0,56,0,850,17.7,2.5,0,4.7,0,71.8,82.3,370,90,280,24.32,75.68,21,69,20,260,41,329,23.3,7.1,11.1,"75% or more P.O.C.","$55000 - $78000"
"36081056000","Census Tract 560, Queens County, New York",1809,70313,288,87,0,570,0,606,15.9,4.8,0,31.5,0,33.5,84.1,483,415,68,85.92,14.08,111,304,31,37,142,341,26.7,45.6,29.4,"75% or more P.O.C.","$55000 - $78000"
"36081056100","Census Tract 561, Queens County, New York",17,NA,0,0,0,8,0,9,0,0,0,47.1,0,52.9,100,8,4,4,50,50,0,4,0,4,0,8,0,0,0,"75% or more P.O.C.","N/A"
"36081056200","Census Tract 562, Queens County, New York",1631,99231,288,202,0,455,0,389,17.7,12.4,0,27.9,0,23.9,82.3,436,413,23,94.72,5.28,90,323,3,20,93,343,21.8,13,21.3,"75% or more P.O.C.","$78000 - $104000"
"36081056400","Census Tract 564, Queens County, New York",1178,57132,166,134,0,295,0,324,14.1,11.4,0,25,0,27.5,85.9,417,209,208,50.12,49.88,32,177,0,208,32,385,15.3,0,7.7,"75% or more P.O.C.","$55000 - $78000"
"36081056500","Census Tract 565, Queens County, New York",1569,71719,342,35,0,39,0,1116,21.8,2.2,0,2.5,0,71.1,78.2,518,226,292,43.63,56.37,7,219,49,243,56,462,3.1,16.8,10.8,"75% or more P.O.C.","$55000 - $78000"
"36081056600","Census Tract 566, Queens County, New York",1316,77031,127,393,0,382,0,285,9.7,29.9,0,29,0,21.7,90.3,446,291,155,65.25,34.75,33,258,14,141,47,399,11.3,9,10.5,"75% or more P.O.C.","$55000 - $78000"
"36081056700","Census Tract 567, Queens County, New York",5175,96970,1563,58,0,176,0,3319,30.2,1.1,0,3.4,0,64.1,69.8,1518,955,563,62.91,37.09,184,771,112,451,296,1222,19.3,19.9,19.5,"50% - 75% P.O.C.","$78000 - $104000"
"36081056800","Census Tract 568, Queens County, New York",5039,83295,262,2830,0,411,0,1048,5.2,56.2,0,8.2,0,20.8,94.8,1435,850,585,59.23,40.77,227,623,53,532,280,1155,26.7,9.1,19.5,"75% or more P.O.C.","$78000 - $104000"
"36081057700","Census Tract 577, Queens County, New York",4169,65607,2361,43,21,67,0,1645,56.6,1,0.5,1.6,0,39.5,43.4,1449,495,954,34.16,65.84,86,409,72,882,158,1291,17.4,7.5,10.9,"25% - 50% P.O.C.","$55000 - $78000"
"36081057900","Census Tract 579, Queens County, New York",1643,59306,921,6,0,62,0,654,56.1,0.4,0,3.8,0,39.8,43.9,594,113,481,19.02,80.98,19,94,27,454,46,548,16.8,5.6,7.7,"25% - 50% P.O.C.","$55000 - $78000"
"36081058000","Census Tract 580, Queens County, New York",4140,87986,34,3109,9,59,33,475,0.8,75.1,0.2,1.4,0.8,11.5,99.2,1127,782,345,69.39,30.61,235,547,22,323,257,870,30.1,6.4,22.8,"75% or more P.O.C.","$78000 - $104000"
"36081058100","Census Tract 581, Queens County, New York",3048,75665,1617,80,0,73,0,1231,53.1,2.6,0,2.4,0,40.4,46.9,1087,435,652,40.02,59.98,21,414,54,598,75,1012,4.8,8.3,6.9,"25% - 50% P.O.C.","$55000 - $78000"
"36081058200","Census Tract 582, Queens County, New York",4838,100505,113,3758,0,160,0,457,2.3,77.7,0,3.3,0,9.4,97.7,1337,1088,249,81.38,18.62,206,882,36,213,242,1095,18.9,14.5,18.1,"75% or more P.O.C.","$78000 - $104000"
"36081058300","Census Tract 583, Queens County, New York",3736,89028,2077,49,0,300,0,1225,55.6,1.3,0,8,0,32.8,44.4,1229,366,863,29.78,70.22,38,328,53,810,91,1138,10.4,6.1,7.4,"25% - 50% P.O.C.","$78000 - $104000"
"36081058500","Census Tract 585, Queens County, New York",4464,79898,2210,53,0,512,0,1627,49.5,1.2,0,11.5,0,36.4,50.5,1443,298,1145,20.65,79.35,24,274,100,1045,124,1319,8.1,8.7,8.6,"50% - 75% P.O.C.","$78000 - $104000"
"36081058700","Census Tract 587, Queens County, New York",3550,69358,2491,39,0,83,0,937,70.2,1.1,0,2.3,0,26.4,29.8,1219,335,884,27.48,72.52,52,283,110,774,162,1057,15.5,12.4,13.3,"25% - 50% P.O.C.","$55000 - $78000"
"36081058900","Census Tract 589, Queens County, New York",5296,62083,2728,18,0,160,0,2390,51.5,0.3,0,3,0,45.1,48.5,1614,268,1346,16.6,83.4,85,183,106,1240,191,1423,31.7,7.9,11.8,"25% - 50% P.O.C.","$55000 - $78000"
"36081059000","Census Tract 590, Queens County, New York",1466,75750,22,1134,124,30,0,129,1.5,77.4,8.5,2,0,8.8,98.5,434,334,100,76.96,23.04,84,250,2,98,86,348,25.1,2,19.8,"75% or more P.O.C.","$55000 - $78000"
"36081059100","Census Tract 591, Queens County, New York",5736,70867,2613,118,0,150,0,2625,45.6,2.1,0,2.6,0,45.8,54.4,2085,348,1737,16.69,83.31,54,294,120,1617,174,1911,15.5,6.9,8.3,"50% - 75% P.O.C.","$55000 - $78000"
"36081059200","Census Tract 592, Queens County, New York",1516,115625,0,1403,0,0,0,86,0,92.5,0,0,0,5.7,100,405,375,30,92.59,7.41,111,264,0,30,111,294,29.6,0,27.4,"75% or more P.O.C.","$104000 or more"
"36081059300","Census Tract 593, Queens County, New York",4217,70962,2700,24,0,255,0,1238,64,0.6,0,6,0,29.4,36,1538,523,1015,34.01,65.99,19,504,55,960,74,1464,3.6,5.4,4.8,"25% - 50% P.O.C.","$55000 - $78000"
"36081059400","Census Tract 594, Queens County, New York",1768,130500,12,1626,0,5,0,101,0.7,92,0,0.3,0,5.7,99.3,520,484,36,93.08,6.92,72,412,5,31,77,443,14.9,13.9,14.8,"75% or more P.O.C.","$104000 or more"
"36081059500","Census Tract 595, Queens County, New York",5533,72292,2646,12,0,217,0,2579,47.8,0.2,0,3.9,0,46.6,52.2,1644,600,1044,36.5,63.5,125,475,179,865,304,1340,20.8,17.1,18.5,"50% - 75% P.O.C.","$55000 - $78000"
"36081059600","Census Tract 596, Queens County, New York",1272,72578,17,1180,0,1,0,66,1.3,92.8,0,0.1,0,5.2,98.7,452,367,85,81.19,18.81,48,319,8,77,56,396,13.1,9.4,12.4,"75% or more P.O.C.","$55000 - $78000"
"36081059800","Census Tract 598, Queens County, New York",1798,88438,24,1614,0,0,0,69,1.3,89.8,0,0,0,3.8,98.7,573,427,146,74.52,25.48,56,371,0,146,56,517,13.1,0,9.8,"75% or more P.O.C.","$78000 - $104000"
"36081059900","Census Tract 599, Queens County, New York",1255,65446,873,8,0,78,0,288,69.6,0.6,0,6.2,0,22.9,30.4,544,365,179,67.1,32.9,21,344,6,173,27,517,5.8,3.4,5,"25% - 50% P.O.C.","$55000 - $78000"
"36081060000","Census Tract 600, Queens County, New York",1102,96875,8,978,14,4,0,77,0.7,88.7,1.3,0.4,0,7,99.3,370,343,27,92.7,7.3,60,283,0,27,60,310,17.5,0,16.2,"75% or more P.O.C.","$78000 - $104000"
"36081060100","Census Tract 601, Queens County, New York",2324,69052,1139,10,0,76,0,1022,49,0.4,0,3.3,0,44,51,778,292,486,37.53,62.47,44,248,62,424,106,672,15.1,12.8,13.6,"50% - 75% P.O.C.","$55000 - $78000"
"36081060300","Census Tract 603, Queens County, New York",2095,89375,1226,0,0,81,0,753,58.5,0,0,3.9,0,35.9,41.5,636,384,252,60.38,39.62,121,263,31,221,152,484,31.5,12.3,23.9,"25% - 50% P.O.C.","$78000 - $104000"
"36081060600","Census Tract 606, Queens County, New York",1351,88214,6,1303,0,0,0,0,0.4,96.4,0,0,0,0,99.6,474,444,30,93.67,6.33,30,414,22,8,52,422,6.8,73.3,11,"75% or more P.O.C.","$78000 - $104000"
"36081060701","Census Tract 607.01, Queens County, New York",14,NA,14,0,0,0,0,0,100,0,0,0,0,0,0,14,14,0,100,0,0,14,0,0,0,14,0,NA,0,"Less than 25% P.O.C.","N/A"
"36081060800","Census Tract 608, Queens County, New York",1564,98750,58,1428,0,0,0,60,3.7,91.3,0,0,0,3.8,96.3,436,388,48,88.99,11.01,80,308,4,44,84,352,20.6,8.3,19.3,"75% or more P.O.C.","$78000 - $104000"
"36081061000","Census Tract 610, Queens County, New York",1551,103333,9,1517,0,0,0,25,0.6,97.8,0,0,0,1.6,99.4,442,437,5,98.87,1.13,139,298,0,5,139,303,31.8,0,31.4,"75% or more P.O.C.","$78000 - $104000"
"36081061200","Census Tract 612, Queens County, New York",2022,121645,0,2003,0,0,0,9,0,99.1,0,0,0,0.4,100,509,489,20,96.07,3.93,162,327,12,8,174,335,33.1,60,34.2,"75% or more P.O.C.","$104000 or more"
"36081061301","Census Tract 613.01, Queens County, New York",5742,73860,3056,17,0,333,0,2308,53.2,0.3,0,5.8,0,40.2,46.8,1883,444,1439,23.58,76.42,82,362,158,1281,240,1643,18.5,11,12.7,"25% - 50% P.O.C.","$55000 - $78000"
"36081061302","Census Tract 613.02, Queens County, New York",0,NA,0,0,0,0,0,0,NA,NA,NA,NA,NA,NA,NA,0,0,0,NA,NA,0,0,0,0,0,0,NA,NA,NA,"N/A","N/A"
"36081061400","Census Tract 614, Queens County, New York",1414,125114,3,1172,0,32,0,151,0.2,82.9,0,2.3,0,10.7,99.8,393,337,56,85.75,14.25,60,277,0,56,60,333,17.8,0,15.3,"75% or more P.O.C.","$104000 or more"
"36081061601","Census Tract 616.01, Queens County, New York",2145,85987,41,1841,0,14,0,249,1.9,85.8,0,0.7,0,11.6,98.1,735,631,104,85.85,14.15,82,549,37,67,119,616,13,35.6,16.2,"75% or more P.O.C.","$78000 - $104000"
"36081061602","Census Tract 616.02, Queens County, New York",1118,108676,24,940,9,42,0,47,2.1,84.1,0.8,3.8,0,4.2,97.9,342,298,44,87.13,12.87,57,241,3,41,60,282,19.1,6.8,17.5,"75% or more P.O.C.","$104000 or more"
"36081061800","Census Tract 618, Queens County, New York",1796,81406,65,1612,0,19,0,89,3.6,89.8,0,1.1,0,5,96.4,709,533,176,75.18,24.82,35,498,0,176,35,674,6.6,0,4.9,"75% or more P.O.C.","$78000 - $104000"
"36081061900","Census Tract 619, Queens County, New York",2683,91750,2068,0,0,81,0,520,77.1,0,0,3,0,19.4,22.9,1018,454,564,44.6,55.4,72,382,23,541,95,923,15.9,4.1,9.3,"Less than 25% P.O.C.","$78000 - $104000"
"36081062000","Census Tract 620, Queens County, New York",1431,113125,25,1211,66,0,0,129,1.7,84.6,4.6,0,0,9,98.3,496,469,27,94.56,5.44,44,425,4,23,48,448,9.4,14.8,9.7,"75% or more P.O.C.","$104000 or more"
"36081062100","Census Tract 621, Queens County, New York",2896,68558,1575,19,33,73,0,1182,54.4,0.7,1.1,2.5,0,40.8,45.6,1019,364,655,35.72,64.28,60,304,40,615,100,919,16.5,6.1,9.8,"25% - 50% P.O.C.","$55000 - $78000"
"36081062200","Census Tract 622, Queens County, New York",2083,103977,15,1772,0,13,0,275,0.7,85.1,0,0.6,0,13.2,99.3,651,540,111,82.95,17.05,72,468,17,94,89,562,13.3,15.3,13.7,"75% or more P.O.C.","$78000 - $104000"
"36081062300","Census Tract 623, Queens County, New York",2246,87333,1328,112,0,16,0,785,59.1,5,0,0.7,0,35,40.9,796,298,498,37.44,62.56,27,271,38,460,65,731,9.1,7.6,8.2,"25% - 50% P.O.C.","$78000 - $104000"
"36081062400","Census Tract 624, Queens County, New York",0,NA,0,0,0,0,0,0,NA,NA,NA,NA,NA,NA,NA,0,0,0,NA,NA,0,0,0,0,0,0,NA,NA,NA,"N/A","N/A"
"36081062500","Census Tract 625, Queens County, New York",2692,86607,1607,26,0,8,0,1030,59.7,1,0,0.3,0,38.3,40.3,888,398,490,44.82,55.18,69,329,56,434,125,763,17.3,11.4,14.1,"25% - 50% P.O.C.","$78000 - $104000"
"36081062600","Census Tract 626, Queens County, New York",2805,83083,31,2377,0,8,0,272,1.1,84.7,0,0.3,0,9.7,98.9,878,801,77,91.23,8.77,148,653,23,54,171,707,18.5,29.9,19.5,"75% or more P.O.C.","$78000 - $104000"
"36081062700","Census Tract 627, Queens County, New York",2944,76859,1453,0,0,41,0,1433,49.4,0,0,1.4,0,48.7,50.6,986,348,638,35.29,64.71,0,348,60,578,60,926,0,9.4,6.1,"50% - 75% P.O.C.","$55000 - $78000"
"36081062900","Census Tract 629, Queens County, New York",3034,80573,1766,5,0,252,0,941,58.2,0.2,0,8.3,0,31,41.8,1022,349,673,34.15,65.85,43,306,31,642,74,948,12.3,4.6,7.2,"25% - 50% P.O.C.","$78000 - $104000"
"36081063000","Census Tract 630, Queens County, New York",1503,112438,25,1425,0,21,0,19,1.7,94.8,0,1.4,0,1.3,98.3,493,425,68,86.21,13.79,37,388,0,68,37,456,8.7,0,7.5,"75% or more P.O.C.","$104000 or more"
"36081063200","Census Tract 632, Queens County, New York",2601,112273,39,2359,0,0,0,140,1.5,90.7,0,0,0,5.4,98.5,670,566,104,84.48,15.52,188,378,18,86,206,464,33.2,17.3,30.7,"75% or more P.O.C.","$104000 or more"
"36081063301","Census Tract 633.01, Queens County, New York",1704,80156,1183,6,0,59,0,456,69.4,0.4,0,3.5,0,26.8,30.6,587,303,284,51.62,48.38,70,233,20,264,90,497,23.1,7,15.3,"25% - 50% P.O.C.","$78000 - $104000"
"36081063302","Census Tract 633.02, Queens County, New York",1475,85000,1185,0,0,5,0,262,80.3,0,0,0.3,0,17.8,19.7,554,331,223,59.75,40.25,42,289,7,216,49,505,12.7,3.1,8.8,"Less than 25% P.O.C.","$78000 - $104000"
"36081063500","Census Tract 635, Queens County, New York",2551,75288,1731,10,12,57,0,719,67.9,0.4,0.5,2.2,0,28.2,32.1,917,534,383,58.23,41.77,54,480,48,335,102,815,10.1,12.5,11.1,"25% - 50% P.O.C.","$55000 - $78000"
"36081063700","Census Tract 637, Queens County, New York",3432,97356,2267,141,0,204,0,812,66.1,4.1,0,5.9,0,23.7,33.9,1125,860,265,76.44,23.56,131,729,51,214,182,943,15.2,19.2,16.2,"25% - 50% P.O.C.","$78000 - $104000"
"36081063800","Census Tract 638, Queens County, New York",3516,101957,108,2770,0,24,0,500,3.1,78.8,0,0.7,0,14.2,96.9,1030,845,185,82.04,17.96,175,670,30,155,205,825,20.7,16.2,19.9,"75% or more P.O.C.","$78000 - $104000"
"36081063900","Census Tract 639, Queens County, New York",3043,77179,1589,147,0,307,0,859,52.2,4.8,0,10.1,0,28.2,47.8,1123,695,428,61.89,38.11,110,585,8,420,118,1005,15.8,1.9,10.5,"25% - 50% P.O.C.","$55000 - $78000"
"36081064101","Census Tract 641.01, Queens County, New York",2388,70769,1481,17,0,345,0,505,62,0.7,0,14.4,0,21.1,38,956,833,123,87.13,12.87,54,779,0,123,54,902,6.5,0,5.6,"25% - 50% P.O.C.","$55000 - $78000"
"36081064102","Census Tract 641.02, Queens County, New York",0,NA,0,0,0,0,0,0,NA,NA,NA,NA,NA,NA,NA,0,0,0,NA,NA,0,0,0,0,0,0,NA,NA,NA,"N/A","N/A"
"36081064500","Census Tract 645, Queens County, New York",1927,77364,1046,68,0,321,0,462,54.3,3.5,0,16.7,0,24,45.7,726,412,314,56.75,43.25,15,397,51,263,66,660,3.6,16.2,9.1,"25% - 50% P.O.C.","$55000 - $78000"
"36081064600","Census Tract 646, Queens County, New York",2976,87823,17,2688,0,29,0,114,0.6,90.3,0,1,0,3.8,99.4,978,843,135,86.2,13.8,128,715,4,131,132,846,15.2,3,13.5,"75% or more P.O.C.","$78000 - $104000"
"36081065000","Census Tract 650, Queens County, New York",2742,93409,76,2499,13,0,0,84,2.8,91.1,0.5,0,0,3.1,97.2,828,696,132,84.06,15.94,144,552,34,98,178,650,20.7,25.8,21.5,"75% or more P.O.C.","$78000 - $104000"
"36081065400","Census Tract 654, Queens County, New York",3782,99792,36,2707,0,104,0,871,1,71.6,0,2.7,0,23,99,935,616,319,65.88,34.12,184,432,29,290,213,722,29.9,9.1,22.8,"75% or more P.O.C.","$78000 - $104000"
"36081065501","Census Tract 655.01, Queens County, New York",0,NA,0,0,0,0,0,0,NA,NA,NA,NA,NA,NA,NA,0,0,0,NA,NA,0,0,0,0,0,0,NA,NA,NA,"N/A","N/A"
"36081065600","Census Tract 656, Queens County, New York",4966,80604,198,3939,0,107,0,506,4,79.3,0,2.2,0,10.2,96,1492,788,704,52.82,47.18,161,627,101,603,262,1230,20.4,14.3,17.6,"75% or more P.O.C.","$78000 - $104000"
"36081065702","Census Tract 657.02, Queens County, New York",1802,71382,1245,0,0,36,0,509,69.1,0,0,2,0,28.2,30.9,735,375,360,51.02,48.98,23,352,32,328,55,680,6.1,8.9,7.5,"25% - 50% P.O.C.","$55000 - $78000"
"36081065703","Census Tract 657.03, Queens County, New York",2746,85795,2182,2,0,82,0,470,79.5,0.1,0,3,0,17.1,20.5,1001,587,414,58.64,41.36,75,512,20,394,95,906,12.8,4.8,9.5,"Less than 25% P.O.C.","$78000 - $104000"
"36081065900","Census Tract 659, Queens County, New York",1884,100039,1485,0,0,160,0,156,78.8,0,0,8.5,0,8.3,21.2,699,562,137,80.4,19.6,63,499,13,124,76,623,11.2,9.5,10.9,"Less than 25% P.O.C.","$78000 - $104000"
"36081066000","Census Tract 660, Queens County, New York",3318,68403,122,2525,116,79,0,469,3.7,76.1,3.5,2.4,0,14.1,96.3,1009,741,268,73.44,26.56,110,631,0,268,110,899,14.8,0,10.9,"75% or more P.O.C.","$55000 - $78000"
"36081066100","Census Tract 661, Queens County, New York",1647,88636,1376,41,0,27,0,188,83.5,2.5,0,1.6,0,11.4,16.5,618,477,141,77.18,22.82,30,447,0,141,30,588,6.3,0,4.9,"Less than 25% P.O.C.","$78000 - $104000"
"36081066300","Census Tract 663, Queens County, New York",2771,110000,2085,5,0,456,0,171,75.2,0.2,0,16.5,0,6.2,24.8,972,852,120,87.65,12.35,119,733,0,120,119,853,14,0,12.2,"Less than 25% P.O.C.","$104000 or more"
"36081066400","Census Tract 664, Queens County, New York",9980,92912,375,8545,0,249,0,609,3.8,85.6,0,2.5,0,6.1,96.2,3054,1670,1384,54.68,45.32,423,1247,137,1247,560,2494,25.3,9.9,18.3,"75% or more P.O.C.","$78000 - $104000"
"36081066501","Census Tract 665.01, Queens County, New York",4149,102708,3215,33,0,75,0,674,77.5,0.8,0,1.8,0,16.2,22.5,1385,798,587,57.62,42.38,113,685,24,563,137,1248,14.2,4.1,9.9,"Less than 25% P.O.C.","$78000 - $104000"
"36081066701","Census Tract 667.01, Queens County, New York",2800,86563,2042,0,0,82,0,676,72.9,0,0,2.9,0,24.1,27.1,1018,664,354,65.23,34.77,59,605,0,354,59,959,8.9,0,5.8,"25% - 50% P.O.C.","$78000 - $104000"
"36081066900","Census Tract 669, Queens County, New York",1642,70875,1392,0,0,107,0,143,84.8,0,0,6.5,0,8.7,15.2,580,319,261,55,45,36,283,18,243,54,526,11.3,6.9,9.3,"Less than 25% P.O.C.","$55000 - $78000"
"36081067100","Census Tract 671, Queens County, New York",2455,108438,1647,0,0,649,0,144,67.1,0,0,26.4,0,5.9,32.9,874,798,76,91.3,8.7,87,711,5,71,92,782,10.9,6.6,10.5,"25% - 50% P.O.C.","$104000 or more"
"36081067700","Census Tract 677, Queens County, New York",1883,101000,1515,0,0,254,0,114,80.5,0,0,13.5,0,6.1,19.5,664,555,109,83.58,16.42,53,502,0,109,53,611,9.5,0,8,"Less than 25% P.O.C.","$78000 - $104000"
"36081067900","Census Tract 679, Queens County, New York",4344,48640,1919,48,0,310,0,1826,44.2,1.1,0,7.1,0,42,55.8,1673,384,1289,22.95,77.05,7,377,76,1213,83,1590,1.8,5.9,5,"50% - 75% P.O.C.","Less than $55000"
"36081068000","Census Tract 680, Queens County, New York",5299,101458,14,5008,0,50,0,205,0.3,94.5,0,0.9,0,3.9,99.7,1462,1027,435,70.25,29.75,192,835,73,362,265,1197,18.7,16.8,18.1,"75% or more P.O.C.","$78000 - $104000"
"36081068200","Census Tract 682, Queens County, New York",994,89000,10,837,0,24,0,108,1,84.2,0,2.4,0,10.9,99,342,238,104,69.59,30.41,35,203,14,90,49,293,14.7,13.5,14.3,"75% or more P.O.C.","$78000 - $104000"
"36081068300","Census Tract 683, Queens County, New York",3970,51491,458,334,0,1638,0,1435,11.5,8.4,0,41.3,0,36.1,88.5,1688,728,960,43.13,56.87,48,680,13,947,61,1627,6.6,1.4,3.6,"75% or more P.O.C.","Less than $55000"
"36081068700","Census Tract 687, Queens County, New York",4188,60855,1515,103,0,1686,0,826,36.2,2.5,0,40.3,0,19.7,63.8,1761,795,966,45.14,54.86,29,766,40,926,69,1692,3.6,4.1,3.9,"50% - 75% P.O.C.","$55000 - $78000"
"36081069000","Census Tract 690, Queens County, New York",3752,96875,114,3313,0,20,57,22,3,88.3,0,0.5,1.5,0.6,97,978,517,461,52.86,47.14,155,362,125,336,280,698,30,27.1,28.6,"75% or more P.O.C.","$78000 - $104000"
"36081069300","Census Tract 693, Queens County, New York",3151,62476,1022,387,0,1109,0,561,32.4,12.3,0,35.2,0,17.8,67.6,1263,285,978,22.57,77.43,7,278,59,919,66,1197,2.5,6,5.2,"50% - 75% P.O.C.","$55000 - $78000"
"36081069400","Census Tract 694, Queens County, New York",3455,82332,124,2786,0,64,0,379,3.6,80.6,0,1.9,0,11,96.4,1079,605,474,56.07,43.93,48,557,33,441,81,998,7.9,7,7.5,"75% or more P.O.C.","$78000 - $104000"
"36081069500","Census Tract 695, Queens County, New York",2211,73984,1018,18,0,750,0,393,46,0.8,0,33.9,0,17.8,54,875,450,425,51.43,48.57,50,400,10,415,60,815,11.1,2.4,6.9,"50% - 75% P.O.C.","$55000 - $78000"
"36081069701","Census Tract 697.01, Queens County, New York",4322,86875,1690,330,0,1209,0,1002,39.1,7.6,0,28,0,23.2,60.9,1863,299,1564,16.05,83.95,0,299,68,1496,68,1795,0,4.3,3.7,"50% - 75% P.O.C.","$78000 - $104000"
"36081069702","Census Tract 697.02, Queens County, New York",3518,87168,1466,14,0,1528,0,489,41.7,0.4,0,43.4,0,13.9,58.3,1401,955,446,68.17,31.83,65,890,25,421,90,1311,6.8,5.6,6.4,"50% - 75% P.O.C.","$78000 - $104000"
"36081070300","Census Tract 703, Queens County, New York",2103,68846,958,59,0,577,0,489,45.6,2.8,0,27.4,0,23.3,54.4,822,598,224,72.75,27.25,71,527,7,217,78,744,11.9,3.1,9.5,"50% - 75% P.O.C.","$55000 - $78000"
"36081070700","Census Tract 707, Queens County, New York",2547,112738,1226,0,0,801,0,416,48.1,0,0,31.4,0,16.3,51.9,980,741,239,75.61,24.39,40,701,18,221,58,922,5.4,7.5,5.9,"50% - 75% P.O.C.","$104000 or more"
"36081070900","Census Tract 709, Queens County, New York",2869,97026,1287,60,0,1039,0,238,44.9,2.1,0,36.2,0,8.3,55.1,1035,573,462,55.36,44.64,73,500,34,428,107,928,12.7,7.4,10.3,"50% - 75% P.O.C.","$78000 - $104000"
"36081071100","Census Tract 711, Queens County, New York",6448,95368,3241,107,0,1787,0,1043,50.3,1.7,0,27.7,0,16.2,49.7,2788,1577,1211,56.56,43.44,113,1464,32,1179,145,2643,7.2,2.6,5.2,"25% - 50% P.O.C.","$78000 - $104000"
"36081071303","Census Tract 713.03, Queens County, New York",5431,95045,3180,92,0,1021,0,834,58.6,1.7,0,18.8,0,15.4,41.4,2635,891,1744,33.81,66.19,0,891,102,1642,102,2533,0,5.8,3.9,"25% - 50% P.O.C.","$78000 - $104000"
"36081071304","Census Tract 713.04, Queens County, New York",6054,55363,3374,106,0,1568,0,738,55.7,1.8,0,25.9,0,12.2,44.3,3095,1051,2044,33.96,66.04,20,1031,68,1976,88,3007,1.9,3.3,2.8,"25% - 50% P.O.C.","$55000 - $78000"
"36081071305","Census Tract 713.05, Queens County, New York",4862,81746,2398,136,0,1351,0,914,49.3,2.8,0,27.8,0,18.8,50.7,2448,478,1970,19.53,80.47,23,455,25,1945,48,2400,4.8,1.3,2,"50% - 75% P.O.C.","$78000 - $104000"
"36081071306","Census Tract 713.06, Queens County, New York",6361,82205,2927,130,0,1655,0,1139,46,2,0,26,0,17.9,54,3012,926,2086,30.74,69.26,61,865,62,2024,123,2889,6.6,3,4.1,"50% - 75% P.O.C.","$78000 - $104000"
"36081071600","Census Tract 716, Queens County, New York",0,NA,0,0,0,0,0,0,NA,NA,NA,NA,NA,NA,NA,0,0,0,NA,NA,0,0,0,0,0,0,NA,NA,NA,"N/A","N/A"
"36081071701","Census Tract 717.01, Queens County, New York",4805,58941,2156,239,0,1698,0,587,44.9,5,0,35.3,0,12.2,55.1,2431,1214,1217,49.94,50.06,13,1201,76,1141,89,2342,1.1,6.2,3.7,"50% - 75% P.O.C.","$55000 - $78000"
"36081071702","Census Tract 717.02, Queens County, New York",3915,59667,1185,342,0,1816,0,335,30.3,8.7,0,46.4,0,8.6,69.7,1988,1101,887,55.38,44.62,4,1097,19,868,23,1965,0.4,2.1,1.2,"50% - 75% P.O.C.","$55000 - $78000"
"36081071900","Census Tract 719, Queens County, New York",2438,45924,1123,129,0,648,0,420,46.1,5.3,0,26.6,0,17.2,53.9,1007,309,698,30.69,69.31,10,299,58,640,68,939,3.2,8.3,6.8,"50% - 75% P.O.C.","Less than $55000"
"36081072100","Census Tract 721, Queens County, New York",4579,63561,2589,33,0,960,0,626,56.5,0.7,0,21,0,13.7,43.5,2084,1126,958,54.03,45.97,63,1063,27,931,90,1994,5.6,2.8,4.3,"25% - 50% P.O.C.","$55000 - $78000"
"36081072300","Census Tract 723, Queens County, New York",2050,118438,1110,72,0,673,0,163,54.1,3.5,0,32.8,0,8,45.9,834,766,68,91.85,8.15,51,715,9,59,60,774,6.7,13.2,7.2,"25% - 50% P.O.C.","$104000 or more"
"36081072900","Census Tract 729, Queens County, New York",1437,128867,645,45,0,575,0,121,44.9,3.1,0,40,0,8.4,55.1,471,412,59,87.47,12.53,55,357,4,55,59,412,13.3,6.8,12.5,"50% - 75% P.O.C.","$104000 or more"
"36081073100","Census Tract 731, Queens County, New York",1507,95536,943,0,0,459,0,72,62.6,0,0,30.5,0,4.8,37.4,544,390,154,71.69,28.31,57,333,6,148,63,481,14.6,3.9,11.6,"25% - 50% P.O.C.","$78000 - $104000"
"36081073700","Census Tract 737, Queens County, New York",1930,83634,1020,30,0,566,0,243,52.8,1.6,0,29.3,0,12.6,47.2,1045,433,612,41.44,58.56,0,433,30,582,30,1015,0,4.9,2.9,"25% - 50% P.O.C.","$78000 - $104000"
"36081073900","Census Tract 739, Queens County, New York",5425,97716,2508,220,0,1692,0,755,46.2,4.1,0,31.2,0,13.9,53.8,2661,1346,1315,50.58,49.42,37,1309,0,1315,37,2624,2.7,0,1.4,"50% - 75% P.O.C.","$78000 - $104000"
"36081074100","Census Tract 741, Queens County, New York",3060,78750,1653,133,36,727,0,379,54,4.3,1.2,23.8,0,12.4,46,1588,1075,513,67.7,32.3,0,1075,0,513,0,1588,0,0,0,"25% - 50% P.O.C.","$78000 - $104000"
"36081074300","Census Tract 743, Queens County, New York",4082,69138,2084,113,17,1064,0,629,51.1,2.8,0.4,26.1,0,15.4,48.9,1740,879,861,50.52,49.48,93,786,29,832,122,1618,10.6,3.4,7,"25% - 50% P.O.C.","$55000 - $78000"
"36081074500","Census Tract 745, Queens County, New York",4014,44006,2437,170,0,665,0,643,60.7,4.2,0,16.6,0,16,39.3,1520,337,1183,22.17,77.83,23,314,140,1043,163,1357,6.8,11.8,10.7,"25% - 50% P.O.C.","Less than $55000"
"36081074700","Census Tract 747, Queens County, New York",3705,86034,901,59,0,1580,0,1009,24.3,1.6,0,42.6,0,27.2,75.7,1284,625,659,48.68,51.32,38,587,182,477,220,1064,6.1,27.6,17.1,"75% or more P.O.C.","$78000 - $104000"
"36081074900","Census Tract 749, Queens County, New York",1429,163750,994,0,0,307,0,71,69.6,0,0,21.5,0,5,30.4,535,394,141,73.64,26.36,28,366,25,116,53,482,7.1,17.7,9.9,"25% - 50% P.O.C.","$104000 or more"
"36081075701","Census Tract 757.01, Queens County, New York",5022,96179,2230,94,0,1827,0,638,44.4,1.9,0,36.4,0,12.7,55.6,2587,1410,1177,54.5,45.5,0,1410,0,1177,0,2587,0,0,0,"50% - 75% P.O.C.","$78000 - $104000"
"36081075702","Census Tract 757.02, Queens County, New York",4898,108990,2457,43,0,1750,0,346,50.2,0.9,0,35.7,0,7.1,49.8,2176,1477,699,67.88,32.12,40,1437,0,699,40,2136,2.7,0,1.8,"25% - 50% P.O.C.","$104000 or more"
"36081076901","Census Tract 769.01, Queens County, New York",4407,88971,2042,170,0,1163,0,827,46.3,3.9,0,26.4,0,18.8,53.7,2036,1027,1009,50.44,49.56,94,933,25,984,119,1917,9.2,2.5,5.8,"50% - 75% P.O.C.","$78000 - $104000"
"36081076902","Census Tract 769.02, Queens County, New York",1186,65000,496,3,0,352,0,307,41.8,0.3,0,29.7,0,25.9,58.2,596,121,475,20.3,79.7,0,121,0,475,0,596,0,0,0,"50% - 75% P.O.C.","$55000 - $78000"
"36081077300","Census Tract 773, Queens County, New York",2093,73500,1153,51,0,328,0,478,55.1,2.4,0,15.7,0,22.8,44.9,1032,563,469,54.55,45.45,0,563,0,469,0,1032,0,0,0,"25% - 50% P.O.C.","$55000 - $78000"
"36081077500","Census Tract 775, Queens County, New York",2234,86319,1536,69,0,162,0,402,68.8,3.1,0,7.3,0,18,31.2,893,324,569,36.28,63.72,103,221,8,561,111,782,31.8,1.4,12.4,"25% - 50% P.O.C.","$78000 - $104000"
"36081077902","Census Tract 779.02, Queens County, New York",4829,84375,3908,78,0,554,0,67,80.9,1.6,0,11.5,0,1.4,19.1,1571,1034,537,65.82,34.18,164,870,80,457,244,1327,15.9,14.9,15.5,"Less than 25% P.O.C.","$78000 - $104000"
"36081077903","Census Tract 779.03, Queens County, New York",3166,80325,1798,31,0,467,0,747,56.8,1,0,14.8,0,23.6,43.2,1145,570,575,49.78,50.22,50,520,57,518,107,1038,8.8,9.9,9.3,"25% - 50% P.O.C.","$78000 - $104000"
"36081077904","Census Tract 779.04, Queens County, New York",5781,78348,3216,67,94,1636,0,520,55.6,1.2,1.6,28.3,0,9,44.4,2043,1065,978,52.13,47.87,165,900,82,896,247,1796,15.5,8.4,12.1,"25% - 50% P.O.C.","$78000 - $104000"
"36081077905","Census Tract 779.05, Queens County, New York",2626,82355,895,431,0,444,0,764,34.1,16.4,0,16.9,0,29.1,65.9,1121,826,295,73.68,26.32,78,748,21,274,99,1022,9.4,7.1,8.8,"50% - 75% P.O.C.","$78000 - $104000"
"36081077906","Census Tract 779.06, Queens County, New York",3388,64614,1690,93,0,1334,0,191,49.9,2.7,0,39.4,0,5.6,50.1,1283,844,439,65.78,34.22,78,766,41,398,119,1164,9.2,9.3,9.3,"50% - 75% P.O.C.","$55000 - $78000"
"36081077907","Census Tract 779.07, Queens County, New York",3500,57827,2620,257,78,100,0,427,74.9,7.3,2.2,2.9,0,12.2,25.1,943,232,711,24.6,75.4,60,172,148,563,208,735,25.9,20.8,22.1,"25% - 50% P.O.C.","$55000 - $78000"
"36081077908","Census Tract 779.08, Queens County, New York",3760,51500,979,786,0,673,0,951,26,20.9,0,17.9,0,25.3,74,1222,58,1164,4.75,95.25,20,38,170,994,190,1032,34.5,14.6,15.5,"50% - 75% P.O.C.","Less than $55000"
"36081078800","Census Tract 788, Queens County, New York",1865,93807,85,1371,0,56,0,136,4.6,73.5,0,3,0,7.3,95.4,523,360,163,68.83,31.17,102,258,17,146,119,404,28.3,10.4,22.8,"75% or more P.O.C.","$78000 - $104000"
"36081079000","Census Tract 790, Queens County, New York",2633,75000,9,1555,0,191,0,419,0.3,59.1,0,7.3,0,15.9,99.7,782,434,348,55.5,44.5,89,345,43,305,132,650,20.5,12.4,16.9,"75% or more P.O.C.","$55000 - $78000"
"36081079200","Census Tract 792, Queens County, New York",2414,81438,7,1019,0,462,0,241,0.3,42.2,0,19.1,0,10,99.7,665,480,185,72.18,27.82,150,330,19,166,169,496,31.2,10.3,25.4,"75% or more P.O.C.","$78000 - $104000"
"36081079300","Census Tract 793, Queens County, New York",0,NA,0,0,0,0,0,0,NA,NA,NA,NA,NA,NA,NA,0,0,0,NA,NA,0,0,0,0,0,0,NA,NA,NA,"N/A","N/A"
"36081079701","Census Tract 797.01, Queens County, New York",6676,32017,431,204,0,5304,0,406,6.5,3.1,0,79.4,0,6.1,93.5,2707,640,2067,23.64,76.36,0,640,152,1915,152,2555,0,7.4,5.6,"75% or more P.O.C.","Less than $55000"
"36081079702","Census Tract 797.02, Queens County, New York",4502,39553,406,19,0,3518,0,479,9,0.4,0,78.1,0,10.6,91,1526,402,1124,26.34,73.66,46,356,141,983,187,1339,11.4,12.5,12.3,"75% or more P.O.C.","Less than $55000"
"36081079900","Census Tract 799, Queens County, New York",3101,46597,218,0,0,2206,0,640,7,0,0,71.1,0,20.6,93,868,330,538,38.02,61.98,94,236,95,443,189,679,28.5,17.7,21.8,"75% or more P.O.C.","Less than $55000"
"36081080301","Census Tract 803.01, Queens County, New York",3859,58298,496,105,0,2413,0,774,12.9,2.7,0,62.5,0,20.1,87.1,1126,437,689,38.81,61.19,82,355,95,594,177,949,18.8,13.8,15.7,"75% or more P.O.C.","$55000 - $78000"
"36081080302","Census Tract 803.02, Queens County, New York",3476,66629,636,33,0,2278,0,529,18.3,0.9,0,65.5,0,15.2,81.7,1047,582,465,55.59,44.41,95,487,96,369,191,856,16.3,20.6,18.2,"75% or more P.O.C.","$55000 - $78000"
"36081080900","Census Tract 809, Queens County, New York",7240,70110,3091,562,0,2171,0,1247,42.7,7.8,0,30,0,17.2,57.3,2663,1650,1013,61.96,38.04,134,1516,0,1013,134,2529,8.1,0,5,"50% - 75% P.O.C.","$55000 - $78000"
"36081081400","Census Tract 814, Queens County, New York",4117,91189,0,1765,0,1203,0,882,0,42.9,0,29.2,0,21.4,100,1018,701,317,68.86,31.14,180,521,72,245,252,766,25.7,22.7,24.8,"75% or more P.O.C.","$78000 - $104000"
"36081081800","Census Tract 818, Queens County, New York",3909,69262,206,1359,0,1006,0,846,5.3,34.8,0,25.7,0,21.6,94.7,1018,625,393,61.39,38.61,136,489,81,312,217,801,21.8,20.6,21.3,"75% or more P.O.C.","$55000 - $78000"
"36081083700","Census Tract 837, Queens County, New York",5283,53707,340,2,0,4336,0,513,6.4,0,0,82.1,0,9.7,93.6,1503,792,711,52.69,47.31,178,614,116,595,294,1209,22.5,16.3,19.6,"75% or more P.O.C.","Less than $55000"
"36081083800","Census Tract 838, Queens County, New York",5260,98484,440,586,75,2099,0,1764,8.4,11.1,1.4,39.9,0,33.5,91.6,1514,1031,483,68.1,31.9,349,682,23,460,372,1142,33.9,4.8,24.6,"75% or more P.O.C.","$78000 - $104000"
"36081084000","Census Tract 840, Queens County, New York",6027,72418,417,1201,19,2300,0,1466,6.9,19.9,0.3,38.2,0,24.3,93.1,1801,1269,532,70.46,29.54,147,1122,52,480,199,1602,11.6,9.8,11,"75% or more P.O.C.","$55000 - $78000"
"36081084500","Census Tract 845, Queens County, New York",4863,34043,268,488,112,2902,0,1093,5.5,10,2.3,59.7,0,22.5,94.5,1975,239,1736,12.1,87.9,42,197,58,1678,100,1875,17.6,3.3,5.1,"75% or more P.O.C.","Less than $55000"
"36081084601","Census Tract 846.01, Queens County, New York",3268,94297,407,288,10,1261,0,820,12.5,8.8,0.3,38.6,0,25.1,87.5,938,663,275,70.68,29.32,224,439,10,265,234,704,33.8,3.6,24.9,"75% or more P.O.C.","$78000 - $104000"
"36081084602","Census Tract 846.02, Queens County, New York",925,65893,95,281,0,261,0,186,10.3,30.4,0,28.2,0,20.1,89.7,195,126,69,64.62,35.38,40,86,4,65,44,151,31.7,5.8,22.6,"75% or more P.O.C.","$55000 - $78000"
"36081084900","Census Tract 849, Queens County, New York",6909,33088,51,436,103,4977,0,1317,0.7,6.3,1.5,72,0,19.1,99.3,2338,177,2161,7.57,92.43,0,177,204,1957,204,2134,0,9.4,8.7,"75% or more P.O.C.","Less than $55000"
"36081085300","Census Tract 853, Queens County, New York",5563,34525,162,24,0,5096,0,228,2.9,0.4,0,91.6,0,4.1,97.1,2060,785,1275,38.11,61.89,37,748,92,1183,129,1931,4.7,7.2,6.3,"75% or more P.O.C.","Less than $55000"
"36081085500","Census Tract 855, Queens County, New York",6772,38270,533,184,0,4213,26,1632,7.9,2.7,0,62.2,0.4,24.1,92.1,2684,139,2545,5.18,94.82,10,129,123,2422,133,2551,7.2,4.8,5,"75% or more P.O.C.","Less than $55000"
"36081085700","Census Tract 857, Queens County, New York",5171,42841,357,90,0,3982,0,675,6.9,1.7,0,77,0,13.1,93.1,1783,346,1437,19.41,80.59,34,312,109,1328,143,1640,9.8,7.6,8,"75% or more P.O.C.","Less than $55000"
"36081085900","Census Tract 859, Queens County, New York",5492,58609,527,31,112,3959,0,764,9.6,0.6,2,72.1,0,13.9,90.4,1881,780,1101,41.47,58.53,129,651,166,935,295,1586,16.5,15.1,15.7,"75% or more P.O.C.","$55000 - $78000"
"36081086100","Census Tract 861, Queens County, New York",2032,48990,157,0,0,1476,0,381,7.7,0,0,72.6,0,18.8,92.3,793,353,440,44.51,55.49,39,314,13,427,52,741,11,3,6.6,"75% or more P.O.C.","Less than $55000"
"36081086300","Census Tract 863, Queens County, New York",6613,42743,508,222,0,4539,0,1344,7.7,3.4,0,68.6,0,20.3,92.3,2397,570,1827,23.78,76.22,77,493,105,1722,182,2215,13.5,5.7,7.6,"75% or more P.O.C.","Less than $55000"
"36081086400","Census Tract 864, Queens County, New York",2727,75741,365,212,0,861,0,1087,13.4,7.8,0,31.6,0,39.9,86.6,742,412,330,55.53,44.47,69,343,85,245,154,588,16.7,25.8,20.8,"75% or more P.O.C.","$55000 - $78000"
"36081086500","Census Tract 865, Queens County, New York",4311,30714,526,79,0,3388,0,228,12.2,1.8,0,78.6,0,5.3,87.8,2070,325,1745,15.7,84.3,25,300,30,1715,55,2015,7.7,1.7,2.7,"75% or more P.O.C.","Less than $55000"
"36081086900","Census Tract 869, Queens County, New York",1771,30000,39,0,10,1617,0,105,2.2,0,0.6,91.3,0,5.9,97.8,674,93,581,13.8,86.2,13,80,75,506,88,586,14,12.9,13.1,"75% or more P.O.C.","Less than $55000"
"36081087100","Census Tract 871, Queens County, New York",2643,41484,83,522,0,1402,0,588,3.1,19.8,0,53,0,22.2,96.9,1069,186,883,17.4,82.6,20,166,56,827,76,993,10.8,6.3,7.1,"75% or more P.O.C.","Less than $55000"
"36081088400","Census Tract 884, Queens County, New York",8345,90977,6571,101,0,96,0,1536,78.7,1.2,0,1.2,0,18.4,21.3,2809,1948,861,69.35,30.65,307,1641,12,849,319,2490,15.8,1.4,11.4,"Less than 25% P.O.C.","$78000 - $104000"
"36081088901","Census Tract 889.01, Queens County, New York",9626,48526,1025,237,0,6334,0,1981,10.6,2.5,0,65.8,0,20.6,89.4,3759,2001,1758,53.23,46.77,109,1892,155,1603,264,3495,5.4,8.8,7,"75% or more P.O.C.","Less than $55000"
"36081089200","Census Tract 892, Queens County, New York",7916,113269,6818,98,0,239,0,682,86.1,1.2,0,3,0,8.6,13.9,2650,2336,314,88.15,11.85,290,2046,67,247,357,2293,12.4,21.3,13.5,"Less than 25% P.O.C.","$104000 or more"
"36081090700","Census Tract 907, Queens County, New York",1434,51696,409,0,0,582,0,393,28.5,0,0,40.6,0,27.4,71.5,459,257,202,55.99,44.01,52,205,24,178,76,383,20.2,11.9,16.6,"50% - 75% P.O.C.","Less than $55000"
"36081091601","Census Tract 916.01, Queens County, New York",3674,105750,3346,23,0,24,0,249,91.1,0.6,0,0.7,0,6.8,8.9,1456,1395,61,95.81,4.19,94,1301,0,61,94,1362,6.7,0,6.5,"Less than 25% P.O.C.","$104000 or more"
"36081091602","Census Tract 916.02, Queens County, New York",0,NA,0,0,0,0,0,0,NA,NA,NA,NA,NA,NA,NA,0,0,0,NA,NA,0,0,0,0,0,0,NA,NA,NA,"N/A","N/A"
"36081091800","Census Tract 918, Queens County, New York",11,NA,11,0,0,0,0,0,100,0,0,0,0,0,0,6,6,0,100,0,0,6,0,0,0,6,0,NA,0,"Less than 25% P.O.C.","N/A"
"36081091900","Census Tract 919, Queens County, New York",5309,49650,910,251,0,1917,48,2019,17.1,4.7,0,36.1,0.9,38,82.9,1554,570,984,36.68,63.32,69,501,85,899,154,1400,12.1,8.6,9.9,"75% or more P.O.C.","Less than $55000"
"36081092200","Census Tract 922, Queens County, New York",2020,131146,1858,0,0,43,0,119,92,0,0,2.1,0,5.9,8,817,790,27,96.7,3.3,58,732,0,27,58,759,7.3,0,7.1,"Less than 25% P.O.C.","$104000 or more"
"36081092500","Census Tract 925, Queens County, New York",3470,47419,633,126,0,1224,0,1469,18.2,3.6,0,35.3,0,42.3,81.8,1060,334,726,31.51,68.49,130,204,95,631,225,835,38.9,13.1,21.2,"75% or more P.O.C.","Less than $55000"
"36081092800","Census Tract 928, Queens County, New York",3594,159773,3446,0,0,52,0,96,95.9,0,0,1.4,0,2.7,4.1,1218,1094,124,89.82,10.18,95,999,40,84,135,1083,8.7,32.3,11.1,"Less than 25% P.O.C.","$104000 or more"
"36081092900","Census Tract 929, Queens County, New York",7036,60973,1159,88,0,2128,27,3312,16.5,1.3,0,30.2,0.4,47.1,83.5,2297,917,1380,39.92,60.08,126,791,108,1272,234,2063,13.7,7.8,10.2,"75% or more P.O.C.","$55000 - $78000"
"36081093401","Census Tract 934.01, Queens County, New York",3734,86942,3202,74,0,80,0,378,85.8,2,0,2.1,0,10.1,14.2,1521,988,533,64.96,35.04,79,909,27,506,106,1415,8,5.1,7,"Less than 25% P.O.C.","$78000 - $104000"
"36081093402","Census Tract 934.02, Queens County, New York",4403,87463,3192,176,0,274,0,489,72.5,4,0,6.2,0,11.1,27.5,1677,755,922,45.02,54.98,118,637,67,855,185,1492,15.6,7.3,11,"25% - 50% P.O.C.","$78000 - $104000"
"36081093800","Census Tract 938, Queens County, New York",5023,52196,3273,438,0,171,0,1048,65.2,8.7,0,3.4,0,20.9,34.8,2219,758,1461,34.16,65.84,73,685,33,1428,106,2113,9.6,2.3,4.8,"25% - 50% P.O.C.","Less than $55000"
"36081093900","Census Tract 939, Queens County, New York",5299,81677,1579,165,0,1722,0,1800,29.8,3.1,0,32.5,0,34,70.2,1701,1025,676,60.26,39.74,83,942,129,547,212,1489,8.1,19.1,12.5,"50% - 75% P.O.C.","$78000 - $104000"
"36081094201","Census Tract 942.01, Queens County, New York",3236,66435,878,862,158,41,0,1270,27.1,26.6,4.9,1.3,0,39.2,72.9,1339,355,984,26.51,73.49,18,337,42,942,60,1279,5.1,4.3,4.5,"50% - 75% P.O.C.","$55000 - $78000"
"36081094202","Census Tract 942.02, Queens County, New York",4806,44013,899,1873,0,292,0,1651,18.7,39,0,6.1,0,34.4,81.3,1739,774,965,44.51,55.49,75,699,63,902,138,1601,9.7,6.5,7.9,"75% or more P.O.C.","Less than $55000"
"36081094203","Census Tract 942.03, Queens County, New York",6602,57411,3430,637,0,154,0,2029,52,9.6,0,2.3,0,30.7,48,2747,1234,1513,44.92,55.08,141,1093,54,1459,195,2552,11.4,3.6,7.1,"25% - 50% P.O.C.","$55000 - $78000"
"36081094500","Census Tract 945, Queens County, New York",3654,75048,1771,15,0,913,0,872,48.5,0.4,0,25,0,23.9,51.5,1139,832,307,73.05,26.95,121,711,48,259,169,970,14.5,15.6,14.8,"50% - 75% P.O.C.","$55000 - $78000"
"36081094700","Census Tract 947, Queens County, New York",2202,67625,849,7,0,307,0,1033,38.6,0.3,0,13.9,0,46.9,61.4,712,316,396,44.38,55.62,75,241,17,379,92,620,23.7,4.3,12.9,"50% - 75% P.O.C.","$55000 - $78000"
"36081095400","Census Tract 954, Queens County, New York",6045,57984,643,3706,18,315,0,1190,10.6,61.3,0.3,5.2,0,19.7,89.4,1846,869,977,47.07,52.93,219,650,94,883,313,1533,25.2,9.6,17,"75% or more P.O.C.","$55000 - $78000"
"36081096400","Census Tract 964, Queens County, New York",6573,77292,783,3619,0,591,0,1277,11.9,55.1,0,9,0,19.4,88.1,1932,1202,730,62.22,37.78,266,936,73,657,339,1593,22.1,10,17.5,"75% or more P.O.C.","$55000 - $78000"
"36081097202","Census Tract 972.02, Queens County, New York",3060,31509,73,2284,23,6,0,556,2.4,74.6,0.8,0.2,0,18.2,97.6,1126,7,1119,0.62,99.38,0,7,130,989,130,996,0,11.6,11.5,"75% or more P.O.C.","Less than $55000"
"36081097203","Census Tract 972.03, Queens County, New York",7356,30536,269,3863,0,457,0,2717,3.7,52.5,0,6.2,0,36.9,96.3,2480,92,2388,3.71,96.29,0,92,399,1989,399,2081,0,16.7,16.1,"75% or more P.O.C.","Less than $55000"
"36081097204","Census Tract 972.04, Queens County, New York",3884,46051,352,2196,0,128,0,1070,9.1,56.5,0,3.3,0,27.5,90.9,1069,266,803,24.88,75.12,71,195,115,688,186,883,26.7,14.3,17.4,"75% or more P.O.C.","Less than $55000"
"36081097300","Census Tract 973, Queens County, New York",1763,100750,1266,0,0,170,0,287,71.8,0,0,9.6,0,16.3,28.2,667,584,83,87.56,12.44,49,535,0,83,49,618,8.4,0,7.3,"25% - 50% P.O.C.","$78000 - $104000"
"36081098100","Census Tract 981, Queens County, New York",2236,89286,1477,0,0,520,0,239,66.1,0,0,23.3,0,10.7,33.9,742,627,115,84.5,15.5,96,531,8,107,104,638,15.3,7,14,"25% - 50% P.O.C.","$78000 - $104000"
"36081098700","Census Tract 987, Queens County, New York",2434,88077,1956,0,0,233,0,197,80.4,0,0,9.6,0,8.1,19.6,856,666,190,77.8,22.2,111,555,7,183,118,738,16.7,3.7,13.8,"Less than 25% P.O.C.","$78000 - $104000"
"36081099100","Census Tract 991, Queens County, New York",7204,100965,5342,0,0,1004,0,751,74.2,0,0,13.9,0,10.4,25.8,2913,2649,264,90.94,9.06,246,2403,0,264,246,2667,9.3,0,8.4,"25% - 50% P.O.C.","$78000 - $104000"
"36081099200","Census Tract 992, Queens County, New York",4339,38301,427,2194,0,79,0,1293,9.8,50.6,0,1.8,0,29.8,90.2,1405,355,1050,25.27,74.73,69,286,196,854,265,1140,19.4,18.7,18.9,"75% or more P.O.C.","Less than $55000"
"36081099701","Census Tract 997.01, Queens County, New York",2922,99342,1925,12,0,653,0,285,65.9,0.4,0,22.3,0,9.8,34.1,1246,1070,176,85.87,14.13,66,1004,0,176,66,1180,6.2,0,5.3,"25% - 50% P.O.C.","$78000 - $104000"
"36081099703","Census Tract 997.03, Queens County, New York",3746,83669,1721,39,23,1536,0,282,45.9,1,0.6,41,0,7.5,54.1,1788,1265,523,70.75,29.25,22,1243,0,523,22,1766,1.7,0,1.2,"50% - 75% P.O.C.","$78000 - $104000"
"36081099704","Census Tract 997.04, Queens County, New York",6847,75344,4069,94,0,1731,0,867,59.4,1.4,0,25.3,0,12.7,40.6,3657,2493,1164,68.17,31.83,61,2432,0,1164,61,3596,2.4,0,1.7,"25% - 50% P.O.C.","$55000 - $78000"
"36081099705","Census Tract 997.05, Queens County, New York",2470,109219,1049,0,0,1165,0,245,42.5,0,0,47.2,0,9.9,57.5,981,745,236,75.94,24.06,17,728,14,222,31,950,2.3,5.9,3.2,"50% - 75% P.O.C.","$104000 or more"
"36081099801","Census Tract 998.01, Queens County, New York",8592,75921,413,5596,0,247,0,2049,4.8,65.1,0,2.9,0,23.8,95.2,2556,453,2103,17.72,82.28,70,383,346,1757,416,2140,15.5,16.5,16.3,"75% or more P.O.C.","$55000 - $78000"
"36081099802","Census Tract 998.02, Queens County, New York",6422,43961,1284,4066,0,221,38,813,20,63.3,0,3.4,0.6,12.7,80,2669,25,2644,0.94,99.06,0,25,264,2380,264,2405,0,10,9.9,"75% or more P.O.C.","Less than $55000"
"36081099900","Census Tract 999, Queens County, New York",0,NA,0,0,0,0,0,0,NA,NA,NA,NA,NA,NA,NA,0,0,0,NA,NA,0,0,0,0,0,0,NA,NA,NA,"N/A","N/A"
"36081100801","Census Tract 1008.01, Queens County, New York",2525,92768,952,1025,0,112,0,374,37.7,40.6,0,4.4,0,14.8,62.3,663,552,111,83.26,16.74,154,398,57,54,211,452,27.9,51.4,31.8,"50% - 75% P.O.C.","$78000 - $104000"
"36081100802","Census Tract 1008.02, Queens County, New York",8976,64267,2624,3881,0,377,0,2094,29.2,43.2,0,4.2,0,23.3,70.8,2570,1107,1463,43.07,56.93,255,852,276,1187,531,2039,23,18.9,20.7,"50% - 75% P.O.C.","$55000 - $78000"
"36081101001","Census Tract 1010.01, Queens County, New York",12253,41332,2915,5379,0,180,0,3545,23.8,43.9,0,1.5,0,28.9,76.2,3343,609,2734,18.22,81.78,414,195,499,2235,913,2430,68,18.3,27.3,"75% or more P.O.C.","Less than $55000"
"36081101002","Census Tract 1010.02, Queens County, New York",4359,31066,3006,778,0,105,0,459,69,17.8,0,2.4,0,10.5,31,1656,526,1130,31.76,68.24,260,266,0,1130,260,1396,49.4,0,15.7,"25% - 50% P.O.C.","Less than $55000"
"36081101700","Census Tract 1017, Queens County, New York",6005,86493,2834,55,0,1700,0,1319,47.2,0.9,0,28.3,0,22,52.8,2404,2026,378,84.28,15.72,133,1893,0,378,133,2271,6.6,0,5.5,"50% - 75% P.O.C.","$78000 - $104000"
"36081102900","Census Tract 1029, Queens County, New York",3598,85141,2360,74,0,493,14,607,65.6,2.1,0,13.7,0.4,16.9,34.4,1304,900,404,69.02,30.98,64,836,59,345,123,1181,7.1,14.6,9.4,"25% - 50% P.O.C.","$78000 - $104000"
"36081103201","Census Tract 1032.01, Queens County, New York",6509,40595,214,3134,0,399,0,2672,3.3,48.1,0,6.1,0,41.1,96.7,1943,341,1602,17.55,82.45,51,290,372,1230,423,1520,15,23.2,21.8,"75% or more P.O.C.","Less than $55000"
"36081103202","Census Tract 1032.02, Queens County, New York",8121,58750,3555,1103,0,84,0,3182,43.8,13.6,0,1,0,39.2,56.2,1982,503,1479,25.38,74.62,170,333,420,1059,590,1392,33.8,28.4,29.8,"50% - 75% P.O.C.","$55000 - $78000"
"36081103300","Census Tract 1033, Queens County, New York",4577,87566,2544,23,0,1437,0,469,55.6,0.5,0,31.4,0,10.2,44.4,1481,988,493,66.71,33.29,142,846,39,454,181,1300,14.4,7.9,12.2,"25% - 50% P.O.C.","$78000 - $104000"
"36081103900","Census Tract 1039, Queens County, New York",6283,77993,2622,0,0,2287,0,1256,41.7,0,0,36.4,0,20,58.3,2107,1138,969,54.01,45.99,180,958,76,893,256,1851,15.8,7.8,12.1,"50% - 75% P.O.C.","$55000 - $78000"
"36081104700","Census Tract 1047, Queens County, New York",6755,55328,1994,3,0,3804,0,589,29.5,0,0,56.3,0,8.7,70.5,2670,1672,998,62.62,37.38,119,1553,17,981,136,2534,7.1,1.7,5.1,"50% - 75% P.O.C.","$55000 - $78000"
"36081105900","Census Tract 1059, Queens County, New York",3907,88906,2201,0,0,1442,0,164,56.3,0,0,36.9,0,4.2,43.7,1282,1141,141,89,11,131,1010,36,105,167,1115,11.5,25.5,13,"25% - 50% P.O.C.","$78000 - $104000"
"36081107201","Census Tract 1072.01, Queens County, New York",2320,86055,1937,3,0,116,0,254,83.5,0.1,0,5,0,10.9,16.5,809,628,181,77.63,22.37,112,516,32,149,144,665,17.8,17.7,17.8,"Less than 25% P.O.C.","$78000 - $104000"
"36081107202","Census Tract 1072.02, Queens County, New York",0,NA,0,0,0,0,0,0,NA,NA,NA,NA,NA,NA,NA,0,0,0,NA,NA,0,0,0,0,0,0,NA,NA,NA,"N/A","N/A"
"36081108500","Census Tract 1085, Queens County, New York",2337,77500,996,24,0,929,0,319,42.6,1,0,39.8,0,13.6,57.4,864,559,305,64.7,35.3,67,492,17,288,84,780,12,5.6,9.7,"50% - 75% P.O.C.","$55000 - $78000"
"36081109300","Census Tract 1093, Queens County, New York",2937,89241,1224,6,0,1364,0,301,41.7,0.2,0,46.4,0,10.2,58.3,1073,911,162,84.9,15.1,103,808,26,136,129,944,11.3,16,12,"50% - 75% P.O.C.","$78000 - $104000"
"36081109700","Census Tract 1097, Queens County, New York",1598,95701,879,20,0,502,0,165,55,1.3,0,31.4,0,10.3,45,629,482,147,76.63,23.37,40,442,9,138,49,580,8.3,6.1,7.8,"25% - 50% P.O.C.","$78000 - $104000"
"36081109900","Census Tract 1099, Queens County, New York",3058,67031,1221,5,0,1619,0,180,39.9,0.2,0,52.9,0,5.9,60.1,1107,771,336,69.65,30.35,36,735,23,313,59,1048,4.7,6.8,5.3,"50% - 75% P.O.C.","$55000 - $78000"
"36081111300","Census Tract 1113, Queens County, New York",2526,102222,1202,13,0,889,0,393,47.6,0.5,0,35.2,0,15.6,52.4,780,587,193,75.26,24.74,79,508,36,157,115,665,13.5,18.7,14.7,"50% - 75% P.O.C.","$78000 - $104000"
"36081112300","Census Tract 1123, Queens County, New York",2058,95250,710,86,0,727,0,518,34.5,4.2,0,35.3,0,25.2,65.5,733,246,487,33.56,66.44,25,221,59,428,84,649,10.2,12.1,11.5,"50% - 75% P.O.C.","$78000 - $104000"
"36081112900","Census Tract 1129, Queens County, New York",2085,82173,1207,57,0,652,0,151,57.9,2.7,0,31.3,0,7.2,42.1,819,590,229,72.04,27.96,64,526,14,215,78,741,10.8,6.1,9.5,"25% - 50% P.O.C.","$78000 - $104000"
"36081113300","Census Tract 1133, Queens County, New York",1603,103056,838,0,0,389,0,362,52.3,0,0,24.3,0,22.6,47.7,600,466,134,77.67,22.33,49,417,6,128,55,545,10.5,4.5,9.2,"25% - 50% P.O.C.","$78000 - $104000"
"36081113900","Census Tract 1139, Queens County, New York",3356,65698,1311,28,0,1328,0,576,39.1,0.8,0,39.6,0,17.2,60.9,1452,661,791,45.52,54.48,10,651,42,749,52,1400,1.5,5.3,3.6,"50% - 75% P.O.C.","$55000 - $78000"
"36081114100","Census Tract 1141, Queens County, New York",2362,99583,1016,0,0,1075,0,248,43,0,0,45.5,0,10.5,57,821,705,116,85.87,14.13,84,621,11,105,95,726,11.9,9.5,11.6,"50% - 75% P.O.C.","$78000 - $104000"
"36081114700","Census Tract 1147, Queens County, New York",1726,89423,762,0,0,735,0,123,44.1,0,0,42.6,0,7.1,55.9,602,504,98,83.72,16.28,57,447,10,88,67,535,11.3,10.2,11.1,"50% - 75% P.O.C.","$78000 - $104000"
"36081115100","Census Tract 1151, Queens County, New York",915,76167,451,0,0,256,0,153,49.3,0,0,28,0,16.7,50.7,344,301,43,87.5,12.5,15,286,0,43,15,329,5,0,4.4,"50% - 75% P.O.C.","$55000 - $78000"
"36081115500","Census Tract 1155, Queens County, New York",2150,51442,378,47,15,972,0,722,17.6,2.2,0.7,45.2,0,33.6,82.4,675,269,406,39.85,60.15,51,218,92,314,143,532,19,22.7,21.2,"75% or more P.O.C.","Less than $55000"
"36081115700","Census Tract 1157, Queens County, New York",3207,45250,554,106,21,2180,0,305,17.3,3.3,0.7,68,0,9.5,82.7,1249,534,715,42.75,57.25,62,472,47,668,109,1140,11.6,6.6,8.7,"75% or more P.O.C.","Less than $55000"
"36081115900","Census Tract 1159, Queens County, New York",4256,59125,402,11,0,3102,0,378,9.4,0.3,0,72.9,0,8.9,90.6,1348,530,818,39.32,60.68,149,381,64,754,213,1135,28.1,7.8,15.8,"75% or more P.O.C.","$55000 - $78000"
"36081116100","Census Tract 1161, Queens County, New York",4301,26783,488,70,0,3233,0,453,11.3,1.6,0,75.2,0,10.5,88.7,1509,403,1106,26.71,73.29,28,375,47,1059,75,1434,6.9,4.2,5,"75% or more P.O.C.","Less than $55000"
"36081116300","Census Tract 1163, Queens County, New York",9346,36261,839,229,0,5861,8,2217,9,2.5,0,62.7,0.1,23.7,91,2854,418,2436,14.65,85.35,89,329,196,2240,285,2569,21.3,8,10,"75% or more P.O.C.","Less than $55000"
"36081116700","Census Tract 1167, Queens County, New York",1676,40714,30,15,18,1250,0,305,1.8,0.9,1.1,74.6,0,18.2,98.2,560,127,433,22.68,77.32,21,106,52,381,73,487,16.5,12,13,"75% or more P.O.C.","Less than $55000"
"36081117100","Census Tract 1171, Queens County, New York",2359,58929,616,10,0,1141,0,583,26.1,0.4,0,48.4,0,24.7,73.9,874,348,526,39.82,60.18,25,323,51,475,76,798,7.2,9.7,8.7,"50% - 75% P.O.C.","$55000 - $78000"
"36081117500","Census Tract 1175, Queens County, New York",4830,62639,1708,11,0,2405,0,678,35.4,0.2,0,49.8,0,14,64.6,1928,769,1159,39.89,60.11,161,608,5,1154,166,1762,20.9,0.4,8.6,"50% - 75% P.O.C.","$55000 - $78000"
"36081118100","Census Tract 1181, Queens County, New York",1530,66711,587,13,0,725,0,189,38.4,0.8,0,47.4,0,12.4,61.6,622,251,371,40.35,59.65,9,242,23,348,32,590,3.6,6.2,5.1,"50% - 75% P.O.C.","$55000 - $78000"
"36081118500","Census Tract 1185, Queens County, New York",1978,45948,140,12,0,1160,0,654,7.1,0.6,0,58.6,0,33.1,92.9,618,116,502,18.77,81.23,26,90,56,446,82,536,22.4,11.2,13.3,"75% or more P.O.C.","Less than $55000"
"36081118700","Census Tract 1187, Queens County, New York",2484,45867,289,16,0,1549,0,606,11.6,0.6,0,62.4,0,24.4,88.4,748,348,400,46.52,53.48,109,239,15,385,124,624,31.3,3.8,16.6,"75% or more P.O.C.","Less than $55000"
"36081118900","Census Tract 1189, Queens County, New York",2050,61630,329,18,0,1402,0,301,16,0.9,0,68.4,0,14.7,84,662,383,279,57.85,42.15,62,321,31,248,93,569,16.2,11.1,14,"75% or more P.O.C.","$55000 - $78000"
"36081119100","Census Tract 1191, Queens County, New York",2985,39605,304,0,0,1684,0,978,10.2,0,0,56.4,0,32.8,89.8,986,356,630,36.11,63.89,42,314,67,563,109,877,11.8,10.6,11.1,"75% or more P.O.C.","Less than $55000"
"36081119300","Census Tract 1193, Queens County, New York",1978,52000,372,39,0,1361,0,177,18.8,2,0,68.8,0,8.9,81.2,728,315,413,43.27,56.73,38,277,0,413,38,690,12.1,0,5.2,"75% or more P.O.C.","Less than $55000"
"36081119500","Census Tract 1195, Queens County, New York",1453,84279,449,3,125,504,0,352,30.9,0.2,8.6,34.7,0,24.2,69.1,413,328,85,79.42,20.58,58,270,14,71,72,341,17.7,16.5,17.4,"50% - 75% P.O.C.","$78000 - $104000"
"36081119900","Census Tract 1199, Queens County, New York",1517,61522,248,3,0,1067,0,175,16.3,0.2,0,70.3,0,11.5,83.7,462,335,127,72.51,27.49,55,280,14,113,69,393,16.4,11,14.9,"75% or more P.O.C.","$55000 - $78000"
"36081120100","Census Tract 1201, Queens County, New York",1559,61806,192,67,0,1129,0,153,12.3,4.3,0,72.4,0,9.8,87.7,414,205,209,49.52,50.48,53,152,41,168,94,320,25.9,19.6,22.7,"75% or more P.O.C.","$55000 - $78000"
"36081120300","Census Tract 1203, Queens County, New York",1573,60179,190,17,0,1224,0,132,12.1,1.1,0,77.8,0,8.4,87.9,449,285,164,63.47,36.53,83,202,22,142,105,344,29.1,13.4,23.4,"75% or more P.O.C.","$55000 - $78000"
"36081120500","Census Tract 1205, Queens County, New York",2568,24826,163,143,42,2090,0,120,6.3,5.6,1.6,81.4,0,4.7,93.7,1016,274,742,26.97,73.03,52,222,85,657,137,879,19,11.5,13.5,"75% or more P.O.C.","Less than $55000"
"36081120700","Census Tract 1207, Queens County, New York",3097,81250,831,4,0,1683,0,490,26.8,0.1,0,54.3,0,15.8,73.2,925,687,238,74.27,25.73,147,540,55,183,202,723,21.4,23.1,21.8,"50% - 75% P.O.C.","$78000 - $104000"
"36081121100","Census Tract 1211, Queens County, New York",0,NA,0,0,0,0,0,0,NA,NA,NA,NA,NA,NA,NA,0,0,0,NA,NA,0,0,0,0,0,0,NA,NA,NA,"N/A","N/A"
"36081121500","Census Tract 1215, Queens County, New York",4447,79297,802,174,0,2652,0,744,18,3.9,0,59.6,0,16.7,82,1317,862,455,65.45,34.55,188,674,54,401,242,1075,21.8,11.9,18.4,"75% or more P.O.C.","$78000 - $104000"
"36081122300","Census Tract 1223, Queens County, New York",3438,69317,952,11,0,1745,0,683,27.7,0.3,0,50.8,0,19.9,72.3,1243,800,443,64.36,35.64,76,724,24,419,100,1143,9.5,5.4,8,"50% - 75% P.O.C.","$55000 - $78000"
"36081122701","Census Tract 1227.01, Queens County, New York",11356,67811,3084,1464,0,3135,0,3370,27.2,12.9,0,27.6,0,29.7,72.8,4433,2010,2423,45.34,54.66,363,1647,277,2146,640,3793,18.1,11.4,14.4,"50% - 75% P.O.C.","$55000 - $78000"
"36081122702","Census Tract 1227.02, Queens County, New York",7519,25473,1288,1694,0,1055,0,3206,17.1,22.5,0,14,0,42.6,82.9,2978,332,2646,11.15,88.85,41,291,276,2370,317,2661,12.3,10.4,10.6,"75% or more P.O.C.","Less than $55000"
"36081124100","Census Tract 1241, Queens County, New York",3666,72446,1136,212,0,1809,0,344,31,5.8,0,49.3,0,9.4,69,1252,790,462,63.1,36.9,105,685,8,454,113,1139,13.3,1.7,9,"50% - 75% P.O.C.","$55000 - $78000"
"36081124700","Census Tract 1247, Queens County, New York",3508,97500,1539,12,0,1832,0,125,43.9,0.3,0,52.2,0,3.6,56.1,1096,930,166,84.85,15.15,136,794,2,164,138,958,14.6,1.2,12.6,"50% - 75% P.O.C.","$78000 - $104000"
"36081125700","Census Tract 1257, Queens County, New York",3248,61513,513,511,0,1502,0,623,15.8,15.7,0,46.2,0,19.2,84.2,914,325,589,35.56,64.44,71,254,87,502,158,756,21.8,14.8,17.3,"75% or more P.O.C.","$55000 - $78000"
"36081126500","Census Tract 1265, Queens County, New York",1743,71250,571,39,0,745,0,164,32.8,2.2,0,42.7,0,9.4,67.2,567,380,187,67.02,32.98,72,308,22,165,94,473,18.9,11.8,16.6,"50% - 75% P.O.C.","$55000 - $78000"
"36081126700","Census Tract 1267, Queens County, New York",4716,76250,1563,687,8,1123,20,1072,33.1,14.6,0.2,23.8,0.4,22.7,66.9,680,524,156,77.06,22.94,162,362,54,102,216,464,30.9,34.6,31.8,"50% - 75% P.O.C.","$55000 - $78000"
"36081127700","Census Tract 1277, Queens County, New York",3615,143281,2792,309,0,436,0,78,77.2,8.5,0,12.1,0,2.2,22.8,1121,1028,93,91.7,8.3,233,795,10,83,243,878,22.7,10.8,21.7,"Less than 25% P.O.C.","$104000 or more"
"36081128300","Census Tract 1283, Queens County, New York",0,NA,0,0,0,0,0,0,NA,NA,NA,NA,NA,NA,NA,0,0,0,NA,NA,0,0,0,0,0,0,NA,NA,NA,"N/A","N/A"
"36081129102","Census Tract 1291.02, Queens County, New York",3912,118824,2177,142,168,1036,0,352,55.6,3.6,4.3,26.5,0,9,44.4,1246,1111,135,89.17,10.83,149,962,16,119,165,1081,13.4,11.9,13.2,"25% - 50% P.O.C.","$104000 or more"
"36081129103","Census Tract 1291.03, Queens County, New York",3887,61434,2233,47,0,1132,0,396,57.4,1.2,0,29.1,0,10.2,42.6,1952,1594,358,81.66,18.34,68,1526,12,346,80,1872,4.3,3.4,4.1,"25% - 50% P.O.C.","$55000 - $78000"
"36081129104","Census Tract 1291.04, Queens County, New York",4455,81875,1796,81,0,1666,0,832,40.3,1.8,0,37.4,0,18.7,59.7,1853,1347,506,72.69,27.31,90,1257,44,462,134,1719,6.7,8.7,7.2,"50% - 75% P.O.C.","$78000 - $104000"
"36081130100","Census Tract 1301, Queens County, New York",4204,87404,1281,681,94,807,0,1218,30.5,16.2,2.2,19.2,0,29,69.5,1510,1263,247,83.64,16.36,147,1116,42,205,189,1321,11.6,17,12.5,"50% - 75% P.O.C.","$78000 - $104000"
"36081133300","Census Tract 1333, Queens County, New York",3896,97663,1807,69,0,1668,0,247,46.4,1.8,0,42.8,0,6.3,53.6,1279,1006,273,78.66,21.34,139,867,45,228,184,1095,13.8,16.5,14.4,"50% - 75% P.O.C.","$78000 - $104000"
"36081133900","Census Tract 1339, Queens County, New York",1302,117407,765,1,0,336,0,199,58.8,0.1,0,25.8,0,15.3,41.2,396,366,30,92.42,7.58,39,327,13,17,52,344,10.7,43.3,13.1,"25% - 50% P.O.C.","$104000 or more"
"36081134100","Census Tract 1341, Queens County, New York",3358,90000,876,28,0,1695,0,659,26.1,0.8,0,50.5,0,19.6,73.9,1018,729,289,71.61,28.39,141,588,41,248,182,836,19.3,14.2,17.9,"50% - 75% P.O.C.","$78000 - $104000"
"36081134700","Census Tract 1347, Queens County, New York",10944,68485,2013,1011,113,5528,0,1584,18.4,9.2,1,50.5,0,14.5,81.6,3984,697,3287,17.49,82.51,97,600,243,3044,340,3644,13.9,7.4,8.5,"75% or more P.O.C.","$55000 - $78000"
"36081136700","Census Tract 1367, Queens County, New York",5846,89116,1706,342,0,2748,0,1019,29.2,5.9,0,47,0,17.4,70.8,2371,1805,566,76.13,23.87,85,1720,60,506,145,2226,4.7,10.6,6.1,"50% - 75% P.O.C.","$78000 - $104000"
"36081137700","Census Tract 1377, Queens County, New York",7123,72719,1503,517,104,3769,0,945,21.1,7.3,1.5,52.9,0,13.3,78.9,2443,1300,1143,53.21,46.79,222,1078,102,1041,324,2119,17.1,8.9,13.3,"75% or more P.O.C.","$55000 - $78000"
"36081138501","Census Tract 1385.01, Queens County, New York",4617,102926,1529,57,22,2807,0,170,33.1,1.2,0.5,60.8,0,3.7,66.9,1451,831,620,57.27,42.73,143,688,9,611,152,1299,17.2,1.5,10.5,"50% - 75% P.O.C.","$78000 - $104000"
"36081138502","Census Tract 1385.02, Queens County, New York",39,NA,15,0,0,0,0,24,38.5,0,0,0,0,61.5,61.5,0,0,0,NA,NA,0,0,0,0,0,0,NA,NA,NA,"50% - 75% P.O.C.","N/A"
"36081139900","Census Tract 1399, Queens County, New York",1666,106583,561,2,0,1022,0,76,33.7,0.1,0,61.3,0,4.6,66.3,573,491,82,85.69,14.31,41,450,11,71,52,521,8.4,13.4,9.1,"50% - 75% P.O.C.","$104000 or more"
"36081140300","Census Tract 1403, Queens County, New York",2344,80457,744,9,8,1437,0,146,31.7,0.4,0.3,61.3,0,6.2,68.3,779,667,112,85.62,14.38,97,570,3,109,100,679,14.5,2.7,12.8,"50% - 75% P.O.C.","$78000 - $104000"
"36081140901","Census Tract 1409.01, Queens County, New York",990,85000,206,31,0,597,0,136,20.8,3.1,0,60.3,0,13.7,79.2,320,279,41,87.19,12.81,53,226,9,32,62,258,19,22,19.4,"75% or more P.O.C.","$78000 - $104000"
"36081140902","Census Tract 1409.02, Queens County, New York",2787,91042,626,3,0,1912,15,187,22.5,0.1,0,68.6,0.5,6.7,77.5,851,676,175,79.44,20.56,113,563,21,154,134,717,16.7,12,15.7,"75% or more P.O.C.","$78000 - $104000"
"36081141700","Census Tract 1417, Queens County, New York",4871,73182,1403,34,0,2748,0,635,28.8,0.7,0,56.4,0,13,71.2,1578,1288,290,81.62,18.38,210,1078,30,260,240,1338,16.3,10.3,15.2,"50% - 75% P.O.C.","$55000 - $78000"
"36081142900","Census Tract 1429, Queens County, New York",3760,84750,1589,0,0,1793,0,292,42.3,0,0,47.7,0,7.8,57.7,1196,885,311,74,26,140,745,12,299,152,1044,15.8,3.9,12.7,"50% - 75% P.O.C.","$78000 - $104000"
"36081143500","Census Tract 1435, Queens County, New York",2452,95472,799,3,0,1433,0,159,32.6,0.1,0,58.4,0,6.5,67.4,737,617,120,83.72,16.28,69,548,37,83,106,631,11.2,30.8,14.4,"50% - 75% P.O.C.","$78000 - $104000"
"36081144100","Census Tract 1441, Queens County, New York",2662,108614,888,10,0,1270,0,494,33.4,0.4,0,47.7,0,18.6,66.6,1083,836,247,77.19,22.81,11,825,0,247,11,1072,1.3,0,1,"50% - 75% P.O.C.","$104000 or more"
"36081144700","Census Tract 1447, Queens County, New York",3109,84659,371,671,0,1773,0,259,11.9,21.6,0,57,0,8.3,88.1,911,591,320,64.87,35.13,114,477,38,282,152,759,19.3,11.9,16.7,"75% or more P.O.C.","$78000 - $104000"
"36081145101","Census Tract 1451.01, Queens County, New York",1127,71111,582,0,0,512,0,33,51.6,0,0,45.4,0,2.9,48.4,410,299,111,72.93,27.07,15,284,18,93,33,377,5,16.2,8,"25% - 50% P.O.C.","$55000 - $78000"
"36081145102","Census Tract 1451.02, Queens County, New York",2464,93000,530,135,0,1578,0,174,21.5,5.5,0,64,0,7.1,78.5,792,403,389,50.88,49.12,78,325,25,364,103,689,19.4,6.4,13,"75% or more P.O.C.","$78000 - $104000"
"36081145900","Census Tract 1459, Queens County, New York",2809,77868,944,9,13,1177,0,610,33.6,0.3,0.5,41.9,0,21.7,66.4,937,702,235,74.92,25.08,73,629,30,205,103,834,10.4,12.8,11,"50% - 75% P.O.C.","$55000 - $78000"
"36081146300","Census Tract 1463, Queens County, New York",2979,71899,1244,100,0,1203,0,432,41.8,3.4,0,40.4,0,14.5,58.2,921,333,588,36.16,63.84,24,309,77,511,101,820,7.2,13.1,11,"50% - 75% P.O.C.","$55000 - $78000"
"36081146700","Census Tract 1467, Queens County, New York",2619,88412,1202,0,0,1079,0,338,45.9,0,0,41.2,0,12.9,54.1,1277,264,1013,20.67,79.33,20,244,23,990,43,1234,7.6,2.3,3.4,"50% - 75% P.O.C.","$78000 - $104000"
"36081147100","Census Tract 1471, Queens County, New York",3231,85741,1492,42,0,1418,0,195,46.2,1.3,0,43.9,0,6,53.8,1236,770,466,62.3,37.7,71,699,74,392,145,1091,9.2,15.9,11.7,"50% - 75% P.O.C.","$78000 - $104000"
"36081147900","Census Tract 1479, Queens County, New York",4526,89286,1831,116,0,1582,0,839,40.5,2.6,0,35,0,18.5,59.5,1810,1184,626,65.41,34.59,76,1108,21,605,97,1713,6.4,3.4,5.4,"50% - 75% P.O.C.","$78000 - $104000"
"36081148300","Census Tract 1483, Queens County, New York",2900,115714,1750,8,0,872,0,234,60.3,0.3,0,30.1,0,8.1,39.7,1098,972,126,88.52,11.48,56,916,11,115,67,1031,5.8,8.7,6.1,"25% - 50% P.O.C.","$104000 or more"
"36081150701","Census Tract 1507.01, Queens County, New York",3036,146071,1556,12,0,984,0,418,51.3,0.4,0,32.4,0,13.8,48.7,1008,922,86,91.47,8.53,100,822,12,74,112,896,10.8,14,11.1,"25% - 50% P.O.C.","$104000 or more"
"36081150702","Census Tract 1507.02, Queens County, New York",3067,101250,1785,29,0,950,0,289,58.2,0.9,0,31,0,9.4,41.8,1118,863,255,77.19,22.81,119,744,34,221,153,965,13.8,13.3,13.7,"25% - 50% P.O.C.","$78000 - $104000"
"36081152901","Census Tract 1529.01, Queens County, New York",6916,93819,2233,428,0,3374,0,793,32.3,6.2,0,48.8,0,11.5,67.7,2623,2019,604,76.97,23.03,199,1820,0,604,199,2424,9.9,0,7.6,"50% - 75% P.O.C.","$78000 - $104000"
"36081152902","Census Tract 1529.02, Queens County, New York",4955,75702,2083,75,0,2274,0,245,42,1.5,0,45.9,0,4.9,58,2135,1718,417,80.47,19.53,44,1674,14,403,58,2077,2.6,3.4,2.7,"50% - 75% P.O.C.","$55000 - $78000"
"36081155101","Census Tract 1551.01, Queens County, New York",1759,55313,1691,0,0,42,0,26,96.1,0,0,2.4,0,1.5,3.9,1315,1225,90,93.16,6.84,0,1225,0,90,0,1315,0,0,0,"Less than 25% P.O.C.","$55000 - $78000"
"36081155102","Census Tract 1551.02, Queens County, New York",8929,92739,3904,759,0,2783,0,1284,43.7,8.5,0,31.2,0,14.4,56.3,3656,2184,1472,59.74,40.26,89,2095,36,1436,125,3531,4.1,2.4,3.4,"50% - 75% P.O.C.","$78000 - $104000"
"36081156700","Census Tract 1567, Queens County, New York",1614,57750,306,363,0,610,0,311,19,22.5,0,37.8,0,19.3,81,253,69,184,27.27,72.73,23,46,22,162,45,208,33.3,12,17.8,"75% or more P.O.C.","$55000 - $78000"
"36081157101","Census Tract 1571.01, Queens County, New York",8406,97629,2157,140,0,4368,0,1595,25.7,1.7,0,52,0,19,74.3,2560,2049,511,80.04,19.96,344,1705,61,450,405,2155,16.8,11.9,15.8,"50% - 75% P.O.C.","$78000 - $104000"
"36081157102","Census Tract 1571.02, Queens County, New York",2294,97500,365,31,8,1425,0,337,15.9,1.4,0.3,62.1,0,14.7,84.1,552,351,201,63.59,36.41,130,221,60,141,190,362,37,29.9,34.4,"75% or more P.O.C.","$78000 - $104000"
"36081157901","Census Tract 1579.01, Queens County, New York",5073,102725,1467,215,0,2571,0,546,28.9,4.2,0,50.7,0,10.8,71.1,1694,1423,271,84,16,236,1187,22,249,258,1436,16.6,8.1,15.2,"50% - 75% P.O.C.","$78000 - $104000"
"36081157902","Census Tract 1579.02, Queens County, New York",4129,110000,1170,80,76,2242,51,237,28.3,1.9,1.8,54.3,1.2,5.7,71.7,1154,1057,97,91.59,8.41,194,863,18,79,212,942,18.4,18.6,18.4,"50% - 75% P.O.C.","$104000 or more"
"36081157903","Census Tract 1579.03, Queens County, New York",4741,82978,1422,149,92,2712,0,290,30,3.1,1.9,57.2,0,6.1,70,1365,1076,289,78.83,21.17,241,835,0,289,241,1124,22.4,0,17.7,"50% - 75% P.O.C.","$78000 - $104000"
"36081161700","Census Tract 1617, Queens County, New York",4762,117813,1707,615,0,1406,0,941,35.8,12.9,0,29.5,0,19.8,64.2,1503,1262,241,83.97,16.03,155,1107,73,168,228,1275,12.3,30.3,15.2,"50% - 75% P.O.C.","$104000 or more"
"36081162100","Census Tract 1621, Queens County, New York",6363,76655,1149,402,0,2496,0,1710,18.1,6.3,0,39.2,0,26.9,81.9,1865,1122,743,60.16,39.84,277,845,63,680,340,1525,24.7,8.5,18.2,"75% or more P.O.C.","$55000 - $78000"
"36081990100","Census Tract 9901, Queens County, New York",0,NA,0,0,0,0,0,0,NA,NA,NA,NA,NA,NA,NA,0,0,0,NA,NA,0,0,0,0,0,0,NA,NA,NA,"N/A","N/A"
"36085000300","Census Tract 3, Richmond County, New York",2004,86477,971,157,0,356,0,480,48.5,7.8,0,17.8,0,24,51.5,1037,308,729,29.7,70.3,0,308,17,712,17,1020,0,2.3,1.6,"50% - 75% P.O.C.","$78000 - $104000"
"36085000600","Census Tract 6, Richmond County, New York",2311,66563,1330,177,0,442,0,328,57.6,7.7,0,19.1,0,14.2,42.4,1064,473,591,44.45,55.55,60,413,60,531,120,944,12.7,10.2,11.3,"25% - 50% P.O.C.","$55000 - $78000"
"36085000700","Census Tract 7, Richmond County, New York",4557,37952,850,2057,0,173,0,1351,18.7,45.1,0,3.8,0,29.6,81.3,2209,385,1824,17.43,82.57,0,385,19,1805,19,2190,0,1,0.9,"75% or more P.O.C.","Less than $55000"
"36085000800","Census Tract 8, Richmond County, New York",5238,78986,2643,437,0,1165,0,961,50.5,8.3,0,22.2,0,18.3,49.5,1886,1318,568,69.88,30.12,214,1104,97,471,311,1575,16.2,17.1,16.5,"25% - 50% P.O.C.","$78000 - $104000"
"36085000900","Census Tract 9, Richmond County, New York",1510,50543,364,416,0,132,0,539,24.1,27.5,0,8.7,0,35.7,75.9,616,256,360,41.56,58.44,30,226,26,334,56,560,11.7,7.2,9.1,"75% or more P.O.C.","Less than $55000"
"36085001100","Census Tract 11, Richmond County, New York",3314,48082,520,1130,0,78,0,1343,15.7,34.1,0,2.4,0,40.5,84.3,1157,465,692,40.19,59.81,93,372,141,551,234,923,20,20.4,20.2,"75% or more P.O.C.","Less than $55000"
"36085001700","Census Tract 17, Richmond County, New York",1475,42431,531,253,0,127,0,404,36,17.2,0,8.6,0,27.4,64,578,242,336,41.87,58.13,11,231,58,278,69,509,4.5,17.3,11.9,"50% - 75% P.O.C.","Less than $55000"
"36085001800","Census Tract 18, Richmond County, New York",588,80313,355,49,0,18,0,126,60.4,8.3,0,3.1,0,21.4,39.6,181,4,177,2.21,97.79,0,4,14,163,14,167,0,7.9,7.7,"25% - 50% P.O.C.","$78000 - $104000"
"36085002001","Census Tract 20.01, Richmond County, New York",2502,80833,1199,286,0,279,0,592,47.9,11.4,0,11.2,0,23.7,52.1,992,585,407,58.97,41.03,79,506,35,372,114,878,13.5,8.6,11.5,"50% - 75% P.O.C.","$78000 - $104000"
"36085002002","Census Tract 20.02, Richmond County, New York",3473,100385,2530,210,0,446,0,128,72.8,6,0,12.8,0,3.7,27.2,1246,894,352,71.75,28.25,120,774,7,345,127,1119,13.4,2,10.2,"25% - 50% P.O.C.","$78000 - $104000"
"36085002100","Census Tract 21, Richmond County, New York",4469,50489,1002,1278,0,326,0,1600,22.4,28.6,0,7.3,0,35.8,77.6,1649,448,1201,27.17,72.83,60,388,164,1037,224,1425,13.4,13.7,13.6,"75% or more P.O.C.","Less than $55000"
"36085002700","Census Tract 27, Richmond County, New York",1751,NA,538,410,0,106,0,580,30.7,23.4,0,6.1,0,33.1,69.3,413,79,334,19.13,80.87,7,72,32,302,39,374,8.9,9.6,9.4,"50% - 75% P.O.C.","N/A"
"36085002900","Census Tract 29, Richmond County, New York",4702,24779,398,2090,0,261,0,1953,8.5,44.4,0,5.6,0,41.5,91.5,1744,438,1306,25.11,74.89,81,357,133,1173,214,1530,18.5,10.2,12.3,"75% or more P.O.C.","Less than $55000"
"36085003300","Census Tract 33, Richmond County, New York",3751,82483,1547,1193,0,350,0,589,41.2,31.8,0,9.3,0,15.7,58.8,1353,674,679,49.82,50.18,128,546,37,642,165,1188,19,5.4,12.2,"50% - 75% P.O.C.","$78000 - $104000"
"36085003600","Census Tract 36, Richmond County, New York",2833,88097,1283,419,0,592,0,443,45.3,14.8,0,20.9,0,15.6,54.7,870,526,344,60.46,39.54,105,421,122,222,227,643,20,35.5,26.1,"50% - 75% P.O.C.","$78000 - $104000"
"36085003900","Census Tract 39, Richmond County, New York",2376,70586,1216,485,0,136,0,446,51.2,20.4,0,5.7,0,18.8,48.8,1015,191,824,18.82,81.18,8,183,27,797,35,980,4.2,3.3,3.4,"25% - 50% P.O.C.","$55000 - $78000"
"36085004000","Census Tract 40, Richmond County, New York",12548,33984,1030,5708,0,1821,0,3989,8.2,45.5,0,14.5,0,31.8,91.8,4524,1541,2983,34.06,65.94,403,1138,193,2790,596,3928,26.2,6.5,13.2,"75% or more P.O.C.","Less than $55000"
"36085004700","Census Tract 47, Richmond County, New York",2805,88571,2046,209,15,289,0,244,72.9,7.5,0.5,10.3,0,8.7,27.1,974,758,216,77.82,22.18,74,684,6,210,80,894,9.8,2.8,8.2,"25% - 50% P.O.C.","$78000 - $104000"
"36085005000","Census Tract 50, Richmond County, New York",4004,81875,2482,101,0,687,0,726,62,2.5,0,17.2,0,18.1,38,1390,1001,389,72.01,27.99,101,900,65,324,166,1224,10.1,16.7,11.9,"25% - 50% P.O.C.","$78000 - $104000"
"36085005900","Census Tract 59, Richmond County, New York",3067,81583,2227,98,0,217,0,475,72.6,3.2,0,7.1,0,15.5,27.4,1191,771,420,64.74,35.26,81,690,0,420,81,1110,10.5,0,6.8,"25% - 50% P.O.C.","$78000 - $104000"
"36085006400","Census Tract 64, Richmond County, New York",3450,49449,1913,632,0,329,0,556,55.4,18.3,0,9.5,0,16.1,44.6,1202,701,501,58.32,41.68,152,549,53,448,205,997,21.7,10.6,17.1,"25% - 50% P.O.C.","Less than $55000"
"36085006700","Census Tract 67, Richmond County, New York",2468,121176,2085,62,0,122,0,158,84.5,2.5,0,4.9,0,6.4,15.5,1022,779,243,76.22,23.78,75,704,0,243,75,947,9.6,0,7.3,"Less than 25% P.O.C.","$104000 or more"
"36085007000","Census Tract 70, Richmond County, New York",9480,76149,5880,455,0,1080,0,1961,62,4.8,0,11.4,0,20.7,38,2659,2072,587,77.92,22.08,487,1585,228,359,715,1944,23.5,38.8,26.9,"25% - 50% P.O.C.","$55000 - $78000"
"36085007400","Census Tract 74, Richmond County, New York",4902,81033,2891,245,0,951,0,661,59,5,0,19.4,0,13.5,41,1648,975,673,59.16,40.84,183,792,30,643,213,1435,18.8,4.5,12.9,"25% - 50% P.O.C.","$78000 - $104000"
"36085007500","Census Tract 75, Richmond County, New York",4299,65833,1775,768,0,114,0,1320,41.3,17.9,0,2.7,0,30.7,58.7,1086,546,540,50.28,49.72,120,426,185,355,305,781,22,34.3,28.1,"50% - 75% P.O.C.","$55000 - $78000"
"36085007700","Census Tract 77, Richmond County, New York",1526,57000,154,589,0,73,0,703,10.1,38.6,0,4.8,0,46.1,89.9,466,245,221,52.58,47.42,65,180,57,164,122,344,26.5,25.8,26.2,"75% or more P.O.C.","$55000 - $78000"
"36085008100","Census Tract 81, Richmond County, New York",4313,37287,1338,1294,32,294,0,1155,31,30,0.7,6.8,0,26.8,69,1667,790,877,47.39,52.61,92,698,88,789,180,1487,11.6,10,10.8,"50% - 75% P.O.C.","Less than $55000"
"36085009601","Census Tract 96.01, Richmond County, New York",4489,91563,3376,63,83,366,0,524,75.2,1.4,1.8,8.2,0,11.7,24.8,1548,1060,488,68.48,31.52,171,889,0,488,171,1377,16.1,0,11,"Less than 25% P.O.C.","$78000 - $104000"
"36085009602","Census Tract 96.02, Richmond County, New York",3149,85750,2261,81,0,393,0,350,71.8,2.6,0,12.5,0,11.1,28.2,1273,743,530,58.37,41.63,58,685,12,518,70,1203,7.8,2.3,5.5,"25% - 50% P.O.C.","$78000 - $104000"
"36085009700","Census Tract 97, Richmond County, New York",4535,75648,1719,1558,0,106,0,1057,37.9,34.4,0,2.3,0,23.3,62.1,1590,918,672,57.74,42.26,146,772,67,605,213,1377,15.9,10,13.4,"50% - 75% P.O.C.","$55000 - $78000"
"36085010500","Census Tract 105, Richmond County, New York",4372,69583,1848,584,0,398,0,1498,42.3,13.4,0,9.1,0,34.3,57.7,1693,922,771,54.46,45.54,122,800,66,705,188,1505,13.2,8.6,11.1,"50% - 75% P.O.C.","$55000 - $78000"
"36085011201","Census Tract 112.01, Richmond County, New York",6358,79557,4490,60,0,556,0,1111,70.6,0.9,0,8.7,0,17.5,29.4,1939,1436,503,74.06,25.94,363,1073,57,446,420,1519,25.3,11.3,21.7,"25% - 50% P.O.C.","$78000 - $104000"
"36085011202","Census Tract 112.02, Richmond County, New York",5731,81016,2931,639,25,571,0,1419,51.1,11.1,0.4,10,0,24.8,48.9,2010,1346,664,66.97,33.03,157,1189,204,460,361,1649,11.7,30.7,18,"25% - 50% P.O.C.","$78000 - $104000"
"36085011401","Census Tract 114.01, Richmond County, New York",2971,44357,1304,440,0,264,0,705,43.9,14.8,0,8.9,0,23.7,56.1,1368,614,754,44.88,55.12,65,549,24,730,89,1279,10.6,3.2,6.5,"50% - 75% P.O.C.","Less than $55000"
"36085011402","Census Tract 114.02, Richmond County, New York",3398,83750,2477,59,0,298,0,564,72.9,1.7,0,8.8,0,16.6,27.1,1300,904,396,69.54,30.46,71,833,34,362,105,1195,7.9,8.6,8.1,"25% - 50% P.O.C.","$78000 - $104000"
"36085012100","Census Tract 121, Richmond County, New York",3143,108906,2380,24,0,29,0,659,75.7,0.8,0,0.9,0,21,24.3,1165,1037,128,89.01,10.99,47,990,41,87,88,1077,4.5,32,7.6,"Less than 25% P.O.C.","$104000 or more"
"36085012200","Census Tract 122, Richmond County, New York",3938,81613,3208,1,0,311,0,418,81.5,0,0,7.9,0,10.6,18.5,1450,1050,400,72.41,27.59,98,952,30,370,128,1322,9.3,7.5,8.8,"Less than 25% P.O.C.","$78000 - $104000"
"36085012500","Census Tract 125, Richmond County, New York",3047,81250,1285,405,0,165,0,1109,42.2,13.3,0,5.4,0,36.4,57.8,965,611,354,63.32,36.68,88,523,89,265,177,788,14.4,25.1,18.3,"50% - 75% P.O.C.","$78000 - $104000"
"36085012804","Census Tract 128.04, Richmond County, New York",4042,81107,3065,39,0,420,0,518,75.8,1,0,10.4,0,12.8,24.2,1547,1128,419,72.92,27.08,124,1004,10,409,134,1413,11,2.4,8.7,"Less than 25% P.O.C.","$78000 - $104000"
"36085012805","Census Tract 128.05, Richmond County, New York",2605,80379,2074,22,0,143,0,366,79.6,0.8,0,5.5,0,14,20.4,868,679,189,78.23,21.77,120,559,0,189,120,748,17.7,0,13.8,"Less than 25% P.O.C.","$78000 - $104000"
"36085012806","Census Tract 128.06, Richmond County, New York",5445,57212,3287,362,0,552,0,783,60.4,6.6,0,10.1,0,14.4,39.6,2273,1022,1251,44.96,55.04,162,860,24,1227,186,2087,15.9,1.9,8.2,"25% - 50% P.O.C.","$55000 - $78000"
"36085013201","Census Tract 132.01, Richmond County, New York",1480,102500,1171,20,0,146,0,143,79.1,1.4,0,9.9,0,9.7,20.9,550,495,55,90,10,70,425,0,55,70,480,14.1,0,12.7,"Less than 25% P.O.C.","$78000 - $104000"
"36085013203","Census Tract 132.03, Richmond County, New York",5729,87014,4666,283,0,155,0,601,81.4,4.9,0,2.7,0,10.5,18.6,2004,1612,392,80.44,19.56,213,1399,0,392,213,1791,13.2,0,10.6,"Less than 25% P.O.C.","$78000 - $104000"
"36085013204","Census Tract 132.04, Richmond County, New York",4863,87561,4013,2,0,132,0,687,82.5,0,0,2.7,0,14.1,17.5,1865,1365,500,73.19,26.81,173,1192,44,456,217,1648,12.7,8.8,11.6,"Less than 25% P.O.C.","$78000 - $104000"
"36085013301","Census Tract 133.01, Richmond County, New York",1095,9899,40,566,0,31,0,455,3.7,51.7,0,2.8,0,41.6,96.3,571,8,563,1.4,98.6,0,8,30,533,30,541,0,5.3,5.3,"75% or more P.O.C.","Less than $55000"
"36085013302","Census Tract 133.02, Richmond County, New York",3096,47905,176,1189,0,131,0,1528,5.7,38.4,0,4.2,0,49.4,94.3,870,375,495,43.1,56.9,67,308,127,368,194,676,17.9,25.7,22.3,"75% or more P.O.C.","Less than $55000"
"36085013400","Census Tract 134, Richmond County, New York",4099,85399,3262,21,0,137,0,640,79.6,0.5,0,3.3,0,15.6,20.4,1549,1077,472,69.53,30.47,127,950,83,389,210,1339,11.8,17.6,13.6,"Less than 25% P.O.C.","$78000 - $104000"
"36085013800","Census Tract 138, Richmond County, New York",6092,87418,4709,0,0,325,0,995,77.3,0,0,5.3,0,16.3,22.7,2333,1997,336,85.6,14.4,143,1854,0,336,143,2190,7.2,0,6.1,"Less than 25% P.O.C.","$78000 - $104000"
"36085014100","Census Tract 141, Richmond County, New York",2287,74773,766,318,22,331,0,780,33.5,13.9,1,14.5,0,34.1,66.5,888,547,341,61.6,38.4,67,480,0,341,67,821,12.2,0,7.5,"50% - 75% P.O.C.","$55000 - $78000"
"36085014604","Census Tract 146.04, Richmond County, New York",6866,103964,5540,16,27,573,0,531,80.7,0.2,0.4,8.3,0,7.7,19.3,2523,2070,453,82.05,17.95,372,1698,16,437,388,2135,18,3.5,15.4,"Less than 25% P.O.C.","$78000 - $104000"
"36085014605","Census Tract 146.05, Richmond County, New York",3853,112143,3454,10,0,274,0,114,89.6,0.3,0,7.1,0,3,10.4,1300,1112,188,85.54,14.46,130,982,16,172,146,1154,11.7,8.5,11.2,"Less than 25% P.O.C.","$104000 or more"
"36085014606","Census Tract 146.06, Richmond County, New York",5963,103825,5263,23,0,146,0,521,88.3,0.4,0,2.4,0,8.7,11.7,2313,2019,294,87.29,12.71,201,1818,0,294,201,2112,10,0,8.7,"Less than 25% P.O.C.","$78000 - $104000"
"36085014607","Census Tract 146.07, Richmond County, New York",4601,95114,3753,49,58,457,0,242,81.6,1.1,1.3,9.9,0,5.3,18.4,1704,1333,371,78.23,21.77,140,1193,65,306,205,1499,10.5,17.5,12,"Less than 25% P.O.C.","$78000 - $104000"
"36085014608","Census Tract 146.08, Richmond County, New York",3477,110469,2855,0,0,91,0,485,82.1,0,0,2.6,0,13.9,17.9,1085,1010,75,93.09,6.91,146,864,40,35,186,899,14.5,53.3,17.1,"Less than 25% P.O.C.","$104000 or more"
"36085014700","Census Tract 147, Richmond County, New York",3124,99856,2609,190,0,35,0,290,83.5,6.1,0,1.1,0,9.3,16.5,1327,1028,299,77.47,22.53,93,935,0,299,93,1234,9,0,7,"Less than 25% P.O.C.","$78000 - $104000"
"36085015100","Census Tract 151, Richmond County, New York",5374,98438,3977,54,0,367,0,947,74,1,0,6.8,0,17.6,26,1924,1597,327,83,17,200,1397,0,327,200,1724,12.5,0,10.4,"25% - 50% P.O.C.","$78000 - $104000"
"36085015400","Census Tract 154, Richmond County, New York",0,NA,0,0,0,0,0,0,NA,NA,NA,NA,NA,NA,NA,0,0,0,NA,NA,0,0,0,0,0,0,NA,NA,NA,"N/A","N/A"
"36085015601","Census Tract 156.01, Richmond County, New York",6391,105344,5642,4,0,265,0,479,88.3,0.1,0,4.1,0,7.5,11.7,2399,2049,350,85.41,14.59,237,1812,0,350,237,2162,11.6,0,9.9,"Less than 25% P.O.C.","$104000 or more"
"36085015602","Census Tract 156.02, Richmond County, New York",3242,112283,2964,27,0,41,0,197,91.4,0.8,0,1.3,0,6.1,8.6,1082,974,108,90.02,9.98,152,822,0,108,152,930,15.6,0,14,"Less than 25% P.O.C.","$104000 or more"
"36085015603","Census Tract 156.03, Richmond County, New York",4844,90106,3903,0,0,157,0,784,80.6,0,0,3.2,0,16.2,19.4,1753,1340,413,76.44,23.56,183,1157,10,403,193,1560,13.7,2.4,11,"Less than 25% P.O.C.","$78000 - $104000"
"36085016901","Census Tract 169.01, Richmond County, New York",3808,98750,2738,130,0,386,0,487,71.9,3.4,0,10.1,0,12.8,28.1,1156,865,291,74.83,25.17,126,739,7,284,133,1023,14.6,2.4,11.5,"25% - 50% P.O.C.","$78000 - $104000"
"36085017005","Census Tract 170.05, Richmond County, New York",5114,100673,4109,31,0,637,0,337,80.3,0.6,0,12.5,0,6.6,19.7,1700,1445,255,85,15,310,1135,16,239,326,1374,21.5,6.3,19.2,"Less than 25% P.O.C.","$78000 - $104000"
"36085017007","Census Tract 170.07, Richmond County, New York",5547,79934,3437,194,17,644,0,1197,62,3.5,0.3,11.6,0,21.6,38,1833,1610,223,87.83,12.17,271,1339,34,189,305,1528,16.8,15.2,16.6,"25% - 50% P.O.C.","$78000 - $104000"
"36085017008","Census Tract 170.08, Richmond County, New York",7795,109412,6979,0,0,255,0,524,89.5,0,0,3.3,0,6.7,10.5,2526,2288,238,90.58,9.42,252,2036,0,238,252,2274,11,0,10,"Less than 25% P.O.C.","$104000 or more"
"36085017009","Census Tract 170.09, Richmond County, New York",4485,93125,3896,0,0,188,0,302,86.9,0,0,4.2,0,6.7,13.1,1558,1257,301,80.68,19.32,210,1047,10,291,220,1338,16.7,3.3,14.1,"Less than 25% P.O.C.","$78000 - $104000"
"36085017010","Census Tract 170.10, Richmond County, New York",9060,82723,6352,84,0,473,22,1985,70.1,0.9,0,5.2,0.2,21.9,29.9,3137,2753,384,87.76,12.24,431,2322,11,373,442,2695,15.7,2.9,14.1,"25% - 50% P.O.C.","$78000 - $104000"
"36085017011","Census Tract 170.11, Richmond County, New York",4865,100662,4087,2,0,69,0,645,84,0,0,1.4,0,13.3,16,1789,1426,363,79.71,20.29,183,1243,0,363,183,1606,12.8,0,10.2,"Less than 25% P.O.C.","$78000 - $104000"
"36085017012","Census Tract 170.12, Richmond County, New York",4321,89273,3379,48,0,226,0,610,78.2,1.1,0,5.2,0,14.1,21.8,1681,1304,377,77.57,22.43,140,1164,0,377,140,1541,10.7,0,8.3,"Less than 25% P.O.C.","$78000 - $104000"
"36085017300","Census Tract 173, Richmond County, New York",2343,36707,723,465,0,565,0,503,30.9,19.8,0,24.1,0,21.5,69.1,957,346,611,36.15,63.85,42,304,14,597,56,901,12.1,2.3,5.9,"50% - 75% P.O.C.","Less than $55000"
"36085017600","Census Tract 176, Richmond County, New York",4849,125139,4512,73,0,49,17,171,93.1,1.5,0,1,0.4,3.5,6.9,1693,1432,261,84.58,15.42,152,1280,0,261,152,1541,10.6,0,9,"Less than 25% P.O.C.","$104000 or more"
"36085017700","Census Tract 177, Richmond County, New York",5983,115603,4882,4,0,759,9,240,81.6,0.1,0,12.7,0.2,4,18.4,2125,1859,266,87.48,12.52,209,1650,0,266,209,1916,11.2,0,9.8,"Less than 25% P.O.C.","$104000 or more"
"36085018100","Census Tract 181, Richmond County, New York",3055,127074,2545,44,0,303,0,133,83.3,1.4,0,9.9,0,4.4,16.7,1019,841,178,82.53,17.47,74,767,0,178,74,945,8.8,0,7.3,"Less than 25% P.O.C.","$104000 or more"
"36085018701","Census Tract 187.01, Richmond County, New York",1874,104118,1149,42,0,205,0,392,61.3,2.2,0,10.9,0,20.9,38.7,652,442,210,67.79,32.21,45,397,29,181,74,578,10.2,13.8,11.3,"25% - 50% P.O.C.","$104000 or more"
"36085018702","Census Tract 187.02, Richmond County, New York",7947,112742,4791,345,0,1817,0,827,60.3,4.3,0,22.9,0,10.4,39.7,2334,1793,541,76.82,23.18,332,1461,48,493,380,1954,18.5,8.9,16.3,"25% - 50% P.O.C.","$104000 or more"
"36085018901","Census Tract 189.01, Richmond County, New York",5057,76518,3388,22,0,795,0,796,67,0.4,0,15.7,0,15.7,33,1841,1333,508,72.41,27.59,235,1098,41,467,276,1565,17.6,8.1,15,"25% - 50% P.O.C.","$55000 - $78000"
"36085018902","Census Tract 189.02, Richmond County, New York",5504,102525,3170,88,0,1363,0,665,57.6,1.6,0,24.8,0,12.1,42.4,1735,1331,404,76.71,23.29,270,1061,87,317,357,1378,20.3,21.5,20.6,"25% - 50% P.O.C.","$78000 - $104000"
"36085019700","Census Tract 197, Richmond County, New York",1755,103000,1497,5,0,113,0,83,85.3,0.3,0,6.4,0,4.7,14.7,686,596,90,86.88,13.12,61,535,0,90,61,625,10.2,0,8.9,"Less than 25% P.O.C.","$78000 - $104000"
"36085019800","Census Tract 198, Richmond County, New York",7410,124130,6086,100,0,259,0,867,82.1,1.3,0,3.5,0,11.7,17.9,2318,1987,331,85.72,14.28,453,1534,0,331,453,1865,22.8,0,19.5,"Less than 25% P.O.C.","$104000 or more"
"36085020100","Census Tract 201, Richmond County, New York",3524,99141,1698,336,0,394,0,1034,48.2,9.5,0,11.2,0,29.3,51.8,1211,798,413,65.9,34.1,76,722,53,360,129,1082,9.5,12.8,10.7,"50% - 75% P.O.C.","$78000 - $104000"
"36085020700","Census Tract 207, Richmond County, New York",5499,33670,469,2035,0,86,0,2868,8.5,37,0,1.6,0,52.2,91.5,1832,856,976,46.72,53.28,221,635,175,801,396,1436,25.8,17.9,21.6,"75% or more P.O.C.","Less than $55000"
"36085020801","Census Tract 208.01, Richmond County, New York",8498,100543,7217,15,0,390,0,831,84.9,0.2,0,4.6,0,9.8,15.1,3230,2751,479,85.17,14.83,240,2511,36,443,276,2954,8.7,7.5,8.5,"Less than 25% P.O.C.","$78000 - $104000"
"36085020803","Census Tract 208.03, Richmond County, New York",7381,119750,6549,0,0,275,0,519,88.7,0,0,3.7,0,7,11.3,2441,2244,197,91.93,8.07,400,1844,0,197,400,2041,17.8,0,16.4,"Less than 25% P.O.C.","$104000 or more"
"36085020804","Census Tract 208.04, Richmond County, New York",5991,102857,5164,2,118,242,0,261,86.2,0,2,4,0,4.4,13.8,2058,1814,244,88.14,11.86,235,1579,0,244,235,1823,13,0,11.4,"Less than 25% P.O.C.","$78000 - $104000"
"36085021300","Census Tract 213, Richmond County, New York",4681,69640,1598,668,11,237,0,2138,34.1,14.3,0.2,5.1,0,45.7,65.9,1491,864,627,57.95,42.05,147,717,132,495,279,1212,17,21.1,18.7,"50% - 75% P.O.C.","$55000 - $78000"
"36085022300","Census Tract 223, Richmond County, New York",2745,63750,440,1014,12,89,0,1150,16,36.9,0.4,3.2,0,41.9,84,837,578,259,69.06,30.94,107,471,58,201,165,672,18.5,22.4,19.7,"75% or more P.O.C.","$55000 - $78000"
"36085022600","Census Tract 226, Richmond County, New York",8141,122917,7042,42,0,149,0,908,86.5,0.5,0,1.8,0,11.2,13.5,2734,2202,532,80.54,19.46,347,1855,47,485,394,2340,15.8,8.8,14.4,"Less than 25% P.O.C.","$104000 or more"
"36085022800","Census Tract 228, Richmond County, New York",23,NA,18,5,0,0,0,0,78.3,21.7,0,0,0,0,21.7,9,0,9,0,100,0,0,0,9,0,9,NA,0,0,"Less than 25% P.O.C.","N/A"
"36085023100","Census Tract 231, Richmond County, New York",5276,82599,905,1753,0,738,0,1859,17.2,33.2,0,14,0,35.2,82.8,1364,905,459,66.35,33.65,198,707,187,272,385,979,21.9,40.7,28.2,"75% or more P.O.C.","$78000 - $104000"
"36085023900","Census Tract 239, Richmond County, New York",3853,83883,939,717,0,107,0,1964,24.4,18.6,0,2.8,0,51,75.6,992,658,334,66.33,33.67,245,413,155,179,400,592,37.2,46.4,40.3,"75% or more P.O.C.","$78000 - $104000"
"36085024401","Census Tract 244.01, Richmond County, New York",6228,76394,5183,0,0,240,0,667,83.2,0,0,3.9,0,10.7,16.8,2111,1637,474,77.55,22.45,370,1267,0,474,370,1741,22.6,0,17.5,"Less than 25% P.O.C.","$55000 - $78000"
"36085024402","Census Tract 244.02, Richmond County, New York",4426,88906,3985,41,0,167,0,233,90,0.9,0,3.8,0,5.3,10,1685,1316,369,78.1,21.9,191,1125,8,361,199,1486,14.5,2.2,11.8,"Less than 25% P.O.C.","$78000 - $104000"
"36085024700","Census Tract 247, Richmond County, New York",2994,64297,749,633,0,433,2,1074,25,21.1,0,14.5,0.1,35.9,75,974,468,506,48.05,51.95,91,377,68,438,159,815,19.4,13.4,16.3,"75% or more P.O.C.","$55000 - $78000"
"36085024800","Census Tract 248, Richmond County, New York",5039,92237,4103,22,20,263,0,631,81.4,0.4,0.4,5.2,0,12.5,18.6,1708,1263,445,73.95,26.05,191,1072,34,411,225,1483,15.1,7.6,13.2,"Less than 25% P.O.C.","$78000 - $104000"
"36085025100","Census Tract 251, Richmond County, New York",6119,107239,3986,170,0,966,0,756,65.1,2.8,0,15.8,0,12.4,34.9,2194,1998,196,91.07,8.93,266,1732,61,135,327,1867,13.3,31.1,14.9,"25% - 50% P.O.C.","$104000 or more"
"36085027301","Census Tract 273.01, Richmond County, New York",3782,68542,2065,33,0,1151,0,344,54.6,0.9,0,30.4,0,9.1,45.4,1503,1208,295,80.37,19.63,132,1076,55,240,187,1316,10.9,18.6,12.4,"25% - 50% P.O.C.","$55000 - $78000"
"36085027302","Census Tract 273.02, Richmond County, New York",4060,85050,2997,7,0,793,0,233,73.8,0.2,0,19.5,0,5.7,26.2,1211,805,406,66.47,33.53,187,618,66,340,253,958,23.2,16.3,20.9,"25% - 50% P.O.C.","$78000 - $104000"
"36085027702","Census Tract 277.02, Richmond County, New York",6893,75022,4273,110,28,1136,0,1339,62,1.6,0.4,16.5,0,19.4,38,2980,1938,1042,65.03,34.97,125,1813,136,906,261,2719,6.4,13.1,8.8,"25% - 50% P.O.C.","$55000 - $78000"
"36085027704","Census Tract 277.04, Richmond County, New York",4629,105341,3357,9,0,724,0,491,72.5,0.2,0,15.6,0,10.6,27.5,1515,1203,312,79.41,20.59,265,938,9,303,274,1241,22,2.9,18.1,"25% - 50% P.O.C.","$104000 or more"
"36085027705","Census Tract 277.05, Richmond County, New York",5809,86397,3425,148,0,1489,0,495,59,2.5,0,25.6,0,8.5,41,1849,1418,431,76.69,23.31,242,1176,65,366,307,1542,17.1,15.1,16.6,"25% - 50% P.O.C.","$78000 - $104000"
"36085027706","Census Tract 277.06, Richmond County, New York",3489,103897,2039,250,0,615,0,474,58.4,7.2,0,17.6,0,13.6,41.6,1116,838,278,75.09,24.91,165,673,73,205,238,878,19.7,26.3,21.3,"25% - 50% P.O.C.","$78000 - $104000"
"36085027900","Census Tract 279, Richmond County, New York",2219,115682,1775,31,0,223,0,179,80,1.4,0,10,0,8.1,20,634,517,117,81.55,18.45,55,462,0,117,55,579,10.6,0,8.7,"Less than 25% P.O.C.","$104000 or more"
"36085029102","Census Tract 291.02, Richmond County, New York",3006,83750,1581,52,0,617,0,756,52.6,1.7,0,20.5,0,25.1,47.4,1047,950,97,90.74,9.26,73,877,13,84,86,961,7.7,13.4,8.2,"25% - 50% P.O.C.","$78000 - $104000"
"36085029103","Census Tract 291.03, Richmond County, New York",8266,104146,5437,150,0,936,76,1428,65.8,1.8,0,11.3,0.9,17.3,34.2,2632,2026,606,76.98,23.02,568,1458,95,511,663,1969,28,15.7,25.2,"25% - 50% P.O.C.","$104000 or more"
"36085029104","Census Tract 291.04, Richmond County, New York",7229,94292,4461,316,0,803,0,1518,61.7,4.4,0,11.1,0,21,38.3,2321,1901,420,81.9,18.1,332,1569,38,382,370,1951,17.5,9,15.9,"25% - 50% P.O.C.","$78000 - $104000"
"36085030301","Census Tract 303.01, Richmond County, New York",4972,85826,1862,444,6,901,0,1564,37.4,8.9,0.1,18.1,0,31.5,62.6,1835,1352,483,73.68,26.32,287,1065,42,441,329,1506,21.2,8.7,17.9,"50% - 75% P.O.C.","$78000 - $104000"
"36085030302","Census Tract 303.02, Richmond County, New York",6702,85660,1986,1015,0,798,0,2684,29.6,15.1,0,11.9,0,40,70.4,1981,1462,519,73.8,26.2,343,1119,163,356,506,1475,23.5,31.4,25.5,"50% - 75% P.O.C.","$78000 - $104000"
"36085031901","Census Tract 319.01, Richmond County, New York",2816,21250,413,1260,0,207,0,936,14.7,44.7,0,7.4,0,33.2,85.3,1051,360,691,34.25,65.75,101,259,36,655,137,914,28.1,5.2,13,"75% or more P.O.C.","Less than $55000"
"36085031902","Census Tract 319.02, Richmond County, New York",5343,46118,563,2790,0,158,0,1714,10.5,52.2,0,3,0,32.1,89.5,1641,771,870,46.98,53.02,179,592,135,735,314,1327,23.2,15.5,19.1,"75% or more P.O.C.","Less than $55000"
"36085032300","Census Tract 323, Richmond County, New York",1073,65089,186,410,0,16,0,453,17.3,38.2,0,1.5,0,42.2,82.7,451,313,138,69.4,30.6,28,285,0,138,28,423,8.9,0,6.2,"75% or more P.O.C.","$55000 - $78000"
"36085990100","Census Tract 9901, Richmond County, New York",0,NA,0,0,0,0,0,0,NA,NA,NA,NA,NA,NA,NA,0,0,0,NA,NA,0,0,0,0,0,0,NA,NA,NA,"N/A","N/A"
"36087010101","Census Tract 101.01, Rockland County, New York",6058,137861,4347,289,41,314,0,1067,71.8,4.8,0.7,5.2,0,17.6,28.2,1933,1704,229,88.15,11.85,243,1461,82,147,325,1608,14.3,35.8,16.8,"25% - 50% P.O.C.","$104000 or more"
"36087010102","Census Tract 101.02, Rockland County, New York",4755,102875,3227,372,0,103,0,991,67.9,7.8,0,2.2,0,20.8,32.1,1743,1511,232,86.69,13.31,187,1324,0,232,187,1556,12.4,0,10.7,"25% - 50% P.O.C.","$78000 - $104000"
"36087010200","Census Tract 102, Rockland County, New York",4538,93839,3055,583,0,52,0,830,67.3,12.8,0,1.1,0,18.3,32.7,1540,1244,296,80.78,19.22,199,1045,0,296,199,1341,16,0,12.9,"25% - 50% P.O.C.","$78000 - $104000"
"36087010501","Census Tract 105.01, Rockland County, New York",4922,128438,2783,625,0,516,0,963,56.5,12.7,0,10.5,0,19.6,43.5,1564,1425,139,91.11,8.89,244,1181,15,124,259,1305,17.1,10.8,16.6,"25% - 50% P.O.C.","$104000 or more"
"36087010502","Census Tract 105.02, Rockland County, New York",7075,71827,2745,1325,0,250,0,2555,38.8,18.7,0,3.5,0,36.1,61.2,2703,1793,910,66.33,33.67,153,1640,19,891,172,2531,8.5,2.1,6.4,"50% - 75% P.O.C.","$55000 - $78000"
"36087010503","Census Tract 105.03, Rockland County, New York",2429,129708,1292,592,0,232,0,299,53.2,24.4,0,9.6,0,12.3,46.8,777,706,71,90.86,9.14,95,611,5,66,100,677,13.5,7,12.9,"25% - 50% P.O.C.","$104000 or more"
"36087010601","Census Tract 106.01, Rockland County, New York",3960,84157,1245,448,0,100,0,1884,31.4,11.3,0,2.5,0,47.6,68.6,1209,894,315,73.95,26.05,128,766,71,244,199,1010,14.3,22.5,16.5,"50% - 75% P.O.C.","$78000 - $104000"
"36087010602","Census Tract 106.02, Rockland County, New York",6663,57574,1584,825,40,325,0,3689,23.8,12.4,0.6,4.9,0,55.4,76.2,2204,1017,1187,46.14,53.86,248,769,100,1087,348,1856,24.4,8.4,15.8,"75% or more P.O.C.","$55000 - $78000"
"36087010701","Census Tract 107.01, Rockland County, New York",4376,73384,1372,510,0,207,0,2221,31.4,11.7,0,4.7,0,50.8,68.6,1343,758,585,56.44,43.56,184,574,105,480,289,1054,24.3,17.9,21.5,"50% - 75% P.O.C.","$55000 - $78000"
"36087010702","Census Tract 107.02, Rockland County, New York",3953,58250,306,238,0,11,0,3398,7.7,6,0,0.3,0,86,92.3,1122,415,707,36.99,63.01,117,298,132,575,249,873,28.2,18.7,22.2,"75% or more P.O.C.","$55000 - $78000"
"36087010703","Census Tract 107.03, Rockland County, New York",3736,60909,749,235,0,64,0,2671,20,6.3,0,1.7,0,71.5,80,1268,384,884,30.28,69.72,45,339,149,735,194,1074,11.7,16.9,15.3,"75% or more P.O.C.","$55000 - $78000"
"36087010801","Census Tract 108.01, Rockland County, New York",4558,155455,3463,368,6,290,0,286,76,8.1,0.1,6.4,0,6.3,24,1518,1470,48,96.84,3.16,173,1297,0,48,173,1345,11.8,0,11.4,"Less than 25% P.O.C.","$104000 or more"
"36087010802","Census Tract 108.02, Rockland County, New York",5195,165807,3960,17,12,755,0,377,76.2,0.3,0.2,14.5,0,7.3,23.8,1743,1634,109,93.75,6.25,212,1422,31,78,243,1500,13,28.4,13.9,"Less than 25% P.O.C.","$104000 or more"
"36087010803","Census Tract 108.03, Rockland County, New York",5413,132344,3727,331,0,656,0,568,68.9,6.1,0,12.1,0,10.5,31.1,1905,1522,383,79.9,20.1,180,1342,75,308,255,1650,11.8,19.6,13.4,"25% - 50% P.O.C.","$104000 or more"
"36087010804","Census Tract 108.04, Rockland County, New York",4261,108906,2775,175,0,533,0,686,65.1,4.1,0,12.5,0,16.1,34.9,1351,1190,161,88.08,11.92,140,1050,19,142,159,1192,11.8,11.8,11.8,"25% - 50% P.O.C.","$104000 or more"
"36087010901","Census Tract 109.01, Rockland County, New York",4809,124444,3641,111,0,297,0,544,75.7,2.3,0,6.2,0,11.3,24.3,1560,1413,147,90.58,9.42,240,1173,0,147,240,1320,17,0,15.4,"Less than 25% P.O.C.","$104000 or more"
"36087010902","Census Tract 109.02, Rockland County, New York",4090,123250,2480,211,42,584,0,705,60.6,5.2,1,14.3,0,17.2,39.4,1460,1125,335,77.05,22.95,112,1013,0,335,112,1348,10,0,7.7,"25% - 50% P.O.C.","$104000 or more"
"36087011000","Census Tract 110, Rockland County, New York",2262,152386,1781,141,0,44,0,215,78.7,6.2,0,1.9,0,9.5,21.3,781,688,93,88.09,11.91,80,608,0,93,80,701,11.6,0,10.2,"Less than 25% P.O.C.","$104000 or more"
"36087011101","Census Tract 111.01, Rockland County, New York",5896,114577,3687,573,0,482,0,998,62.5,9.7,0,8.2,0,16.9,37.5,1958,1645,313,84.01,15.99,134,1511,46,267,180,1778,8.1,14.7,9.2,"25% - 50% P.O.C.","$104000 or more"
"36087011102","Census Tract 111.02, Rockland County, New York",6217,100045,3097,1405,0,428,0,1167,49.8,22.6,0,6.9,0,18.8,50.2,2402,1581,821,65.82,34.18,102,1479,203,618,305,2097,6.5,24.7,12.7,"50% - 75% P.O.C.","$78000 - $104000"
"36087011200","Census Tract 112, Rockland County, New York",6609,170260,5121,91,0,626,0,659,77.5,1.4,0,9.5,0,10,22.5,2312,2192,120,94.81,5.19,217,1975,41,79,258,2054,9.9,34.2,11.2,"Less than 25% P.O.C.","$104000 or more"
"36087011301","Census Tract 113.01, Rockland County, New York",7704,57222,1735,2586,0,538,0,2535,22.5,33.6,0,7,0,32.9,77.5,2336,820,1516,35.1,64.9,240,580,197,1319,437,1899,29.3,13,18.7,"75% or more P.O.C.","$55000 - $78000"
"36087011302","Census Tract 113.02, Rockland County, New York",5244,125938,3614,182,0,839,0,549,68.9,3.5,0,16,0,10.5,31.1,1770,1590,180,89.83,10.17,201,1389,40,140,241,1529,12.6,22.2,13.6,"25% - 50% P.O.C.","$104000 or more"
"36087011303","Census Tract 113.03, Rockland County, New York",5622,112763,3708,264,0,741,0,681,66,4.7,0,13.2,0,12.1,34,2246,1488,758,66.25,33.75,242,1246,0,758,242,2004,16.3,0,10.8,"25% - 50% P.O.C.","$104000 or more"
"36087011401","Census Tract 114.01, Rockland County, New York",4250,167717,2865,213,12,467,0,654,67.4,5,0.3,11,0,15.4,32.6,1352,1292,60,95.56,4.44,250,1042,0,60,250,1102,19.3,0,18.5,"25% - 50% P.O.C.","$104000 or more"
"36087011403","Census Tract 114.03, Rockland County, New York",5690,130552,4276,0,0,653,0,652,75.1,0,0,11.5,0,11.5,24.9,1971,1718,253,87.16,12.84,141,1577,9,244,150,1821,8.2,3.6,7.6,"Less than 25% P.O.C.","$104000 or more"
"36087011404","Census Tract 114.04, Rockland County, New York",4181,106997,2229,784,0,380,0,747,53.3,18.8,0,9.1,0,17.9,46.7,1739,1613,126,92.75,7.25,108,1505,4,122,112,1627,6.7,3.2,6.4,"25% - 50% P.O.C.","$104000 or more"
"36087011405","Census Tract 114.05, Rockland County, New York",4487,132419,1720,1480,0,401,0,695,38.3,33,0,8.9,0,15.5,61.7,1288,1032,256,80.12,19.88,252,780,33,223,285,1003,24.4,12.9,22.1,"50% - 75% P.O.C.","$104000 or more"
"36087011501","Census Tract 115.01, Rockland County, New York",7818,123526,7043,249,0,167,0,288,90.1,3.2,0,2.1,0,3.7,9.9,1976,1729,247,87.5,12.5,689,1040,5,242,694,1282,39.8,2,35.1,"Less than 25% P.O.C.","$104000 or more"
"36087011502","Census Tract 115.02, Rockland County, New York",7844,110806,4189,1137,0,438,0,2026,53.4,14.5,0,5.6,0,25.8,46.6,1874,1568,306,83.67,16.33,513,1055,181,125,694,1180,32.7,59.2,37,"25% - 50% P.O.C.","$104000 or more"
"36087011504","Census Tract 115.04, Rockland County, New York",7273,94152,835,3483,22,537,0,2214,11.5,47.9,0.3,7.4,0,30.4,88.5,1770,1431,339,80.85,19.15,340,1091,98,241,438,1332,23.8,28.9,24.7,"75% or more P.O.C.","$78000 - $104000"
"36087011505","Census Tract 115.05, Rockland County, New York",3313,26838,3131,65,0,67,0,30,94.5,2,0,2,0,0.9,5.5,649,94,555,14.48,85.52,32,62,306,249,338,311,34,55.1,52.1,"Less than 25% P.O.C.","Less than $55000"
"36087011506","Census Tract 115.06, Rockland County, New York",5621,24352,5366,78,0,44,0,121,95.5,1.4,0,0.8,0,2.2,4.5,956,150,806,15.69,84.31,64,86,504,302,568,388,42.7,62.5,59.4,"Less than 25% P.O.C.","Less than $55000"
"36087011601","Census Tract 116.01, Rockland County, New York",3352,146389,2997,55,0,135,0,82,89.4,1.6,0,4,0,2.4,10.6,1074,1037,37,96.55,3.45,213,824,0,37,213,861,20.5,0,19.8,"Less than 25% P.O.C.","$104000 or more"
"36087011602","Census Tract 116.02, Rockland County, New York",5830,89038,4703,313,23,300,0,374,80.7,5.4,0.4,5.1,0,6.4,19.3,2034,1220,814,59.98,40.02,340,880,45,769,385,1649,27.9,5.5,18.9,"Less than 25% P.O.C.","$78000 - $104000"
"36087011603","Census Tract 116.03, Rockland County, New York",5409,127417,4000,253,0,296,14,737,74,4.7,0,5.5,0.3,13.6,26,1792,1397,395,77.96,22.04,108,1289,74,321,182,1610,7.7,18.7,10.2,"25% - 50% P.O.C.","$104000 or more"
"36087011700","Census Tract 117, Rockland County, New York",3116,105000,2467,142,0,67,0,388,79.2,4.6,0,2.2,0,12.5,20.8,1102,878,224,79.67,20.33,113,765,19,205,132,970,12.9,8.5,12,"Less than 25% P.O.C.","$104000 or more"
"36087011800","Census Tract 118, Rockland County, New York",918,69531,335,147,20,87,0,247,36.5,16,2.2,9.5,0,26.9,63.5,287,190,97,66.2,33.8,41,149,23,74,64,223,21.6,23.7,22.3,"50% - 75% P.O.C.","$55000 - $78000"
"36087011901","Census Tract 119.01, Rockland County, New York",3968,100875,2148,361,0,288,0,1010,54.1,9.1,0,7.3,0,25.5,45.9,1277,924,353,72.36,27.64,117,807,28,325,145,1132,12.7,7.9,11.4,"25% - 50% P.O.C.","$78000 - $104000"
"36087011902","Census Tract 119.02, Rockland County, New York",3207,72014,1797,198,0,168,0,1002,56,6.2,0,5.2,0,31.2,44,1321,644,677,48.75,51.25,53,591,26,651,79,1242,8.2,3.8,6,"25% - 50% P.O.C.","$55000 - $78000"
"36087012000","Census Tract 120, Rockland County, New York",3768,79583,3134,122,0,223,0,166,83.2,3.2,0,5.9,0,4.4,16.8,1799,1578,221,87.72,12.28,51,1527,0,221,51,1748,3.2,0,2.8,"Less than 25% P.O.C.","$78000 - $104000"
"36087012101","Census Tract 121.01, Rockland County, New York",6345,56286,5751,397,0,0,0,166,90.6,6.3,0,0,0,2.6,9.4,1178,494,684,41.94,58.06,194,300,449,235,643,535,39.3,65.6,54.6,"Less than 25% P.O.C.","$55000 - $78000"
"36087012102","Census Tract 121.02, Rockland County, New York",9503,27996,9362,35,0,0,0,24,98.5,0.4,0,0,0,0.3,1.5,1695,413,1282,24.37,75.63,176,237,915,367,1091,604,42.6,71.4,64.4,"Less than 25% P.O.C.","Less than $55000"
"36087012103","Census Tract 121.03, Rockland County, New York",5899,51632,5882,8,0,0,0,9,99.7,0.1,0,0,0,0.2,0.3,1133,544,589,48.01,51.99,244,300,345,244,589,544,44.9,58.6,52,"Less than 25% P.O.C.","Less than $55000"
"36087012105","Census Tract 121.05, Rockland County, New York",6508,38625,6164,198,0,0,0,136,94.7,3,0,0,0,2.1,5.3,1123,180,943,16.03,83.97,133,47,497,446,630,493,73.9,52.7,56.1,"Less than 25% P.O.C.","Less than $55000"
"36087012106","Census Tract 121.06, Rockland County, New York",4808,63083,3799,423,0,91,0,471,79,8.8,0,1.9,0,9.8,21,815,379,436,46.5,53.5,222,157,272,164,494,321,58.6,62.4,60.6,"Less than 25% P.O.C.","$55000 - $78000"
"36087012202","Census Tract 122.02, Rockland County, New York",6527,40853,333,3839,0,243,0,1894,5.1,58.8,0,3.7,0,29,94.9,2158,769,1389,35.63,64.37,108,661,266,1123,374,1784,14,19.2,17.3,"75% or more P.O.C.","Less than $55000"
"36087012203","Census Tract 122.03, Rockland County, New York",3375,40437,3264,81,2,6,0,16,96.7,2.4,0.1,0.2,0,0.5,3.3,934,259,675,27.73,72.27,102,157,106,569,208,726,39.4,15.7,22.3,"Less than 25% P.O.C.","Less than $55000"
"36087012204","Census Tract 122.04, Rockland County, New York",3908,51506,3671,81,0,5,0,63,93.9,2.1,0,0.1,0,1.6,6.1,687,303,384,44.1,55.9,224,79,235,149,459,228,73.9,61.2,66.8,"Less than 25% P.O.C.","Less than $55000"
"36087012300","Census Tract 123, Rockland County, New York",6283,37426,1927,1626,7,0,0,2723,30.7,25.9,0.1,0,0,43.3,69.3,1608,325,1283,20.21,79.79,138,187,402,881,540,1068,42.5,31.3,33.6,"50% - 75% P.O.C.","Less than $55000"
"36087012401","Census Tract 124.01, Rockland County, New York",4989,50607,1622,2509,0,408,0,402,32.5,50.3,0,8.2,0,8.1,67.5,2105,433,1672,20.57,79.43,26,407,131,1541,157,1948,6,7.8,7.5,"50% - 75% P.O.C.","Less than $55000"
"36087012402","Census Tract 124.02, Rockland County, New York",5377,58333,484,1517,0,120,0,3222,9,28.2,0,2.2,0,59.9,91,1418,514,904,36.25,63.75,152,362,201,703,353,1065,29.6,22.2,24.9,"75% or more P.O.C.","$55000 - $78000"
"36087012501","Census Tract 125.01, Rockland County, New York",5088,80726,4073,305,0,188,0,452,80.1,6,0,3.7,0,8.9,19.9,1274,1033,241,81.08,18.92,339,694,93,148,432,842,32.8,38.6,33.9,"Less than 25% P.O.C.","$78000 - $104000"
"36087012502","Census Tract 125.02, Rockland County, New York",5513,96990,3626,879,0,235,0,498,65.8,15.9,0,4.3,0,9,34.2,1590,1251,339,78.68,21.32,309,942,95,244,404,1186,24.7,28,25.4,"25% - 50% P.O.C.","$78000 - $104000"
"36087012600","Census Tract 126, Rockland County, New York",6478,123010,4782,398,0,595,0,662,73.8,6.1,0,9.2,0,10.2,26.2,1994,1796,198,90.07,9.93,378,1418,0,198,378,1616,21,0,19,"25% - 50% P.O.C.","$104000 or more"
"36087012700","Census Tract 127, Rockland County, New York",4542,86250,3561,109,117,155,0,542,78.4,2.4,2.6,3.4,0,11.9,21.6,1721,955,766,55.49,44.51,139,816,39,727,178,1543,14.6,5.1,10.3,"Less than 25% P.O.C.","$78000 - $104000"
"36087012800","Census Tract 128, Rockland County, New York",6891,130375,5890,165,0,485,0,270,85.5,2.4,0,7,0,3.9,14.5,2379,2147,232,90.25,9.75,204,1943,0,232,204,2175,9.5,0,8.6,"Less than 25% P.O.C.","$104000 or more"
"36087013001","Census Tract 130.01, Rockland County, New York",2917,120795,2211,188,12,224,0,192,75.8,6.4,0.4,7.7,0,6.6,24.2,775,679,96,87.61,12.39,118,561,11,85,129,646,17.4,11.5,16.6,"Less than 25% P.O.C.","$104000 or more"
"36087013002","Census Tract 130.02, Rockland County, New York",5433,125964,4126,92,0,682,0,460,75.9,1.7,0,12.6,0,8.5,24.1,1661,1448,213,87.18,12.82,252,1196,0,213,252,1409,17.4,0,15.2,"Less than 25% P.O.C.","$104000 or more"
"36087013003","Census Tract 130.03, Rockland County, New York",2854,151111,2151,149,0,170,0,272,75.4,5.2,0,6,0,9.5,24.6,996,698,298,70.08,29.92,26,672,9,289,35,961,3.7,3,3.5,"Less than 25% P.O.C.","$104000 or more"
"36087013100","Census Tract 131, Rockland County, New York",6309,76589,3132,1460,0,285,0,1223,49.6,23.1,0,4.5,0,19.4,50.4,2916,1112,1804,38.13,61.87,0,1112,51,1753,51,2865,0,2.8,1.7,"50% - 75% P.O.C.","$55000 - $78000"
"36087013200","Census Tract 132, Rockland County, New York",3387,105114,2170,467,0,195,0,378,64.1,13.8,0,5.8,0,11.2,35.9,1213,734,479,60.51,39.49,58,676,0,479,58,1155,7.9,0,4.8,"25% - 50% P.O.C.","$104000 or more"
"36087013300","Census Tract 133, Rockland County, New York",2540,124716,1959,109,0,145,0,265,77.1,4.3,0,5.7,0,10.4,22.9,1194,796,398,66.67,33.33,9,787,24,374,33,1161,1.1,6,2.8,"Less than 25% P.O.C.","$104000 or more"
"36087013401","Census Tract 134.01, Rockland County, New York",4787,117525,3380,60,0,642,0,629,70.6,1.3,0,13.4,0,13.1,29.4,1543,1426,117,92.42,7.58,212,1214,30,87,242,1301,14.9,25.6,15.7,"25% - 50% P.O.C.","$104000 or more"
"36087013402","Census Tract 134.02, Rockland County, New York",3771,127092,2766,27,12,405,0,507,73.3,0.7,0.3,10.7,0,13.4,26.7,1319,1199,120,90.9,9.1,188,1011,0,120,188,1131,15.7,0,14.3,"25% - 50% P.O.C.","$104000 or more"
"36103110101","Census Tract 1101.01, Suffolk County, New York",3677,250001,3334,23,0,136,0,121,90.7,0.6,0,3.7,0,3.3,9.3,1196,1140,56,95.32,4.68,185,955,7,49,192,1004,16.2,12.5,16.1,"Less than 25% P.O.C.","$104000 or more"
"36103110102","Census Tract 1101.02, Suffolk County, New York",4932,202208,4199,9,0,299,0,306,85.1,0.2,0,6.1,0,6.2,14.9,1671,1476,195,88.33,11.67,181,1295,26,169,207,1464,12.3,13.3,12.4,"Less than 25% P.O.C.","$104000 or more"
"36103110200","Census Tract 1102, Suffolk County, New York",5037,108611,4531,157,0,266,0,83,90,3.1,0,5.3,0,1.6,10,2196,1865,331,84.93,15.07,116,1749,0,331,116,2080,6.2,0,5.3,"Less than 25% P.O.C.","$104000 or more"
"36103110300","Census Tract 1103, Suffolk County, New York",5031,136607,4624,75,8,40,0,256,91.9,1.5,0.2,0.8,0,5.1,8.1,2069,1688,381,81.59,18.41,126,1562,0,381,126,1943,7.5,0,6.1,"Less than 25% P.O.C.","$104000 or more"
"36103110401","Census Tract 1104.01, Suffolk County, New York",2219,166250,2124,5,0,21,0,59,95.7,0.2,0,0.9,0,2.7,4.3,883,838,45,94.9,5.1,51,787,0,45,51,832,6.1,0,5.8,"Less than 25% P.O.C.","$104000 or more"
"36103110402","Census Tract 1104.02, Suffolk County, New York",3221,147756,3026,0,0,131,0,64,93.9,0,0,4.1,0,2,6.1,1227,1192,35,97.15,2.85,105,1087,0,35,105,1122,8.8,0,8.6,"Less than 25% P.O.C.","$104000 or more"
"36103110501","Census Tract 1105.01, Suffolk County, New York",2937,141630,2505,11,0,174,0,197,85.3,0.4,0,5.9,0,6.7,14.7,1036,961,75,92.76,7.24,98,863,0,75,98,938,10.2,0,9.5,"Less than 25% P.O.C.","$104000 or more"
"36103110502","Census Tract 1105.02, Suffolk County, New York",2783,146063,2592,30,0,82,0,57,93.1,1.1,0,2.9,0,2,6.9,933,871,62,93.35,6.65,61,810,0,62,61,872,7,0,6.5,"Less than 25% P.O.C.","$104000 or more"
"36103110600","Census Tract 1106, Suffolk County, New York",7328,114375,6741,160,0,58,0,349,92,2.2,0,0.8,0,4.8,8,2914,2432,482,83.46,16.54,276,2156,0,482,276,2638,11.3,0,9.5,"Less than 25% P.O.C.","$104000 or more"
"36103110801","Census Tract 1108.01, Suffolk County, New York",1948,156250,1864,8,4,8,0,61,95.7,0.4,0.2,0.4,0,3.1,4.3,716,666,50,93.02,6.98,41,625,5,45,46,670,6.2,10,6.4,"Less than 25% P.O.C.","$104000 or more"
"36103110803","Census Tract 1108.03, Suffolk County, New York",6056,147089,5300,66,0,35,0,625,87.5,1.1,0,0.6,0,10.3,12.5,2117,1919,198,90.65,9.35,198,1721,0,198,198,1919,10.3,0,9.4,"Less than 25% P.O.C.","$104000 or more"
"36103110901","Census Tract 1109.01, Suffolk County, New York",2777,117330,2411,22,0,87,0,149,86.8,0.8,0,3.1,0,5.4,13.2,1137,844,293,74.23,25.77,99,745,0,293,99,1038,11.7,0,8.7,"Less than 25% P.O.C.","$104000 or more"
"36103110902","Census Tract 1109.02, Suffolk County, New York",4474,95333,1732,1051,0,123,0,1482,38.7,23.5,0,2.7,0,33.1,61.3,1414,804,610,56.86,43.14,79,725,143,467,222,1192,9.8,23.4,15.7,"50% - 75% P.O.C.","$78000 - $104000"
"36103111001","Census Tract 1110.01, Suffolk County, New York",2011,99342,1643,75,0,66,0,199,81.7,3.7,0,3.3,0,9.9,18.3,878,669,209,76.2,23.8,39,630,0,209,39,839,5.8,0,4.4,"Less than 25% P.O.C.","$78000 - $104000"
"36103111002","Census Tract 1110.02, Suffolk County, New York",5432,71860,2147,528,0,119,0,2157,39.5,9.7,0,2.2,0,39.7,60.5,1780,1051,729,59.04,40.96,237,814,41,688,278,1502,22.5,5.6,15.6,"50% - 75% P.O.C.","$55000 - $78000"
"36103111100","Census Tract 1111, Suffolk County, New York",7898,75500,2587,603,0,117,0,3856,32.8,7.6,0,1.5,0,48.8,67.2,2226,1604,622,72.06,27.94,362,1242,88,534,450,1776,22.6,14.1,20.2,"50% - 75% P.O.C.","$55000 - $78000"
"36103111201","Census Tract 1112.01, Suffolk County, New York",3481,88417,1504,208,0,16,0,1728,43.2,6,0,0.5,0,49.6,56.8,1133,692,441,61.08,38.92,80,612,85,356,165,968,11.6,19.3,14.6,"50% - 75% P.O.C.","$78000 - $104000"
"36103111202","Census Tract 1112.02, Suffolk County, New York",5371,112250,3187,111,0,198,0,1698,59.3,2.1,0,3.7,0,31.6,40.7,1565,1398,167,89.33,10.67,253,1145,54,113,307,1258,18.1,32.3,19.6,"25% - 50% P.O.C.","$104000 or more"
"36103111300","Census Tract 1113, Suffolk County, New York",4445,141902,4098,0,0,68,0,271,92.2,0,0,1.5,0,6.1,7.8,1517,1464,53,96.51,3.49,160,1304,0,53,160,1357,10.9,0,10.5,"Less than 25% P.O.C.","$104000 or more"
"36103111401","Census Tract 1114.01, Suffolk County, New York",1368,152759,1082,54,0,59,0,149,79.1,3.9,0,4.3,0,10.9,20.9,472,465,7,98.52,1.48,39,426,0,7,39,433,8.4,0,8.3,"Less than 25% P.O.C.","$104000 or more"
"36103111402","Census Tract 1114.02, Suffolk County, New York",4842,120096,3745,199,0,374,0,463,77.3,4.1,0,7.7,0,9.6,22.7,1668,1566,102,93.88,6.12,255,1311,17,85,272,1396,16.3,16.7,16.3,"Less than 25% P.O.C.","$104000 or more"
"36103111503","Census Tract 1115.03, Suffolk County, New York",4479,99091,3584,214,0,158,0,438,80,4.8,0,3.5,0,9.8,20,1612,1109,503,68.8,31.2,216,893,0,503,216,1396,19.5,0,13.4,"Less than 25% P.O.C.","$78000 - $104000"
"36103111504","Census Tract 1115.04, Suffolk County, New York",1554,128920,1258,16,0,115,0,129,81,1,0,7.4,0,8.3,19,481,473,8,98.34,1.66,76,397,8,0,84,397,16.1,100,17.5,"Less than 25% P.O.C.","$104000 or more"
"36103111505","Census Tract 1115.05, Suffolk County, New York",7130,111250,3686,1163,22,338,0,1321,51.7,16.3,0.3,4.7,0,18.5,48.3,2041,1786,255,87.51,12.49,286,1500,69,186,355,1686,16,27.1,17.4,"25% - 50% P.O.C.","$104000 or more"
"36103111506","Census Tract 1115.06, Suffolk County, New York",3630,122024,2295,772,0,199,0,206,63.2,21.3,0,5.5,0,5.7,36.8,1018,1000,18,98.23,1.77,128,872,0,18,128,890,12.8,0,12.6,"25% - 50% P.O.C.","$104000 or more"
"36103111601","Census Tract 1116.01, Suffolk County, New York",4403,114583,3928,3,0,52,0,373,89.2,0.1,0,1.2,0,8.5,10.8,1492,1248,244,83.65,16.35,149,1099,36,208,185,1307,11.9,14.8,12.4,"Less than 25% P.O.C.","$104000 or more"
"36103111602","Census Tract 1116.02, Suffolk County, New York",2605,112222,2480,27,0,13,0,59,95.2,1,0,0.5,0,2.3,4.8,1018,934,84,91.75,8.25,78,856,11,73,89,929,8.4,13.1,8.7,"Less than 25% P.O.C.","$104000 or more"
"36103111701","Census Tract 1117.01, Suffolk County, New York",5937,103682,5135,35,0,276,0,372,86.5,0.6,0,4.6,0,6.3,13.5,2042,1783,259,87.32,12.68,250,1533,0,259,250,1792,14,0,12.2,"Less than 25% P.O.C.","$78000 - $104000"
"36103111703","Census Tract 1117.03, Suffolk County, New York",3015,125875,2687,9,0,120,0,199,89.1,0.3,0,4,0,6.6,10.9,975,863,112,88.51,11.49,102,761,0,112,102,873,11.8,0,10.5,"Less than 25% P.O.C.","$104000 or more"
"36103111704","Census Tract 1117.04, Suffolk County, New York",3466,131029,3126,40,0,52,0,237,90.2,1.2,0,1.5,0,6.8,9.8,1142,1106,36,96.85,3.15,145,961,0,36,145,997,13.1,0,12.7,"Less than 25% P.O.C.","$104000 or more"
"36103111801","Census Tract 1118.01, Suffolk County, New York",6314,110801,4970,241,0,561,0,427,78.7,3.8,0,8.9,0,6.8,21.3,2067,1928,139,93.28,6.72,151,1777,27,112,178,1889,7.8,19.4,8.6,"Less than 25% P.O.C.","$104000 or more"
"36103111802","Census Tract 1118.02, Suffolk County, New York",2911,143098,2474,2,0,168,0,260,85,0.1,0,5.8,0,8.9,15,897,861,36,95.99,4.01,134,727,7,29,141,756,15.6,19.4,15.7,"Less than 25% P.O.C.","$104000 or more"
"36103111803","Census Tract 1118.03, Suffolk County, New York",2914,160526,2488,0,0,140,0,222,85.4,0,0,4.8,0,7.6,14.6,864,824,40,95.37,4.63,141,683,0,40,141,723,17.1,0,16.3,"Less than 25% P.O.C.","$104000 or more"
"36103111804","Census Tract 1118.04, Suffolk County, New York",2505,140833,2223,30,0,78,0,174,88.7,1.2,0,3.1,0,6.9,11.3,796,739,57,92.84,7.16,81,658,0,57,81,715,11,0,10.2,"Less than 25% P.O.C.","$104000 or more"
"36103111900","Census Tract 1119, Suffolk County, New York",5055,135843,4241,21,0,289,0,321,83.9,0.4,0,5.7,0,6.4,16.1,1813,1738,75,95.86,4.14,168,1570,11,64,179,1634,9.7,14.7,9.9,"Less than 25% P.O.C.","$104000 or more"
"36103112001","Census Tract 1120.01, Suffolk County, New York",5475,121051,4034,92,0,379,0,908,73.7,1.7,0,6.9,0,16.6,26.3,1709,1501,208,87.83,12.17,171,1330,35,173,206,1503,11.4,16.8,12.1,"25% - 50% P.O.C.","$104000 or more"
"36103112002","Census Tract 1120.02, Suffolk County, New York",4847,107026,3922,30,0,263,0,576,80.9,0.6,0,5.4,0,11.9,19.1,1711,1424,287,83.23,16.77,139,1285,49,238,188,1523,9.8,17.1,11,"Less than 25% P.O.C.","$104000 or more"
"36103112102","Census Tract 1121.02, Suffolk County, New York",3805,184432,3002,140,0,262,0,227,78.9,3.7,0,6.9,0,6,21.1,1222,1209,13,98.94,1.06,136,1073,0,13,136,1086,11.2,0,11.1,"Less than 25% P.O.C.","$104000 or more"
"36103112103","Census Tract 1121.03, Suffolk County, New York",4569,94605,3884,74,0,310,0,271,85,1.6,0,6.8,0,5.9,15,1572,1255,317,79.83,20.17,110,1145,0,317,110,1462,8.8,0,7,"Less than 25% P.O.C.","$78000 - $104000"
"36103112104","Census Tract 1121.04, Suffolk County, New York",2109,136205,1538,65,0,310,0,116,72.9,3.1,0,14.7,0,5.5,27.1,691,653,38,94.5,5.5,94,559,7,31,101,590,14.4,18.4,14.6,"25% - 50% P.O.C.","$104000 or more"
"36103112204","Census Tract 1122.04, Suffolk County, New York",3916,130398,3292,80,0,188,16,140,84.1,2,0,4.8,0.4,3.6,15.9,1328,1152,176,86.75,13.25,90,1062,22,154,112,1216,7.8,12.5,8.4,"Less than 25% P.O.C.","$104000 or more"
"36103112206","Census Tract 1122.06, Suffolk County, New York",7581,129133,6534,114,0,372,0,475,86.2,1.5,0,4.9,0,6.3,13.8,2909,2373,536,81.57,18.43,228,2145,26,510,254,2655,9.6,4.9,8.7,"Less than 25% P.O.C.","$104000 or more"
"36103112210","Census Tract 1122.10, Suffolk County, New York",6915,156678,4797,366,0,1375,0,377,69.4,5.3,0,19.9,0,5.5,30.6,2118,2042,76,96.41,3.59,169,1873,0,76,169,1949,8.3,0,8,"25% - 50% P.O.C.","$104000 or more"
"36103112211","Census Tract 1122.11, Suffolk County, New York",4437,163984,3487,240,0,485,0,174,78.6,5.4,0,10.9,0,3.9,21.4,1399,1340,59,95.78,4.22,187,1153,0,59,187,1212,14,0,13.4,"Less than 25% P.O.C.","$104000 or more"
"36103112212","Census Tract 1122.12, Suffolk County, New York",3568,213942,2479,164,0,590,0,241,69.5,4.6,0,16.5,0,6.8,30.5,1051,1051,0,100,0,124,927,0,0,124,927,11.8,NA,11.8,"25% - 50% P.O.C.","$104000 or more"
"36103112213","Census Tract 1122.13, Suffolk County, New York",5091,161818,2962,240,0,1368,15,448,58.2,4.7,0,26.9,0.3,8.8,41.8,1516,1458,58,96.17,3.83,245,1213,13,45,258,1258,16.8,22.4,17,"25% - 50% P.O.C.","$104000 or more"
"36103112214","Census Tract 1122.14, Suffolk County, New York",6219,125024,4700,368,0,828,0,240,75.6,5.9,0,13.3,0,3.9,24.4,2521,2311,210,91.67,8.33,162,2149,0,210,162,2359,7,0,6.4,"Less than 25% P.O.C.","$104000 or more"
"36103122300","Census Tract 1223, Suffolk County, New York",3916,115417,2604,98,0,584,0,531,66.5,2.5,0,14.9,0,13.6,33.5,1141,869,272,76.16,23.84,134,735,0,272,134,1007,15.4,0,11.7,"25% - 50% P.O.C.","$104000 or more"
"36103122403","Census Tract 1224.03, Suffolk County, New York",2296,94816,478,1295,0,33,0,340,20.8,56.4,0,1.4,0,14.8,79.2,723,613,110,84.79,15.21,153,460,16,94,169,554,25,14.5,23.4,"75% or more P.O.C.","$78000 - $104000"
"36103122404","Census Tract 1224.04, Suffolk County, New York",3412,97825,2165,310,0,45,0,870,63.5,9.1,0,1.3,0,25.5,36.5,1027,860,167,83.74,16.26,53,807,97,70,150,877,6.2,58.1,14.6,"25% - 50% P.O.C.","$78000 - $104000"
"36103122405","Census Tract 1224.05, Suffolk County, New York",3447,126650,495,1924,0,205,0,603,14.4,55.8,0,5.9,0,17.5,85.6,805,773,32,96.02,3.98,184,589,10,22,194,611,23.8,31.2,24.1,"75% or more P.O.C.","$104000 or more"
"36103122406","Census Tract 1224.06, Suffolk County, New York",4997,68949,61,3274,38,28,0,1364,1.2,65.5,0.8,0.6,0,27.3,98.8,1199,872,327,72.73,27.27,279,593,97,230,376,823,32,29.7,31.4,"75% or more P.O.C.","$55000 - $78000"
"36103122501","Census Tract 1225.01, Suffolk County, New York",4832,38571,167,2610,46,54,0,1803,3.5,54,1,1.1,0,37.3,96.5,1114,454,660,40.75,59.25,228,226,157,503,385,729,50.2,23.8,34.6,"75% or more P.O.C.","Less than $55000"
"36103122502","Census Tract 1225.02, Suffolk County, New York",4931,109853,232,3359,51,62,0,1189,4.7,68.1,1,1.3,0,24.1,95.3,1140,987,153,86.58,13.42,322,665,45,108,367,773,32.6,29.4,32.2,"75% or more P.O.C.","$104000 or more"
"36103122601","Census Tract 1226.01, Suffolk County, New York",5886,113750,3518,1002,0,592,0,736,59.8,17,0,10.1,0,12.5,40.2,1772,1604,168,90.52,9.48,320,1284,45,123,365,1407,20,26.8,20.6,"25% - 50% P.O.C.","$104000 or more"
"36103122602","Census Tract 1226.02, Suffolk County, New York",4825,97969,2864,147,0,254,0,1361,59.4,3,0,5.3,0,28.2,40.6,1408,1269,139,90.13,9.87,181,1088,17,122,198,1210,14.3,12.2,14.1,"25% - 50% P.O.C.","$78000 - $104000"
"36103122603","Census Tract 1226.03, Suffolk County, New York",5692,107143,3550,258,0,546,0,1087,62.4,4.5,0,9.6,0,19.1,37.6,1784,1381,403,77.41,22.59,241,1140,26,377,267,1517,17.5,6.5,15,"25% - 50% P.O.C.","$104000 or more"
"36103122704","Census Tract 1227.04, Suffolk County, New York",2147,89352,986,255,10,356,0,522,45.9,11.9,0.5,16.6,0,24.3,54.1,740,601,139,81.22,18.78,60,541,18,121,78,662,10,12.9,10.5,"50% - 75% P.O.C.","$78000 - $104000"
"36103122705","Census Tract 1227.05, Suffolk County, New York",3123,97450,1632,315,0,199,0,755,52.3,10.1,0,6.4,0,24.2,47.7,909,738,171,81.19,18.81,84,654,88,83,172,737,11.4,51.5,18.9,"25% - 50% P.O.C.","$78000 - $104000"
"36103122706","Census Tract 1227.06, Suffolk County, New York",4045,94907,2422,156,0,871,0,432,59.9,3.9,0,21.5,0,10.7,40.1,1330,904,426,67.97,32.03,152,752,30,396,182,1148,16.8,7,13.7,"25% - 50% P.O.C.","$78000 - $104000"
"36103122707","Census Tract 1227.07, Suffolk County, New York",3119,96055,2156,14,0,245,0,704,69.1,0.4,0,7.9,0,22.6,30.9,965,862,103,89.33,10.67,144,718,0,103,144,821,16.7,0,14.9,"25% - 50% P.O.C.","$78000 - $104000"
"36103122801","Census Tract 1228.01, Suffolk County, New York",5072,66250,2005,1790,0,267,0,868,39.5,35.3,0,5.3,0,17.1,60.5,1780,1222,558,68.65,31.35,125,1097,0,558,125,1655,10.2,0,7,"50% - 75% P.O.C.","$55000 - $78000"
"36103122802","Census Tract 1228.02, Suffolk County, New York",4143,90625,2546,466,0,62,0,998,61.5,11.2,0,1.5,0,24.1,38.5,1372,1027,345,74.85,25.15,182,845,0,345,182,1190,17.7,0,13.3,"25% - 50% P.O.C.","$78000 - $104000"
"36103122901","Census Tract 1229.01, Suffolk County, New York",6316,109500,4405,38,17,383,0,1395,69.7,0.6,0.3,6.1,0,22.1,30.3,1748,1492,256,85.35,14.65,298,1194,15,241,313,1435,20,5.9,17.9,"25% - 50% P.O.C.","$104000 or more"
"36103122902","Census Tract 1229.02, Suffolk County, New York",4313,98718,3730,18,0,41,0,451,86.5,0.4,0,1,0,10.5,13.5,1534,1137,397,74.12,25.88,95,1042,10,387,105,1429,8.4,2.5,6.8,"Less than 25% P.O.C.","$78000 - $104000"
"36103123001","Census Tract 1230.01, Suffolk County, New York",5713,101184,3674,478,22,415,0,925,64.3,8.4,0.4,7.3,0,16.2,35.7,1692,1357,335,80.2,19.8,201,1156,93,242,294,1398,14.8,27.8,17.4,"25% - 50% P.O.C.","$78000 - $104000"
"36103123002","Census Tract 1230.02, Suffolk County, New York",4690,93145,2775,393,0,138,0,1196,59.2,8.4,0,2.9,0,25.5,40.8,1380,1148,232,83.19,16.81,297,851,22,210,319,1061,25.9,9.5,23.1,"25% - 50% P.O.C.","$78000 - $104000"
"36103123101","Census Tract 1231.01, Suffolk County, New York",3170,90109,2500,179,15,0,0,425,78.9,5.6,0.5,0,0,13.4,21.1,1160,1092,68,94.14,5.86,141,951,0,68,141,1019,12.9,0,12.2,"Less than 25% P.O.C.","$78000 - $104000"
"36103123102","Census Tract 1231.02, Suffolk County, New York",4129,93143,3063,187,13,75,0,664,74.2,4.5,0.3,1.8,0,16.1,25.8,1332,1182,150,88.74,11.26,154,1028,17,133,171,1161,13,11.3,12.8,"25% - 50% P.O.C.","$78000 - $104000"
"36103123201","Census Tract 1232.01, Suffolk County, New York",2252,58836,564,708,5,54,0,843,25,31.4,0.2,2.4,0,37.4,75,685,299,386,43.65,56.35,121,178,15,371,136,549,40.5,3.9,19.9,"75% or more P.O.C.","$55000 - $78000"
"36103123202","Census Tract 1232.02, Suffolk County, New York",8558,83618,624,4929,0,18,0,2818,7.3,57.6,0,0.2,0,32.9,92.7,2293,1462,831,63.76,36.24,454,1008,143,688,597,1696,31.1,17.2,26,"75% or more P.O.C.","$78000 - $104000"
"36103123301","Census Tract 1233.01, Suffolk County, New York",7687,80071,450,4028,93,81,0,2849,5.9,52.4,1.2,1.1,0,37.1,94.1,2115,1193,922,56.41,43.59,384,809,131,791,515,1600,32.2,14.2,24.3,"75% or more P.O.C.","$78000 - $104000"
"36103123302","Census Tract 1233.02, Suffolk County, New York",2025,51797,101,633,0,76,0,1192,5,31.3,0,3.8,0,58.9,95,469,283,186,60.34,39.66,108,175,41,145,149,320,38.2,22,31.8,"75% or more P.O.C.","Less than $55000"
"36103123401","Census Tract 1234.01, Suffolk County, New York",4258,88214,2493,503,0,28,0,1129,58.5,11.8,0,0.7,0,26.5,41.5,1292,909,383,70.36,29.64,149,760,27,356,176,1116,16.4,7,13.6,"25% - 50% P.O.C.","$78000 - $104000"
"36103123402","Census Tract 1234.02, Suffolk County, New York",6366,80375,4433,568,0,231,0,1038,69.6,8.9,0,3.6,0,16.3,30.4,2315,1708,607,73.78,26.22,248,1460,83,524,331,1984,14.5,13.7,14.3,"25% - 50% P.O.C.","$78000 - $104000"
"36103123500","Census Tract 1235, Suffolk County, New York",6278,83438,3764,1273,5,74,0,1127,60,20.3,0.1,1.2,0,18,40,2120,1152,968,54.34,45.66,149,1003,143,825,292,1828,12.9,14.8,13.8,"25% - 50% P.O.C.","$78000 - $104000"
"36103123600","Census Tract 1236, Suffolk County, New York",3277,131103,3013,59,0,11,0,184,91.9,1.8,0,0.3,0,5.6,8.1,1342,1197,145,89.2,10.8,79,1118,0,145,79,1263,6.6,0,5.9,"Less than 25% P.O.C.","$104000 or more"
"36103123701","Census Tract 1237.01, Suffolk County, New York",7272,73608,1377,1151,116,122,0,4348,18.9,15.8,1.6,1.7,0,59.8,81.1,1775,1203,572,67.77,32.23,413,790,112,460,525,1250,34.3,19.6,29.6,"75% or more P.O.C.","$55000 - $78000"
"36103123702","Census Tract 1237.02, Suffolk County, New York",8532,76892,4303,603,0,191,0,3000,50.4,7.1,0,2.2,0,35.2,49.6,2499,2056,443,82.27,17.73,478,1578,0,443,478,2021,23.2,0,19.1,"25% - 50% P.O.C.","$55000 - $78000"
"36103123801","Census Tract 1238.01, Suffolk County, New York",3931,95565,2931,75,32,124,0,722,74.6,1.9,0.8,3.2,0,18.4,25.4,1528,1292,236,84.55,15.45,80,1212,0,236,80,1448,6.2,0,5.2,"25% - 50% P.O.C.","$78000 - $104000"
"36103123802","Census Tract 1238.02, Suffolk County, New York",3826,85665,2622,0,66,63,0,1000,68.5,0,1.7,1.6,0,26.1,31.5,1266,1090,176,86.1,13.9,79,1011,56,120,135,1131,7.2,31.8,10.7,"25% - 50% P.O.C.","$78000 - $104000"
"36103123900","Census Tract 1239, Suffolk County, New York",5634,105298,3767,207,0,320,0,1110,66.9,3.7,0,5.7,0,19.7,33.1,1622,1339,283,82.55,17.45,233,1106,75,208,308,1314,17.4,26.5,19,"25% - 50% P.O.C.","$104000 or more"
"36103124001","Census Tract 1240.01, Suffolk County, New York",5051,109138,3817,165,0,44,0,1019,75.6,3.3,0,0.9,0,20.2,24.4,1450,1312,138,90.48,9.52,223,1089,35,103,258,1192,17,25.4,17.8,"Less than 25% P.O.C.","$104000 or more"
"36103124002","Census Tract 1240.02, Suffolk County, New York",3257,115875,2238,411,11,26,0,489,68.7,12.6,0.3,0.8,0,15,31.3,999,858,141,85.89,14.11,91,767,46,95,137,862,10.6,32.6,13.7,"25% - 50% P.O.C.","$104000 or more"
"36103124101","Census Tract 1241.01, Suffolk County, New York",4184,97880,3311,84,0,47,0,724,79.1,2,0,1.1,0,17.3,20.9,1359,1069,290,78.66,21.34,144,925,14,276,158,1201,13.5,4.8,11.6,"Less than 25% P.O.C.","$78000 - $104000"
"36103124102","Census Tract 1241.02, Suffolk County, New York",3496,89167,2759,43,0,37,0,608,78.9,1.2,0,1.1,0,17.4,21.1,1250,1026,224,82.08,17.92,75,951,41,183,116,1134,7.3,18.3,9.3,"Less than 25% P.O.C.","$78000 - $104000"
"36103124200","Census Tract 1242, Suffolk County, New York",5357,90479,4189,80,0,50,0,910,78.2,1.5,0,0.9,0,17,21.8,2103,1501,602,71.37,28.63,176,1325,14,588,190,1913,11.7,2.3,9,"Less than 25% P.O.C.","$78000 - $104000"
"36103124300","Census Tract 1243, Suffolk County, New York",6593,84481,4898,317,0,303,0,1045,74.3,4.8,0,4.6,0,15.9,25.7,2494,1575,919,63.15,36.85,218,1357,66,853,284,2210,13.8,7.2,11.4,"25% - 50% P.O.C.","$78000 - $104000"
"36103124401","Census Tract 1244.01, Suffolk County, New York",3474,85313,3133,59,0,27,0,242,90.2,1.7,0,0.8,0,7,9.8,1464,689,775,47.06,52.94,80,609,0,775,80,1384,11.6,0,5.5,"Less than 25% P.O.C.","$78000 - $104000"
"36103124402","Census Tract 1244.02, Suffolk County, New York",3629,122273,3185,0,0,41,0,403,87.8,0,0,1.1,0,11.1,12.2,1104,1038,66,94.02,5.98,53,985,19,47,72,1032,5.1,28.8,6.5,"Less than 25% P.O.C.","$104000 or more"
"36103124500","Census Tract 1245, Suffolk County, New York",5075,145570,4369,43,0,98,0,416,86.1,0.8,0,1.9,0,8.2,13.9,1767,1422,345,80.48,19.52,153,1269,13,332,166,1601,10.8,3.8,9.4,"Less than 25% P.O.C.","$104000 or more"
"36103124601","Census Tract 1246.01, Suffolk County, New York",2637,129960,2397,6,0,42,0,172,90.9,0.2,0,1.6,0,6.5,9.1,935,884,51,94.55,5.45,50,834,0,51,50,885,5.7,0,5.3,"Less than 25% P.O.C.","$104000 or more"
"36103124602","Census Tract 1246.02, Suffolk County, New York",4344,119940,3957,19,0,125,0,206,91.1,0.4,0,2.9,0,4.7,8.9,1693,1199,494,70.82,29.18,148,1051,13,481,161,1532,12.3,2.6,9.5,"Less than 25% P.O.C.","$104000 or more"
"36103134702","Census Tract 1347.02, Suffolk County, New York",5495,84385,4791,92,0,415,0,106,87.2,1.7,0,7.6,0,1.9,12.8,2270,1517,753,66.83,33.17,170,1347,30,723,200,2070,11.2,4,8.8,"Less than 25% P.O.C.","$78000 - $104000"
"36103134703","Census Tract 1347.03, Suffolk County, New York",3719,168393,3550,2,0,79,0,88,95.5,0.1,0,2.1,0,2.4,4.5,1273,1237,36,97.17,2.83,150,1087,21,15,171,1102,12.1,58.3,13.4,"Less than 25% P.O.C.","$104000 or more"
"36103134704","Census Tract 1347.04, Suffolk County, New York",2528,104375,2272,17,0,78,0,148,89.9,0.7,0,3.1,0,5.9,10.1,925,762,163,82.38,17.62,74,688,5,158,79,846,9.7,3.1,8.5,"Less than 25% P.O.C.","$104000 or more"
"36103134902","Census Tract 1349.02, Suffolk County, New York",4738,167500,4423,106,6,120,0,83,93.4,2.2,0.1,2.5,0,1.8,6.6,1550,1474,76,95.1,4.9,95,1379,0,76,95,1455,6.4,0,6.1,"Less than 25% P.O.C.","$104000 or more"
"36103134903","Census Tract 1349.03, Suffolk County, New York",1268,165761,1123,23,0,0,0,117,88.6,1.8,0,0,0,9.2,11.4,404,391,13,96.78,3.22,65,326,0,13,65,339,16.6,0,16.1,"Less than 25% P.O.C.","$104000 or more"
"36103134904","Census Tract 1349.04, Suffolk County, New York",6106,139258,5147,65,0,354,0,434,84.3,1.1,0,5.8,0,7.1,15.7,2181,1873,308,85.88,14.12,147,1726,17,291,164,2017,7.8,5.5,7.5,"Less than 25% P.O.C.","$104000 or more"
"36103134906","Census Tract 1349.06, Suffolk County, New York",5692,97443,5007,26,0,149,0,461,88,0.5,0,2.6,0,8.1,12,2242,1653,589,73.73,26.27,127,1526,0,589,127,2115,7.7,0,5.7,"Less than 25% P.O.C.","$78000 - $104000"
"36103134907","Census Tract 1349.07, Suffolk County, New York",4169,103646,3537,50,0,109,0,452,84.8,1.2,0,2.6,0,10.8,15.2,1503,1297,206,86.29,13.71,78,1219,0,206,78,1425,6,0,5.2,"Less than 25% P.O.C.","$78000 - $104000"
"36103135002","Census Tract 1350.02, Suffolk County, New York",5510,121154,4556,26,0,453,0,421,82.7,0.5,0,8.2,0,7.6,17.3,1824,1543,281,84.59,15.41,168,1375,68,213,236,1588,10.9,24.2,12.9,"Less than 25% P.O.C.","$104000 or more"
"36103135003","Census Tract 1350.03, Suffolk County, New York",4787,124447,4230,9,0,171,0,300,88.4,0.2,0,3.6,0,6.3,11.6,1617,1581,36,97.77,2.23,155,1426,15,21,170,1447,9.8,41.7,10.5,"Less than 25% P.O.C.","$104000 or more"
"36103135004","Census Tract 1350.04, Suffolk County, New York",3056,203750,2513,174,0,118,0,225,82.2,5.7,0,3.9,0,7.4,17.8,999,947,52,94.79,5.21,95,852,21,31,116,883,10,40.4,11.6,"Less than 25% P.O.C.","$104000 or more"
"36103135005","Census Tract 1350.05, Suffolk County, New York",3374,75667,2997,13,0,50,0,261,88.8,0.4,0,1.5,0,7.7,11.2,1286,1177,109,91.52,8.48,110,1067,8,101,118,1168,9.3,7.3,9.2,"Less than 25% P.O.C.","$55000 - $78000"
"36103135101","Census Tract 1351.01, Suffolk County, New York",4238,145069,3209,133,0,298,0,484,75.7,3.1,0,7,0,11.4,24.3,1293,1285,8,99.38,0.62,170,1115,0,8,170,1123,13.2,0,13.1,"Less than 25% P.O.C.","$104000 or more"
"36103135102","Census Tract 1351.02, Suffolk County, New York",4535,124442,3880,42,0,136,0,301,85.6,0.9,0,3,0,6.6,14.4,1503,1300,203,86.49,13.51,102,1198,32,171,134,1369,7.8,15.8,8.9,"Less than 25% P.O.C.","$104000 or more"
"36103135103","Census Tract 1351.03, Suffolk County, New York",5014,179028,4693,92,0,36,0,126,93.6,1.8,0,0.7,0,2.5,6.4,1598,1554,44,97.25,2.75,167,1387,12,32,179,1419,10.7,27.3,11.2,"Less than 25% P.O.C.","$104000 or more"
"36103135104","Census Tract 1351.04, Suffolk County, New York",5502,129899,5087,41,0,132,0,151,92.5,0.7,0,2.4,0,2.7,7.5,1681,1586,95,94.35,5.65,190,1396,10,85,200,1481,12,10.5,11.9,"Less than 25% P.O.C.","$104000 or more"
"36103135201","Census Tract 1352.01, Suffolk County, New York",2116,154286,1986,12,0,61,0,48,93.9,0.6,0,2.9,0,2.3,6.1,706,674,32,95.47,4.53,44,630,0,32,44,662,6.5,0,6.2,"Less than 25% P.O.C.","$104000 or more"
"36103135204","Census Tract 1352.04, Suffolk County, New York",4642,135357,4368,0,0,98,0,165,94.1,0,0,2.1,0,3.6,5.9,1456,1383,73,94.99,5.01,243,1140,0,73,243,1213,17.6,0,16.7,"Less than 25% P.O.C.","$104000 or more"
"36103135205","Census Tract 1352.05, Suffolk County, New York",5060,132569,4364,43,0,328,0,270,86.2,0.8,0,6.5,0,5.3,13.8,1699,1501,198,88.35,11.65,197,1304,6,192,203,1496,13.1,3,11.9,"Less than 25% P.O.C.","$104000 or more"
"36103135208","Census Tract 1352.08, Suffolk County, New York",3091,134010,2816,37,0,84,0,154,91.1,1.2,0,2.7,0,5,8.9,1053,1027,26,97.53,2.47,86,941,0,26,86,967,8.4,0,8.2,"Less than 25% P.O.C.","$104000 or more"
"36103135209","Census Tract 1352.09, Suffolk County, New York",3065,120566,2619,0,0,281,0,148,85.4,0,0,9.2,0,4.8,14.6,1172,990,182,84.47,15.53,37,953,0,182,37,1135,3.7,0,3.2,"Less than 25% P.O.C.","$104000 or more"
"36103135301","Census Tract 1353.01, Suffolk County, New York",3692,141174,3216,0,0,202,0,244,87.1,0,0,5.5,0,6.6,12.9,1231,1202,29,97.64,2.36,148,1054,0,29,148,1083,12.3,0,12,"Less than 25% P.O.C.","$104000 or more"
"36103135303","Census Tract 1353.03, Suffolk County, New York",4093,131495,3672,0,0,124,0,297,89.7,0,0,3,0,7.3,10.3,1471,1362,109,92.59,7.41,185,1177,7,102,192,1279,13.6,6.4,13.1,"Less than 25% P.O.C.","$104000 or more"
"36103135304","Census Tract 1353.04, Suffolk County, New York",3340,115781,3141,1,0,88,0,82,94,0,0,2.6,0,2.5,6,1235,1161,74,94.01,5.99,91,1070,0,74,91,1144,7.8,0,7.4,"Less than 25% P.O.C.","$104000 or more"
"36103135401","Census Tract 1354.01, Suffolk County, New York",6662,139661,5837,17,0,305,0,373,87.6,0.3,0,4.6,0,5.6,12.4,2253,1855,398,82.33,17.67,215,1640,0,398,215,2038,11.6,0,9.5,"Less than 25% P.O.C.","$104000 or more"
"36103135402","Census Tract 1354.02, Suffolk County, New York",6631,116178,5531,121,0,217,0,719,83.4,1.8,0,3.3,0,10.8,16.6,2253,2061,192,91.48,8.52,149,1912,0,192,149,2104,7.2,0,6.6,"Less than 25% P.O.C.","$104000 or more"
"36103135403","Census Tract 1354.03, Suffolk County, New York",4546,107500,3500,152,0,229,0,636,77,3.3,0,5,0,14,23,1508,1224,284,81.17,18.83,170,1054,42,242,212,1296,13.9,14.8,14.1,"Less than 25% P.O.C.","$104000 or more"
"36103145602","Census Tract 1456.02, Suffolk County, New York",6903,89548,635,727,0,99,100,5242,9.2,10.5,0,1.4,1.4,75.9,90.8,1503,1310,193,87.16,12.84,471,839,74,119,545,958,36,38.3,36.3,"75% or more P.O.C.","$78000 - $104000"
"36103145603","Census Tract 1456.03, Suffolk County, New York",6442,66563,918,871,0,78,0,4439,14.3,13.5,0,1.2,0,68.9,85.7,1435,908,527,63.28,36.72,363,545,78,449,441,994,40,14.8,30.7,"75% or more P.O.C.","$55000 - $78000"
"36103145604","Census Tract 1456.04, Suffolk County, New York",4645,74777,637,771,0,141,0,3037,13.7,16.6,0,3,0,65.4,86.3,1041,767,274,73.68,26.32,288,479,34,240,322,719,37.5,12.4,30.9,"75% or more P.O.C.","$55000 - $78000"
"36103145605","Census Tract 1456.05, Suffolk County, New York",4172,90385,645,410,0,193,0,2890,15.5,9.8,0,4.6,0,69.3,84.5,820,654,166,79.76,20.24,253,401,107,59,360,460,38.7,64.5,43.9,"75% or more P.O.C.","$78000 - $104000"
"36103145701","Census Tract 1457.01, Suffolk County, New York",4964,98870,3077,676,14,579,0,528,62,13.6,0.3,11.7,0,10.6,38,1694,940,754,55.49,44.51,54,886,123,631,177,1517,5.7,16.3,10.4,"25% - 50% P.O.C.","$78000 - $104000"
"36103145702","Census Tract 1457.02, Suffolk County, New York",7209,81601,1270,1036,0,31,0,4730,17.6,14.4,0,0.4,0,65.6,82.4,1423,1071,352,75.26,24.74,455,616,135,217,590,833,42.5,38.4,41.5,"75% or more P.O.C.","$78000 - $104000"
"36103145703","Census Tract 1457.03, Suffolk County, New York",4210,70560,1199,633,0,207,0,1940,28.5,15,0,4.9,0,46.1,71.5,1145,708,437,61.83,38.17,194,514,23,414,217,928,27.4,5.3,19,"50% - 75% P.O.C.","$55000 - $78000"
"36103145704","Census Tract 1457.04, Suffolk County, New York",6993,81327,1446,1511,0,583,0,3342,20.7,21.6,0,8.3,0,47.8,79.3,2094,1337,757,63.85,36.15,330,1007,91,666,421,1673,24.7,12,20.1,"75% or more P.O.C.","$78000 - $104000"
"36103145803","Census Tract 1458.03, Suffolk County, New York",4944,125764,3686,71,0,167,0,1009,74.6,1.4,0,3.4,0,20.4,25.4,1560,1382,178,88.59,11.41,135,1247,61,117,196,1364,9.8,34.3,12.6,"25% - 50% P.O.C.","$104000 or more"
"36103145804","Census Tract 1458.04, Suffolk County, New York",3341,93555,1589,292,9,358,0,1012,47.6,8.7,0.3,10.7,0,30.3,52.4,1019,927,92,90.97,9.03,152,775,7,85,159,860,16.4,7.6,15.6,"50% - 75% P.O.C.","$78000 - $104000"
"36103145805","Census Tract 1458.05, Suffolk County, New York",5703,102614,4218,237,0,264,0,640,74,4.2,0,4.6,0,11.2,26,1961,1577,384,80.42,19.58,134,1443,0,384,134,1827,8.5,0,6.8,"25% - 50% P.O.C.","$78000 - $104000"
"36103145807","Census Tract 1458.07, Suffolk County, New York",4192,115744,3181,187,0,189,0,568,75.9,4.5,0,4.5,0,13.5,24.1,1325,1235,90,93.21,6.79,152,1083,0,90,152,1173,12.3,0,11.5,"Less than 25% P.O.C.","$104000 or more"
"36103145808","Census Tract 1458.08, Suffolk County, New York",3001,97375,2197,18,0,335,0,385,73.2,0.6,0,11.2,0,12.8,26.8,936,786,150,83.97,16.03,133,653,11,139,144,792,16.9,7.3,15.4,"25% - 50% P.O.C.","$78000 - $104000"
"36103145901","Census Tract 1459.01, Suffolk County, New York",3158,90060,1318,475,0,75,0,1210,41.7,15,0,2.4,0,38.3,58.3,987,781,206,79.13,20.87,162,619,30,176,192,795,20.7,14.6,19.5,"50% - 75% P.O.C.","$78000 - $104000"
"36103145902","Census Tract 1459.02, Suffolk County, New York",10721,93705,1332,1286,190,0,0,6912,12.4,12,1.8,0,0,64.5,87.6,2041,1375,666,67.37,32.63,417,958,365,301,782,1259,30.3,54.8,38.3,"75% or more P.O.C.","$78000 - $104000"
"36103145903","Census Tract 1459.03, Suffolk County, New York",5411,87404,3213,361,8,67,0,1566,59.4,6.7,0.1,1.2,0,28.9,40.6,1719,1467,252,85.34,14.66,194,1273,55,197,249,1470,13.2,21.8,14.5,"25% - 50% P.O.C.","$78000 - $104000"
"36103146001","Census Tract 1460.01, Suffolk County, New York",6018,99755,985,485,0,221,0,4238,16.4,8.1,0,3.7,0,70.4,83.6,1136,924,212,81.34,18.66,345,579,163,49,508,628,37.3,76.9,44.7,"75% or more P.O.C.","$78000 - $104000"
"36103146002","Census Tract 1460.02, Suffolk County, New York",5924,77962,961,689,0,249,0,3987,16.2,11.6,0,4.2,0,67.3,83.8,1342,1153,189,85.92,14.08,401,752,120,69,521,821,34.8,63.5,38.8,"75% or more P.O.C.","$55000 - $78000"
"36103146003","Census Tract 1460.03, Suffolk County, New York",9998,83274,1974,2410,0,855,0,4586,19.7,24.1,0,8.6,0,45.9,80.3,2405,1619,786,67.32,32.68,571,1048,148,638,719,1686,35.3,18.8,29.9,"75% or more P.O.C.","$78000 - $104000"
"36103146102","Census Tract 1461.02, Suffolk County, New York",2848,98663,470,531,0,67,0,1729,16.5,18.6,0,2.4,0,60.7,83.5,638,533,105,83.54,16.46,181,352,28,77,209,429,34,26.7,32.8,"75% or more P.O.C.","$78000 - $104000"
"36103146103","Census Tract 1461.03, Suffolk County, New York",4435,120373,2757,260,0,129,0,1289,62.2,5.9,0,2.9,0,29.1,37.8,1185,1042,143,87.93,12.07,168,874,75,68,243,942,16.1,52.4,20.5,"25% - 50% P.O.C.","$104000 or more"
"36103146105","Census Tract 1461.05, Suffolk County, New York",6454,80208,1043,581,0,151,0,4679,16.2,9,0,2.3,0,72.5,83.8,1641,1050,591,63.99,36.01,397,653,84,507,481,1160,37.8,14.2,29.3,"75% or more P.O.C.","$78000 - $104000"
"36103146106","Census Tract 1461.06, Suffolk County, New York",5362,111719,743,895,0,121,0,3496,13.9,16.7,0,2.3,0,65.2,86.1,1005,748,257,74.43,25.57,427,321,67,190,494,511,57.1,26.1,49.2,"75% or more P.O.C.","$104000 or more"
"36103146201","Census Tract 1462.01, Suffolk County, New York",5623,76536,602,700,0,0,0,4154,10.7,12.4,0,0,0,73.9,89.3,1241,869,372,70.02,29.98,441,428,132,240,573,668,50.7,35.5,46.2,"75% or more P.O.C.","$55000 - $78000"
"36103146202","Census Tract 1462.02, Suffolk County, New York",4205,80909,363,1587,42,0,0,2122,8.6,37.7,1,0,0,50.5,91.4,1114,950,164,85.28,14.72,245,705,75,89,320,794,25.8,45.7,28.7,"75% or more P.O.C.","$78000 - $104000"
"36103146203","Census Tract 1462.03, Suffolk County, New York",4923,64417,1030,897,0,89,0,2842,20.9,18.2,0,1.8,0,57.7,79.1,1375,839,536,61.02,38.98,187,652,135,401,322,1053,22.3,25.2,23.4,"75% or more P.O.C.","$55000 - $78000"
"36103146204","Census Tract 1462.04, Suffolk County, New York",6720,83375,900,795,0,66,0,4959,13.4,11.8,0,1,0,73.8,86.6,1551,1331,220,85.82,14.18,515,816,109,111,624,927,38.7,49.5,40.2,"75% or more P.O.C.","$78000 - $104000"
"36103146205","Census Tract 1462.05, Suffolk County, New York",2363,103958,2077,74,0,33,0,107,87.9,3.1,0,1.4,0,4.5,12.1,669,659,10,98.51,1.49,95,564,6,4,101,568,14.4,60,15.1,"Less than 25% P.O.C.","$78000 - $104000"
"36103146206","Census Tract 1462.06, Suffolk County, New York",2141,106532,1394,253,0,14,0,406,65.1,11.8,0,0.7,0,19,34.9,670,635,35,94.78,5.22,93,542,11,24,104,566,14.6,31.4,15.5,"25% - 50% P.O.C.","$104000 or more"
"36103146300","Census Tract 1463, Suffolk County, New York",2241,66513,1169,561,1,113,0,307,52.2,25,0,5,0,13.7,47.8,1225,869,356,70.94,29.06,38,831,0,356,38,1187,4.4,0,3.1,"25% - 50% P.O.C.","$55000 - $78000"
"36103146402","Census Tract 1464.02, Suffolk County, New York",3883,90156,3123,139,1,131,0,425,80.4,3.6,0,3.4,0,10.9,19.6,1313,985,328,75.02,24.98,150,835,0,328,150,1163,15.2,0,11.4,"Less than 25% P.O.C.","$78000 - $104000"
"36103146403","Census Tract 1464.03, Suffolk County, New York",4927,61167,831,1367,0,111,0,2520,16.9,27.7,0,2.3,0,51.1,83.1,1252,854,398,68.21,31.79,247,607,151,247,398,854,28.9,37.9,31.8,"75% or more P.O.C.","$55000 - $78000"
"36103146404","Census Tract 1464.04, Suffolk County, New York",3706,82321,1119,815,0,33,0,1739,30.2,22,0,0.9,0,46.9,69.8,940,725,215,77.13,22.87,163,562,70,145,233,707,22.5,32.6,24.8,"50% - 75% P.O.C.","$78000 - $104000"
"36103146500","Census Tract 1465, Suffolk County, New York",5579,121010,4402,40,0,181,0,899,78.9,0.7,0,3.2,0,16.1,21.1,1616,1392,224,86.14,13.86,272,1120,33,191,305,1311,19.5,14.7,18.9,"Less than 25% P.O.C.","$104000 or more"
"36103146604","Census Tract 1466.04, Suffolk County, New York",4430,109355,2959,128,99,437,41,753,66.8,2.9,2.2,9.9,0.9,17,33.2,1508,932,576,61.8,38.2,167,765,0,576,167,1341,17.9,0,11.1,"25% - 50% P.O.C.","$104000 or more"
"36103146605","Census Tract 1466.05, Suffolk County, New York",983,107500,721,26,0,43,18,135,73.3,2.6,0,4.4,1.8,13.7,26.7,274,270,4,98.54,1.46,51,219,0,4,51,223,18.9,0,18.6,"25% - 50% P.O.C.","$104000 or more"
"36103146606","Census Tract 1466.06, Suffolk County, New York",6908,117368,6016,191,0,54,0,647,87.1,2.8,0,0.8,0,9.4,12.9,2336,2053,283,87.89,12.11,294,1759,2,281,296,2040,14.3,0.7,12.7,"Less than 25% P.O.C.","$104000 or more"
"36103146607","Census Tract 1466.07, Suffolk County, New York",2354,73542,1852,47,0,113,0,316,78.7,2,0,4.8,0,13.4,21.3,1059,579,480,54.67,45.33,27,552,0,480,27,1032,4.7,0,2.5,"Less than 25% P.O.C.","$55000 - $78000"
"36103146608","Census Tract 1466.08, Suffolk County, New York",2596,88488,1726,0,92,122,0,633,66.5,0,3.5,4.7,0,24.4,33.5,1026,491,535,47.86,52.14,46,445,27,508,73,953,9.4,5,7.1,"25% - 50% P.O.C.","$78000 - $104000"
"36103146611","Census Tract 1466.11, Suffolk County, New York",3233,94219,2345,436,0,69,0,307,72.5,13.5,0,2.1,0,9.5,27.5,1113,660,453,59.3,40.7,74,586,0,453,74,1039,11.2,0,6.6,"25% - 50% P.O.C.","$78000 - $104000"
"36103146612","Census Tract 1466.12, Suffolk County, New York",5204,126161,4230,155,65,89,0,613,81.3,3,1.2,1.7,0,11.8,18.7,1505,1435,70,95.35,4.65,227,1208,6,64,233,1272,15.8,8.6,15.5,"Less than 25% P.O.C.","$104000 or more"
"36103146613","Census Tract 1466.13, Suffolk County, New York",3961,117917,3064,310,0,151,0,341,77.4,7.8,0,3.8,0,8.6,22.6,1114,949,165,85.19,14.81,283,666,0,165,283,831,29.8,0,25.4,"Less than 25% P.O.C.","$104000 or more"
"36103146614","Census Tract 1466.14, Suffolk County, New York",4790,121515,4357,0,0,122,0,295,91,0,0,2.5,0,6.2,9,1810,1719,91,94.97,5.03,236,1483,0,91,236,1574,13.7,0,13,"Less than 25% P.O.C.","$104000 or more"
"36103146615","Census Tract 1466.15, Suffolk County, New York",4431,89583,3568,114,0,139,35,526,80.5,2.6,0,3.1,0.8,11.9,19.5,1822,973,849,53.4,46.6,122,851,0,849,122,1700,12.5,0,6.7,"Less than 25% P.O.C.","$78000 - $104000"
"36103146703","Census Tract 1467.03, Suffolk County, New York",4117,110972,2028,298,0,116,11,1597,49.3,7.2,0,2.8,0.3,38.8,50.7,1146,998,148,87.09,12.91,239,759,10,138,249,897,23.9,6.8,21.7,"50% - 75% P.O.C.","$104000 or more"
"36103146704","Census Tract 1467.04, Suffolk County, New York",2050,117386,1793,5,0,86,0,144,87.5,0.2,0,4.2,0,7,12.5,634,630,4,99.37,0.63,70,560,0,4,70,564,11.1,0,11,"Less than 25% P.O.C.","$104000 or more"
"36103146705","Census Tract 1467.05, Suffolk County, New York",2862,131250,2545,92,0,18,0,193,88.9,3.2,0,0.6,0,6.7,11.1,950,943,7,99.26,0.74,107,836,0,7,107,843,11.3,0,11.3,"Less than 25% P.O.C.","$104000 or more"
"36103146706","Census Tract 1467.06, Suffolk County, New York",2609,116042,2363,7,0,90,0,147,90.6,0.3,0,3.4,0,5.6,9.4,804,738,66,91.79,8.21,158,580,9,57,167,637,21.4,13.6,20.8,"Less than 25% P.O.C.","$104000 or more"
"36103146800","Census Tract 1468, Suffolk County, New York",6174,121563,5467,0,0,155,0,503,88.5,0,0,2.5,0,8.1,11.5,1830,1745,85,95.36,4.64,364,1381,0,85,364,1466,20.9,0,19.9,"Less than 25% P.O.C.","$104000 or more"
"36103146901","Census Tract 1469.01, Suffolk County, New York",5123,125976,4829,0,0,22,0,258,94.3,0,0,0.4,0,5,5.7,1658,1647,11,99.34,0.66,180,1467,0,11,180,1478,10.9,0,10.9,"Less than 25% P.O.C.","$104000 or more"
"36103146902","Census Tract 1469.02, Suffolk County, New York",3769,154663,3571,30,3,0,0,161,94.7,0.8,0.1,0,0,4.3,5.3,1173,1124,49,95.82,4.18,134,990,0,49,134,1039,11.9,0,11.4,"Less than 25% P.O.C.","$104000 or more"
"36103147001","Census Tract 1470.01, Suffolk County, New York",4257,126046,3806,0,0,67,0,328,89.4,0,0,1.6,0,7.7,10.6,1349,1279,70,94.81,5.19,105,1174,18,52,123,1226,8.2,25.7,9.1,"Less than 25% P.O.C.","$104000 or more"
"36103147003","Census Tract 1470.03, Suffolk County, New York",4801,131292,3909,27,0,152,0,628,81.4,0.6,0,3.2,0,13.1,18.6,1653,1583,70,95.77,4.23,200,1383,2,68,202,1451,12.6,2.9,12.2,"Less than 25% P.O.C.","$104000 or more"
"36103147004","Census Tract 1470.04, Suffolk County, New York",139,120625,138,0,1,0,0,0,99.3,0,0.7,0,0,0,0.7,59,51,8,86.44,13.56,2,49,0,8,2,57,3.9,0,3.4,"Less than 25% P.O.C.","$104000 or more"
"36103147100","Census Tract 1471, Suffolk County, New York",3075,127931,2694,57,0,9,0,216,87.6,1.9,0,0.3,0,7,12.4,1082,1024,58,94.64,5.36,119,905,0,58,119,963,11.6,0,11,"Less than 25% P.O.C.","$104000 or more"
"36103147200","Census Tract 1472, Suffolk County, New York",6172,76212,2627,1123,0,134,0,2152,42.6,18.2,0,2.2,0,34.9,57.4,2200,1055,1145,47.95,52.05,168,887,95,1050,263,1937,15.9,8.3,12,"50% - 75% P.O.C.","$55000 - $78000"
"36103147300","Census Tract 1473, Suffolk County, New York",8218,77227,2514,2134,0,153,0,3288,30.6,26,0,1.9,0,40,69.4,2591,1463,1128,56.46,43.54,294,1169,66,1062,360,2231,20.1,5.9,13.9,"50% - 75% P.O.C.","$55000 - $78000"
"36103147401","Census Tract 1474.01, Suffolk County, New York",5630,99123,4320,415,0,61,0,731,76.7,7.4,0,1.1,0,13,23.3,2281,1829,452,80.18,19.82,113,1716,0,452,113,2168,6.2,0,5,"Less than 25% P.O.C.","$78000 - $104000"
"36103147402","Census Tract 1474.02, Suffolk County, New York",3284,145278,2920,0,0,39,0,282,88.9,0,0,1.2,0,8.6,11.1,1116,1057,59,94.71,5.29,164,893,0,59,164,952,15.5,0,14.7,"Less than 25% P.O.C.","$104000 or more"
"36103147501","Census Tract 1475.01, Suffolk County, New York",6989,104414,5620,279,0,146,0,944,80.4,4,0,2.1,0,13.5,19.6,2403,1873,530,77.94,22.06,146,1727,54,476,200,2203,7.8,10.2,8.3,"Less than 25% P.O.C.","$104000 or more"
"36103147502","Census Tract 1475.02, Suffolk County, New York",6233,135110,5800,6,0,0,0,371,93.1,0.1,0,0,0,6,6.9,1937,1889,48,97.52,2.48,311,1578,24,24,335,1602,16.5,50,17.3,"Less than 25% P.O.C.","$104000 or more"
"36103147503","Census Tract 1475.03, Suffolk County, New York",1405,128523,1291,0,0,0,0,111,91.9,0,0,0,0,7.9,8.1,505,406,99,80.4,19.6,62,344,0,99,62,443,15.3,0,12.3,"Less than 25% P.O.C.","$104000 or more"
"36103147601","Census Tract 1476.01, Suffolk County, New York",2238,121818,1976,62,0,43,0,133,88.3,2.8,0,1.9,0,5.9,11.7,786,729,57,92.75,7.25,60,669,8,49,68,718,8.2,14,8.7,"Less than 25% P.O.C.","$104000 or more"
"36103147602","Census Tract 1476.02, Suffolk County, New York",4746,97847,4419,78,0,0,0,234,93.1,1.6,0,0,0,4.9,6.9,2043,1607,436,78.66,21.34,169,1438,0,436,169,1874,10.5,0,8.3,"Less than 25% P.O.C.","$78000 - $104000"
"36103147701","Census Tract 1477.01, Suffolk County, New York",3442,105727,2985,6,0,161,0,180,86.7,0.2,0,4.7,0,5.2,13.3,1104,822,282,74.46,25.54,78,744,0,282,78,1026,9.5,0,7.1,"Less than 25% P.O.C.","$104000 or more"
"36103147702","Census Tract 1477.02, Suffolk County, New York",5010,110250,4554,30,16,78,0,231,90.9,0.6,0.3,1.6,0,4.6,9.1,1670,1438,232,86.11,13.89,186,1252,0,232,186,1484,12.9,0,11.1,"Less than 25% P.O.C.","$104000 or more"
"36103147802","Census Tract 1478.02, Suffolk County, New York",3738,138493,3470,1,0,89,0,115,92.8,0,0,2.4,0,3.1,7.2,1281,1039,242,81.11,18.89,142,897,37,205,179,1102,13.7,15.3,14,"Less than 25% P.O.C.","$104000 or more"
"36103147803","Census Tract 1478.03, Suffolk County, New York",3126,81034,2969,22,0,6,0,83,95,0.7,0,0.2,0,2.7,5,1252,677,575,54.07,45.93,81,596,0,575,81,1171,12,0,6.5,"Less than 25% P.O.C.","$78000 - $104000"
"36103147804","Census Tract 1478.04, Suffolk County, New York",5604,150726,5069,105,0,109,0,272,90.5,1.9,0,1.9,0,4.9,9.5,1788,1609,179,89.99,10.01,178,1431,29,150,207,1581,11.1,16.2,11.6,"Less than 25% P.O.C.","$104000 or more"
"36103147901","Census Tract 1479.01, Suffolk County, New York",4299,82306,3521,172,0,97,0,473,81.9,4,0,2.3,0,11,18.1,1725,964,761,55.88,44.12,134,830,5,756,139,1586,13.9,0.7,8.1,"Less than 25% P.O.C.","$78000 - $104000"
"36103147902","Census Tract 1479.02, Suffolk County, New York",4103,153393,3746,3,40,25,0,188,91.3,0.1,1,0.6,0,4.6,8.7,1374,1338,36,97.38,2.62,120,1218,0,36,120,1254,9,0,8.7,"Less than 25% P.O.C.","$104000 or more"
"36103158001","Census Tract 1580.01, Suffolk County, New York",4020,170804,3441,27,0,249,0,148,85.6,0.7,0,6.2,0,3.7,14.4,1496,1300,196,86.9,13.1,107,1193,12,184,119,1377,8.2,6.1,8,"Less than 25% P.O.C.","$104000 or more"
"36103158002","Census Tract 1580.02, Suffolk County, New York",5732,160357,4864,12,0,388,0,385,84.9,0.2,0,6.8,0,6.7,15.1,2120,1835,285,86.56,13.44,116,1719,33,252,149,1971,6.3,11.6,7,"Less than 25% P.O.C.","$104000 or more"
"36103158006","Census Tract 1580.06, Suffolk County, New York",5886,107019,4629,191,0,681,10,291,78.6,3.2,0,11.6,0.2,4.9,21.4,2196,2108,88,95.99,4.01,139,1969,30,58,169,2027,6.6,34.1,7.7,"Less than 25% P.O.C.","$104000 or more"
"36103158007","Census Tract 1580.07, Suffolk County, New York",8943,206250,2677,810,13,4143,0,792,29.9,9.1,0.1,46.3,0,8.9,70.1,16,16,0,100,0,0,16,0,0,0,16,0,NA,0,"50% - 75% P.O.C.","$104000 or more"
"36103158009","Census Tract 1580.09, Suffolk County, New York",2423,151406,2073,31,0,217,0,102,85.6,1.3,0,9,0,4.2,14.4,804,748,56,93.03,6.97,114,634,16,40,130,674,15.2,28.6,16.2,"Less than 25% P.O.C.","$104000 or more"
"36103158010","Census Tract 1580.10, Suffolk County, New York",3231,175417,2731,86,0,196,0,186,84.5,2.7,0,6.1,0,5.8,15.5,1071,1046,25,97.67,2.33,122,924,0,25,122,949,11.7,0,11.4,"Less than 25% P.O.C.","$104000 or more"
"36103158011","Census Tract 1580.11, Suffolk County, New York",4574,120491,3535,9,0,500,0,456,77.3,0.2,0,10.9,0,10,22.7,1677,1554,123,92.67,7.33,182,1372,0,123,182,1495,11.7,0,10.9,"Less than 25% P.O.C.","$104000 or more"
"36103158102","Census Tract 1581.02, Suffolk County, New York",4431,90670,3044,128,11,199,0,944,68.7,2.9,0.2,4.5,0,21.3,31.3,1576,1228,348,77.92,22.08,171,1057,18,330,189,1387,13.9,5.2,12,"25% - 50% P.O.C.","$78000 - $104000"
"36103158103","Census Tract 1581.03, Suffolk County, New York",4577,104297,2739,383,0,159,0,1150,59.8,8.4,0,3.5,0,25.1,40.2,1280,1029,251,80.39,19.61,105,924,111,140,216,1064,10.2,44.2,16.9,"25% - 50% P.O.C.","$104000 or more"
"36103158104","Census Tract 1581.04, Suffolk County, New York",5250,108320,4129,186,0,129,0,696,78.6,3.5,0,2.5,0,13.3,21.4,1683,1564,119,92.93,7.07,164,1400,37,82,201,1482,10.5,31.1,11.9,"Less than 25% P.O.C.","$104000 or more"
"36103158107","Census Tract 1581.07, Suffolk County, New York",4073,111917,3279,98,0,322,0,233,80.5,2.4,0,7.9,0,5.7,19.5,1444,1247,197,86.36,13.64,104,1143,8,189,112,1332,8.3,4.1,7.8,"Less than 25% P.O.C.","$104000 or more"
"36103158108","Census Tract 1581.08, Suffolk County, New York",2705,125733,1684,36,0,655,0,276,62.3,1.3,0,24.2,0,10.2,37.7,859,651,208,75.79,24.21,113,538,0,208,113,746,17.4,0,13.2,"25% - 50% P.O.C.","$104000 or more"
"36103158110","Census Tract 1581.10, Suffolk County, New York",3379,113125,2647,111,0,41,0,550,78.3,3.3,0,1.2,0,16.3,21.7,1016,976,40,96.06,3.94,183,793,9,31,192,824,18.8,22.5,18.9,"Less than 25% P.O.C.","$104000 or more"
"36103158111","Census Tract 1581.11, Suffolk County, New York",3205,116071,2323,226,0,184,0,414,72.5,7.1,0,5.7,0,12.9,27.5,942,864,78,91.72,8.28,155,709,34,44,189,753,17.9,43.6,20.1,"25% - 50% P.O.C.","$104000 or more"
"36103158112","Census Tract 1581.12, Suffolk County, New York",4479,95000,3179,271,5,313,0,649,71,6.1,0.1,7,0,14.5,29,1286,1080,206,83.98,16.02,194,886,0,206,194,1092,18,0,15.1,"25% - 50% P.O.C.","$78000 - $104000"
"36103158114","Census Tract 1581.14, Suffolk County, New York",3868,108654,3229,2,0,176,0,446,83.5,0.1,0,4.6,0,11.5,16.5,1254,941,313,75.04,24.96,166,775,16,297,182,1072,17.6,5.1,14.5,"Less than 25% P.O.C.","$104000 or more"
"36103158115","Census Tract 1581.15, Suffolk County, New York",6765,107899,5126,460,0,315,0,680,75.8,6.8,0,4.7,0,10.1,24.2,2219,1699,520,76.57,23.43,274,1425,57,463,331,1888,16.1,11,14.9,"Less than 25% P.O.C.","$104000 or more"
"36103158116","Census Tract 1581.16, Suffolk County, New York",2033,77540,1560,199,0,79,0,195,76.7,9.8,0,3.9,0,9.6,23.3,709,679,30,95.77,4.23,134,545,1,29,135,574,19.7,3.3,19,"Less than 25% P.O.C.","$55000 - $78000"
"36103158202","Census Tract 1582.02, Suffolk County, New York",7397,93542,5564,148,0,351,0,1190,75.2,2,0,4.7,0,16.1,24.8,2664,1925,739,72.26,27.74,165,1760,7,732,172,2492,8.6,0.9,6.5,"Less than 25% P.O.C.","$78000 - $104000"
"36103158203","Census Tract 1582.03, Suffolk County, New York",1561,153403,1193,38,0,155,0,160,76.4,2.4,0,9.9,0,10.2,23.6,497,440,57,88.53,11.47,69,371,10,47,79,418,15.7,17.5,15.9,"Less than 25% P.O.C.","$104000 or more"
"36103158205","Census Tract 1582.05, Suffolk County, New York",1769,133958,1564,7,0,33,0,157,88.4,0.4,0,1.9,0,8.9,11.6,615,559,56,90.89,9.11,60,499,0,56,60,555,10.7,0,9.8,"Less than 25% P.O.C.","$104000 or more"
"36103158206","Census Tract 1582.06, Suffolk County, New York",4088,106838,3272,112,0,303,0,345,80,2.7,0,7.4,0,8.4,20,1485,933,552,62.83,37.17,107,826,50,502,157,1328,11.5,9.1,10.6,"Less than 25% P.O.C.","$104000 or more"
"36103158207","Census Tract 1582.07, Suffolk County, New York",4548,125855,3788,62,0,376,0,206,83.3,1.4,0,8.3,0,4.5,16.7,1775,1368,407,77.07,22.93,162,1206,0,407,162,1613,11.8,0,9.1,"Less than 25% P.O.C.","$104000 or more"
"36103158304","Census Tract 1583.04, Suffolk County, New York",6793,136894,5918,27,0,20,0,778,87.1,0.4,0,0.3,0,11.5,12.9,2193,2080,113,94.85,5.15,294,1786,13,100,307,1886,14.1,11.5,14,"Less than 25% P.O.C.","$104000 or more"
"36103158306","Census Tract 1583.06, Suffolk County, New York",5957,126208,5133,70,0,46,0,696,86.2,1.2,0,0.8,0,11.7,13.8,2137,2089,48,97.75,2.25,147,1942,0,48,147,1990,7,0,6.9,"Less than 25% P.O.C.","$104000 or more"
"36103158308","Census Tract 1583.08, Suffolk County, New York",8896,110717,4963,405,0,206,0,3258,55.8,4.6,0,2.3,0,36.6,44.2,2542,1922,620,75.61,24.39,457,1465,135,485,592,1950,23.8,21.8,23.3,"25% - 50% P.O.C.","$104000 or more"
"36103158309","Census Tract 1583.09, Suffolk County, New York",4746,89306,2878,470,0,206,0,955,60.6,9.9,0,4.3,0,20.1,39.4,1621,985,636,60.76,39.24,182,803,17,619,199,1422,18.5,2.7,12.3,"25% - 50% P.O.C.","$78000 - $104000"
"36103158310","Census Tract 1583.10, Suffolk County, New York",4413,75294,3638,155,6,7,0,554,82.4,3.5,0.1,0.2,0,12.6,17.6,1716,1340,376,78.09,21.91,125,1215,43,333,168,1548,9.3,11.4,9.8,"Less than 25% P.O.C.","$55000 - $78000"
"36103158315","Census Tract 1583.15, Suffolk County, New York",4460,109808,2702,903,0,122,0,702,60.6,20.2,0,2.7,0,15.7,39.4,1590,1533,57,96.42,3.58,221,1312,0,57,221,1369,14.4,0,13.9,"25% - 50% P.O.C.","$104000 or more"
"36103158317","Census Tract 1583.17, Suffolk County, New York",6193,106094,5455,0,231,109,0,398,88.1,0,3.7,1.8,0,6.4,11.9,2091,1870,221,89.43,10.57,275,1595,26,195,301,1790,14.7,11.8,14.4,"Less than 25% P.O.C.","$104000 or more"
"36103158318","Census Tract 1583.18, Suffolk County, New York",4316,111397,3773,30,0,35,0,428,87.4,0.7,0,0.8,0,9.9,12.6,1511,1391,120,92.06,7.94,67,1324,0,120,67,1444,4.8,0,4.4,"Less than 25% P.O.C.","$104000 or more"
"36103158319","Census Tract 1583.19, Suffolk County, New York",3684,110428,2469,256,0,316,0,620,67,6.9,0,8.6,0,16.8,33,1169,1100,69,94.1,5.9,161,939,21,48,182,987,14.6,30.4,15.6,"25% - 50% P.O.C.","$104000 or more"
"36103158320","Census Tract 1583.20, Suffolk County, New York",6802,101622,5418,459,0,67,0,822,79.7,6.7,0,1,0,12.1,20.3,2412,2043,369,84.7,15.3,426,1617,0,369,426,1986,20.9,0,17.7,"Less than 25% P.O.C.","$78000 - $104000"
"36103158321","Census Tract 1583.21, Suffolk County, New York",10224,81813,6848,1083,0,834,0,1263,67,10.6,0,8.2,0,12.4,33,3637,1490,2147,40.97,59.03,320,1170,155,1992,475,3162,21.5,7.2,13.1,"25% - 50% P.O.C.","$78000 - $104000"
"36103158322","Census Tract 1583.22, Suffolk County, New York",1856,136042,1557,18,0,199,0,72,83.9,1,0,10.7,0,3.9,16.1,765,728,37,95.16,4.84,57,671,0,37,57,708,7.8,0,7.5,"Less than 25% P.O.C.","$104000 or more"
"36103158323","Census Tract 1583.23, Suffolk County, New York",6742,126979,5918,4,0,101,0,660,87.8,0.1,0,1.5,0,9.8,12.2,2112,1916,196,90.72,9.28,327,1589,0,196,327,1785,17.1,0,15.5,"Less than 25% P.O.C.","$104000 or more"
"36103158401","Census Tract 1584.01, Suffolk County, New York",1286,106518,1105,38,0,11,0,117,85.9,3,0,0.9,0,9.1,14.1,443,380,63,85.78,14.22,44,336,12,51,56,387,11.6,19,12.6,"Less than 25% P.O.C.","$104000 or more"
"36103158402","Census Tract 1584.02, Suffolk County, New York",4342,132750,3746,60,0,23,0,450,86.3,1.4,0,0.5,0,10.4,13.7,1351,1275,76,94.37,5.63,211,1064,8,68,219,1132,16.5,10.5,16.2,"Less than 25% P.O.C.","$104000 or more"
"36103158403","Census Tract 1584.03, Suffolk County, New York",2286,106250,1633,340,0,83,0,223,71.4,14.9,0,3.6,0,9.8,28.6,886,665,221,75.06,24.94,115,550,30,191,145,741,17.3,13.6,16.4,"25% - 50% P.O.C.","$104000 or more"
"36103158405","Census Tract 1584.05, Suffolk County, New York",5308,108103,4385,192,0,256,0,361,82.6,3.6,0,4.8,0,6.8,17.4,1686,1535,151,91.04,8.96,296,1239,25,126,321,1365,19.3,16.6,19,"Less than 25% P.O.C.","$104000 or more"
"36103158407","Census Tract 1584.07, Suffolk County, New York",5750,96990,4839,46,0,35,0,476,84.2,0.8,0,0.6,0,8.3,15.8,1919,1615,304,84.16,15.84,198,1417,0,304,198,1721,12.3,0,10.3,"Less than 25% P.O.C.","$78000 - $104000"
"36103158408","Census Tract 1584.08, Suffolk County, New York",3797,91659,3299,77,0,18,0,255,86.9,2,0,0.5,0,6.7,13.1,1433,1187,246,82.83,17.17,99,1088,0,246,99,1334,8.3,0,6.9,"Less than 25% P.O.C.","$78000 - $104000"
"36103158409","Census Tract 1584.09, Suffolk County, New York",3633,62740,2746,105,0,413,0,369,75.6,2.9,0,11.4,0,10.2,24.4,1566,1285,281,82.06,17.94,55,1230,31,250,86,1480,4.3,11,5.5,"Less than 25% P.O.C.","$55000 - $78000"
"36103158410","Census Tract 1584.10, Suffolk County, New York",3000,44781,2810,86,0,0,0,104,93.7,2.9,0,0,0,3.5,6.3,1884,1716,168,91.08,8.92,27,1689,0,168,27,1857,1.6,0,1.4,"Less than 25% P.O.C.","Less than $55000"
"36103158502","Census Tract 1585.02, Suffolk County, New York",3708,61816,2748,69,0,87,0,714,74.1,1.9,0,2.3,0,19.3,25.9,1577,651,926,41.28,58.72,115,536,23,903,138,1439,17.7,2.5,8.8,"25% - 50% P.O.C.","$55000 - $78000"
"36103158505","Census Tract 1585.05, Suffolk County, New York",4432,114032,3482,67,0,266,0,461,78.6,1.5,0,6,0,10.4,21.4,1454,1151,303,79.16,20.84,182,969,17,286,199,1255,15.8,5.6,13.7,"Less than 25% P.O.C.","$104000 or more"
"36103158506","Census Tract 1585.06, Suffolk County, New York",2595,119545,2191,5,0,87,0,301,84.4,0.2,0,3.4,0,11.6,15.6,898,837,61,93.21,6.79,85,752,0,61,85,813,10.2,0,9.5,"Less than 25% P.O.C.","$104000 or more"
"36103158507","Census Tract 1585.07, Suffolk County, New York",4203,109167,3053,80,0,328,0,540,72.6,1.9,0,7.8,0,12.8,27.4,1142,1002,140,87.74,12.26,260,742,0,140,260,882,25.9,0,22.8,"25% - 50% P.O.C.","$104000 or more"
"36103158508","Census Tract 1585.08, Suffolk County, New York",6364,134276,4837,307,0,307,0,742,76,4.8,0,4.8,0,11.7,24,1815,1722,93,94.88,5.12,346,1376,0,93,346,1469,20.1,0,19.1,"Less than 25% P.O.C.","$104000 or more"
"36103158509","Census Tract 1585.09, Suffolk County, New York",4959,83237,3460,179,0,411,0,824,69.8,3.6,0,8.3,0,16.6,30.2,1619,1098,521,67.82,32.18,191,907,62,459,253,1366,17.4,11.9,15.6,"25% - 50% P.O.C.","$78000 - $104000"
"36103158510","Census Tract 1585.10, Suffolk County, New York",7218,103816,5116,190,0,261,0,1317,70.9,2.6,0,3.6,0,18.2,29.1,2217,1974,243,89.04,10.96,283,1691,3,240,286,1931,14.3,1.2,12.9,"25% - 50% P.O.C.","$78000 - $104000"
"36103158511","Census Tract 1585.11, Suffolk County, New York",6554,106135,4647,58,0,244,0,1601,70.9,0.9,0,3.7,0,24.4,29.1,1961,1648,313,84.04,15.96,264,1384,36,277,300,1661,16,11.5,15.3,"25% - 50% P.O.C.","$104000 or more"
"36103158512","Census Tract 1585.12, Suffolk County, New York",3666,129091,3265,36,0,155,0,210,89.1,1,0,4.2,0,5.7,10.9,1090,986,104,90.46,9.54,190,796,22,82,212,878,19.3,21.2,19.4,"Less than 25% P.O.C.","$104000 or more"
"36103158604","Census Tract 1586.04, Suffolk County, New York",4842,101944,3605,177,0,209,0,728,74.5,3.7,0,4.3,0,15,25.5,1522,1420,102,93.3,6.7,168,1252,35,67,203,1319,11.8,34.3,13.3,"25% - 50% P.O.C.","$78000 - $104000"
"36103158605","Census Tract 1586.05, Suffolk County, New York",5046,120833,4011,161,0,250,0,443,79.5,3.2,0,5,0,8.8,20.5,1484,1324,160,89.22,10.78,187,1137,7,153,194,1290,14.1,4.4,13.1,"Less than 25% P.O.C.","$104000 or more"
"36103158606","Census Tract 1586.06, Suffolk County, New York",4912,110029,3889,57,0,225,0,541,79.2,1.2,0,4.6,0,11,20.8,1531,1323,208,86.41,13.59,223,1100,0,208,223,1308,16.9,0,14.6,"Less than 25% P.O.C.","$104000 or more"
"36103158607","Census Tract 1586.07, Suffolk County, New York",3139,95313,2246,110,0,106,0,677,71.6,3.5,0,3.4,0,21.6,28.4,1200,925,275,77.08,22.92,80,845,0,275,80,1120,8.6,0,6.7,"25% - 50% P.O.C.","$78000 - $104000"
"36103158608","Census Tract 1586.08, Suffolk County, New York",4123,95755,2344,427,0,442,0,783,56.9,10.4,0,10.7,0,19,43.1,1159,889,270,76.7,23.3,186,703,57,213,243,916,20.9,21.1,21,"25% - 50% P.O.C.","$78000 - $104000"
"36103158609","Census Tract 1586.09, Suffolk County, New York",4624,103750,3555,221,21,277,0,429,76.9,4.8,0.5,6,0,9.3,23.1,1392,1244,148,89.37,10.63,195,1049,32,116,227,1165,15.7,21.6,16.3,"Less than 25% P.O.C.","$78000 - $104000"
"36103158704","Census Tract 1587.04, Suffolk County, New York",8362,65330,4091,1196,0,146,48,2727,48.9,14.3,0,1.7,0.6,32.6,51.1,3660,2345,1315,64.07,35.93,183,2162,111,1204,294,3366,7.8,8.4,8,"50% - 75% P.O.C.","$55000 - $78000"
"36103158705","Census Tract 1587.05, Suffolk County, New York",3596,92548,805,1782,0,24,0,898,22.4,49.6,0,0.7,0,25,77.6,1053,731,322,69.42,30.58,136,595,30,292,166,887,18.6,9.3,15.8,"75% or more P.O.C.","$78000 - $104000"
"36103158707","Census Tract 1587.07, Suffolk County, New York",1836,99784,1309,172,0,0,0,331,71.3,9.4,0,0,0,18,28.7,593,510,83,86,14,56,454,0,83,56,537,11,0,9.4,"25% - 50% P.O.C.","$78000 - $104000"
"36103158708","Census Tract 1587.08, Suffolk County, New York",3529,72348,2143,701,0,123,0,521,60.7,19.9,0,3.5,0,14.8,39.3,1521,1031,490,67.78,32.22,50,981,29,461,79,1442,4.8,5.9,5.2,"25% - 50% P.O.C.","$55000 - $78000"
"36103158709","Census Tract 1587.09, Suffolk County, New York",2717,103529,2369,71,5,42,0,230,87.2,2.6,0.2,1.5,0,8.5,12.8,1138,853,285,74.96,25.04,38,815,16,269,54,1084,4.5,5.6,4.7,"Less than 25% P.O.C.","$78000 - $104000"
"36103158710","Census Tract 1587.10, Suffolk County, New York",3859,104714,2539,680,68,51,0,412,65.8,17.6,1.8,1.3,0,10.7,34.2,1204,953,251,79.15,20.85,57,896,50,201,107,1097,6,19.9,8.9,"25% - 50% P.O.C.","$104000 or more"
"36103158711","Census Tract 1587.11, Suffolk County, New York",5410,80417,4305,652,0,133,0,320,79.6,12.1,0,2.5,0,5.9,20.4,2315,1737,578,75.03,24.97,90,1647,18,560,108,2207,5.2,3.1,4.7,"Less than 25% P.O.C.","$78000 - $104000"
"36103158712","Census Tract 1587.12, Suffolk County, New York",7844,87938,4542,629,0,177,0,2483,57.9,8,0,2.3,0,31.7,42.1,2293,1995,298,87,13,393,1602,77,221,470,1823,19.7,25.8,20.5,"25% - 50% P.O.C.","$78000 - $104000"
"36103158802","Census Tract 1588.02, Suffolk County, New York",4942,119837,4411,16,0,10,0,492,89.3,0.3,0,0.2,0,10,10.7,1766,1517,249,85.9,14.1,151,1366,0,249,151,1615,10,0,8.6,"Less than 25% P.O.C.","$104000 or more"
"36103158803","Census Tract 1588.03, Suffolk County, New York",6360,104911,4797,133,0,401,0,993,75.4,2.1,0,6.3,0,15.6,24.6,2143,1864,279,86.98,13.02,353,1511,0,279,353,1790,18.9,0,16.5,"Less than 25% P.O.C.","$104000 or more"
"36103158804","Census Tract 1588.04, Suffolk County, New York",7657,104254,5314,22,0,217,0,2037,69.4,0.3,0,2.8,0,26.6,30.6,2372,2095,277,88.32,11.68,288,1807,62,215,350,2022,13.7,22.4,14.8,"25% - 50% P.O.C.","$104000 or more"
"36103158900","Census Tract 1589, Suffolk County, New York",7797,75213,4330,342,65,478,0,2500,55.5,4.4,0.8,6.1,0,32.1,44.5,3421,1561,1860,45.63,54.37,79,1482,109,1751,188,3233,5.1,5.9,5.5,"25% - 50% P.O.C.","$55000 - $78000"
"36103159000","Census Tract 1590, Suffolk County, New York",4587,66016,3085,121,25,43,0,1279,67.3,2.6,0.5,0.9,0,27.9,32.7,2085,1245,840,59.71,40.29,124,1121,0,840,124,1961,10,0,5.9,"25% - 50% P.O.C.","$55000 - $78000"
"36103159102","Census Tract 1591.02, Suffolk County, New York",6330,61976,4134,477,0,194,0,1503,65.3,7.5,0,3.1,0,23.7,34.7,2627,1244,1383,47.35,52.65,147,1097,27,1356,174,2453,11.8,2,6.6,"25% - 50% P.O.C.","$55000 - $78000"
"36103159103","Census Tract 1591.03, Suffolk County, New York",5820,53005,1360,1599,13,0,0,2675,23.4,27.5,0.2,0,0,46,76.6,1623,1043,580,64.26,35.74,161,882,58,522,219,1404,15.4,10,13.5,"75% or more P.O.C.","Less than $55000"
"36103159105","Census Tract 1591.05, Suffolk County, New York",7487,86411,5010,420,0,186,0,1827,66.9,5.6,0,2.5,0,24.4,33.1,2491,1403,1088,56.32,43.68,354,1049,31,1057,385,2106,25.2,2.8,15.5,"25% - 50% P.O.C.","$78000 - $104000"
"36103159106","Census Tract 1591.06, Suffolk County, New York",6597,91284,3798,1021,18,267,0,1440,57.6,15.5,0.3,4,0,21.8,42.4,1914,1115,799,58.25,41.75,161,954,94,705,255,1659,14.4,11.8,13.3,"25% - 50% P.O.C.","$78000 - $104000"
"36103159107","Census Tract 1591.07, Suffolk County, New York",3658,101101,2798,131,0,72,0,593,76.5,3.6,0,2,0,16.2,23.5,1167,1042,125,89.29,10.71,135,907,0,125,135,1032,13,0,11.6,"Less than 25% P.O.C.","$78000 - $104000"
"36103159108","Census Tract 1591.08, Suffolk County, New York",7494,113708,4692,764,0,51,0,1810,62.6,10.2,0,0.7,0,24.2,37.4,2301,2096,205,91.09,8.91,399,1697,17,188,416,1885,19,8.3,18.1,"25% - 50% P.O.C.","$104000 or more"
"36103159201","Census Tract 1592.01, Suffolk County, New York",2769,101250,2180,1,0,32,0,556,78.7,0,0,1.2,0,20.1,21.3,962,867,95,90.12,9.88,87,780,0,95,87,875,10,0,9,"Less than 25% P.O.C.","$78000 - $104000"
"36103159203","Census Tract 1592.03, Suffolk County, New York",5586,116387,5105,0,0,0,0,428,91.4,0,0,0,0,7.7,8.6,2055,1834,221,89.25,10.75,190,1644,0,221,190,1865,10.4,0,9.2,"Less than 25% P.O.C.","$104000 or more"
"36103159204","Census Tract 1592.04, Suffolk County, New York",4251,79128,2950,260,0,8,5,991,69.4,6.1,0,0.2,0.1,23.3,30.6,1474,1139,335,77.27,22.73,130,1009,32,303,162,1312,11.4,9.6,11,"25% - 50% P.O.C.","$78000 - $104000"
"36103159300","Census Tract 1593, Suffolk County, New York",2041,122708,1887,20,0,43,0,39,92.5,1,0,2.1,0,1.9,7.5,857,740,117,86.35,13.65,70,670,0,117,70,787,9.5,0,8.2,"Less than 25% P.O.C.","$104000 or more"
"36103159404","Census Tract 1594.04, Suffolk County, New York",6893,76424,4358,734,24,216,0,1392,63.2,10.6,0.3,3.1,0,20.2,36.8,2419,1492,927,61.68,38.32,165,1327,25,902,190,2229,11.1,2.7,7.9,"25% - 50% P.O.C.","$55000 - $78000"
"36103159406","Census Tract 1594.06, Suffolk County, New York",4885,83558,3498,324,0,18,0,901,71.6,6.6,0,0.4,0,18.4,28.4,1643,1021,622,62.14,37.86,212,809,33,589,245,1398,20.8,5.3,14.9,"25% - 50% P.O.C.","$78000 - $104000"
"36103159407","Census Tract 1594.07, Suffolk County, New York",6744,94698,4813,600,0,109,0,1091,71.4,8.9,0,1.6,0,16.2,28.6,1928,1670,258,86.62,13.38,301,1369,41,217,342,1586,18,15.9,17.7,"25% - 50% P.O.C.","$78000 - $104000"
"36103159408","Census Tract 1594.08, Suffolk County, New York",5024,102933,2893,412,44,169,0,1399,57.6,8.2,0.9,3.4,0,27.8,42.4,1288,1114,174,86.49,13.51,269,845,58,116,327,961,24.1,33.3,25.4,"25% - 50% P.O.C.","$78000 - $104000"
"36103159410","Census Tract 1594.10, Suffolk County, New York",7509,108420,5946,303,0,89,0,945,79.2,4,0,1.2,0,12.6,20.8,2409,2124,285,88.17,11.83,408,1716,15,270,423,1986,19.2,5.3,17.6,"Less than 25% P.O.C.","$104000 or more"
"36103159411","Census Tract 1594.11, Suffolk County, New York",3434,102098,2827,120,0,0,0,469,82.3,3.5,0,0,0,13.7,17.7,955,865,90,90.58,9.42,183,682,29,61,212,743,21.2,32.2,22.2,"Less than 25% P.O.C.","$78000 - $104000"
"36103159412","Census Tract 1594.12, Suffolk County, New York",7523,77725,5900,439,0,97,0,907,78.4,5.8,0,1.3,0,12.1,21.6,3025,2071,954,68.46,31.54,235,1836,0,954,235,2790,11.3,0,7.8,"Less than 25% P.O.C.","$55000 - $78000"
"36103159505","Census Tract 1595.05, Suffolk County, New York",7671,85617,5669,360,0,50,0,1592,73.9,4.7,0,0.7,0,20.8,26.1,2401,2020,381,84.13,15.87,187,1833,101,280,288,2113,9.3,26.5,12,"25% - 50% P.O.C.","$78000 - $104000"
"36103159506","Census Tract 1595.06, Suffolk County, New York",9144,80417,5796,595,0,762,0,1933,63.4,6.5,0,8.3,0,21.1,36.6,2686,2032,654,75.65,24.35,376,1656,164,490,540,2146,18.5,25.1,20.1,"25% - 50% P.O.C.","$78000 - $104000"
"36103159508","Census Tract 1595.08, Suffolk County, New York",6880,69000,5402,398,57,118,0,700,78.5,5.8,0.8,1.7,0,10.2,21.5,2450,1741,709,71.06,28.94,135,1606,77,632,212,2238,7.8,10.9,8.7,"Less than 25% P.O.C.","$55000 - $78000"
"36103159509","Census Tract 1595.09, Suffolk County, New York",3513,71673,2161,127,0,27,0,1154,61.5,3.6,0,0.8,0,32.8,38.5,1199,886,313,73.89,26.11,25,861,102,211,127,1072,2.8,32.6,10.6,"25% - 50% P.O.C.","$55000 - $78000"
"36103159510","Census Tract 1595.10, Suffolk County, New York",194,101500,100,0,0,4,0,90,51.5,0,0,2.1,0,46.4,48.5,62,59,3,95.16,4.84,11,48,2,1,13,49,18.6,66.7,21,"25% - 50% P.O.C.","$78000 - $104000"
"36103159511","Census Tract 1595.11, Suffolk County, New York",7784,82455,4245,543,498,78,0,2106,54.5,7,6.4,1,0,27.1,45.5,2151,1522,629,70.76,29.24,386,1136,224,405,610,1541,25.4,35.6,28.4,"25% - 50% P.O.C.","$78000 - $104000"
"36103159512","Census Tract 1595.12, Suffolk County, New York",2217,79276,1627,29,0,39,0,455,73.4,1.3,0,1.8,0,20.5,26.6,605,565,40,93.39,6.61,166,399,14,26,180,425,29.4,35,29.8,"25% - 50% P.O.C.","$78000 - $104000"
"36103159601","Census Tract 1596.01, Suffolk County, New York",6188,103828,5492,12,0,108,0,563,88.8,0.2,0,1.7,0,9.1,11.2,2369,2166,203,91.43,8.57,157,2009,6,197,163,2206,7.2,3,6.9,"Less than 25% P.O.C.","$78000 - $104000"
"36103159602","Census Tract 1596.02, Suffolk County, New York",4262,108264,3998,39,0,87,0,64,93.8,0.9,0,2,0,1.5,6.2,1421,1374,47,96.69,3.31,191,1183,0,47,191,1230,13.9,0,13.4,"Less than 25% P.O.C.","$104000 or more"
"36103169701","Census Tract 1697.01, Suffolk County, New York",7733,135351,7109,131,0,37,0,427,91.9,1.7,0,0.5,0,5.5,8.1,2580,2374,206,92.02,7.98,121,2253,52,154,173,2407,5.1,25.2,6.7,"Less than 25% P.O.C.","$104000 or more"
"36103169703","Census Tract 1697.03, Suffolk County, New York",1731,94167,1524,19,0,17,0,127,88,1.1,0,1,0,7.3,12,684,627,57,91.67,8.33,34,593,12,45,46,638,5.4,21.1,6.7,"Less than 25% P.O.C.","$78000 - $104000"
"36103169704","Census Tract 1697.04, Suffolk County, New York",6827,49028,5415,748,0,225,0,397,79.3,11,0,3.3,0,5.8,20.7,3432,2732,700,79.6,20.4,97,2635,34,666,131,3301,3.6,4.9,3.8,"Less than 25% P.O.C.","Less than $55000"
"36103169800","Census Tract 1698, Suffolk County, New York",6388,62640,2727,820,0,191,0,2506,42.7,12.8,0,3,0,39.2,57.3,2004,1309,695,65.32,34.68,139,1170,218,477,357,1647,10.6,31.4,17.8,"50% - 75% P.O.C.","$55000 - $78000"
"36103169901","Census Tract 1699.01, Suffolk County, New York",6487,52644,3634,1315,0,159,0,1332,56,20.3,0,2.5,0,20.5,44,2551,1479,1072,57.98,42.02,100,1379,152,920,252,2299,6.8,14.2,9.9,"25% - 50% P.O.C.","Less than $55000"
"36103169902","Census Tract 1699.02, Suffolk County, New York",4383,102983,3841,167,0,31,0,344,87.6,3.8,0,0.7,0,7.8,12.4,1725,1498,227,86.84,13.16,137,1361,21,206,158,1567,9.1,9.3,9.2,"Less than 25% P.O.C.","$78000 - $104000"
"36103170001","Census Tract 1700.01, Suffolk County, New York",5646,93478,5213,13,0,0,0,416,92.3,0.2,0,0,0,7.4,7.7,2380,2182,198,91.68,8.32,76,2106,0,198,76,2304,3.5,0,3.2,"Less than 25% P.O.C.","$78000 - $104000"
"36103170002","Census Tract 1700.02, Suffolk County, New York",4262,97905,4021,32,0,0,0,207,94.3,0.8,0,0,0,4.9,5.7,1800,1561,239,86.72,13.28,86,1475,0,239,86,1714,5.5,0,4.8,"Less than 25% P.O.C.","$78000 - $104000"
"36103170101","Census Tract 1701.01, Suffolk County, New York",2082,48750,1288,326,0,13,0,436,61.9,15.7,0,0.6,0,20.9,38.1,903,536,367,59.36,40.64,3,533,11,356,14,889,0.6,3,1.6,"25% - 50% P.O.C.","Less than $55000"
"36103170201","Census Tract 1702.01, Suffolk County, New York",5904,77386,5104,12,0,154,0,634,86.4,0.2,0,2.6,0,10.7,13.6,2508,2112,396,84.21,15.79,71,2041,19,377,90,2418,3.4,4.8,3.6,"Less than 25% P.O.C.","$55000 - $78000"
"36103170202","Census Tract 1702.02, Suffolk County, New York",4242,70039,3571,76,12,17,0,457,84.2,1.8,0.3,0.4,0,10.8,15.8,1983,1608,375,81.09,18.91,41,1567,13,362,54,1929,2.5,3.5,2.7,"Less than 25% P.O.C.","$55000 - $78000"
"36103180300","Census Tract 1803, Suffolk County, New York",2793,84643,2389,0,0,92,0,154,85.5,0,0,3.3,0,5.5,14.5,1236,975,261,78.88,21.12,0,975,151,110,151,1085,0,57.9,12.2,"Less than 25% P.O.C.","$78000 - $104000"
"36103190401","Census Tract 1904.01, Suffolk County, New York",8997,90159,2878,1973,25,55,0,3910,32,21.9,0.3,0.6,0,43.5,68,2084,1485,599,71.26,28.74,353,1132,77,522,430,1654,23.8,12.9,20.6,"50% - 75% P.O.C.","$78000 - $104000"
"36103190402","Census Tract 1904.02, Suffolk County, New York",2539,88269,2112,167,0,13,0,235,83.2,6.6,0,0.5,0,9.3,16.8,872,748,124,85.78,14.22,84,664,5,119,89,783,11.2,4,10.2,"Less than 25% P.O.C.","$78000 - $104000"
"36103190403","Census Tract 1904.03, Suffolk County, New York",4382,76897,2806,101,0,9,0,1442,64,2.3,0,0.2,0,32.9,36,1618,907,711,56.06,43.94,49,858,124,587,173,1445,5.4,17.4,10.7,"25% - 50% P.O.C.","$55000 - $78000"
"36103190502","Census Tract 1905.02, Suffolk County, New York",2558,103942,1907,48,37,48,0,462,74.6,1.9,1.4,1.9,0,18.1,25.4,1116,827,289,74.1,25.9,27,800,21,268,48,1068,3.3,7.3,4.3,"25% - 50% P.O.C.","$78000 - $104000"
"36103190503","Census Tract 1905.03, Suffolk County, New York",2700,112371,2315,86,0,0,0,299,85.7,3.2,0,0,0,11.1,14.3,1117,854,263,76.45,23.55,21,833,0,263,21,1096,2.5,0,1.9,"Less than 25% P.O.C.","$104000 or more"
"36103190504","Census Tract 1905.04, Suffolk County, New York",1736,123977,1631,9,0,29,0,64,94,0.5,0,1.7,0,3.7,6,653,559,94,85.6,14.4,43,516,14,80,57,596,7.7,14.9,8.7,"Less than 25% P.O.C.","$104000 or more"
"36103190601","Census Tract 1906.01, Suffolk County, New York",4521,91679,3799,19,0,140,0,545,84,0.4,0,3.1,0,12.1,16,1841,1645,196,89.35,10.65,155,1490,32,164,187,1654,9.4,16.3,10.2,"Less than 25% P.O.C.","$78000 - $104000"
"36103190603","Census Tract 1906.03, Suffolk County, New York",4904,79760,2742,56,0,11,0,2010,55.9,1.1,0,0.2,0,41,44.1,1886,1243,643,65.91,34.09,94,1149,67,576,161,1725,7.6,10.4,8.5,"25% - 50% P.O.C.","$78000 - $104000"
"36103190604","Census Tract 1906.04, Suffolk County, New York",4457,97708,3351,13,0,0,7,1037,75.2,0.3,0,0,0.2,23.3,24.8,1831,1638,193,89.46,10.54,75,1563,0,193,75,1756,4.6,0,4.1,"Less than 25% P.O.C.","$78000 - $104000"
"36103190704","Census Tract 1907.04, Suffolk County, New York",3081,91614,2054,297,13,25,0,567,66.7,9.6,0.4,0.8,0,18.4,33.3,1157,994,163,85.91,14.09,130,864,36,127,166,991,13.1,22.1,14.3,"25% - 50% P.O.C.","$78000 - $104000"
"36103190705","Census Tract 1907.05, Suffolk County, New York",3478,106957,2148,5,5,445,0,847,61.8,0.1,0.1,12.8,0,24.4,38.2,1400,1101,299,78.64,21.36,31,1070,36,263,67,1333,2.8,12,4.8,"25% - 50% P.O.C.","$104000 or more"
"36103190706","Census Tract 1907.06, Suffolk County, New York",4365,84167,3643,30,0,49,0,553,83.5,0.7,0,1.1,0,12.7,16.5,1778,1344,434,75.59,24.41,48,1296,44,390,92,1686,3.6,10.1,5.2,"Less than 25% P.O.C.","$78000 - $104000"
"36103190707","Census Tract 1907.07, Suffolk County, New York",5293,105143,4131,247,0,248,0,645,78,4.7,0,4.7,0,12.2,22,2064,1819,245,88.13,11.87,106,1713,14,231,120,1944,5.8,5.7,5.8,"Less than 25% P.O.C.","$104000 or more"
"36103190708","Census Tract 1907.08, Suffolk County, New York",1813,117443,1682,0,0,41,0,61,92.8,0,0,2.3,0,3.4,7.2,831,729,102,87.73,12.27,29,700,12,90,41,790,4,11.8,4.9,"Less than 25% P.O.C.","$104000 or more"
"36103190800","Census Tract 1908, Suffolk County, New York",3285,122614,2572,238,0,40,0,403,78.3,7.2,0,1.2,0,12.3,21.7,1364,1099,265,80.57,19.43,31,1068,35,230,66,1298,2.8,13.2,4.8,"Less than 25% P.O.C.","$104000 or more"
"36103200901","Census Tract 2009.01, Suffolk County, New York",869,109250,733,21,0,12,0,58,84.3,2.4,0,1.4,0,6.7,15.7,467,389,78,83.3,16.7,15,374,0,78,15,452,3.9,0,3.2,"Less than 25% P.O.C.","$104000 or more"
"36103200902","Census Tract 2009.02, Suffolk County, New York",7046,113309,5194,198,0,50,0,1557,73.7,2.8,0,0.7,0,22.1,26.3,3225,2809,416,87.1,12.9,111,2698,0,416,111,3114,4,0,3.4,"25% - 50% P.O.C.","$104000 or more"
"36103201001","Census Tract 2010.01, Suffolk County, New York",7036,89491,4473,0,0,386,0,2177,63.6,0,0,5.5,0,30.9,36.4,2743,2268,475,82.68,17.32,91,2177,124,351,215,2528,4,26.1,7.8,"25% - 50% P.O.C.","$78000 - $104000"
"36103201003","Census Tract 2010.03, Suffolk County, New York",3316,91295,1890,351,0,14,0,1029,57,10.6,0,0.4,0,31,43,1283,962,321,74.98,25.02,28,934,44,277,72,1211,2.9,13.7,5.6,"25% - 50% P.O.C.","$78000 - $104000"
"36103201004","Census Tract 2010.04, Suffolk County, New York",3685,96389,3201,7,10,10,0,387,86.9,0.2,0.3,0.3,0,10.5,13.1,1458,1254,204,86.01,13.99,62,1192,0,204,62,1396,4.9,0,4.3,"Less than 25% P.O.C.","$78000 - $104000"
"36103201100","Census Tract 2011, Suffolk County, New York",6037,75458,1605,577,0,114,0,3652,26.6,9.6,0,1.9,0,60.5,73.4,1357,1155,202,85.11,14.89,435,720,80,122,515,842,37.7,39.6,38,"50% - 75% P.O.C.","$55000 - $78000"
"36103990100","Census Tract 9901, Suffolk County, New York",0,NA,0,0,0,0,0,0,NA,NA,NA,NA,NA,NA,NA,0,0,0,NA,NA,0,0,0,0,0,0,NA,NA,NA,"N/A","N/A"
"36105950100","Census Tract 9501, Sullivan County, New York",3436,73650,3094,74,0,0,0,242,90,2.2,0,0,0,7,10,1291,1033,258,80.02,19.98,101,932,21,237,122,1169,9.8,8.1,9.5,"Less than 25% P.O.C.","$55000 - $78000"
"36105950200","Census Tract 9502, Sullivan County, New York",3647,53388,2815,12,0,7,0,224,77.2,0.3,0,0.2,0,6.1,22.8,1507,1159,348,76.91,23.09,82,1077,26,322,108,1399,7.1,7.5,7.2,"Less than 25% P.O.C.","Less than $55000"
"36105950300","Census Tract 9503, Sullivan County, New York",1235,61607,988,46,0,0,0,196,80,3.7,0,0,0,15.9,20,556,489,67,87.95,12.05,27,462,0,67,27,529,5.5,0,4.9,"Less than 25% P.O.C.","$55000 - $78000"
"36105950400","Census Tract 9504, Sullivan County, New York",2925,62486,2602,39,0,27,0,170,89,1.3,0,0.9,0,5.8,11,1319,1055,264,79.98,20.02,35,1020,12,252,47,1272,3.3,4.5,3.6,"Less than 25% P.O.C.","$55000 - $78000"
"36105950500","Census Tract 9505, Sullivan County, New York",3370,50143,2613,78,8,66,0,510,77.5,2.3,0.2,2,0,15.1,22.5,1234,719,515,58.27,41.73,69,650,48,467,117,1117,9.6,9.3,9.5,"Less than 25% P.O.C.","Less than $55000"
"36105950600","Census Tract 9506, Sullivan County, New York",1722,72586,1414,91,0,80,0,119,82.1,5.3,0,4.6,0,6.9,17.9,588,423,165,71.94,28.06,82,341,0,165,82,506,19.4,0,13.9,"Less than 25% P.O.C.","$55000 - $78000"
"36105950700","Census Tract 9507, Sullivan County, New York",4253,37125,1975,761,0,11,0,1277,46.4,17.9,0,0.3,0,30,53.6,1642,695,947,42.33,57.67,40,655,62,885,102,1540,5.8,6.5,6.2,"50% - 75% P.O.C.","Less than $55000"
"36105950800","Census Tract 9508, Sullivan County, New York",4571,48083,3354,186,0,32,0,900,73.4,4.1,0,0.7,0,19.7,26.6,1616,1218,398,75.37,24.63,65,1153,0,398,65,1551,5.3,0,4,"25% - 50% P.O.C.","Less than $55000"
"36105950900","Census Tract 9509, Sullivan County, New York",3085,32793,1935,311,0,267,0,537,62.7,10.1,0,8.7,0,17.4,37.3,973,421,552,43.27,56.73,73,348,102,450,175,798,17.3,18.5,18,"25% - 50% P.O.C.","Less than $55000"
"36105951000","Census Tract 9510, Sullivan County, New York",2130,44167,1200,185,0,0,0,586,56.3,8.7,0,0,0,27.5,43.7,1076,470,606,43.68,56.32,20,450,18,588,38,1038,4.3,3,3.5,"25% - 50% P.O.C.","Less than $55000"
"36105951100","Census Tract 9511, Sullivan County, New York",3139,44375,1546,663,10,50,0,699,49.3,21.1,0.3,1.6,0,22.3,50.7,686,454,232,66.18,33.82,56,398,7,225,63,623,12.3,3,9.2,"50% - 75% P.O.C.","Less than $55000"
"36105951200","Census Tract 9512, Sullivan County, New York",7299,69766,6035,110,46,55,0,884,82.7,1.5,0.6,0.8,0,12.1,17.3,2486,1824,662,73.37,26.63,167,1657,159,503,326,2160,9.2,24,13.1,"Less than 25% P.O.C.","$55000 - $78000"
"36105951300","Census Tract 9513, Sullivan County, New York",4154,87045,3566,118,0,46,0,396,85.8,2.8,0,1.1,0,9.5,14.2,1638,1385,253,84.55,15.45,98,1287,19,234,117,1521,7.1,7.5,7.1,"Less than 25% P.O.C.","$78000 - $104000"
"36105951500","Census Tract 9515, Sullivan County, New York",2765,42966,1606,190,0,47,0,774,58.1,6.9,0,1.7,0,28,41.9,919,438,481,47.66,52.34,49,389,130,351,179,740,11.2,27,19.5,"25% - 50% P.O.C.","Less than $55000"
"36105951600","Census Tract 9516, Sullivan County, New York",3742,45995,2049,340,0,147,0,1118,54.8,9.1,0,3.9,0,29.9,45.2,1263,723,540,57.24,42.76,61,662,94,446,155,1108,8.4,17.4,12.3,"25% - 50% P.O.C.","Less than $55000"
"36105951700","Census Tract 9517, Sullivan County, New York",3917,95357,3270,258,3,85,0,257,83.5,6.6,0.1,2.2,0,6.6,16.5,1608,1433,175,89.12,10.88,55,1378,5,170,60,1548,3.8,2.9,3.7,"Less than 25% P.O.C.","$78000 - $104000"
"36105951800","Census Tract 9518, Sullivan County, New York",5654,33442,1426,1700,65,158,0,2085,25.2,30.1,1.1,2.8,0,36.9,74.8,2071,760,1311,36.7,63.3,99,661,110,1201,209,1862,13,8.4,10.1,"50% - 75% P.O.C.","Less than $55000"
"36105951900","Census Tract 9519, Sullivan County, New York",1922,62721,1605,37,17,0,0,263,83.5,1.9,0.9,0,0,13.7,16.5,729,510,219,69.96,30.04,8,502,19,200,27,702,1.6,8.7,3.7,"Less than 25% P.O.C.","$55000 - $78000"
"36105952000","Census Tract 9520, Sullivan County, New York",2214,66815,2086,3,0,17,0,76,94.2,0.1,0,0.8,0,3.4,5.8,945,797,148,84.34,15.66,39,758,18,130,57,888,4.9,12.2,6,"Less than 25% P.O.C.","$55000 - $78000"
"36105952100","Census Tract 9521, Sullivan County, New York",2565,55650,2007,158,6,25,0,268,78.2,6.2,0.2,1,0,10.4,21.8,1023,782,241,76.44,23.56,28,754,24,217,52,971,3.6,10,5.1,"Less than 25% P.O.C.","$55000 - $78000"
"36105952200","Census Tract 9522, Sullivan County, New York",1430,58875,1245,83,0,3,0,98,87.1,5.8,0,0.2,0,6.9,12.9,597,458,139,76.72,23.28,16,442,11,128,27,570,3.5,7.9,4.5,"Less than 25% P.O.C.","$55000 - $78000"
"36105952300","Census Tract 9523, Sullivan County, New York",1367,47938,1186,50,12,48,0,47,86.8,3.7,0.9,3.5,0,3.4,13.2,625,491,134,78.56,21.44,3,488,7,127,10,615,0.6,5.2,1.6,"Less than 25% P.O.C.","Less than $55000"
"36105952400","Census Tract 9524, Sullivan County, New York",2260,61058,2123,38,6,17,0,71,93.9,1.7,0.3,0.8,0,3.1,6.1,941,758,183,80.55,19.45,25,733,0,183,25,916,3.3,0,2.7,"Less than 25% P.O.C.","$55000 - $78000"
"36105952500","Census Tract 9525, Sullivan County, New York",2314,77989,1979,29,0,37,0,212,85.5,1.3,0,1.6,0,9.2,14.5,851,760,91,89.31,10.69,95,665,7,84,102,749,12.5,7.7,12,"Less than 25% P.O.C.","$55000 - $78000"
"36111950100","Census Tract 9501, Ulster County, New York",4920,66250,4500,0,0,15,0,203,91.5,0,0,0.3,0,4.1,8.5,1971,1630,341,82.7,17.3,173,1457,32,309,205,1766,10.6,9.4,10.4,"Less than 25% P.O.C.","$55000 - $78000"
"36111950200","Census Tract 9502, Ulster County, New York",3847,39631,3348,39,0,18,0,326,87,1,0,0.5,0,8.5,13,1803,900,903,49.92,50.08,39,861,28,875,67,1736,4.3,3.1,3.7,"Less than 25% P.O.C.","Less than $55000"
"36111950300","Census Tract 9503, Ulster County, New York",4380,49808,3805,83,44,0,0,357,86.9,1.9,1,0,0,8.2,13.1,1820,1061,759,58.3,41.7,43,1018,0,759,43,1777,4.1,0,2.4,"Less than 25% P.O.C.","Less than $55000"
"36111950400","Census Tract 9504, Ulster County, New York",4413,63938,4032,106,0,18,0,217,91.4,2.4,0,0.4,0,4.9,8.6,1936,1492,444,77.07,22.93,106,1386,15,429,121,1815,7.1,3.4,6.2,"Less than 25% P.O.C.","$55000 - $78000"
"36111950500","Census Tract 9505, Ulster County, New York",3068,61017,2598,118,0,114,0,121,84.7,3.8,0,3.7,0,3.9,15.3,1444,1020,424,70.64,29.36,65,955,22,402,87,1357,6.4,5.2,6,"Less than 25% P.O.C.","$55000 - $78000"
"36111950600","Census Tract 9506, Ulster County, New York",2736,78941,2569,3,0,70,0,29,93.9,0.1,0,2.6,0,1.1,6.1,1279,968,311,75.68,24.32,66,902,0,311,66,1213,6.8,0,5.2,"Less than 25% P.O.C.","$78000 - $104000"
"36111950900","Census Tract 9509, Ulster County, New York",1222,62857,1154,0,0,12,0,43,94.4,0,0,1,0,3.5,5.6,548,441,107,80.47,19.53,19,422,3,104,22,526,4.3,2.8,4,"Less than 25% P.O.C.","$55000 - $78000"
"36111951000","Census Tract 9510, Ulster County, New York",4296,68636,3692,25,24,150,95,216,85.9,0.6,0.6,3.5,2.2,5,14.1,1836,1548,288,84.31,15.69,0,1548,28,260,28,1808,0,9.7,1.5,"Less than 25% P.O.C.","$55000 - $78000"
"36111951100","Census Tract 9511, Ulster County, New York",2449,67426,2416,0,0,20,0,6,98.7,0,0,0.8,0,0.2,1.3,1147,1041,106,90.76,9.24,35,1006,0,106,35,1112,3.4,0,3.1,"Less than 25% P.O.C.","$55000 - $78000"
"36111951200","Census Tract 9512, Ulster County, New York",3631,93295,3176,60,9,0,0,252,87.5,1.7,0.2,0,0,6.9,12.5,1489,1352,137,90.8,9.2,87,1265,0,137,87,1402,6.4,0,5.8,"Less than 25% P.O.C.","$78000 - $104000"
"36111951300","Census Tract 9513, Ulster County, New York",4119,56863,3408,167,0,50,0,343,82.7,4.1,0,1.2,0,8.3,17.3,1600,989,611,61.81,38.19,62,927,7,604,69,1531,6.3,1.1,4.3,"Less than 25% P.O.C.","$55000 - $78000"
"36111951400","Census Tract 9514, Ulster County, New York",3618,44063,2741,236,0,107,0,402,75.8,6.5,0,3,0,11.1,24.2,1793,879,914,49.02,50.98,16,863,0,914,16,1777,1.8,0,0.9,"Less than 25% P.O.C.","Less than $55000"
"36111951500","Census Tract 9515, Ulster County, New York",3759,68250,2862,174,0,41,7,479,76.1,4.6,0,1.1,0.2,12.7,23.9,1411,1093,318,77.46,22.54,91,1002,29,289,120,1291,8.3,9.1,8.5,"Less than 25% P.O.C.","$55000 - $78000"
"36111951600","Census Tract 9516, Ulster County, New York",2004,76094,1746,85,0,56,0,117,87.1,4.2,0,2.8,0,5.8,12.9,832,644,188,77.4,22.6,57,587,0,188,57,775,8.9,0,6.9,"Less than 25% P.O.C.","$55000 - $78000"
"36111951700","Census Tract 9517, Ulster County, New York",5312,43452,3346,1058,0,0,0,497,63,19.9,0,0,0,9.4,37,1990,782,1208,39.3,60.7,132,650,165,1043,297,1693,16.9,13.7,14.9,"25% - 50% P.O.C.","Less than $55000"
"36111951800","Census Tract 9518, Ulster County, New York",1580,41500,1160,239,0,14,0,131,73.4,15.1,0,0.9,0,8.3,26.6,692,349,343,50.43,49.57,6,343,39,304,45,647,1.7,11.4,6.5,"25% - 50% P.O.C.","Less than $55000"
"36111951900","Census Tract 9519, Ulster County, New York",2542,66667,1617,250,17,130,0,472,63.6,9.8,0.7,5.1,0,18.6,36.4,946,568,378,60.04,39.96,73,495,0,378,73,873,12.9,0,7.7,"25% - 50% P.O.C.","$55000 - $78000"
"36111952000","Census Tract 9520, Ulster County, New York",2806,43903,1407,355,7,202,0,726,50.1,12.7,0.2,7.2,0,25.9,49.9,951,344,607,36.17,63.83,79,265,70,537,149,802,23,11.5,15.7,"25% - 50% P.O.C.","Less than $55000"
"36111952100","Census Tract 9521, Ulster County, New York",3605,57601,1642,890,0,0,0,941,45.5,24.7,0,0,0,26.1,54.5,1223,483,740,39.49,60.51,43,440,177,563,220,1003,8.9,23.9,18,"50% - 75% P.O.C.","$55000 - $78000"
"36111952200","Census Tract 9522, Ulster County, New York",3330,67604,2630,197,0,158,0,272,79,5.9,0,4.7,0,8.2,21,1303,945,358,72.52,27.48,83,862,45,313,128,1175,8.8,12.6,9.8,"Less than 25% P.O.C.","$55000 - $78000"
"36111952300","Census Tract 9523, Ulster County, New York",1455,58158,962,197,0,111,0,123,66.1,13.5,0,7.6,0,8.5,33.9,730,250,480,34.25,65.75,5,245,12,468,17,713,2,2.5,2.3,"25% - 50% P.O.C.","$55000 - $78000"
"36111952400","Census Tract 9524, Ulster County, New York",2440,40568,1821,174,7,102,0,242,74.6,7.1,0.3,4.2,0,9.9,25.4,1253,407,846,32.48,67.52,34,373,14,832,48,1205,8.4,1.7,3.8,"25% - 50% P.O.C.","Less than $55000"
"36111952500","Census Tract 9525, Ulster County, New York",3242,68934,2692,30,0,52,0,163,83,0.9,0,1.6,0,5,17,1393,1085,308,77.89,22.11,44,1041,0,308,44,1349,4.1,0,3.2,"Less than 25% P.O.C.","$55000 - $78000"
"36111952600","Census Tract 9526, Ulster County, New York",5540,76295,4966,45,0,14,0,399,89.6,0.8,0,0.3,0,7.2,10.4,2044,1493,551,73.04,26.96,46,1447,0,551,46,1998,3.1,0,2.3,"Less than 25% P.O.C.","$55000 - $78000"
"36111952700","Census Tract 9527, Ulster County, New York",2773,63929,2362,31,0,0,0,238,85.2,1.1,0,0,0,8.6,14.8,1042,744,298,71.4,28.6,35,709,18,280,53,989,4.7,6,5.1,"Less than 25% P.O.C.","$55000 - $78000"
"36111952800","Census Tract 9528, Ulster County, New York",3085,79402,2770,89,0,71,0,103,89.8,2.9,0,2.3,0,3.3,10.2,1231,962,269,78.15,21.85,83,879,8,261,91,1140,8.6,3,7.4,"Less than 25% P.O.C.","$78000 - $104000"
"36111952900","Census Tract 9529, Ulster County, New York",5497,74357,4496,323,0,249,0,157,81.8,5.9,0,4.5,0,2.9,18.2,2222,1934,288,87.04,12.96,63,1871,0,288,63,2159,3.3,0,2.8,"Less than 25% P.O.C.","$55000 - $78000"
"36111953000","Census Tract 9530, Ulster County, New York",1760,54309,1656,7,13,9,0,68,94.1,0.4,0.7,0.5,0,3.9,5.9,776,564,212,72.68,27.32,43,521,17,195,60,716,7.6,8,7.7,"Less than 25% P.O.C.","Less than $55000"
"36111953300","Census Tract 9533, Ulster County, New York",4414,105147,3879,105,29,12,0,296,87.9,2.4,0.7,0.3,0,6.7,12.1,1598,1319,279,82.54,17.46,93,1226,0,279,93,1505,7.1,0,5.8,"Less than 25% P.O.C.","$104000 or more"
"36111953400","Census Tract 9534, Ulster County, New York",4572,65841,3603,374,0,233,0,283,78.8,8.2,0,5.1,0,6.2,21.2,2009,829,1180,41.26,58.74,59,770,47,1133,106,1903,7.1,4,5.3,"Less than 25% P.O.C.","$55000 - $78000"
"36111953500","Census Tract 9535, Ulster County, New York",5176,56328,3640,222,0,309,0,920,70.3,4.3,0,6,0,17.8,29.7,928,388,540,41.81,58.19,0,388,42,498,42,886,0,7.8,4.5,"25% - 50% P.O.C.","$55000 - $78000"
"36111953600","Census Tract 9536, Ulster County, New York",5707,69922,4466,416,0,73,0,619,78.3,7.3,0,1.3,0,10.8,21.7,2246,1210,1036,53.87,46.13,143,1067,93,943,236,2010,11.8,9,10.5,"Less than 25% P.O.C.","$55000 - $78000"
"36111953700","Census Tract 9537, Ulster County, New York",4807,91698,3975,143,2,38,0,554,82.7,3,0,0.8,0,11.5,17.3,1814,1477,337,81.42,18.58,134,1343,27,310,161,1653,9.1,8,8.9,"Less than 25% P.O.C.","$78000 - $104000"
"36111953800","Census Tract 9538, Ulster County, New York",3909,73068,3392,93,0,0,0,378,86.8,2.4,0,0,0,9.7,13.2,1670,1068,602,63.95,36.05,60,1008,27,575,87,1583,5.6,4.5,5.2,"Less than 25% P.O.C.","$55000 - $78000"
"36111953900","Census Tract 9539, Ulster County, New York",4751,96716,4198,165,0,113,0,183,88.4,3.5,0,2.4,0,3.9,11.6,1794,1421,373,79.21,20.79,120,1301,11,362,131,1663,8.4,2.9,7.3,"Less than 25% P.O.C.","$78000 - $104000"
"36111954000","Census Tract 9540, Ulster County, New York",4596,59777,3439,520,0,112,0,464,74.8,11.3,0,2.4,0,10.1,25.2,2107,1645,462,78.07,21.93,41,1604,0,462,41,2066,2.5,0,1.9,"25% - 50% P.O.C.","$55000 - $78000"
"36111954100","Census Tract 9541, Ulster County, New York",5658,66667,3851,374,0,0,0,1213,68.1,6.6,0,0,0,21.4,31.9,1918,1450,468,75.6,24.4,171,1279,10,458,181,1737,11.8,2.1,9.4,"25% - 50% P.O.C.","$55000 - $78000"
"36111954200","Census Tract 9542, Ulster County, New York",5620,76674,5167,14,0,0,0,293,91.9,0.2,0,0,0,5.2,8.1,2232,1711,521,76.66,23.34,217,1494,0,521,217,2015,12.7,0,9.7,"Less than 25% P.O.C.","$55000 - $78000"
"36111954400","Census Tract 9544, Ulster County, New York",9664,88967,7692,448,0,151,0,1143,79.6,4.6,0,1.6,0,11.8,20.4,2573,2116,457,82.24,17.76,243,1873,12,445,255,2318,11.5,2.6,9.9,"Less than 25% P.O.C.","$78000 - $104000"
"36111954500","Census Tract 9545, Ulster County, New York",4480,61042,2751,689,11,30,0,866,61.4,15.4,0.2,0.7,0,19.3,38.6,1168,887,281,75.94,24.06,55,832,11,270,66,1102,6.2,3.9,5.7,"25% - 50% P.O.C.","$55000 - $78000"
"36111954600","Census Tract 9546, Ulster County, New York",1470,62629,1087,2,13,25,0,293,73.9,0.1,0.9,1.7,0,19.9,26.1,671,585,86,87.18,12.82,36,549,0,86,36,635,6.2,0,5.4,"25% - 50% P.O.C.","$55000 - $78000"
"36111954700","Census Tract 9547, Ulster County, New York",1840,46429,1576,38,0,33,0,122,85.7,2.1,0,1.8,0,6.6,14.3,628,444,184,70.7,29.3,31,413,0,184,31,597,7,0,4.9,"Less than 25% P.O.C.","Less than $55000"
"36111954800","Census Tract 9548, Ulster County, New York",5009,42432,2430,428,1,207,0,1611,48.5,8.5,0,4.1,0,32.2,51.5,1983,897,1086,45.23,54.77,151,746,67,1019,218,1765,16.8,6.2,11,"50% - 75% P.O.C.","Less than $55000"
"36111954900","Census Tract 9549, Ulster County, New York",1506,71875,1406,21,0,20,0,59,93.4,1.4,0,1.3,0,3.9,6.6,603,475,128,78.77,21.23,12,463,0,128,12,591,2.5,0,2,"Less than 25% P.O.C.","$55000 - $78000"
"36111955000","Census Tract 9550, Ulster County, New York",5417,58193,4328,147,0,61,0,374,79.9,2.7,0,1.1,0,6.9,20.1,2184,1667,517,76.33,23.67,85,1582,50,467,135,2049,5.1,9.7,6.2,"Less than 25% P.O.C.","$55000 - $78000"
"36111955300","Census Tract 9553, Ulster County, New York",2361,43750,2071,9,0,20,0,230,87.7,0.4,0,0.8,0,9.7,12.3,1237,901,336,72.84,27.16,6,895,0,336,6,1231,0.7,0,0.5,"Less than 25% P.O.C.","Less than $55000"
"36111955400","Census Tract 9554, Ulster County, New York",4279,67500,2710,657,0,107,0,693,63.3,15.4,0,2.5,0,16.2,36.7,1252,863,389,68.93,31.07,43,820,33,356,76,1176,5,8.5,6.1,"25% - 50% P.O.C.","$55000 - $78000"
"36119000101","Census Tract 1.01, Westchester County, New York",4017,31875,47,662,0,15,0,3234,1.2,16.5,0,0.4,0,80.5,98.8,1620,215,1405,13.27,86.73,11,204,57,1348,68,1552,5.1,4.1,4.2,"75% or more P.O.C.","Less than $55000"
"36119000103","Census Tract 1.03, Westchester County, New York",5114,31477,450,1967,0,61,0,1914,8.8,38.5,0,1.2,0,37.4,91.2,2122,213,1909,10.04,89.96,0,213,221,1688,221,1901,0,11.6,10.4,"75% or more P.O.C.","Less than $55000"
"36119000104","Census Tract 1.04, Westchester County, New York",716,94063,157,317,0,51,0,167,21.9,44.3,0,7.1,0,23.3,78.1,369,86,283,23.31,76.69,0,86,20,263,20,349,0,7.1,5.4,"75% or more P.O.C.","$78000 - $104000"
"36119000201","Census Tract 2.01, Westchester County, New York",7936,42313,482,1178,0,49,0,5735,6.1,14.8,0,0.6,0,72.3,93.9,2767,294,2473,10.63,89.37,91,203,333,2140,424,2343,31,13.5,15.3,"75% or more P.O.C.","Less than $55000"
"36119000202","Census Tract 2.02, Westchester County, New York",4067,64307,1162,929,0,8,0,1780,28.6,22.8,0,0.2,0,43.8,71.4,1385,560,825,40.43,59.57,104,456,58,767,162,1223,18.6,7,11.7,"50% - 75% P.O.C.","$55000 - $78000"
"36119000203","Census Tract 2.03, Westchester County, New York",3157,63239,935,374,0,129,0,1708,29.6,11.8,0,4.1,0,54.1,70.4,1377,412,965,29.92,70.08,9,403,98,867,107,1270,2.2,10.2,7.8,"50% - 75% P.O.C.","$55000 - $78000"
"36119000300","Census Tract 3, Westchester County, New York",4223,30677,335,673,0,321,0,2886,7.9,15.9,0,7.6,0,68.3,92.1,1529,0,1529,0,100,0,0,206,1323,206,1323,NA,13.5,13.5,"75% or more P.O.C.","Less than $55000"
"36119000401","Census Tract 4.01, Westchester County, New York",4191,54683,591,1598,0,290,28,1684,14.1,38.1,0,6.9,0.7,40.2,85.9,1767,138,1629,7.81,92.19,0,138,54,1575,54,1713,0,3.3,3.1,"75% or more P.O.C.","Less than $55000"
"36119000402","Census Tract 4.02, Westchester County, New York",5628,50485,331,2357,0,364,18,2557,5.9,41.9,0,6.5,0.3,45.4,94.1,2276,532,1744,23.37,76.63,102,430,18,1726,120,2156,19.2,1,5.3,"75% or more P.O.C.","Less than $55000"
"36119000500","Census Tract 5, Westchester County, New York",4681,20508,184,1617,0,444,0,2435,3.9,34.5,0,9.5,0,52,96.1,1783,271,1512,15.2,84.8,33,238,198,1314,231,1552,12.2,13.1,13,"75% or more P.O.C.","Less than $55000"
"36119000600","Census Tract 6, Westchester County, New York",6994,40054,973,2215,0,11,0,3717,13.9,31.7,0,0.2,0,53.1,86.1,2444,668,1776,27.33,72.67,80,588,195,1581,275,2169,12,11,11.3,"75% or more P.O.C.","Less than $55000"
"36119000701","Census Tract 7.01, Westchester County, New York",3576,80764,1821,633,0,226,0,763,50.9,17.7,0,6.3,0,21.3,49.1,1345,941,404,69.96,30.04,63,878,42,362,105,1240,6.7,10.4,7.8,"25% - 50% P.O.C.","$78000 - $104000"
"36119000702","Census Tract 7.02, Westchester County, New York",4275,77389,1295,1179,0,220,0,1358,30.3,27.6,0,5.1,0,31.8,69.7,2295,1006,1289,43.83,56.17,15,991,44,1245,59,2236,1.5,3.4,2.6,"50% - 75% P.O.C.","$55000 - $78000"
"36119000801","Census Tract 8.01, Westchester County, New York",6439,92472,2973,751,0,826,0,1438,46.2,11.7,0,12.8,0,22.3,53.8,2357,1630,727,69.16,30.84,99,1531,147,580,246,2111,6.1,20.2,10.4,"50% - 75% P.O.C.","$78000 - $104000"
"36119000802","Census Tract 8.02, Westchester County, New York",2530,67500,1147,171,0,132,0,1038,45.3,6.8,0,5.2,0,41,54.7,792,528,264,66.67,33.33,64,464,37,227,101,691,12.1,14,12.8,"50% - 75% P.O.C.","$55000 - $78000"
"36119000803","Census Tract 8.03, Westchester County, New York",4919,76992,2259,468,0,270,0,1847,45.9,9.5,0,5.5,0,37.5,54.1,1537,893,644,58.1,41.9,234,659,26,618,260,1277,26.2,4,16.9,"50% - 75% P.O.C.","$55000 - $78000"
"36119000900","Census Tract 9, Westchester County, New York",3071,82132,1306,328,0,212,0,1225,42.5,10.7,0,6.9,0,39.9,57.5,1054,714,340,67.74,32.26,81,633,31,309,112,942,11.3,9.1,10.6,"50% - 75% P.O.C.","$78000 - $104000"
"36119001000","Census Tract 10, Westchester County, New York",1786,20850,90,619,0,19,0,984,5,34.7,0,1.1,0,55.1,95,721,58,663,8.04,91.96,3,55,111,552,114,607,5.2,16.7,15.8,"75% or more P.O.C.","Less than $55000"
"36119001101","Census Tract 11.01, Westchester County, New York",3445,35302,316,538,0,108,0,2459,9.2,15.6,0,3.1,0,71.4,90.8,1031,47,984,4.56,95.44,13,34,162,822,175,856,27.7,16.5,17,"75% or more P.O.C.","Less than $55000"
"36119001102","Census Tract 11.02, Westchester County, New York",5608,39278,1106,1159,11,149,0,3145,19.7,20.7,0.2,2.7,0,56.1,80.3,1935,556,1379,28.73,71.27,64,492,301,1078,365,1570,11.5,21.8,18.9,"75% or more P.O.C.","Less than $55000"
"36119001200","Census Tract 12, Westchester County, New York",4146,29987,534,883,0,119,0,2531,12.9,21.3,0,2.9,0,61,87.1,1361,263,1098,19.32,80.68,29,234,199,899,228,1133,11,18.1,16.8,"75% or more P.O.C.","Less than $55000"
"36119001301","Census Tract 13.01, Westchester County, New York",3883,100529,1153,529,0,479,0,1577,29.7,13.6,0,12.3,0,40.6,70.3,1201,812,389,67.61,32.39,173,639,65,324,238,963,21.3,16.7,19.8,"50% - 75% P.O.C.","$78000 - $104000"
"36119001302","Census Tract 13.02, Westchester County, New York",3939,40114,501,545,0,223,0,2617,12.7,13.8,0,5.7,0,66.4,87.3,1413,364,1049,25.76,74.24,57,307,162,887,219,1194,15.7,15.4,15.5,"75% or more P.O.C.","Less than $55000"
"36119001303","Census Tract 13.03, Westchester County, New York",7745,50341,695,1422,0,721,0,4725,9,18.4,0,9.3,0,61,91,2220,318,1902,14.32,85.68,30,288,453,1449,483,1737,9.4,23.8,21.8,"75% or more P.O.C.","Less than $55000"
"36119001401","Census Tract 14.01, Westchester County, New York",3926,72250,2147,284,0,134,0,1329,54.7,7.2,0,3.4,0,33.9,45.3,1389,854,535,61.48,38.52,154,700,26,509,180,1209,18,4.9,13,"25% - 50% P.O.C.","$55000 - $78000"
"36119001402","Census Tract 14.02, Westchester County, New York",1697,81250,1135,46,0,215,0,301,66.9,2.7,0,12.7,0,17.7,33.1,686,610,76,88.92,11.08,40,570,0,76,40,646,6.6,0,5.8,"25% - 50% P.O.C.","$78000 - $104000"
"36119001403","Census Tract 14.03, Westchester County, New York",3444,93648,1672,501,0,128,0,1119,48.5,14.5,0,3.7,0,32.5,51.5,1305,596,709,45.67,54.33,41,555,41,668,82,1223,6.9,5.8,6.3,"50% - 75% P.O.C.","$78000 - $104000"
"36119001502","Census Tract 15.02, Westchester County, New York",3021,75759,2206,303,0,183,0,299,73,10,0,6.1,0,9.9,27,1338,566,772,42.3,57.7,47,519,11,761,58,1280,8.3,1.4,4.3,"25% - 50% P.O.C.","$55000 - $78000"
"36119001503","Census Tract 15.03, Westchester County, New York",2757,77750,2206,17,0,119,0,334,80,0.6,0,4.3,0,12.1,20,1192,552,640,46.31,53.69,53,499,47,593,100,1092,9.6,7.3,8.4,"Less than 25% P.O.C.","$55000 - $78000"
"36119001504","Census Tract 15.04, Westchester County, New York",5552,80559,2949,828,0,350,0,1317,53.1,14.9,0,6.3,0,23.7,46.9,1849,993,856,53.7,46.3,202,791,11,845,213,1636,20.3,1.3,11.5,"25% - 50% P.O.C.","$78000 - $104000"
"36119001505","Census Tract 15.05, Westchester County, New York",2102,75757,794,530,0,14,0,716,37.8,25.2,0,0.7,0,34.1,62.2,1097,657,440,59.89,40.11,0,657,0,440,0,1097,0,0,0,"50% - 75% P.O.C.","$55000 - $78000"
"36119001600","Census Tract 16, Westchester County, New York",3561,60875,1376,404,56,54,0,1671,38.6,11.3,1.6,1.5,0,46.9,61.4,1271,474,797,37.29,62.71,23,451,101,696,124,1147,4.9,12.7,9.8,"50% - 75% P.O.C.","$55000 - $78000"
"36119001700","Census Tract 17, Westchester County, New York",6732,60483,4541,70,18,228,0,1776,67.5,1,0.3,3.4,0,26.4,32.5,2359,1672,687,70.88,29.12,240,1432,0,687,240,2119,14.4,0,10.2,"25% - 50% P.O.C.","$55000 - $78000"
"36119001800","Census Tract 18, Westchester County, New York",1814,84000,173,939,0,28,0,656,9.5,51.8,0,1.5,0,36.2,90.5,550,371,179,67.45,32.55,64,307,17,162,81,469,17.3,9.5,14.7,"75% or more P.O.C.","$78000 - $104000"
"36119001900","Census Tract 19, Westchester County, New York",1566,122083,919,111,0,130,0,375,58.7,7.1,0,8.3,0,23.9,41.3,506,461,45,91.11,8.89,65,396,7,38,72,434,14.1,15.6,14.2,"25% - 50% P.O.C.","$104000 or more"
"36119002000","Census Tract 20, Westchester County, New York",4260,102586,2574,259,0,498,0,874,60.4,6.1,0,11.7,0,20.5,39.6,1516,1403,113,92.55,7.45,119,1284,0,113,119,1397,8.5,0,7.8,"25% - 50% P.O.C.","$78000 - $104000"
"36119002101","Census Tract 21.01, Westchester County, New York",3976,70227,2139,214,6,630,0,897,53.8,5.4,0.2,15.8,0,22.6,46.2,1536,847,689,55.14,44.86,112,735,54,635,166,1370,13.2,7.8,10.8,"25% - 50% P.O.C.","$55000 - $78000"
"36119002103","Census Tract 21.03, Westchester County, New York",3076,193611,2477,10,0,87,0,435,80.5,0.3,0,2.8,0,14.1,19.5,1002,983,19,98.1,1.9,148,835,0,19,148,854,15.1,0,14.8,"Less than 25% P.O.C.","$104000 or more"
"36119002104","Census Tract 21.04, Westchester County, New York",4973,98966,2567,339,45,261,0,1635,51.6,6.8,0.9,5.2,0,32.9,48.4,2078,1673,405,80.51,19.49,69,1604,52,353,121,1957,4.1,12.8,5.8,"25% - 50% P.O.C.","$78000 - $104000"
"36119002105","Census Tract 21.05, Westchester County, New York",1658,123500,1113,43,0,432,0,70,67.1,2.6,0,26.1,0,4.2,32.9,610,526,84,86.23,13.77,50,476,13,71,63,547,9.5,15.5,10.3,"25% - 50% P.O.C.","$104000 or more"
"36119002106","Census Tract 21.06, Westchester County, New York",2553,72179,394,873,0,538,0,704,15.4,34.2,0,21.1,0,27.6,84.6,992,69,923,6.96,93.04,6,63,51,872,57,935,8.7,5.5,5.7,"75% or more P.O.C.","$55000 - $78000"
"36119002107","Census Tract 21.07, Westchester County, New York",1726,66000,566,240,139,446,0,325,32.8,13.9,8.1,25.8,0,18.8,67.2,552,216,336,39.13,60.87,27,189,41,295,68,484,12.5,12.2,12.3,"50% - 75% P.O.C.","$55000 - $78000"
"36119002201","Census Tract 22.01, Westchester County, New York",2381,133787,1586,135,0,239,0,421,66.6,5.7,0,10,0,17.7,33.4,853,739,114,86.64,13.36,114,625,0,114,114,739,15.4,0,13.4,"25% - 50% P.O.C.","$104000 or more"
"36119002202","Census Tract 22.02, Westchester County, New York",4812,124979,3798,152,0,270,0,331,78.9,3.2,0,5.6,0,6.9,21.1,2305,1797,508,77.96,22.04,61,1736,51,457,112,2193,3.4,10,4.9,"Less than 25% P.O.C.","$104000 or more"
"36119002203","Census Tract 22.03, Westchester County, New York",1802,54643,990,116,0,207,0,451,54.9,6.4,0,11.5,0,25,45.1,1104,592,512,53.62,46.38,0,592,0,512,0,1104,0,0,0,"25% - 50% P.O.C.","Less than $55000"
"36119002204","Census Tract 22.04, Westchester County, New York",4989,81780,3192,378,4,218,8,1098,64,7.6,0.1,4.4,0.2,22,36,1873,1457,416,77.79,22.21,33,1424,0,416,33,1840,2.3,0,1.8,"25% - 50% P.O.C.","$78000 - $104000"
"36119002300","Census Tract 23, Westchester County, New York",4304,86316,2686,137,27,475,0,917,62.4,3.2,0.6,11,0,21.3,37.6,1348,883,465,65.5,34.5,134,749,47,418,181,1167,15.2,10.1,13.4,"25% - 50% P.O.C.","$78000 - $104000"
"36119002401","Census Tract 24.01, Westchester County, New York",1846,71875,952,213,15,36,0,566,51.6,11.5,0.8,2,0,30.7,48.4,773,320,453,41.4,58.6,41,279,9,444,50,723,12.8,2,6.5,"25% - 50% P.O.C.","$55000 - $78000"
"36119002402","Census Tract 24.02, Westchester County, New York",3383,77532,1566,599,0,166,0,979,46.3,17.7,0,4.9,0,28.9,53.7,1860,1288,572,69.25,30.75,13,1275,23,549,36,1824,1,4,1.9,"50% - 75% P.O.C.","$55000 - $78000"
"36119002403","Census Tract 24.03, Westchester County, New York",5241,60833,2120,1103,37,392,0,1589,40.5,21,0.7,7.5,0,30.3,59.5,2190,1099,1091,50.18,49.82,73,1026,36,1055,109,2081,6.6,3.3,5,"50% - 75% P.O.C.","$55000 - $78000"
"36119002404","Census Tract 24.04, Westchester County, New York",3242,87500,1676,110,0,457,0,900,51.7,3.4,0,14.1,0,27.8,48.3,952,680,272,71.43,28.57,189,491,25,247,214,738,27.8,9.2,22.5,"25% - 50% P.O.C.","$78000 - $104000"
"36119002405","Census Tract 24.05, Westchester County, New York",3488,83250,1960,216,12,289,7,990,56.2,6.2,0.3,8.3,0.2,28.4,43.8,1110,667,443,60.09,39.91,111,556,77,366,188,922,16.6,17.4,16.9,"25% - 50% P.O.C.","$78000 - $104000"
"36119002600","Census Tract 26, Westchester County, New York",4462,77700,194,3615,148,80,0,355,4.3,81,3.3,1.8,0,8,95.7,1274,712,562,55.89,44.11,164,548,88,474,252,1022,23,15.7,19.8,"75% or more P.O.C.","$55000 - $78000"
"36119002700","Census Tract 27, Westchester County, New York",4154,58826,45,3454,0,0,0,481,1.1,83.1,0,0,0,11.6,98.9,1146,397,749,34.64,65.36,116,281,73,676,189,957,29.2,9.7,16.5,"75% or more P.O.C.","$55000 - $78000"
"36119002800","Census Tract 28, Westchester County, New York",2222,51319,28,1972,0,62,0,160,1.3,88.7,0,2.8,0,7.2,98.7,837,280,557,33.45,66.55,82,198,21,536,103,734,29.3,3.8,12.3,"75% or more P.O.C.","Less than $55000"
"36119002900","Census Tract 29, Westchester County, New York",3798,33627,16,2828,7,0,0,940,0.4,74.5,0.2,0,0,24.7,99.6,1534,297,1237,19.36,80.64,110,187,50,1187,160,1374,37,4,10.4,"75% or more P.O.C.","Less than $55000"
"36119003000","Census Tract 30, Westchester County, New York",2995,60633,73,2443,0,124,0,309,2.4,81.6,0,4.1,0,10.3,97.6,1030,253,777,24.56,75.44,30,223,35,742,65,965,11.9,4.5,6.3,"75% or more P.O.C.","$55000 - $78000"
"36119003100","Census Tract 31, Westchester County, New York",3081,30855,12,2823,0,0,0,202,0.4,91.6,0,0,0,6.6,99.6,1307,62,1245,4.74,95.26,2,60,45,1200,47,1260,3.2,3.6,3.6,"75% or more P.O.C.","Less than $55000"
"36119003200","Census Tract 32, Westchester County, New York",2508,40000,17,1963,7,0,0,343,0.7,78.3,0.3,0,0,13.7,99.3,886,216,670,24.38,75.62,52,164,60,610,112,774,24.1,9,12.6,"75% or more P.O.C.","Less than $55000"
"36119003300","Census Tract 33, Westchester County, New York",3144,53945,60,2642,0,0,0,339,1.9,84,0,0,0,10.8,98.1,1172,551,621,47.01,52.99,75,476,64,557,139,1033,13.6,10.3,11.9,"75% or more P.O.C.","Less than $55000"
"36119003400","Census Tract 34, Westchester County, New York",4839,74132,115,4077,0,10,0,526,2.4,84.3,0,0.2,0,10.9,97.6,1567,891,676,56.86,43.14,220,671,44,632,264,1303,24.7,6.5,16.8,"75% or more P.O.C.","$55000 - $78000"
"36119003500","Census Tract 35, Westchester County, New York",1805,34489,196,1168,0,17,0,363,10.9,64.7,0,0.9,0,20.1,89.1,723,127,596,17.57,82.43,9,118,23,573,32,691,7.1,3.9,4.4,"75% or more P.O.C.","Less than $55000"
"36119003600","Census Tract 36, Westchester County, New York",3512,29470,650,1443,12,165,0,1156,18.5,41.1,0.3,4.7,0,32.9,81.5,1444,207,1237,14.34,85.66,48,159,134,1103,182,1262,23.2,10.8,12.6,"75% or more P.O.C.","Less than $55000"
"36119003700","Census Tract 37, Westchester County, New York",3404,58729,736,1524,0,65,0,1017,21.6,44.8,0,1.9,0,29.9,78.4,1419,413,1006,29.11,70.89,86,327,46,960,132,1287,20.8,4.6,9.3,"75% or more P.O.C.","$55000 - $78000"
"36119003800","Census Tract 38, Westchester County, New York",2675,59728,1251,483,8,171,0,725,46.8,18.1,0.3,6.4,0,27.1,53.2,1623,555,1068,34.2,65.8,3,552,61,1007,64,1559,0.5,5.7,3.9,"50% - 75% P.O.C.","$55000 - $78000"
"36119003900","Census Tract 39, Westchester County, New York",3703,76705,1577,1125,22,151,0,782,42.6,30.4,0.6,4.1,0,21.1,57.4,1266,673,593,53.16,46.84,130,543,9,584,139,1127,19.3,1.5,11,"50% - 75% P.O.C.","$55000 - $78000"
"36119004000","Census Tract 40, Westchester County, New York",6156,62695,1204,3366,90,106,0,1341,19.6,54.7,1.5,1.7,0,21.8,80.4,2568,304,2264,11.84,88.16,38,266,27,2237,65,2503,12.5,1.2,2.5,"75% or more P.O.C.","$55000 - $78000"
"36119004100","Census Tract 41, Westchester County, New York",4415,81206,282,3449,0,19,0,604,6.4,78.1,0,0.4,0,13.7,93.6,1533,935,598,60.99,39.01,109,826,27,571,136,1397,11.7,4.5,8.9,"75% or more P.O.C.","$78000 - $104000"
"36119004200","Census Tract 42, Westchester County, New York",4414,63736,1168,2271,0,15,0,584,26.5,51.4,0,0.3,0,13.2,73.5,2026,1383,643,68.26,31.74,26,1357,0,643,26,2000,1.9,0,1.3,"50% - 75% P.O.C.","$55000 - $78000"
"36119004300","Census Tract 43, Westchester County, New York",1836,91875,914,637,0,37,0,215,49.8,34.7,0,2,0,11.7,50.2,624,314,310,50.32,49.68,49,265,16,294,65,559,15.6,5.2,10.4,"50% - 75% P.O.C.","$78000 - $104000"
"36119004400","Census Tract 44, Westchester County, New York",3348,140463,1758,759,0,324,0,317,52.5,22.7,0,9.7,0,9.5,47.5,1162,925,237,79.6,20.4,84,841,77,160,161,1001,9.1,32.5,13.9,"25% - 50% P.O.C.","$104000 or more"
"36119004500","Census Tract 45, Westchester County, New York",1425,86643,661,500,0,26,0,223,46.4,35.1,0,1.8,0,15.6,53.6,622,231,391,37.14,62.86,12,219,15,376,27,595,5.2,3.8,4.3,"50% - 75% P.O.C.","$78000 - $104000"
"36119004600","Census Tract 46, Westchester County, New York",2958,130000,2282,1,0,352,0,245,77.1,0,0,11.9,0,8.3,22.9,1300,931,369,71.62,28.38,83,848,16,353,99,1201,8.9,4.3,7.6,"Less than 25% P.O.C.","$104000 or more"
"36119004700","Census Tract 47, Westchester County, New York",3451,250001,3000,69,0,105,0,224,86.9,2,0,3,0,6.5,13.1,912,863,49,94.63,5.37,214,649,0,49,214,698,24.8,0,23.5,"Less than 25% P.O.C.","$104000 or more"
"36119004800","Census Tract 48, Westchester County, New York",6584,90736,4549,464,0,697,0,685,69.1,7,0,10.6,0,10.4,30.9,2793,1527,1266,54.67,45.33,91,1436,0,1266,91,2702,6,0,3.3,"25% - 50% P.O.C.","$78000 - $104000"
"36119004900","Census Tract 49, Westchester County, New York",3060,88250,2303,39,36,393,0,155,75.3,1.3,1.2,12.8,0,5.1,24.7,1666,1339,327,80.37,19.63,0,1339,0,327,0,1666,0,0,0,"Less than 25% P.O.C.","$78000 - $104000"
"36119005001","Census Tract 50.01, Westchester County, New York",3836,144844,2558,88,0,584,0,392,66.7,2.3,0,15.2,0,10.2,33.3,1257,928,329,73.83,26.17,130,798,29,300,159,1098,14,8.8,12.6,"25% - 50% P.O.C.","$104000 or more"
"36119005002","Census Tract 50.02, Westchester County, New York",4459,147685,3774,30,0,468,0,146,84.6,0.7,0,10.5,0,3.3,15.4,1586,1477,109,93.13,6.87,178,1299,30,79,208,1378,12.1,27.5,13.1,"Less than 25% P.O.C.","$104000 or more"
"36119005100","Census Tract 51, Westchester County, New York",3855,85769,3147,155,9,328,0,190,81.6,4,0.2,8.5,0,4.9,18.4,1706,946,760,55.45,44.55,23,923,80,680,103,1603,2.4,10.5,6,"Less than 25% P.O.C.","$78000 - $104000"
"36119005200","Census Tract 52, Westchester County, New York",4780,169388,4251,28,0,116,0,311,88.9,0.6,0,2.4,0,6.5,11.1,1542,1366,176,88.59,11.41,186,1180,31,145,217,1325,13.6,17.6,14.1,"Less than 25% P.O.C.","$104000 or more"
"36119005300","Census Tract 53, Westchester County, New York",5222,114737,2846,696,0,594,0,885,54.5,13.3,0,11.4,0,16.9,45.5,1754,1138,616,64.88,35.12,106,1032,73,543,179,1575,9.3,11.9,10.2,"25% - 50% P.O.C.","$104000 or more"
"36119005400","Census Tract 54, Westchester County, New York",1719,250001,1264,48,0,66,0,180,73.5,2.8,0,3.8,0,10.5,26.5,531,417,114,78.53,21.47,85,332,0,114,85,446,20.4,0,16,"25% - 50% P.O.C.","$104000 or more"
"36119005500","Census Tract 55, Westchester County, New York",5569,174688,4212,374,0,309,0,529,75.6,6.7,0,5.5,0,9.5,24.4,1721,1551,170,90.12,9.88,187,1364,77,93,264,1457,12.1,45.3,15.3,"Less than 25% P.O.C.","$104000 or more"
"36119005600","Census Tract 56, Westchester County, New York",0,NA,0,0,0,0,0,0,NA,NA,NA,NA,NA,NA,NA,0,0,0,NA,NA,0,0,0,0,0,0,NA,NA,NA,"N/A","N/A"
"36119005701","Census Tract 57.01, Westchester County, New York",6730,70294,3172,1312,0,358,0,1801,47.1,19.5,0,5.3,0,26.8,52.9,2942,1453,1489,49.39,50.61,115,1338,36,1453,151,2791,7.9,2.4,5.1,"50% - 75% P.O.C.","$55000 - $78000"
"36119005702","Census Tract 57.02, Westchester County, New York",3077,64034,1332,675,0,136,0,910,43.3,21.9,0,4.4,0,29.6,56.7,1350,436,914,32.3,67.7,12,424,30,884,42,1308,2.8,3.3,3.1,"50% - 75% P.O.C.","$55000 - $78000"
"36119005800","Census Tract 58, Westchester County, New York",4929,53819,1093,496,0,101,0,3131,22.2,10.1,0,2,0,63.5,77.8,1642,496,1146,30.21,69.79,101,395,231,915,332,1310,20.4,20.2,20.2,"75% or more P.O.C.","Less than $55000"
"36119005901","Census Tract 59.01, Westchester County, New York",5254,69408,1724,623,2,529,0,2114,32.8,11.9,0,10.1,0,40.2,67.2,1828,617,1211,33.75,66.25,42,575,195,1016,237,1591,6.8,16.1,13,"50% - 75% P.O.C.","$55000 - $78000"
"36119005902","Census Tract 59.02, Westchester County, New York",5319,82415,2510,1149,0,382,0,1278,47.2,21.6,0,7.2,0,24,52.8,2475,1102,1373,44.53,55.47,71,1031,29,1344,100,2375,6.4,2.1,4,"50% - 75% P.O.C.","$78000 - $104000"
"36119006000","Census Tract 60, Westchester County, New York",4175,87625,1627,1068,0,495,0,946,39,25.6,0,11.9,0,22.7,61,1627,556,1071,34.17,65.83,61,495,42,1029,103,1524,11,3.9,6.3,"50% - 75% P.O.C.","$78000 - $104000"
"36119006100","Census Tract 61, Westchester County, New York",4713,86716,953,999,0,378,0,2303,20.2,21.2,0,8,0,48.9,79.8,1608,487,1121,30.29,69.71,145,342,156,965,301,1307,29.8,13.9,18.7,"75% or more P.O.C.","$78000 - $104000"
"36119006200","Census Tract 62, Westchester County, New York",5428,48208,1250,525,0,0,0,3440,23,9.7,0,0,0,63.4,77,1868,546,1322,29.23,70.77,33,513,220,1102,253,1615,6,16.6,13.5,"75% or more P.O.C.","Less than $55000"
"36119006300","Census Tract 63, Westchester County, New York",6378,34189,1176,1759,0,208,25,2793,18.4,27.6,0,3.3,0.4,43.8,81.6,2320,436,1884,18.79,81.21,108,328,46,1838,154,2166,24.8,2.4,6.6,"75% or more P.O.C.","Less than $55000"
"36119006400","Census Tract 64, Westchester County, New York",5958,64764,929,3028,0,105,0,1777,15.6,50.8,0,1.8,0,29.8,84.4,1954,805,1149,41.2,58.8,141,664,109,1040,250,1704,17.5,9.5,12.8,"75% or more P.O.C.","$55000 - $78000"
"36119006500","Census Tract 65, Westchester County, New York",4908,67500,1911,1331,0,238,0,1251,38.9,27.1,0,4.8,0,25.5,61.1,1634,960,674,58.75,41.25,130,830,121,553,251,1383,13.5,18,15.4,"50% - 75% P.O.C.","$55000 - $78000"
"36119006600","Census Tract 66, Westchester County, New York",6203,123910,4220,831,0,320,0,676,68,13.4,0,5.2,0,10.9,32,1937,1540,397,79.5,20.5,177,1363,42,355,219,1718,11.5,10.6,11.3,"25% - 50% P.O.C.","$104000 or more"
"36119006700","Census Tract 67, Westchester County, New York",5226,209414,3830,482,0,239,0,619,73.3,9.2,0,4.6,0,11.8,26.7,1557,1523,34,97.82,2.18,252,1271,12,22,264,1293,16.5,35.3,17,"25% - 50% P.O.C.","$104000 or more"
"36119006801","Census Tract 68.01, Westchester County, New York",5237,190104,4315,177,0,383,0,312,82.4,3.4,0,7.3,0,6,17.6,1732,1652,80,95.38,4.62,245,1407,12,68,257,1475,14.8,15,14.8,"Less than 25% P.O.C.","$104000 or more"
"36119006802","Census Tract 68.02, Westchester County, New York",5532,179408,4405,336,0,170,0,554,79.6,6.1,0,3.1,0,10,20.4,2107,1996,111,94.73,5.27,132,1864,0,111,132,1975,6.6,0,6.3,"Less than 25% P.O.C.","$104000 or more"
"36119006900","Census Tract 69, Westchester County, New York",6390,207778,5355,61,0,376,0,439,83.8,1,0,5.9,0,6.9,16.2,2126,1831,295,86.12,13.88,161,1670,54,241,215,1911,8.8,18.3,10.1,"Less than 25% P.O.C.","$104000 or more"
"36119007000","Census Tract 70, Westchester County, New York",5733,129632,4853,37,0,267,0,429,84.7,0.6,0,4.7,0,7.5,15.3,2192,1885,307,85.99,14.01,171,1714,0,307,171,2021,9.1,0,7.8,"Less than 25% P.O.C.","$104000 or more"
"36119007100","Census Tract 71, Westchester County, New York",6096,215375,4849,38,0,461,0,603,79.5,0.6,0,7.6,0,9.9,20.5,2133,1660,473,77.82,22.18,209,1451,26,447,235,1898,12.6,5.5,11,"Less than 25% P.O.C.","$104000 or more"
"36119007200","Census Tract 72, Westchester County, New York",6622,103555,4590,224,0,186,0,1503,69.3,3.4,0,2.8,0,22.7,30.7,2647,1711,936,64.64,35.36,71,1640,56,880,127,2520,4.1,6,4.8,"25% - 50% P.O.C.","$78000 - $104000"
"36119007300","Census Tract 73, Westchester County, New York",4829,88306,2496,120,0,113,0,2100,51.7,2.5,0,2.3,0,43.5,48.3,1633,681,952,41.7,58.3,130,551,161,791,291,1342,19.1,16.9,17.8,"25% - 50% P.O.C.","$78000 - $104000"
"36119007401","Census Tract 74.01, Westchester County, New York",4707,91375,2797,536,0,252,0,1049,59.4,11.4,0,5.4,0,22.3,40.6,1657,901,756,54.38,45.62,74,827,87,669,161,1496,8.2,11.5,9.7,"25% - 50% P.O.C.","$78000 - $104000"
"36119007402","Census Tract 74.02, Westchester County, New York",3059,144397,2561,37,0,206,0,131,83.7,1.2,0,6.7,0,4.3,16.3,1054,806,248,76.47,23.53,53,753,74,174,127,927,6.6,29.8,12,"Less than 25% P.O.C.","$104000 or more"
"36119007500","Census Tract 75, Westchester County, New York",4727,229617,3872,23,0,286,0,335,81.9,0.5,0,6.1,0,7.1,18.1,1605,1203,402,74.95,25.05,313,890,11,391,324,1281,26,2.7,20.2,"Less than 25% P.O.C.","$104000 or more"
"36119007600","Census Tract 76, Westchester County, New York",5809,207813,5218,26,120,103,0,288,89.8,0.4,2.1,1.8,0,5,10.2,1942,1738,204,89.5,10.5,281,1457,28,176,309,1633,16.2,13.7,15.9,"Less than 25% P.O.C.","$104000 or more"
"36119007700","Census Tract 77, Westchester County, New York",5284,139868,4019,112,0,483,0,435,76.1,2.1,0,9.1,0,8.2,23.9,1944,1066,878,54.84,45.16,96,970,66,812,162,1782,9,7.5,8.3,"Less than 25% P.O.C.","$104000 or more"
"36119007800","Census Tract 78, Westchester County, New York",4616,60000,943,244,8,37,0,3320,20.4,5.3,0.2,0.8,0,71.9,79.6,1224,287,937,23.45,76.55,120,167,139,798,259,965,41.8,14.8,21.2,"75% or more P.O.C.","$55000 - $78000"
"36119007900","Census Tract 79, Westchester County, New York",7693,65300,1740,138,0,280,0,5476,22.6,1.8,0,3.6,0,71.2,77.4,2296,795,1501,34.63,65.37,132,663,361,1140,493,1803,16.6,24.1,21.5,"75% or more P.O.C.","$55000 - $78000"
"36119008000","Census Tract 80, Westchester County, New York",5217,53750,737,233,0,9,0,4211,14.1,4.5,0,0.2,0,80.7,85.9,1551,224,1327,14.44,85.56,49,175,300,1027,349,1202,21.9,22.6,22.5,"75% or more P.O.C.","Less than $55000"
"36119008100","Census Tract 81, Westchester County, New York",4245,83720,1356,176,0,34,9,2658,31.9,4.1,0,0.8,0.2,62.6,68.1,1562,913,649,58.45,41.55,78,835,95,554,173,1389,8.5,14.6,11.1,"50% - 75% P.O.C.","$78000 - $104000"
"36119008200","Census Tract 82, Westchester County, New York",7571,102052,4215,100,0,152,0,3090,55.7,1.3,0,2,0,40.8,44.3,2439,1731,708,70.97,29.03,216,1515,58,650,274,2165,12.5,8.2,11.2,"25% - 50% P.O.C.","$78000 - $104000"
"36119008301","Census Tract 83.01, Westchester County, New York",2986,115283,1456,117,14,129,0,1198,48.8,3.9,0.5,4.3,0,40.1,51.2,1058,796,262,75.24,24.76,28,768,0,262,28,1030,3.5,0,2.6,"50% - 75% P.O.C.","$104000 or more"
"36119008302","Census Tract 83.02, Westchester County, New York",6501,185625,5619,21,0,472,0,293,86.4,0.3,0,7.3,0,4.5,13.6,2360,2001,359,84.79,15.21,110,1891,0,359,110,2250,5.5,0,4.7,"Less than 25% P.O.C.","$104000 or more"
"36119008401","Census Tract 84.01, Westchester County, New York",2080,242031,1721,22,0,91,0,165,82.7,1.1,0,4.4,0,7.9,17.3,709,624,85,88.01,11.99,63,561,7,78,70,639,10.1,8.2,9.9,"Less than 25% P.O.C.","$104000 or more"
"36119008403","Census Tract 84.03, Westchester County, New York",4146,102939,2887,157,0,492,0,543,69.6,3.8,0,11.9,0,13.1,30.4,1406,757,649,53.84,46.16,89,668,54,595,143,1263,11.8,8.3,10.2,"25% - 50% P.O.C.","$78000 - $104000"
"36119008404","Census Tract 84.04, Westchester County, New York",5191,101500,3401,64,102,926,0,698,65.5,1.2,2,17.8,0,13.4,34.5,2076,910,1166,43.83,56.17,124,786,50,1116,174,1902,13.6,4.3,8.4,"25% - 50% P.O.C.","$78000 - $104000"
"36119008500","Census Tract 85, Westchester County, New York",3374,250001,3061,2,0,160,0,128,90.7,0.1,0,4.7,0,3.8,9.3,1116,991,125,88.8,11.2,149,842,11,114,160,956,15,8.8,14.3,"Less than 25% P.O.C.","$104000 or more"
"36119008602","Census Tract 86.02, Westchester County, New York",5609,217083,4248,319,6,359,0,456,75.7,5.7,0.1,6.4,0,8.1,24.3,1287,1179,108,91.61,8.39,131,1048,63,45,194,1093,11.1,58.3,15.1,"Less than 25% P.O.C.","$104000 or more"
"36119008700","Census Tract 87, Westchester County, New York",5375,96206,3673,366,0,122,0,1192,68.3,6.8,0,2.3,0,22.2,31.7,1818,1144,674,62.93,37.07,111,1033,130,544,241,1577,9.7,19.3,13.3,"25% - 50% P.O.C.","$78000 - $104000"
"36119008800","Census Tract 88, Westchester County, New York",3912,73977,1800,447,0,574,0,1030,46,11.4,0,14.7,0,26.3,54,1991,943,1048,47.36,52.64,0,943,134,914,134,1857,0,12.8,6.7,"50% - 75% P.O.C.","$55000 - $78000"
"36119008901","Census Tract 89.01, Westchester County, New York",5854,81576,3139,603,0,711,0,1350,53.6,10.3,0,12.1,0,23.1,46.4,2663,1181,1482,44.35,55.65,66,1115,23,1459,89,2574,5.6,1.6,3.3,"25% - 50% P.O.C.","$78000 - $104000"
"36119008902","Census Tract 89.02, Westchester County, New York",4034,86146,1391,519,25,363,0,1630,34.5,12.9,0.6,9,0,40.4,65.5,1420,597,823,42.04,57.96,37,560,80,743,117,1303,6.2,9.7,8.2,"50% - 75% P.O.C.","$78000 - $104000"
"36119009000","Census Tract 90, Westchester County, New York",4163,93723,1509,718,0,401,0,1443,36.2,17.2,0,9.6,0,34.7,63.8,1700,771,929,45.35,54.65,28,743,100,829,128,1572,3.6,10.8,7.5,"50% - 75% P.O.C.","$78000 - $104000"
"36119009100","Census Tract 91, Westchester County, New York",6085,76389,1471,981,0,468,0,3125,24.2,16.1,0,7.7,0,51.4,75.8,2006,938,1068,46.76,53.24,88,850,270,798,358,1648,9.4,25.3,17.8,"75% or more P.O.C.","$55000 - $78000"
"36119009200","Census Tract 92, Westchester County, New York",7279,71875,1853,819,0,266,0,4232,25.5,11.3,0,3.7,0,58.1,74.5,2190,752,1438,34.34,65.66,148,604,247,1191,395,1795,19.7,17.2,18,"50% - 75% P.O.C.","$55000 - $78000"
"36119009300","Census Tract 93, Westchester County, New York",2968,31775,648,594,0,439,0,1287,21.8,20,0,14.8,0,43.4,78.2,1430,384,1046,26.85,73.15,11,373,53,993,64,1366,2.9,5.1,4.5,"75% or more P.O.C.","Less than $55000"
"36119009400","Census Tract 94, Westchester County, New York",3866,70556,1130,352,0,352,0,1981,29.2,9.1,0,9.1,0,51.2,70.8,1726,472,1254,27.35,72.65,37,435,98,1156,135,1591,7.8,7.8,7.8,"50% - 75% P.O.C.","$55000 - $78000"
"36119009500","Census Tract 95, Westchester County, New York",5538,91827,2571,679,0,376,0,1438,46.4,12.3,0,6.8,0,26,53.6,2393,985,1408,41.16,58.84,97,888,51,1357,148,2245,9.8,3.6,6.2,"50% - 75% P.O.C.","$78000 - $104000"
"36119009600","Census Tract 96, Westchester County, New York",4419,175362,3443,280,0,245,0,337,77.9,6.3,0,5.5,0,7.6,22.1,1507,1409,98,93.5,6.5,195,1214,9,89,204,1303,13.8,9.2,13.5,"Less than 25% P.O.C.","$104000 or more"
"36119009701","Census Tract 97.01, Westchester County, New York",3021,166037,2431,102,0,134,0,262,80.5,3.4,0,4.4,0,8.7,19.5,1116,964,152,86.38,13.62,60,904,9,143,69,1047,6.2,5.9,6.2,"Less than 25% P.O.C.","$104000 or more"
"36119009702","Census Tract 97.02, Westchester County, New York",2850,104444,2147,190,0,73,0,437,75.3,6.7,0,2.6,0,15.3,24.7,1076,954,122,88.66,11.34,47,907,0,122,47,1029,4.9,0,4.4,"Less than 25% P.O.C.","$104000 or more"
"36119009703","Census Tract 97.03, Westchester County, New York",4148,182132,3437,176,0,120,0,283,82.9,4.2,0,2.9,0,6.8,17.1,1451,1386,65,95.52,4.48,121,1265,9,56,130,1321,8.7,13.8,9,"Less than 25% P.O.C.","$104000 or more"
"36119009800","Census Tract 98, Westchester County, New York",4545,250001,3483,12,0,554,6,353,76.6,0.3,0,12.2,0.1,7.8,23.4,1430,1320,110,92.31,7.69,229,1091,39,71,268,1162,17.3,35.5,18.7,"Less than 25% P.O.C.","$104000 or more"
"36119009900","Census Tract 99, Westchester County, New York",3012,250001,2390,0,0,340,0,187,79.3,0,0,11.3,0,6.2,20.7,919,896,23,97.5,2.5,125,771,5,18,130,789,14,21.7,14.1,"Less than 25% P.O.C.","$104000 or more"
"36119010000","Census Tract 100, Westchester County, New York",5643,250001,4362,2,0,940,0,229,77.3,0,0,16.7,0,4.1,22.7,1756,1672,84,95.22,4.78,298,1374,40,44,338,1418,17.8,47.6,19.2,"Less than 25% P.O.C.","$104000 or more"
"36119010100","Census Tract 101, Westchester County, New York",4637,250001,3032,209,0,843,0,300,65.4,4.5,0,18.2,0,6.5,34.6,1472,1146,326,77.85,22.15,165,981,25,301,190,1282,14.4,7.7,12.9,"25% - 50% P.O.C.","$104000 or more"
"36119010200","Census Tract 102, Westchester County, New York",4698,205125,3933,54,0,254,0,284,83.7,1.1,0,5.4,0,6,16.3,1540,1445,95,93.83,6.17,75,1370,0,95,75,1465,5.2,0,4.9,"Less than 25% P.O.C.","$104000 or more"
"36119010300","Census Tract 103, Westchester County, New York",3223,98242,2541,170,0,158,0,242,78.8,5.3,0,4.9,0,7.5,21.2,1335,799,536,59.85,40.15,17,782,29,507,46,1289,2.1,5.4,3.4,"Less than 25% P.O.C.","$78000 - $104000"
"36119010400","Census Tract 104, Westchester County, New York",4119,150560,2673,265,27,194,0,762,64.9,6.4,0.7,4.7,0,18.5,35.1,1327,709,618,53.43,46.57,51,658,29,589,80,1247,7.2,4.7,6,"25% - 50% P.O.C.","$104000 or more"
"36119010500","Census Tract 105, Westchester County, New York",6951,136902,5155,612,0,458,0,475,74.2,8.8,0,6.6,0,6.8,25.8,2343,1564,779,66.75,33.25,118,1446,41,738,159,2184,7.5,5.3,6.8,"25% - 50% P.O.C.","$104000 or more"
"36119010600","Census Tract 106, Westchester County, New York",4512,160880,3146,146,9,590,0,388,69.7,3.2,0.2,13.1,0,8.6,30.3,1601,1292,309,80.7,19.3,68,1224,0,309,68,1533,5.3,0,4.2,"25% - 50% P.O.C.","$104000 or more"
"36119010701","Census Tract 107.01, Westchester County, New York",6273,219545,4431,56,6,1280,0,305,70.6,0.9,0.1,20.4,0,4.9,29.4,1996,1924,72,96.39,3.61,218,1706,0,72,218,1778,11.3,0,10.9,"25% - 50% P.O.C.","$104000 or more"
"36119010702","Census Tract 107.02, Westchester County, New York",5106,121031,3217,90,0,1468,0,258,63,1.8,0,28.8,0,5.1,37,2209,1800,409,81.48,18.52,134,1666,27,382,161,2048,7.4,6.6,7.3,"25% - 50% P.O.C.","$104000 or more"
"36119010801","Census Tract 108.01, Westchester County, New York",2999,141250,2027,129,19,363,0,337,67.6,4.3,0.6,12.1,0,11.2,32.4,1192,1020,172,85.57,14.43,106,914,0,172,106,1086,10.4,0,8.9,"25% - 50% P.O.C.","$104000 or more"
"36119010803","Census Tract 108.03, Westchester County, New York",3519,92813,2015,492,0,329,0,598,57.3,14,0,9.3,0,17,42.7,1836,1476,360,80.39,19.61,67,1409,0,360,67,1769,4.5,0,3.6,"25% - 50% P.O.C.","$78000 - $104000"
"36119010804","Census Tract 108.04, Westchester County, New York",2726,132011,1489,367,0,212,0,558,54.6,13.5,0,7.8,0,20.5,45.4,1161,993,168,85.53,14.47,51,942,0,168,51,1110,5.1,0,4.4,"25% - 50% P.O.C.","$104000 or more"
"36119010901","Census Tract 109.01, Westchester County, New York",2160,123750,1218,506,4,102,0,280,56.4,23.4,0.2,4.7,0,13,43.6,737,533,204,72.32,27.68,64,469,7,197,71,666,12,3.4,9.6,"25% - 50% P.O.C.","$104000 or more"
"36119010902","Census Tract 109.02, Westchester County, New York",5732,118938,2035,1424,0,750,0,1459,35.5,24.8,0,13.1,0,25.5,64.5,2276,1737,539,76.32,23.68,37,1700,23,516,60,2216,2.1,4.3,2.6,"50% - 75% P.O.C.","$104000 or more"
"36119010903","Census Tract 109.03, Westchester County, New York",5257,81463,955,2628,0,266,0,1379,18.2,50,0,5.1,0,26.2,81.8,1792,954,838,53.24,46.76,124,830,69,769,193,1599,13,8.2,10.8,"75% or more P.O.C.","$78000 - $104000"
"36119011000","Census Tract 110, Westchester County, New York",2663,104554,772,1201,0,138,0,397,29,45.1,0,5.2,0,14.9,71,761,566,195,74.38,25.62,77,489,52,143,129,632,13.6,26.7,17,"50% - 75% P.O.C.","$104000 or more"
"36119011101","Census Tract 111.01, Westchester County, New York",6268,125217,3135,932,24,989,0,912,50,14.9,0.4,15.8,0,14.6,50,2466,1376,1090,55.8,44.2,193,1183,23,1067,216,2250,14,2.1,8.8,"50% - 75% P.O.C.","$104000 or more"
"36119011102","Census Tract 111.02, Westchester County, New York",2839,175852,1804,204,25,391,0,323,63.5,7.2,0.9,13.8,0,11.4,36.5,935,885,50,94.65,5.35,65,820,16,34,81,854,7.3,32,8.7,"25% - 50% P.O.C.","$104000 or more"
"36119011200","Census Tract 112, Westchester County, New York",4372,96458,893,1117,0,227,0,2088,20.4,25.5,0,5.2,0,47.8,79.6,1225,765,460,62.45,37.55,141,624,147,313,288,937,18.4,32,23.5,"75% or more P.O.C.","$78000 - $104000"
"36119011300","Census Tract 113, Westchester County, New York",6529,139917,5486,12,0,472,17,399,84,0.2,0,7.2,0.3,6.1,16,2366,1898,468,80.22,19.78,282,1616,0,468,282,2084,14.9,0,11.9,"Less than 25% P.O.C.","$104000 or more"
"36119011400","Census Tract 114, Westchester County, New York",5758,162007,4092,353,0,748,0,491,71.1,6.1,0,13,0,8.5,28.9,2253,1615,638,71.68,28.32,145,1470,62,576,207,2046,9,9.7,9.2,"25% - 50% P.O.C.","$104000 or more"
"36119011500","Census Tract 115, Westchester County, New York",5678,93924,2790,227,0,178,0,2470,49.1,4,0,3.1,0,43.5,50.9,2207,1123,1084,50.88,49.12,32,1091,124,960,156,2051,2.8,11.4,7.1,"50% - 75% P.O.C.","$78000 - $104000"
"36119011600","Census Tract 116, Westchester County, New York",6779,47424,2148,194,0,45,0,4122,31.7,2.9,0,0.7,0,60.8,68.3,2566,438,2128,17.07,82.93,19,419,248,1880,267,2299,4.3,11.7,10.4,"50% - 75% P.O.C.","Less than $55000"
"36119011700","Census Tract 117, Westchester County, New York",3263,155385,2280,14,0,110,0,707,69.9,0.4,0,3.4,0,21.7,30.1,1166,868,298,74.44,25.56,62,806,57,241,119,1047,7.1,19.1,10.2,"25% - 50% P.O.C.","$104000 or more"
"36119011800","Census Tract 118, Westchester County, New York",5704,217500,4715,101,0,208,0,436,82.7,1.8,0,3.6,0,7.6,17.3,1616,1426,190,88.24,11.76,124,1302,57,133,181,1435,8.7,30,11.2,"Less than 25% P.O.C.","$104000 or more"
"36119011902","Census Tract 119.02, Westchester County, New York",4808,125563,3528,264,0,247,0,671,73.4,5.5,0,5.1,0,14,26.6,1581,1240,341,78.43,21.57,142,1098,66,275,208,1373,11.5,19.4,13.2,"25% - 50% P.O.C.","$104000 or more"
"36119012000","Census Tract 120, Westchester County, New York",4628,103281,3702,175,0,261,0,461,80,3.8,0,5.6,0,10,20,1598,1371,227,85.79,14.21,70,1301,24,203,94,1504,5.1,10.6,5.9,"Less than 25% P.O.C.","$78000 - $104000"
"36119012101","Census Tract 121.01, Westchester County, New York",5657,192500,4895,108,0,294,0,258,86.5,1.9,0,5.2,0,4.6,13.5,1770,1739,31,98.25,1.75,268,1471,0,31,268,1502,15.4,0,15.1,"Less than 25% P.O.C.","$104000 or more"
"36119012102","Census Tract 121.02, Westchester County, New York",4729,126719,3610,169,0,228,0,687,76.3,3.6,0,4.8,0,14.5,23.7,1513,1178,335,77.86,22.14,195,983,34,301,229,1284,16.6,10.1,15.1,"Less than 25% P.O.C.","$104000 or more"
"36119012200","Census Tract 122, Westchester County, New York",7221,128958,5114,310,0,214,0,1353,70.8,4.3,0,3,0,18.7,29.2,2417,1879,538,77.74,22.26,238,1641,12,526,250,2167,12.7,2.2,10.3,"25% - 50% P.O.C.","$104000 or more"
"36119012301","Census Tract 123.01, Westchester County, New York",2633,107045,1444,116,4,157,0,848,54.8,4.4,0.2,6,0,32.2,45.2,876,602,274,68.72,31.28,88,514,4,270,92,784,14.6,1.5,10.5,"25% - 50% P.O.C.","$104000 or more"
"36119012303","Census Tract 123.03, Westchester County, New York",4908,210455,4061,0,0,246,0,496,82.7,0,0,5,0,10.1,17.3,1664,1487,177,89.36,10.64,147,1340,0,177,147,1517,9.9,0,8.8,"Less than 25% P.O.C.","$104000 or more"
"36119012304","Census Tract 123.04, Westchester County, New York",4694,214453,4088,60,0,258,0,188,87.1,1.3,0,5.5,0,4,12.9,1552,1469,83,94.65,5.35,183,1286,0,83,183,1369,12.5,0,11.8,"Less than 25% P.O.C.","$104000 or more"
"36119012400","Census Tract 124, Westchester County, New York",5177,204778,4546,102,0,121,0,282,87.8,2,0,2.3,0,5.4,12.2,1884,1686,198,89.49,10.51,97,1589,0,198,97,1787,5.8,0,5.1,"Less than 25% P.O.C.","$104000 or more"
"36119012501","Census Tract 125.01, Westchester County, New York",3230,155000,2722,45,0,69,0,394,84.3,1.4,0,2.1,0,12.2,15.7,1108,981,127,88.54,11.46,42,939,36,91,78,1030,4.3,28.3,7,"Less than 25% P.O.C.","$104000 or more"
"36119012502","Census Tract 125.02, Westchester County, New York",5684,170313,4875,163,16,272,0,205,85.8,2.9,0.3,4.8,0,3.6,14.2,2077,2015,62,97.01,2.99,124,1891,0,62,124,1953,6.2,0,6,"Less than 25% P.O.C.","$104000 or more"
"36119012503","Census Tract 125.03, Westchester County, New York",3685,152946,3288,2,0,105,0,253,89.2,0.1,0,2.8,0,6.9,10.8,1518,1322,196,87.09,12.91,85,1237,0,196,85,1433,6.4,0,5.6,"Less than 25% P.O.C.","$104000 or more"
"36119012600","Census Tract 126, Westchester County, New York",4367,176125,3886,62,0,129,0,165,89,1.4,0,3,0,3.8,11,1537,1314,223,85.49,14.51,134,1180,0,223,134,1403,10.2,0,8.7,"Less than 25% P.O.C.","$104000 or more"
"36119012700","Census Tract 127, Westchester County, New York",5012,184839,4031,115,0,177,0,651,80.4,2.3,0,3.5,0,13,19.6,1584,1354,230,85.48,14.52,176,1178,56,174,232,1352,13,24.3,14.6,"Less than 25% P.O.C.","$104000 or more"
"36119012802","Census Tract 128.02, Westchester County, New York",7136,86771,4609,114,0,283,0,1972,64.6,1.6,0,4,0,27.6,35.4,2757,1797,960,65.18,34.82,190,1607,96,864,286,2471,10.6,10,10.4,"25% - 50% P.O.C.","$78000 - $104000"
"36119012900","Census Tract 129, Westchester County, New York",4279,71796,1623,280,0,280,0,2025,37.9,6.5,0,6.5,0,47.3,62.1,1724,831,893,48.2,51.8,39,792,163,730,202,1522,4.7,18.3,11.7,"50% - 75% P.O.C.","$55000 - $78000"
"36119013000","Census Tract 130, Westchester County, New York",6587,98929,3643,136,0,240,0,2507,55.3,2.1,0,3.6,0,38.1,44.7,2202,1558,644,70.75,29.25,183,1375,219,425,402,1800,11.7,34,18.3,"25% - 50% P.O.C.","$78000 - $104000"
"36119013102","Census Tract 131.02, Westchester County, New York",6439,250001,5386,26,0,644,0,121,83.6,0.4,0,10,0,1.9,16.4,2148,1997,151,92.97,7.03,193,1804,32,119,225,1923,9.7,21.2,10.5,"Less than 25% P.O.C.","$104000 or more"
"36119013103","Census Tract 131.03, Westchester County, New York",5332,204097,4629,89,5,293,0,212,86.8,1.7,0.1,5.5,0,4,13.2,1771,1607,164,90.74,9.26,124,1483,9,155,133,1638,7.7,5.5,7.5,"Less than 25% P.O.C.","$104000 or more"
"36119013104","Census Tract 131.04, Westchester County, New York",6134,250001,5080,352,0,554,0,119,82.8,5.7,0,9,0,1.9,17.2,1961,1878,83,95.77,4.23,208,1670,18,65,226,1735,11.1,21.7,11.5,"Less than 25% P.O.C.","$104000 or more"
"36119013201","Census Tract 132.01, Westchester County, New York",4017,250001,3142,74,0,224,7,418,78.2,1.8,0,5.6,0.2,10.4,21.8,1272,1211,61,95.2,4.8,128,1083,0,61,128,1144,10.6,0,10.1,"Less than 25% P.O.C.","$104000 or more"
"36119013202","Census Tract 132.02, Westchester County, New York",3018,117188,2585,74,0,159,0,138,85.7,2.5,0,5.3,0,4.6,14.3,1244,867,377,69.69,30.31,54,813,0,377,54,1190,6.2,0,4.3,"Less than 25% P.O.C.","$104000 or more"
"36119013301","Census Tract 133.01, Westchester County, New York",3331,64242,729,527,0,114,0,1924,21.9,15.8,0,3.4,0,57.8,78.1,1310,500,810,38.17,61.83,82,418,32,778,114,1196,16.4,4,8.7,"75% or more P.O.C.","$55000 - $78000"
"36119013304","Census Tract 133.04, Westchester County, New York",4957,69632,1211,557,0,75,0,2988,24.4,11.2,0,1.5,0,60.3,75.6,1707,1001,706,58.64,41.36,141,860,93,613,234,1473,14.1,13.2,13.7,"75% or more P.O.C.","$55000 - $78000"
"36119013400","Census Tract 134, Westchester County, New York",6722,66485,2700,595,0,666,0,2601,40.2,8.9,0,9.9,0,38.7,59.8,2663,1292,1371,48.52,51.48,87,1205,139,1232,226,2437,6.7,10.1,8.5,"50% - 75% P.O.C.","$55000 - $78000"
"36119013500","Census Tract 135, Westchester County, New York",4010,101042,2125,191,0,139,0,1536,53,4.8,0,3.5,0,38.3,47,1315,866,449,65.86,34.14,134,732,82,367,216,1099,15.5,18.3,16.4,"25% - 50% P.O.C.","$78000 - $104000"
"36119013600","Census Tract 136, Westchester County, New York",4343,67455,1912,475,0,231,0,1583,44,10.9,0,5.3,0,36.4,56,1812,957,855,52.81,47.19,43,914,103,752,146,1666,4.5,12,8.1,"50% - 75% P.O.C.","$55000 - $78000"
"36119013700","Census Tract 137, Westchester County, New York",5521,130403,3726,506,0,331,0,761,67.5,9.2,0,6,0,13.8,32.5,2124,1882,242,88.61,11.39,24,1858,0,242,24,2100,1.3,0,1.1,"25% - 50% P.O.C.","$104000 or more"
"36119013800","Census Tract 138, Westchester County, New York",3344,146488,2844,60,0,146,0,204,85,1.8,0,4.4,0,6.1,15,1178,1003,175,85.14,14.86,66,937,19,156,85,1093,6.6,10.9,7.2,"Less than 25% P.O.C.","$104000 or more"
"36119013900","Census Tract 139, Westchester County, New York",4811,117500,3223,281,0,146,0,1004,67,5.8,0,3,0,20.9,33,1760,1201,559,68.24,31.76,87,1114,15,544,102,1658,7.2,2.7,5.8,"25% - 50% P.O.C.","$104000 or more"
"36119014000","Census Tract 140, Westchester County, New York",2140,109375,1613,144,5,8,0,322,75.4,6.7,0.2,0.4,0,15,24.6,728,564,164,77.47,22.53,54,510,15,149,69,659,9.6,9.1,9.5,"Less than 25% P.O.C.","$104000 or more"
"36119014100","Census Tract 141, Westchester County, New York",6373,49614,1907,1458,20,127,0,2567,29.9,22.9,0.3,2,0,40.3,70.1,2465,929,1536,37.69,62.31,98,831,0,1536,98,2367,10.5,0,4,"50% - 75% P.O.C.","Less than $55000"
"36119014200","Census Tract 142, Westchester County, New York",3539,54668,985,707,0,9,0,1772,27.8,20,0,0.3,0,50.1,72.2,1301,486,815,37.36,62.64,29,457,95,720,124,1177,6,11.7,9.5,"50% - 75% P.O.C.","Less than $55000"
"36119014300","Census Tract 143, Westchester County, New York",3984,34794,585,1311,0,1,0,1923,14.7,32.9,0,0,0,48.3,85.3,1439,171,1268,11.88,88.12,9,162,146,1122,155,1284,5.3,11.5,10.8,"75% or more P.O.C.","Less than $55000"
"36119014400","Census Tract 144, Westchester County, New York",6270,86307,1125,1424,13,98,0,3553,17.9,22.7,0.2,1.6,0,56.7,82.1,2201,1261,940,57.29,42.71,44,1217,211,729,255,1946,3.5,22.4,11.6,"75% or more P.O.C.","$78000 - $104000"
"36119014500","Census Tract 145, Westchester County, New York",3909,78875,2420,450,0,270,0,658,61.9,11.5,0,6.9,0,16.8,38.1,1996,1474,522,73.85,26.15,38,1436,0,522,38,1958,2.6,0,1.9,"25% - 50% P.O.C.","$78000 - $104000"
"36119014604","Census Tract 146.04, Westchester County, New York",4438,90938,3544,124,0,24,0,627,79.9,2.8,0,0.5,0,14.1,20.1,1635,1158,477,70.83,29.17,112,1046,9,468,121,1514,9.7,1.9,7.4,"Less than 25% P.O.C.","$78000 - $104000"
"36119014605","Census Tract 146.05, Westchester County, New York",3376,70302,2152,194,0,317,0,661,63.7,5.7,0,9.4,0,19.6,36.3,1618,519,1099,32.08,67.92,30,489,65,1034,95,1523,5.8,5.9,5.9,"25% - 50% P.O.C.","$55000 - $78000"
"36119014606","Census Tract 146.06, Westchester County, New York",5835,188913,4982,187,0,256,7,366,85.4,3.2,0,4.4,0.1,6.3,14.6,1924,1817,107,94.44,5.56,166,1651,12,95,178,1746,9.1,11.2,9.3,"Less than 25% P.O.C.","$104000 or more"
"36119014607","Census Tract 146.07, Westchester County, New York",4283,148670,2905,257,0,192,0,809,67.8,6,0,4.5,0,18.9,32.2,1336,1227,109,91.84,8.16,135,1092,0,109,135,1201,11,0,10.1,"25% - 50% P.O.C.","$104000 or more"
"36119014701","Census Tract 147.01, Westchester County, New York",5009,104783,2807,360,8,137,0,1445,56,7.2,0.2,2.7,0,28.8,44,1734,1533,201,88.41,11.59,182,1351,25,176,207,1527,11.9,12.4,11.9,"25% - 50% P.O.C.","$104000 or more"
"36119014703","Census Tract 147.03, Westchester County, New York",6271,124509,3901,155,0,22,0,1971,62.2,2.5,0,0.4,0,31.4,37.8,2056,1770,286,86.09,13.91,161,1609,24,262,185,1871,9.1,8.4,9,"25% - 50% P.O.C.","$104000 or more"
"36119014704","Census Tract 147.04, Westchester County, New York",2480,81500,1474,192,0,64,0,654,59.4,7.7,0,2.6,0,26.4,40.6,842,533,309,63.3,36.7,66,467,37,272,103,739,12.4,12,12.2,"25% - 50% P.O.C.","$78000 - $104000"
"36119014804","Census Tract 148.04, Westchester County, New York",8669,119453,5542,224,0,504,0,2376,63.9,2.6,0,5.8,0,27.4,36.1,3003,2104,899,70.06,29.94,149,1955,78,821,227,2776,7.1,8.7,7.6,"25% - 50% P.O.C.","$104000 or more"
"36119014805","Census Tract 148.05, Westchester County, New York",4406,139766,3109,434,0,136,0,577,70.6,9.9,0,3.1,0,13.1,29.4,1457,1306,151,89.64,10.36,122,1184,0,151,122,1335,9.3,0,8.4,"25% - 50% P.O.C.","$104000 or more"
"36119014806","Census Tract 148.06, Westchester County, New York",6528,143125,4841,319,212,217,0,814,74.2,4.9,3.2,3.3,0,12.5,25.8,2211,2005,206,90.68,9.32,207,1798,40,166,247,1964,10.3,19.4,11.2,"25% - 50% P.O.C.","$104000 or more"
"36119014808","Census Tract 148.08, Westchester County, New York",3661,136058,3041,64,0,357,0,194,83.1,1.7,0,9.8,0,5.3,16.9,1171,1053,118,89.92,10.08,194,859,9,109,203,968,18.4,7.6,17.3,"Less than 25% P.O.C.","$104000 or more"
"36119014809","Census Tract 148.09, Westchester County, New York",5597,102861,4170,161,0,456,12,732,74.5,2.9,0,8.1,0.2,13.1,25.5,2116,1646,470,77.79,22.21,237,1409,9,461,246,1870,14.4,1.9,11.6,"25% - 50% P.O.C.","$78000 - $104000"
"36119014810","Census Tract 148.10, Westchester County, New York",2021,59327,1811,30,0,0,0,180,89.6,1.5,0,0,0,8.9,10.4,1198,1037,161,86.56,13.44,29,1008,0,161,29,1169,2.8,0,2.4,"Less than 25% P.O.C.","$55000 - $78000"
"36119014811","Census Tract 148.11, Westchester County, New York",5656,145893,4560,269,0,387,0,313,80.6,4.8,0,6.8,0,5.5,19.4,1829,1791,38,97.92,2.08,261,1530,14,24,275,1554,14.6,36.8,15,"Less than 25% P.O.C.","$104000 or more"
"36119014901","Census Tract 149.01, Westchester County, New York",6222,161875,5386,62,84,183,0,431,86.6,1,1.4,2.9,0,6.9,13.4,1980,1836,144,92.73,7.27,224,1612,5,139,229,1751,12.2,3.5,11.6,"Less than 25% P.O.C.","$104000 or more"
"36119014903","Census Tract 149.03, Westchester County, New York",4191,84491,4043,9,0,55,0,84,96.5,0.2,0,1.3,0,2,3.5,2169,2080,89,95.9,4.1,32,2048,0,89,32,2137,1.5,0,1.5,"Less than 25% P.O.C.","$78000 - $104000"
"36119014907","Census Tract 149.07, Westchester County, New York",4620,132989,3681,97,30,155,0,625,79.7,2.1,0.6,3.4,0,13.5,20.3,1549,1379,170,89.03,10.97,158,1221,12,158,170,1379,11.5,7.1,11,"Less than 25% P.O.C.","$104000 or more"
"36119014908","Census Tract 149.08, Westchester County, New York",3412,149625,2965,22,0,53,0,309,86.9,0.6,0,1.6,0,9.1,13.1,1180,927,253,78.56,21.44,117,810,20,233,137,1043,12.6,7.9,11.6,"Less than 25% P.O.C.","$104000 or more"
"36119014909","Census Tract 149.09, Westchester County, New York",3042,100833,2756,10,0,41,0,235,90.6,0.3,0,1.3,0,7.7,9.4,1294,1134,160,87.64,12.36,75,1059,0,160,75,1219,6.6,0,5.8,"Less than 25% P.O.C.","$78000 - $104000"
"36119015000","Census Tract 150, Westchester County, New York",5167,141944,4050,243,42,263,0,402,78.4,4.7,0.8,5.1,0,7.8,21.6,1824,1440,384,78.95,21.05,113,1327,53,331,166,1658,7.8,13.8,9.1,"Less than 25% P.O.C.","$104000 or more"
"36119981000","Census Tract 9810, Westchester County, New York",2181,48077,650,650,9,385,0,468,29.8,29.8,0.4,17.7,0,21.5,70.2,310,4,306,1.29,98.71,0,4,26,280,26,284,0,8.5,8.4,"50% - 75% P.O.C.","Less than $55000"
"36119982000","Census Tract 9820, Westchester County, New York",1723,NA,279,857,0,64,0,472,16.2,49.7,0,3.7,0,27.4,83.8,0,0,0,NA,NA,0,0,0,0,0,0,NA,NA,NA,"75% or more P.O.C.","N/A"
"36119983000","Census Tract 9830, Westchester County, New York",1288,NA,496,417,17,7,0,261,38.5,32.4,1.3,0.5,0,20.3,61.5,0,0,0,NA,NA,0,0,0,0,0,0,NA,NA,NA,"50% - 75% P.O.C.","N/A"
"36119984000","Census Tract 9840, Westchester County, New York",439,32411,263,161,0,0,0,11,59.9,36.7,0,0,0,2.5,40.1,103,17,86,16.5,83.5,0,17,4,82,4,99,0,4.7,3.9,"25% - 50% P.O.C.","Less than $55000"
"36119985000","Census Tract 9850, Westchester County, New York",2360,NA,1389,360,6,81,10,455,58.9,15.3,0.3,3.4,0.4,19.3,41.1,0,0,0,NA,NA,0,0,0,0,0,0,NA,NA,NA,"25% - 50% P.O.C.","N/A"
