"GEOID","NAME","total_pop","median_hh_income","white","black","ai_an","asian","hi_pi","hisp_lat","pct_white","pct_black","pct_ai_an","pct_asian","pct_hi_pi","pct_hisp_lat","pct_poc","total_hh","total_hh_owner","total_hh_renter","pct_owners","pct_renters","total_owner_more_than_4","total_owner_less_than_4","total_renter_more_than_4","total_renter_less_than_4","total_hh_more_than_4","total_hh_less_than_4","pct_owner_more_than_4","pct_renter_more_than_4","pct_total_hh_more_than_4","poc_bin","income_bin"
"17031010100","Census Tract 101, Cook County, Illinois",4599,32474,1853,2045,0,46,0,523,40.3,44.5,0,1,0,11.4,59.7,2363,497,1866,21.03,78.97,16,481,55,1811,71,2292,3.2,2.9,3,"50% - 75% P.O.C.","Less than $49000"
"17031010201","Census Tract 102.01, Cook County, Illinois",7455,45639,2328,2481,15,287,0,1671,31.2,33.3,0.2,3.8,0,22.4,68.8,2747,691,2056,25.15,74.85,28,663,315,1741,343,2404,4.1,15.3,12.5,"50% - 75% P.O.C.","Less than $49000"
"17031010202","Census Tract 102.02, Cook County, Illinois",2896,41486,879,974,0,155,0,753,30.4,33.6,0,5.4,0,26,69.6,1136,259,877,22.8,77.2,30,229,83,794,113,1023,11.6,9.5,9.9,"50% - 75% P.O.C.","Less than $49000"
"17031010300","Census Tract 103, Cook County, Illinois",6485,41250,3051,1995,6,66,7,1099,47,30.8,0.1,1,0.1,16.9,53,3091,1042,2049,33.71,66.29,19,1023,0,2049,19,3072,1.8,0,0.6,"50% - 75% P.O.C.","Less than $49000"
"17031010400","Census Tract 104, Cook County, Illinois",5213,39700,3361,1104,0,241,0,392,64.5,21.2,0,4.6,0,7.5,35.5,1988,422,1566,21.23,78.77,5,417,53,1513,58,1930,1.2,3.4,2.9,"25% - 50% P.O.C.","Less than $49000"
"17031010501","Census Tract 105.01, Cook County, Illinois",4102,39730,1902,1358,0,233,0,387,46.4,33.1,0,5.7,0,9.4,53.6,2374,321,2053,13.52,86.48,17,304,0,2053,17,2357,5.3,0,0.7,"50% - 75% P.O.C.","Less than $49000"
"17031010502","Census Tract 105.02, Cook County, Illinois",3089,39388,1610,669,0,262,0,465,52.1,21.7,0,8.5,0,15.1,47.9,1572,339,1233,21.56,78.44,19,320,49,1184,68,1504,5.6,4,4.3,"25% - 50% P.O.C.","Less than $49000"
"17031010503","Census Tract 105.03, Cook County, Illinois",1806,18516,1204,255,0,225,0,54,66.7,14.1,0,12.5,0,3,33.3,1059,189,870,17.85,82.15,0,189,20,850,20,1039,0,2.3,1.9,"25% - 50% P.O.C.","Less than $49000"
"17031010600","Census Tract 106, Cook County, Illinois",6395,50882,3335,1139,0,204,0,1536,52.2,17.8,0,3.2,0,24,47.8,2933,647,2286,22.06,77.94,25,622,113,2173,138,2795,3.9,4.9,4.7,"25% - 50% P.O.C.","$49000 - $70000"
"17031010701","Census Tract 107.01, Cook County, Illinois",3620,60167,1489,849,0,310,0,943,41.1,23.5,0,8.6,0,26,58.9,1512,724,788,47.88,52.12,80,644,34,754,114,1398,11,4.3,7.5,"50% - 75% P.O.C.","$49000 - $70000"
"17031010702","Census Tract 107.02, Cook County, Illinois",5082,44583,1636,1599,0,361,0,1377,32.2,31.5,0,7.1,0,27.1,67.8,2083,480,1603,23.04,76.96,41,439,267,1336,308,1775,8.5,16.7,14.8,"50% - 75% P.O.C.","Less than $49000"
"17031020100","Census Tract 201, Cook County, Illinois",3618,48841,1134,1206,0,171,0,935,31.3,33.3,0,4.7,0,25.8,68.7,1504,662,842,44.02,55.98,48,614,85,757,133,1371,7.3,10.1,8.8,"50% - 75% P.O.C.","Less than $49000"
"17031020200","Census Tract 202, Cook County, Illinois",6840,94115,3294,711,0,1280,0,1246,48.2,10.4,0,18.7,0,18.2,51.8,2069,1599,470,77.28,22.72,332,1267,28,442,360,1709,20.8,6,17.4,"50% - 75% P.O.C.","$70000 - $98000"
"17031020301","Census Tract 203.01, Cook County, Illinois",5384,56973,4041,196,11,596,0,378,75.1,3.6,0.2,11.1,0,7,24.9,2093,1528,565,73.01,26.99,291,1237,55,510,346,1747,19,9.7,16.5,"Less than 25% P.O.C.","$49000 - $70000"
"17031020302","Census Tract 203.02, Cook County, Illinois",5137,77500,2996,497,0,677,0,697,58.3,9.7,0,13.2,0,13.6,41.7,1726,1038,688,60.14,39.86,131,907,59,629,190,1536,12.6,8.6,11,"25% - 50% P.O.C.","$70000 - $98000"
"17031020400","Census Tract 204, Cook County, Illinois",4258,65917,1642,980,0,554,0,887,38.6,23,0,13,0,20.8,61.4,1675,924,751,55.16,44.84,66,858,62,689,128,1547,7.1,8.3,7.6,"50% - 75% P.O.C.","$49000 - $70000"
"17031020500","Census Tract 205, Cook County, Illinois",6775,44926,901,900,0,2749,0,1708,13.3,13.3,0,40.6,0,25.2,86.7,2094,539,1555,25.74,74.26,119,420,273,1282,392,1702,22.1,17.6,18.7,"75% or more P.O.C.","Less than $49000"
"17031020601","Census Tract 206.01, Cook County, Illinois",6525,38177,3685,356,66,1807,0,340,56.5,5.5,1,27.7,0,5.2,43.5,1959,896,1063,45.74,54.26,176,720,303,760,479,1480,19.6,28.5,24.5,"25% - 50% P.O.C.","Less than $49000"
"17031020602","Census Tract 206.02, Cook County, Illinois",4765,57045,1765,625,0,1082,0,1203,37,13.1,0,22.7,0,25.2,63,1394,608,786,43.62,56.38,42,566,283,503,325,1069,6.9,36,23.3,"50% - 75% P.O.C.","$49000 - $70000"
"17031020701","Census Tract 207.01, Cook County, Illinois",1844,97250,1217,80,0,304,0,212,66,4.3,0,16.5,0,11.5,34,677,455,222,67.21,32.79,36,419,12,210,48,629,7.9,5.4,7.1,"25% - 50% P.O.C.","$70000 - $98000"
"17031020702","Census Tract 207.02, Cook County, Illinois",8226,49167,2965,698,0,1997,0,2475,36,8.5,0,24.3,0,30.1,64,2396,750,1646,31.3,68.7,69,681,369,1277,438,1958,9.2,22.4,18.3,"50% - 75% P.O.C.","$49000 - $70000"
"17031020801","Census Tract 208.01, Cook County, Illinois",6175,54052,2290,187,0,1775,0,1529,37.1,3,0,28.7,0,24.8,62.9,2213,1011,1202,45.68,54.32,88,923,152,1050,240,1973,8.7,12.6,10.8,"50% - 75% P.O.C.","$49000 - $70000"
"17031020802","Census Tract 208.02, Cook County, Illinois",7916,46219,2593,568,134,2712,0,977,32.8,7.2,1.7,34.3,0,12.3,67.2,2315,710,1605,30.67,69.33,147,563,577,1028,724,1591,20.7,36,31.3,"50% - 75% P.O.C.","Less than $49000"
"17031020901","Census Tract 209.01, Cook County, Illinois",6155,52254,1448,1426,0,1588,0,1352,23.5,23.2,0,25.8,0,22,76.5,1950,640,1310,32.82,67.18,107,533,248,1062,355,1595,16.7,18.9,18.2,"75% or more P.O.C.","$49000 - $70000"
"17031020902","Census Tract 209.02, Cook County, Illinois",4848,39484,1865,656,0,1358,0,896,38.5,13.5,0,28,0,18.5,61.5,1649,886,763,53.73,46.27,104,782,63,700,167,1482,11.7,8.3,10.1,"50% - 75% P.O.C.","Less than $49000"
"17031030101","Census Tract 301.01, Cook County, Illinois",3911,48207,1435,1017,0,625,0,715,36.7,26,0,16,0,18.3,63.3,2035,727,1308,35.72,64.28,0,727,143,1165,143,1892,0,10.9,7,"50% - 75% P.O.C.","Less than $49000"
"17031030102","Census Tract 301.02, Cook County, Illinois",2841,42123,1394,527,16,386,0,317,49.1,18.5,0.6,13.6,0,11.2,50.9,1864,662,1202,35.52,64.48,0,662,12,1190,12,1852,0,1,0.6,"50% - 75% P.O.C.","Less than $49000"
"17031030103","Census Tract 301.03, Cook County, Illinois",2242,57985,1189,443,0,248,4,246,53,19.8,0,11.1,0.2,11,47,885,229,656,25.88,74.12,0,229,0,656,0,885,0,0,0,"25% - 50% P.O.C.","$49000 - $70000"
"17031030104","Census Tract 301.04, Cook County, Illinois",3411,35988,2217,272,0,544,0,299,65,8,0,15.9,0,8.8,35,1050,423,627,40.29,59.71,0,423,0,627,0,1050,0,0,0,"25% - 50% P.O.C.","Less than $49000"
"17031030200","Census Tract 302, Cook County, Illinois",5702,74434,4356,303,0,223,0,660,76.4,5.3,0,3.9,0,11.6,23.6,2610,1312,1298,50.27,49.73,77,1235,17,1281,94,2516,5.9,1.3,3.6,"Less than 25% P.O.C.","$70000 - $98000"
"17031030300","Census Tract 303, Cook County, Illinois",3676,41109,1266,560,19,510,0,1158,34.4,15.2,0.5,13.9,0,31.5,65.6,1513,459,1054,30.34,69.66,58,401,92,962,150,1363,12.6,8.7,9.9,"50% - 75% P.O.C.","Less than $49000"
"17031030400","Census Tract 304, Cook County, Illinois",2631,57500,1514,73,28,186,0,712,57.5,2.8,1.1,7.1,0,27.1,42.5,1318,496,822,37.63,62.37,10,486,12,810,22,1296,2,1.5,1.7,"25% - 50% P.O.C.","$49000 - $70000"
"17031030500","Census Tract 305, Cook County, Illinois",6786,90955,4171,375,0,360,14,1525,61.5,5.5,0,5.3,0.2,22.5,38.5,2932,1425,1507,48.6,51.4,92,1333,0,1507,92,2840,6.5,0,3.1,"25% - 50% P.O.C.","$70000 - $98000"
"17031030601","Census Tract 306.01, Cook County, Illinois",3353,34861,1464,593,0,746,0,501,43.7,17.7,0,22.2,0,14.9,56.3,1701,407,1294,23.93,76.07,0,407,18,1276,18,1683,0,1.4,1.1,"50% - 75% P.O.C.","Less than $49000"
"17031030603","Census Tract 306.03, Cook County, Illinois",2410,42059,985,437,39,363,0,532,40.9,18.1,1.6,15.1,0,22.1,59.1,1470,161,1309,10.95,89.05,7,154,25,1284,32,1438,4.3,1.9,2.2,"50% - 75% P.O.C.","Less than $49000"
"17031030604","Census Tract 306.04, Cook County, Illinois",3763,47500,1809,748,0,844,0,222,48.1,19.9,0,22.4,0,5.9,51.9,2362,706,1656,29.89,70.11,0,706,11,1645,11,2351,0,0.7,0.5,"50% - 75% P.O.C.","Less than $49000"
"17031030701","Census Tract 307.01, Cook County, Illinois",1625,39464,758,437,15,173,0,208,46.6,26.9,0.9,10.6,0,12.8,53.4,906,188,718,20.75,79.25,12,176,11,707,23,883,6.4,1.5,2.5,"50% - 75% P.O.C.","Less than $49000"
"17031030702","Census Tract 307.02, Cook County, Illinois",2211,58299,1370,43,0,609,0,116,62,1.9,0,27.5,0,5.2,38,1473,885,588,60.08,39.92,6,879,0,588,6,1467,0.7,0,0.4,"25% - 50% P.O.C.","$49000 - $70000"
"17031030703","Census Tract 307.03, Cook County, Illinois",2947,43553,1761,531,0,108,0,473,59.8,18,0,3.7,0,16.1,40.2,1808,483,1325,26.71,73.29,0,483,5,1320,5,1803,0,0.4,0.3,"25% - 50% P.O.C.","Less than $49000"
"17031030706","Census Tract 307.06, Cook County, Illinois",2845,43512,1638,426,0,569,0,193,57.6,15,0,20,0,6.8,42.4,1967,688,1279,34.98,65.02,0,688,14,1265,14,1953,0,1.1,0.7,"25% - 50% P.O.C.","Less than $49000"
"17031030800","Census Tract 308, Cook County, Illinois",4169,95688,3086,126,0,398,0,469,74,3,0,9.5,0,11.2,26,1950,875,1075,44.87,55.13,95,780,0,1075,95,1855,10.9,0,4.9,"25% - 50% P.O.C.","$70000 - $98000"
"17031030900","Census Tract 309, Cook County, Illinois",3126,107148,2217,185,0,277,0,327,70.9,5.9,0,8.9,0,10.5,29.1,1431,733,698,51.22,48.78,39,694,0,698,39,1392,5.3,0,2.7,"25% - 50% P.O.C.","$98000 or more"
"17031031000","Census Tract 310, Cook County, Illinois",3907,82902,2696,187,0,359,0,602,69,4.8,0,9.2,0,15.4,31,1998,778,1220,38.94,61.06,20,758,19,1201,39,1959,2.6,1.6,2,"25% - 50% P.O.C.","$70000 - $98000"
"17031031100","Census Tract 311, Cook County, Illinois",4720,78822,3177,176,0,523,0,660,67.3,3.7,0,11.1,0,14,32.7,2329,652,1677,27.99,72.01,19,633,31,1646,50,2279,2.9,1.8,2.1,"25% - 50% P.O.C.","$70000 - $98000"
"17031031200","Census Tract 312, Cook County, Illinois",6359,41389,2034,1403,20,1074,0,1622,32,22.1,0.3,16.9,0,25.5,68,2846,707,2139,24.84,75.16,0,707,161,1978,161,2685,0,7.5,5.7,"50% - 75% P.O.C.","Less than $49000"
"17031031300","Census Tract 313, Cook County, Illinois",7775,39064,3625,1648,16,1548,0,817,46.6,21.2,0.2,19.9,0,10.5,53.4,4225,1355,2870,32.07,67.93,32,1323,52,2818,84,4141,2.4,1.8,2,"50% - 75% P.O.C.","Less than $49000"
"17031031400","Census Tract 314, Cook County, Illinois",4964,70237,3337,356,11,626,0,472,67.2,7.2,0.2,12.6,0,9.5,32.8,3105,1730,1375,55.72,44.28,0,1730,0,1375,0,3105,0,0,0,"25% - 50% P.O.C.","$70000 - $98000"
"17031031501","Census Tract 315.01, Cook County, Illinois",4474,36917,1595,1401,0,750,0,640,35.7,31.3,0,16.8,0,14.3,64.3,1916,341,1575,17.8,82.2,14,327,30,1545,44,1872,4.1,1.9,2.3,"50% - 75% P.O.C.","Less than $49000"
"17031031502","Census Tract 315.02, Cook County, Illinois",4628,28403,1634,1714,0,141,0,1008,35.3,37,0,3,0,21.8,64.7,2375,338,2037,14.23,85.77,0,338,98,1939,98,2277,0,4.8,4.1,"50% - 75% P.O.C.","Less than $49000"
"17031031700","Census Tract 317, Cook County, Illinois",6785,56448,4267,1544,173,178,0,532,62.9,22.8,2.5,2.6,0,7.8,37.1,3617,1232,2385,34.06,65.94,30,1202,104,2281,134,3483,2.4,4.4,3.7,"25% - 50% P.O.C.","$49000 - $70000"
"17031031800","Census Tract 318, Cook County, Illinois",1889,84758,1393,54,0,165,0,237,73.7,2.9,0,8.7,0,12.5,26.3,978,443,535,45.3,54.7,15,428,6,529,21,957,3.4,1.1,2.1,"25% - 50% P.O.C.","$70000 - $98000"
"17031031900","Census Tract 319, Cook County, Illinois",2558,69265,1786,205,14,126,0,295,69.8,8,0.5,4.9,0,11.5,30.2,1270,436,834,34.33,65.67,10,426,9,825,19,1251,2.3,1.1,1.5,"25% - 50% P.O.C.","$49000 - $70000"
"17031032100","Census Tract 321, Cook County, Illinois",7106,64702,4871,312,0,489,0,1205,68.5,4.4,0,6.9,0,17,31.5,4043,1136,2907,28.1,71.9,26,1110,0,2907,26,4017,2.3,0,0.6,"25% - 50% P.O.C.","$49000 - $70000"
"17031040100","Census Tract 401, Cook County, Illinois",4139,96467,2560,253,15,170,0,1049,61.9,6.1,0.4,4.1,0,25.3,38.1,1648,827,821,50.18,49.82,36,791,52,769,88,1560,4.4,6.3,5.3,"25% - 50% P.O.C.","$70000 - $98000"
"17031040201","Census Tract 402.01, Cook County, Illinois",6814,73475,4043,284,1,530,0,1680,59.3,4.2,0,7.8,0,24.7,40.7,2994,1135,1859,37.91,62.09,39,1096,33,1826,72,2922,3.4,1.8,2.4,"25% - 50% P.O.C.","$70000 - $98000"
"17031040202","Census Tract 402.02, Cook County, Illinois",7634,47367,3501,369,0,1233,0,1870,45.9,4.8,0,16.2,0,24.5,54.1,2963,803,2160,27.1,72.9,74,729,197,1963,271,2692,9.2,9.1,9.1,"50% - 75% P.O.C.","Less than $49000"
"17031040300","Census Tract 403, Cook County, Illinois",2953,88125,1513,68,0,975,0,329,51.2,2.3,0,33,0,11.1,48.8,1081,680,401,62.9,37.1,42,638,0,401,42,1039,6.2,0,3.9,"25% - 50% P.O.C.","$70000 - $98000"
"17031040401","Census Tract 404.01, Cook County, Illinois",3250,105121,2094,114,0,152,0,763,64.4,3.5,0,4.7,0,23.5,35.6,1267,737,530,58.17,41.83,50,687,12,518,62,1205,6.8,2.3,4.9,"25% - 50% P.O.C.","$98000 or more"
"17031040402","Census Tract 404.02, Cook County, Illinois",5154,87479,3992,105,0,258,0,573,77.5,2,0,5,0,11.1,22.5,2551,902,1649,35.36,64.64,13,889,40,1609,53,2498,1.4,2.4,2.1,"Less than 25% P.O.C.","$70000 - $98000"
"17031040600","Census Tract 406, Cook County, Illinois",2607,90167,2021,105,0,46,0,331,77.5,4,0,1.8,0,12.7,22.5,1160,401,759,34.57,65.43,16,385,0,759,16,1144,4,0,1.4,"Less than 25% P.O.C.","$70000 - $98000"
"17031040700","Census Tract 407, Cook County, Illinois",3435,86125,2684,70,0,164,0,277,78.1,2,0,4.8,0,8.1,21.9,1566,709,857,45.27,54.73,31,678,25,832,56,1510,4.4,2.9,3.6,"Less than 25% P.O.C.","$70000 - $98000"
"17031040800","Census Tract 408, Cook County, Illinois",1691,85577,1213,56,0,49,0,248,71.7,3.3,0,2.9,0,14.7,28.3,776,354,422,45.62,54.38,6,348,5,417,11,765,1.7,1.2,1.4,"25% - 50% P.O.C.","$70000 - $98000"
"17031040900","Census Tract 409, Cook County, Illinois",1904,77250,1596,35,0,101,0,115,83.8,1.8,0,5.3,0,6,16.2,993,395,598,39.78,60.22,7,388,0,598,7,986,1.8,0,0.7,"Less than 25% P.O.C.","$70000 - $98000"
"17031050100","Census Tract 501, Cook County, Illinois",2736,113352,2156,97,44,171,0,173,78.8,3.5,1.6,6.2,0,6.3,21.2,1135,476,659,41.94,58.06,23,453,28,631,51,1084,4.8,4.2,4.5,"Less than 25% P.O.C.","$98000 or more"
"17031050200","Census Tract 502, Cook County, Illinois",5092,94821,4131,95,0,224,29,386,81.1,1.9,0,4.4,0.6,7.6,18.9,2078,1323,755,63.67,36.33,112,1211,0,755,112,1966,8.5,0,5.4,"Less than 25% P.O.C.","$70000 - $98000"
"17031050300","Census Tract 503, Cook County, Illinois",2483,79892,1733,0,0,291,0,418,69.8,0,0,11.7,0,16.8,30.2,1065,548,517,51.46,48.54,39,509,7,510,46,1019,7.1,1.4,4.3,"25% - 50% P.O.C.","$70000 - $98000"
"17031050500","Census Tract 505, Cook County, Illinois",5914,162616,5135,18,0,195,0,347,86.8,0.3,0,3.3,0,5.9,13.2,2046,1311,735,64.08,35.92,343,968,0,735,343,1703,26.2,0,16.8,"Less than 25% P.O.C.","$98000 or more"
"17031050600","Census Tract 506, Cook County, Illinois",2160,116595,1937,8,0,52,0,117,89.7,0.4,0,2.4,0,5.4,10.3,1071,641,430,59.85,40.15,7,634,0,430,7,1064,1.1,0,0.7,"Less than 25% P.O.C.","$98000 or more"
"17031050700","Census Tract 507, Cook County, Illinois",1742,134583,1596,9,5,37,0,65,91.6,0.5,0.3,2.1,0,3.7,8.4,658,512,146,77.81,22.19,31,481,6,140,37,621,6.1,4.1,5.6,"Less than 25% P.O.C.","$98000 or more"
"17031050800","Census Tract 508, Cook County, Illinois",1402,116488,1073,41,0,38,0,207,76.5,2.9,0,2.7,0,14.8,23.5,589,235,354,39.9,60.1,16,219,14,340,30,559,6.8,4,5.1,"Less than 25% P.O.C.","$98000 or more"
"17031050900","Census Tract 509, Cook County, Illinois",1414,103750,949,12,0,85,0,324,67.1,0.8,0,6,0,22.9,32.9,530,233,297,43.96,56.04,25,208,28,269,53,477,10.7,9.4,10,"25% - 50% P.O.C.","$98000 or more"
"17031051000","Census Tract 510, Cook County, Illinois",1829,126250,1136,44,0,108,0,500,62.1,2.4,0,5.9,0,27.3,37.9,724,429,295,59.25,40.75,13,416,0,295,13,711,3,0,1.8,"25% - 50% P.O.C.","$98000 or more"
"17031051100","Census Tract 511, Cook County, Illinois",1732,145000,1225,23,0,96,0,262,70.7,1.3,0,5.5,0,15.1,29.3,634,359,275,56.62,43.38,15,344,4,271,19,615,4.2,1.5,3,"25% - 50% P.O.C.","$98000 or more"
"17031051200","Census Tract 512, Cook County, Illinois",1546,141944,1216,98,0,54,0,107,78.7,6.3,0,3.5,0,6.9,21.3,580,264,316,45.52,54.48,36,228,0,316,36,544,13.6,0,6.2,"Less than 25% P.O.C.","$98000 or more"
"17031051300","Census Tract 513, Cook County, Illinois",2893,188697,2430,72,0,91,0,226,84,2.5,0,3.1,0,7.8,16,1115,824,291,73.9,26.1,34,790,13,278,47,1068,4.1,4.5,4.2,"Less than 25% P.O.C.","$98000 or more"
"17031051400","Census Tract 514, Cook County, Illinois",2073,123214,1427,137,0,125,0,288,68.8,6.6,0,6,0,13.9,31.2,876,534,342,60.96,39.04,47,487,12,330,59,817,8.8,3.5,6.7,"25% - 50% P.O.C.","$98000 or more"
"17031060100","Census Tract 601, Cook County, Illinois",2939,94800,2198,152,0,196,0,252,74.8,5.2,0,6.7,0,8.6,25.2,1304,672,632,51.53,48.47,44,628,17,615,61,1243,6.5,2.7,4.7,"25% - 50% P.O.C.","$70000 - $98000"
"17031060200","Census Tract 602, Cook County, Illinois",2248,83598,1572,42,0,170,10,384,69.9,1.9,0,7.6,0.4,17.1,30.1,1113,336,777,30.19,69.81,49,287,0,777,49,1064,14.6,0,4.4,"25% - 50% P.O.C.","$70000 - $98000"
"17031060300","Census Tract 603, Cook County, Illinois",2936,112574,2236,49,0,242,0,332,76.2,1.7,0,8.2,0,11.3,23.8,1307,626,681,47.9,52.1,15,611,6,675,21,1286,2.4,0.9,1.6,"Less than 25% P.O.C.","$98000 or more"
"17031060400","Census Tract 604, Cook County, Illinois",3877,132143,3156,25,0,136,0,446,81.4,0.6,0,3.5,0,11.5,18.6,1626,756,870,46.49,53.51,52,704,6,864,58,1568,6.9,0.7,3.6,"Less than 25% P.O.C.","$98000 or more"
"17031060500","Census Tract 605, Cook County, Illinois",1197,38571,842,34,0,150,0,154,70.3,2.8,0,12.5,0,12.9,29.7,738,153,585,20.73,79.27,4,149,8,577,12,726,2.6,1.4,1.6,"25% - 50% P.O.C.","Less than $49000"
"17031060800","Census Tract 608, Cook County, Illinois",5037,87552,3617,174,0,509,0,459,71.8,3.5,0,10.1,0,9.1,28.2,3188,1567,1621,49.15,50.85,19,1548,0,1621,19,3169,1.2,0,0.6,"25% - 50% P.O.C.","$70000 - $98000"
"17031060900","Census Tract 609, Cook County, Illinois",7292,63610,5088,625,0,386,0,1070,69.8,8.6,0,5.3,0,14.7,30.2,4701,1815,2886,38.61,61.39,0,1815,0,2886,0,4701,0,0,0,"25% - 50% P.O.C.","$49000 - $70000"
"17031061000","Census Tract 610, Cook County, Illinois",2202,110739,1750,33,0,120,0,267,79.5,1.5,0,5.4,0,12.1,20.5,1113,320,793,28.75,71.25,13,307,0,793,13,1100,4.1,0,1.2,"Less than 25% P.O.C.","$98000 or more"
"17031061100","Census Tract 611, Cook County, Illinois",1368,117500,1199,41,0,55,0,66,87.6,3,0,4,0,4.8,12.4,622,232,390,37.3,62.7,20,212,0,390,20,602,8.6,0,3.2,"Less than 25% P.O.C.","$98000 or more"
"17031061200","Census Tract 612, Cook County, Illinois",2164,138000,1698,28,0,94,0,252,78.5,1.3,0,4.3,0,11.6,21.5,810,347,463,42.84,57.16,33,314,21,442,54,756,9.5,4.5,6.7,"Less than 25% P.O.C.","$98000 or more"
"17031061500","Census Tract 615, Cook County, Illinois",2000,123409,1677,27,0,41,0,177,83.9,1.4,0,2.1,0,8.8,16.1,842,288,554,34.2,65.8,25,263,0,554,25,817,8.7,0,3,"Less than 25% P.O.C.","$98000 or more"
"17031061800","Census Tract 618, Cook County, Illinois",1415,72308,978,45,0,102,0,190,69.1,3.2,0,7.2,0,13.4,30.9,706,147,559,20.82,79.18,5,142,18,541,23,683,3.4,3.2,3.3,"25% - 50% P.O.C.","$70000 - $98000"
"17031061901","Census Tract 619.01, Cook County, Illinois",3492,65882,2406,79,0,652,0,294,68.9,2.3,0,18.7,0,8.4,31.1,2234,681,1553,30.48,69.52,16,665,0,1553,16,2218,2.3,0,0.7,"25% - 50% P.O.C.","$49000 - $70000"
"17031061902","Census Tract 619.02, Cook County, Illinois",4759,76792,3876,134,24,473,0,163,81.4,2.8,0.5,9.9,0,3.4,18.6,2841,862,1979,30.34,69.66,104,758,17,1962,121,2720,12.1,0.9,4.3,"Less than 25% P.O.C.","$70000 - $98000"
"17031062000","Census Tract 620, Cook County, Illinois",3027,77222,2475,117,0,145,0,132,81.8,3.9,0,4.8,0,4.4,18.2,1594,482,1112,30.24,69.76,12,470,11,1101,23,1571,2.5,1,1.4,"Less than 25% P.O.C.","$70000 - $98000"
"17031062100","Census Tract 621, Cook County, Illinois",3722,91438,3005,180,0,237,0,215,80.7,4.8,0,6.4,0,5.8,19.3,1901,650,1251,34.19,65.81,10,640,21,1230,31,1870,1.5,1.7,1.6,"Less than 25% P.O.C.","$70000 - $98000"
"17031062200","Census Tract 622, Cook County, Illinois",2988,128102,2465,33,0,74,0,416,82.5,1.1,0,2.5,0,13.9,17.5,1293,656,637,50.73,49.27,25,631,0,637,25,1268,3.8,0,1.9,"Less than 25% P.O.C.","$98000 or more"
"17031062300","Census Tract 623, Cook County, Illinois",1595,140556,1302,34,0,112,0,56,81.6,2.1,0,7,0,3.5,18.4,718,398,320,55.43,44.57,11,387,0,320,11,707,2.8,0,1.5,"Less than 25% P.O.C.","$98000 or more"
"17031062400","Census Tract 624, Cook County, Illinois",1571,133897,1346,75,0,43,0,81,85.7,4.8,0,2.7,0,5.2,14.3,737,422,315,57.26,42.74,12,410,6,309,18,719,2.8,1.9,2.4,"Less than 25% P.O.C.","$98000 or more"
"17031062500","Census Tract 625, Cook County, Illinois",1556,150240,1175,49,0,145,0,187,75.5,3.1,0,9.3,0,12,24.5,713,378,335,53.02,46.98,6,372,8,327,14,699,1.6,2.4,2,"Less than 25% P.O.C.","$98000 or more"
"17031062600","Census Tract 626, Cook County, Illinois",2442,164286,1785,45,0,245,8,271,73.1,1.8,0,10,0.3,11.1,26.9,980,634,346,64.69,35.31,60,574,5,341,65,915,9.5,1.4,6.6,"25% - 50% P.O.C.","$98000 or more"
"17031062700","Census Tract 627, Cook County, Illinois",2982,172850,2587,7,18,40,0,252,86.8,0.2,0.6,1.3,0,8.5,13.2,1097,597,500,54.42,45.58,100,497,13,487,113,984,16.8,2.6,10.3,"Less than 25% P.O.C.","$98000 or more"
"17031062800","Census Tract 628, Cook County, Illinois",3460,156875,2854,63,17,272,0,208,82.5,1.8,0.5,7.9,0,6,17.5,1418,648,770,45.7,54.3,46,602,6,764,52,1366,7.1,0.8,3.7,"Less than 25% P.O.C.","$98000 or more"
"17031062900","Census Tract 629, Cook County, Illinois",3818,131900,3068,276,0,205,0,201,80.4,7.2,0,5.4,0,5.3,19.6,1842,805,1037,43.7,56.3,26,779,6,1031,32,1810,3.2,0.6,1.7,"Less than 25% P.O.C.","$98000 or more"
"17031063000","Census Tract 630, Cook County, Illinois",3456,95897,2506,172,0,353,41,229,72.5,5,0,10.2,1.2,6.6,27.5,1787,667,1120,37.33,62.67,34,633,15,1105,49,1738,5.1,1.3,2.7,"25% - 50% P.O.C.","$70000 - $98000"
"17031063100","Census Tract 631, Cook County, Illinois",2238,90978,1823,24,0,150,0,128,81.5,1.1,0,6.7,0,5.7,18.5,1296,375,921,28.94,71.06,16,359,0,921,16,1280,4.3,0,1.2,"Less than 25% P.O.C.","$70000 - $98000"
"17031063200","Census Tract 632, Cook County, Illinois",6745,72457,5660,193,0,346,0,456,83.9,2.9,0,5.1,0,6.8,16.1,4208,1473,2735,35,65,46,1427,0,2735,46,4162,3.1,0,1.1,"Less than 25% P.O.C.","$70000 - $98000"
"17031063301","Census Tract 633.01, Cook County, Illinois",2735,60361,2100,164,0,123,0,209,76.8,6,0,4.5,0,7.6,23.2,1865,316,1549,16.94,83.06,13,303,0,1549,13,1852,4.1,0,0.7,"Less than 25% P.O.C.","$49000 - $70000"
"17031063302","Census Tract 633.02, Cook County, Illinois",3967,81638,3120,102,0,370,0,306,78.6,2.6,0,9.3,0,7.7,21.4,2736,853,1883,31.18,68.82,0,853,0,1883,0,2736,0,0,0,"Less than 25% P.O.C.","$70000 - $98000"
"17031063303","Census Tract 633.03, Cook County, Illinois",1243,92250,1057,0,0,158,0,22,85,0,0,12.7,0,1.8,15,905,387,518,42.76,57.24,0,387,0,518,0,905,0,0,0,"Less than 25% P.O.C.","$70000 - $98000"
"17031063400","Census Tract 634, Cook County, Illinois",2443,105735,1949,65,0,177,0,178,79.8,2.7,0,7.2,0,7.3,20.2,1204,422,782,35.05,64.95,0,422,19,763,19,1185,0,2.4,1.6,"Less than 25% P.O.C.","$98000 or more"
"17031070101","Census Tract 701.01, Cook County, Illinois",3885,75804,3053,72,15,194,0,344,78.6,1.9,0.4,5,0,8.9,21.4,2516,904,1612,35.93,64.07,0,904,16,1596,16,2500,0,1,0.6,"Less than 25% P.O.C.","$70000 - $98000"
"17031070102","Census Tract 701.02, Cook County, Illinois",2918,71373,2239,173,0,118,16,300,76.7,5.9,0,4,0.5,10.3,23.3,1932,515,1417,26.66,73.34,7,508,0,1417,7,1925,1.4,0,0.4,"Less than 25% P.O.C.","$70000 - $98000"
"17031070103","Census Tract 701.03, Cook County, Illinois",1636,61118,1221,64,0,173,0,150,74.6,3.9,0,10.6,0,9.2,25.4,1230,98,1132,7.97,92.03,0,98,0,1132,0,1230,0,0,0,"25% - 50% P.O.C.","$49000 - $70000"
"17031070200","Census Tract 702, Cook County, Illinois",4216,91723,3444,166,0,195,0,362,81.7,3.9,0,4.6,0,8.6,18.3,2045,777,1268,38,62,48,729,21,1247,69,1976,6.2,1.7,3.4,"Less than 25% P.O.C.","$70000 - $98000"
"17031070300","Census Tract 703, Cook County, Illinois",3634,145855,3070,31,0,174,0,184,84.5,0.9,0,4.8,0,5.1,15.5,1700,720,980,42.35,57.65,52,668,9,971,61,1639,7.2,0.9,3.6,"Less than 25% P.O.C.","$98000 or more"
"17031070400","Census Tract 704, Cook County, Illinois",3151,114902,2532,177,0,254,0,93,80.4,5.6,0,8.1,0,3,19.6,1546,679,867,43.92,56.08,11,668,0,867,11,1535,1.6,0,0.7,"Less than 25% P.O.C.","$98000 or more"
"17031070500","Census Tract 705, Cook County, Illinois",3458,152850,2816,237,0,189,0,126,81.4,6.9,0,5.5,0,3.6,18.6,1299,785,514,60.43,39.57,72,713,7,507,79,1220,9.2,1.4,6.1,"Less than 25% P.O.C.","$98000 or more"
"17031070600","Census Tract 706, Cook County, Illinois",3296,170750,2889,11,0,215,0,153,87.7,0.3,0,6.5,0,4.6,12.3,1234,839,395,67.99,32.01,99,740,0,395,99,1135,11.8,0,8,"Less than 25% P.O.C.","$98000 or more"
"17031070700","Census Tract 707, Cook County, Illinois",4191,121298,2666,665,0,352,0,420,63.6,15.9,0,8.4,0,10,36.4,1642,834,808,50.79,49.21,72,762,32,776,104,1538,8.6,4,6.3,"25% - 50% P.O.C.","$98000 or more"
"17031071000","Census Tract 710, Cook County, Illinois",4634,147552,3606,303,8,332,0,276,77.8,6.5,0.2,7.2,0,6,22.2,1013,485,528,47.88,52.12,25,460,0,528,25,988,5.2,0,2.5,"Less than 25% P.O.C.","$98000 or more"
"17031071100","Census Tract 711, Cook County, Illinois",3394,160662,2459,56,0,388,0,314,72.5,1.6,0,11.4,0,9.3,27.5,1118,554,564,49.55,50.45,67,487,14,550,81,1037,12.1,2.5,7.2,"25% - 50% P.O.C.","$98000 or more"
"17031071200","Census Tract 712, Cook County, Illinois",1956,114286,1431,162,0,160,0,167,73.2,8.3,0,8.2,0,8.5,26.8,920,489,431,53.15,46.85,33,456,0,431,33,887,6.7,0,3.6,"25% - 50% P.O.C.","$98000 or more"
"17031071300","Census Tract 713, Cook County, Illinois",4308,122621,3360,45,0,597,0,193,78,1,0,13.9,0,4.5,22,1951,976,975,50.03,49.97,25,951,0,975,25,1926,2.6,0,1.3,"Less than 25% P.O.C.","$98000 or more"
"17031071400","Census Tract 714, Cook County, Illinois",5096,117150,3990,282,0,274,0,326,78.3,5.5,0,5.4,0,6.4,21.7,2851,1307,1544,45.84,54.16,11,1296,0,1544,11,2840,0.8,0,0.4,"Less than 25% P.O.C.","$98000 or more"
"17031071500","Census Tract 715, Cook County, Illinois",6187,99510,5223,131,0,462,0,245,84.4,2.1,0,7.5,0,4,15.6,3839,1269,2570,33.06,66.94,13,1256,0,2570,13,3826,1,0,0.3,"Less than 25% P.O.C.","$98000 or more"
"17031071600","Census Tract 716, Cook County, Illinois",1914,147031,1398,217,0,171,0,71,73,11.3,0,8.9,0,3.7,27,752,461,291,61.3,38.7,47,414,0,291,47,705,10.2,0,6.2,"25% - 50% P.O.C.","$98000 or more"
"17031071700","Census Tract 717, Cook County, Illinois",1670,187614,1198,149,0,160,0,71,71.7,8.9,0,9.6,0,4.3,28.3,659,398,261,60.39,39.61,27,371,17,244,44,615,6.8,6.5,6.7,"25% - 50% P.O.C.","$98000 or more"
"17031071800","Census Tract 718, Cook County, Illinois",2613,131734,1807,297,0,305,0,157,69.2,11.4,0,11.7,0,6,30.8,1067,665,402,62.32,37.68,51,614,9,393,60,1007,7.7,2.2,5.6,"25% - 50% P.O.C.","$98000 or more"
"17031080100","Census Tract 801, Cook County, Illinois",6741,125880,5461,197,47,484,0,150,81,2.9,0.7,7.2,0,2.2,19,3963,1997,1966,50.39,49.61,75,1922,0,1966,75,3888,3.8,0,1.9,"Less than 25% P.O.C.","$98000 or more"
"17031080201","Census Tract 802.01, Cook County, Illinois",3160,91961,2535,185,0,280,0,141,80.2,5.9,0,8.9,0,4.5,19.8,2208,1245,963,56.39,43.61,0,1245,0,963,0,2208,0,0,0,"Less than 25% P.O.C.","$70000 - $98000"
"17031080202","Census Tract 802.02, Cook County, Illinois",3339,86419,2782,111,0,147,0,299,83.3,3.3,0,4.4,0,9,16.7,2281,1209,1072,53,47,0,1209,0,1072,0,2281,0,0,0,"Less than 25% P.O.C.","$70000 - $98000"
"17031080300","Census Tract 803, Cook County, Illinois",4911,138173,3882,174,0,475,0,311,79,3.5,0,9.7,0,6.3,21,2876,1617,1259,56.22,43.78,15,1602,0,1259,15,2861,0.9,0,0.5,"Less than 25% P.O.C.","$98000 or more"
"17031080400","Census Tract 804, Cook County, Illinois",4331,41250,1300,2500,0,107,0,193,30,57.7,0,2.5,0,4.5,70,1873,594,1279,31.71,68.29,0,594,63,1216,63,1810,0,4.9,3.4,"50% - 75% P.O.C.","Less than $49000"
"17031081000","Census Tract 810, Cook County, Illinois",8204,64640,5130,1135,0,1201,0,659,62.5,13.8,0,14.6,0,8,37.5,4751,684,4067,14.4,85.6,0,684,0,4067,0,4751,0,0,0,"25% - 50% P.O.C.","$49000 - $70000"
"17031081100","Census Tract 811, Cook County, Illinois",4200,77605,2886,399,0,336,0,400,68.7,9.5,0,8,0,9.5,31.3,2782,668,2114,24.01,75.99,0,668,0,2114,0,2782,0,0,0,"25% - 50% P.O.C.","$70000 - $98000"
"17031081201","Census Tract 812.01, Cook County, Illinois",4711,94288,3635,147,0,654,0,248,77.2,3.1,0,13.9,0,5.3,22.8,2983,1300,1683,43.58,56.42,18,1282,0,1683,18,2965,1.4,0,0.6,"Less than 25% P.O.C.","$70000 - $98000"
"17031081202","Census Tract 812.02, Cook County, Illinois",2928,136010,2497,72,0,210,0,61,85.3,2.5,0,7.2,0,2.1,14.7,1703,1323,380,77.69,22.31,34,1289,0,380,34,1669,2.6,0,2,"Less than 25% P.O.C.","$98000 or more"
"17031081300","Census Tract 813, Cook County, Illinois",5393,86207,4187,168,0,754,0,155,77.6,3.1,0,14,0,2.9,22.4,3480,2276,1204,65.4,34.6,18,2258,0,1204,18,3462,0.8,0,0.5,"Less than 25% P.O.C.","$70000 - $98000"
"17031081401","Census Tract 814.01, Cook County, Illinois",2224,79960,1803,32,0,183,0,82,81.1,1.4,0,8.2,0,3.7,18.9,1437,763,674,53.1,46.9,0,763,0,674,0,1437,0,0,0,"Less than 25% P.O.C.","$70000 - $98000"
"17031081402","Census Tract 814.02, Cook County, Illinois",5651,119387,3553,237,0,1442,0,273,62.9,4.2,0,25.5,0,4.8,37.1,3401,1447,1954,42.55,57.45,0,1447,0,1954,0,3401,0,0,0,"25% - 50% P.O.C.","$98000 or more"
"17031081403","Census Tract 814.03, Cook County, Illinois",8450,115642,5665,239,0,1906,0,412,67,2.8,0,22.6,0,4.9,33,5445,1694,3751,31.11,68.89,0,1694,0,3751,0,5445,0,0,0,"25% - 50% P.O.C.","$98000 or more"
"17031081500","Census Tract 815, Cook County, Illinois",4521,107847,2979,91,0,1060,0,374,65.9,2,0,23.4,0,8.3,34.1,2985,1347,1638,45.13,54.87,0,1347,0,1638,0,2985,0,0,0,"25% - 50% P.O.C.","$98000 or more"
"17031081600","Census Tract 816, Cook County, Illinois",4040,130673,2869,189,0,682,0,165,71,4.7,0,16.9,0,4.1,29,2643,966,1677,36.55,63.45,12,954,0,1677,12,2631,1.2,0,0.5,"25% - 50% P.O.C.","$98000 or more"
"17031081700","Census Tract 817, Cook County, Illinois",4118,101758,2863,153,0,732,0,243,69.5,3.7,0,17.8,0,5.9,30.5,2767,783,1984,28.3,71.7,0,783,0,1984,0,2767,0,0,0,"25% - 50% P.O.C.","$98000 or more"
"17031081800","Census Tract 818, Cook County, Illinois",10298,149135,7856,250,0,1340,0,551,76.3,2.4,0,13,0,5.4,23.7,6284,3099,3185,49.32,50.68,24,3075,0,3185,24,6260,0.8,0,0.4,"Less than 25% P.O.C.","$98000 or more"
"17031081900","Census Tract 819, Cook County, Illinois",1026,194167,586,379,0,39,0,22,57.1,36.9,0,3.8,0,2.1,42.9,456,255,201,55.92,44.08,0,255,9,192,9,447,0,4.5,2,"25% - 50% P.O.C.","$98000 or more"
"17031090100","Census Tract 901, Cook County, Illinois",3509,98446,2681,26,0,188,0,400,76.4,0.7,0,5.4,0,11.4,23.6,1424,1232,192,86.52,13.48,120,1112,0,192,120,1304,9.7,0,8.4,"Less than 25% P.O.C.","$98000 or more"
"17031090200","Census Tract 902, Cook County, Illinois",6416,108583,5473,16,0,176,0,686,85.3,0.2,0,2.7,0,10.7,14.7,2745,2083,662,75.88,24.12,91,1992,0,662,91,2654,4.4,0,3.3,"Less than 25% P.O.C.","$98000 or more"
"17031090300","Census Tract 903, Cook County, Illinois",1339,108563,1228,0,0,23,0,45,91.7,0,0,1.7,0,3.4,8.3,493,410,83,83.16,16.84,55,355,0,83,55,438,13.4,0,11.2,"Less than 25% P.O.C.","$98000 or more"
"17031100100","Census Tract 1001, Cook County, Illinois",5630,89427,4388,1,0,167,0,1074,77.9,0,0,3,0,19.1,22.1,2173,1332,841,61.3,38.7,164,1168,66,775,230,1943,12.3,7.8,10.6,"Less than 25% P.O.C.","$70000 - $98000"
"17031100200","Census Tract 1002, Cook County, Illinois",6819,80817,5283,178,27,248,0,923,77.5,2.6,0.4,3.6,0,13.5,22.5,2861,1950,911,68.16,31.84,229,1721,10,901,239,2622,11.7,1.1,8.4,"Less than 25% P.O.C.","$70000 - $98000"
"17031100300","Census Tract 1003, Cook County, Illinois",6259,79138,5021,29,14,303,0,667,80.2,0.5,0.2,4.8,0,10.7,19.8,2676,1670,1006,62.41,37.59,141,1529,0,1006,141,2535,8.4,0,5.3,"Less than 25% P.O.C.","$70000 - $98000"
"17031100400","Census Tract 1004, Cook County, Illinois",3404,99710,2729,2,0,68,0,548,80.2,0.1,0,2,0,16.1,19.8,1242,1182,60,95.17,4.83,99,1083,8,52,107,1135,8.4,13.3,8.6,"Less than 25% P.O.C.","$98000 or more"
"17031100500","Census Tract 1005, Cook County, Illinois",5840,77945,4715,17,0,152,23,549,80.7,0.3,0,2.6,0.4,9.4,19.3,2315,2014,301,87,13,237,1777,0,301,237,2078,11.8,0,10.2,"Less than 25% P.O.C.","$70000 - $98000"
"17031100600","Census Tract 1006, Cook County, Illinois",4792,77813,3203,60,0,363,0,1103,66.8,1.3,0,7.6,0,23,33.2,1882,1422,460,75.56,24.44,106,1316,53,407,159,1723,7.5,11.5,8.4,"25% - 50% P.O.C.","$70000 - $98000"
"17031100700","Census Tract 1007, Cook County, Illinois",5180,85953,3938,10,0,314,0,877,76,0.2,0,6.1,0,16.9,24,1871,1624,247,86.8,13.2,165,1459,0,247,165,1706,10.2,0,8.8,"Less than 25% P.O.C.","$70000 - $98000"
"17031110100","Census Tract 1101, Cook County, Illinois",5514,77813,3682,54,0,405,0,1266,66.8,1,0,7.3,0,23,33.2,2091,1359,732,64.99,35.01,80,1279,106,626,186,1905,5.9,14.5,8.9,"25% - 50% P.O.C.","$70000 - $98000"
"17031110200","Census Tract 1102, Cook County, Illinois",3095,85474,2053,42,0,368,0,632,66.3,1.4,0,11.9,0,20.4,33.7,1185,708,477,59.75,40.25,28,680,76,401,104,1081,4,15.9,8.8,"25% - 50% P.O.C.","$70000 - $98000"
"17031110300","Census Tract 1103, Cook County, Illinois",5331,82634,3554,11,19,354,0,1238,66.7,0.2,0.4,6.6,0,23.2,33.3,1936,1583,353,81.77,18.23,113,1470,49,304,162,1774,7.1,13.9,8.4,"25% - 50% P.O.C.","$70000 - $98000"
"17031110400","Census Tract 1104, Cook County, Illinois",4666,68996,2776,22,0,423,0,1258,59.5,0.5,0,9.1,0,27,40.5,1867,1109,758,59.4,40.6,40,1069,40,718,80,1787,3.6,5.3,4.3,"25% - 50% P.O.C.","$49000 - $70000"
"17031110501","Census Tract 1105.01, Cook County, Illinois",5323,84273,2890,41,0,844,15,1473,54.3,0.8,0,15.9,0.3,27.7,45.7,1780,1332,448,74.83,25.17,180,1152,33,415,213,1567,13.5,7.4,12,"25% - 50% P.O.C.","$70000 - $98000"
"17031110502","Census Tract 1105.02, Cook County, Illinois",3574,62155,2105,123,42,231,0,939,58.9,3.4,1.2,6.5,0,26.3,41.1,1522,725,797,47.63,52.37,37,688,80,717,117,1405,5.1,10,7.7,"25% - 50% P.O.C.","$49000 - $70000"
"17031120100","Census Tract 1201, Cook County, Illinois",4158,140417,3363,12,0,134,0,581,80.9,0.3,0,3.2,0,14,19.1,1494,1403,91,93.91,6.09,184,1219,7,84,191,1303,13.1,7.7,12.8,"Less than 25% P.O.C.","$98000 or more"
"17031120200","Census Tract 1202, Cook County, Illinois",4607,123594,3387,142,0,465,0,486,73.5,3.1,0,10.1,0,10.5,26.5,1751,1493,258,85.27,14.73,150,1343,4,254,154,1597,10,1.6,8.8,"25% - 50% P.O.C.","$98000 or more"
"17031120300","Census Tract 1203, Cook County, Illinois",6892,127473,4973,59,0,869,0,775,72.2,0.9,0,12.6,0,11.2,27.8,2491,2397,94,96.23,3.77,263,2134,0,94,263,2228,11,0,10.6,"25% - 50% P.O.C.","$98000 or more"
"17031120400","Census Tract 1204, Cook County, Illinois",3727,99306,1902,18,0,603,0,1091,51,0.5,0,16.2,0,29.3,49,1235,1016,219,82.27,17.73,92,924,24,195,116,1119,9.1,11,9.4,"25% - 50% P.O.C.","$98000 or more"
"17031130100","Census Tract 1301, Cook County, Illinois",5341,47875,2907,186,7,1593,0,545,54.4,3.5,0.1,29.8,0,10.2,45.6,1921,1010,911,52.58,47.42,186,824,100,811,286,1635,18.4,11,14.9,"25% - 50% P.O.C.","Less than $49000"
"17031130200","Census Tract 1302, Cook County, Illinois",1571,75875,889,15,0,242,0,369,56.6,1,0,15.4,0,23.5,43.4,655,478,177,72.98,27.02,40,438,10,167,50,605,8.4,5.6,7.6,"25% - 50% P.O.C.","$70000 - $98000"
"17031130300","Census Tract 1303, Cook County, Illinois",5509,58824,2451,222,62,1491,0,1143,44.5,4,1.1,27.1,0,20.7,55.5,1766,749,1017,42.41,57.59,141,608,172,845,313,1453,18.8,16.9,17.7,"50% - 75% P.O.C.","$49000 - $70000"
"17031140100","Census Tract 1401, Cook County, Illinois",3194,54394,1011,442,0,381,0,1296,31.7,13.8,0,11.9,0,40.6,68.3,1126,323,803,28.69,71.31,56,267,102,701,158,968,17.3,12.7,14,"50% - 75% P.O.C.","$49000 - $70000"
"17031140200","Census Tract 1402, Cook County, Illinois",6514,46761,2131,347,2,1156,0,2779,32.7,5.3,0,17.7,0,42.7,67.3,1882,382,1500,20.3,79.7,12,370,252,1248,264,1618,3.1,16.8,14,"50% - 75% P.O.C.","Less than $49000"
"17031140301","Census Tract 1403.01, Cook County, Illinois",2839,50667,397,57,0,642,0,1724,14,2,0,22.6,0,60.7,86,812,293,519,36.08,63.92,21,272,123,396,144,668,7.2,23.7,17.7,"75% or more P.O.C.","$49000 - $70000"
"17031140302","Census Tract 1403.02, Cook County, Illinois",4189,75789,1465,228,0,686,0,1433,35,5.4,0,16.4,0,34.2,65,1292,594,698,45.98,54.02,6,588,150,548,156,1136,1,21.5,12.1,"50% - 75% P.O.C.","$70000 - $98000"
"17031140400","Census Tract 1404, Cook County, Illinois",5978,69203,2815,26,0,721,0,2231,47.1,0.4,0,12.1,0,37.3,52.9,2305,1507,798,65.38,34.62,216,1291,70,728,286,2019,14.3,8.8,12.4,"50% - 75% P.O.C.","$49000 - $70000"
"17031140500","Census Tract 1405, Cook County, Illinois",3920,66818,1275,217,0,809,0,1549,32.5,5.5,0,20.6,0,39.5,67.5,1276,635,641,49.76,50.24,47,588,152,489,199,1077,7.4,23.7,15.6,"50% - 75% P.O.C.","$49000 - $70000"
"17031140601","Census Tract 1406.01, Cook County, Illinois",2886,43988,661,329,0,695,0,1183,22.9,11.4,0,24.1,0,41,77.1,881,356,525,40.41,59.59,90,266,54,471,144,737,25.3,10.3,16.3,"75% or more P.O.C.","Less than $49000"
"17031140602","Census Tract 1406.02, Cook County, Illinois",5003,67237,1146,285,0,676,0,2693,22.9,5.7,0,13.5,0,53.8,77.1,1676,596,1080,35.56,64.44,39,557,173,907,212,1464,6.5,16,12.6,"75% or more P.O.C.","$49000 - $70000"
"17031140701","Census Tract 1407.01, Cook County, Illinois",3028,71125,723,161,9,556,0,1450,23.9,5.3,0.3,18.4,0,47.9,76.1,1073,303,770,28.24,71.76,45,258,62,708,107,966,14.9,8.1,10,"75% or more P.O.C.","$70000 - $98000"
"17031140702","Census Tract 1407.02, Cook County, Illinois",5882,57708,1461,183,0,286,0,3746,24.8,3.1,0,4.9,0,63.7,75.2,1997,627,1370,31.4,68.6,35,592,198,1172,233,1764,5.6,14.5,11.7,"75% or more P.O.C.","$49000 - $70000"
"17031140800","Census Tract 1408, Cook County, Illinois",6373,73875,2955,186,0,783,0,2315,46.4,2.9,0,12.3,0,36.3,53.6,2589,1193,1396,46.08,53.92,30,1163,183,1213,213,2376,2.5,13.1,8.2,"50% - 75% P.O.C.","$70000 - $98000"
"17031150200","Census Tract 1502, Cook County, Illinois",7753,67623,4202,41,25,557,0,2734,54.2,0.5,0.3,7.2,0,35.3,45.8,2904,1615,1289,55.61,44.39,123,1492,81,1208,204,2700,7.6,6.3,7,"25% - 50% P.O.C.","$49000 - $70000"
"17031150300","Census Tract 1503, Cook County, Illinois",7862,77877,4325,163,0,332,0,2637,55,2.1,0,4.2,0,33.5,45,2890,1672,1218,57.85,42.15,207,1465,88,1130,295,2595,12.4,7.2,10.2,"25% - 50% P.O.C.","$70000 - $98000"
"17031150401","Census Tract 1504.01, Cook County, Illinois",4909,63125,2932,91,66,225,0,1353,59.7,1.9,1.3,4.6,0,27.6,40.3,1812,1060,752,58.5,41.5,131,929,55,697,186,1626,12.4,7.3,10.3,"25% - 50% P.O.C.","$49000 - $70000"
"17031150402","Census Tract 1504.02, Cook County, Illinois",3817,87708,2281,42,0,183,0,1163,59.8,1.1,0,4.8,0,30.5,40.2,1298,887,411,68.34,31.66,106,781,59,352,165,1133,12,14.4,12.7,"25% - 50% P.O.C.","$70000 - $98000"
"17031150501","Census Tract 1505.01, Cook County, Illinois",3903,75956,2337,127,0,209,0,1047,59.9,3.3,0,5.4,0,26.8,40.1,1407,1011,396,71.86,28.14,130,881,45,351,175,1232,12.9,11.4,12.4,"25% - 50% P.O.C.","$70000 - $98000"
"17031150502","Census Tract 1505.02, Cook County, Illinois",4339,63813,2551,71,0,238,0,1456,58.8,1.6,0,5.5,0,33.6,41.2,1482,984,498,66.4,33.6,166,818,53,445,219,1263,16.9,10.6,14.8,"25% - 50% P.O.C.","$49000 - $70000"
"17031150600","Census Tract 1506, Cook County, Illinois",4063,67957,1909,78,32,333,0,1626,47,1.9,0.8,8.2,0,40,53,1425,1031,394,72.35,27.65,146,885,20,374,166,1259,14.2,5.1,11.6,"50% - 75% P.O.C.","$49000 - $70000"
"17031150700","Census Tract 1507, Cook County, Illinois",4040,75545,1775,70,0,243,0,1906,43.9,1.7,0,6,0,47.2,56.1,1429,1010,419,70.68,29.32,122,888,0,419,122,1307,12.1,0,8.5,"50% - 75% P.O.C.","$70000 - $98000"
"17031150800","Census Tract 1508, Cook County, Illinois",4814,59919,2043,66,0,87,0,2354,42.4,1.4,0,1.8,0,48.9,57.6,1653,976,677,59.04,40.96,141,835,61,616,202,1451,14.4,9,12.2,"50% - 75% P.O.C.","$49000 - $70000"
"17031151001","Census Tract 1510.01, Cook County, Illinois",2803,65417,776,57,0,129,0,1832,27.7,2,0,4.6,0,65.4,72.3,911,477,434,52.36,47.64,78,399,31,403,109,802,16.4,7.1,12,"50% - 75% P.O.C.","$49000 - $70000"
"17031151002","Census Tract 1510.02, Cook County, Illinois",4892,62483,1183,90,0,61,12,3453,24.2,1.8,0,1.2,0.2,70.6,75.8,1531,763,768,49.84,50.16,149,614,173,595,322,1209,19.5,22.5,21,"75% or more P.O.C.","$49000 - $70000"
"17031151100","Census Tract 1511, Cook County, Illinois",5335,64063,1622,42,0,346,0,3293,30.4,0.8,0,6.5,0,61.7,69.6,1757,846,911,48.15,51.85,190,656,139,772,329,1428,22.5,15.3,18.7,"50% - 75% P.O.C.","$49000 - $70000"
"17031151200","Census Tract 1512, Cook County, Illinois",3616,76885,1567,21,0,227,0,1764,43.3,0.6,0,6.3,0,48.8,56.7,1210,914,296,75.54,24.46,145,769,67,229,212,998,15.9,22.6,17.5,"50% - 75% P.O.C.","$70000 - $98000"
"17031160100","Census Tract 1601, Cook County, Illinois",2537,68750,1181,8,13,436,0,670,46.6,0.3,0.5,17.2,0,26.4,53.4,988,540,448,54.66,45.34,73,467,31,417,104,884,13.5,6.9,10.5,"50% - 75% P.O.C.","$49000 - $70000"
"17031160200","Census Tract 1602, Cook County, Illinois",3023,85216,1862,92,0,356,0,634,61.6,3,0,11.8,0,21,38.4,1223,794,429,64.92,35.08,89,705,10,419,99,1124,11.2,2.3,8.1,"25% - 50% P.O.C.","$70000 - $98000"
"17031160300","Census Tract 1603, Cook County, Illinois",3524,57568,2088,203,33,487,0,486,59.3,5.8,0.9,13.8,0,13.8,40.7,1852,858,994,46.33,53.67,38,820,21,973,59,1793,4.4,2.1,3.2,"25% - 50% P.O.C.","$49000 - $70000"
"17031160400","Census Tract 1604, Cook County, Illinois",4734,61815,2241,200,0,310,0,1771,47.3,4.2,0,6.5,0,37.4,52.7,1835,922,913,50.25,49.75,92,830,82,831,174,1661,10,9,9.5,"50% - 75% P.O.C.","$49000 - $70000"
"17031160501","Census Tract 1605.01, Cook County, Illinois",4019,60349,1104,188,0,517,0,2048,27.5,4.7,0,12.9,0,51,72.5,1301,552,749,42.43,57.57,81,471,156,593,237,1064,14.7,20.8,18.2,"50% - 75% P.O.C.","$49000 - $70000"
"17031160502","Census Tract 1605.02, Cook County, Illinois",3729,56875,1003,45,0,173,0,2436,26.9,1.2,0,4.6,0,65.3,73.1,1370,590,780,43.07,56.93,66,524,101,679,167,1203,11.2,12.9,12.2,"50% - 75% P.O.C.","$49000 - $70000"
"17031160601","Census Tract 1606.01, Cook County, Illinois",3362,69375,1643,96,0,195,0,1339,48.9,2.9,0,5.8,0,39.8,51.1,1304,639,665,49,51,55,584,34,631,89,1215,8.6,5.1,6.8,"50% - 75% P.O.C.","$49000 - $70000"
"17031160602","Census Tract 1606.02, Cook County, Illinois",3735,66776,1394,140,0,361,0,1692,37.3,3.7,0,9.7,0,45.3,62.7,1449,667,782,46.03,53.97,84,583,58,724,142,1307,12.6,7.4,9.8,"50% - 75% P.O.C.","$49000 - $70000"
"17031160700","Census Tract 1607, Cook County, Illinois",5811,72317,2497,242,0,500,0,2415,43,4.2,0,8.6,0,41.6,57,2341,999,1342,42.67,57.33,61,938,98,1244,159,2182,6.1,7.3,6.8,"50% - 75% P.O.C.","$70000 - $98000"
"17031160800","Census Tract 1608, Cook County, Illinois",5459,63007,1558,151,0,477,0,3161,28.5,2.8,0,8.7,0,57.9,71.5,1826,731,1095,40.03,59.97,149,582,169,926,318,1508,20.4,15.4,17.4,"50% - 75% P.O.C.","$49000 - $70000"
"17031160900","Census Tract 1609, Cook County, Illinois",2535,86060,1450,79,0,203,0,704,57.2,3.1,0,8,0,27.8,42.8,1035,478,557,46.18,53.82,60,418,31,526,91,944,12.6,5.6,8.8,"25% - 50% P.O.C.","$70000 - $98000"
"17031161000","Census Tract 1610, Cook County, Illinois",2171,88750,1300,42,0,107,0,680,59.9,1.9,0,4.9,0,31.3,40.1,813,481,332,59.16,40.84,55,426,20,312,75,738,11.4,6,9.2,"25% - 50% P.O.C.","$70000 - $98000"
"17031161100","Census Tract 1611, Cook County, Illinois",2038,143438,1267,143,0,144,0,367,62.2,7,0,7.1,0,18,37.8,755,586,169,77.62,22.38,67,519,6,163,73,682,11.4,3.6,9.7,"25% - 50% P.O.C.","$98000 or more"
"17031161200","Census Tract 1612, Cook County, Illinois",3121,67903,942,26,7,139,0,1982,30.2,0.8,0.2,4.5,0,63.5,69.8,986,620,366,62.88,37.12,105,515,64,302,169,817,16.9,17.5,17.1,"50% - 75% P.O.C.","$49000 - $70000"
"17031161300","Census Tract 1613, Cook County, Illinois",3732,51578,1372,95,0,124,11,2041,36.8,2.5,0,3.3,0.3,54.7,63.2,1483,603,880,40.66,59.34,55,548,65,815,120,1363,9.1,7.4,8.1,"50% - 75% P.O.C.","$49000 - $70000"
"17031170100","Census Tract 1701, Cook County, Illinois",1931,54625,1526,117,0,94,0,194,79,6.1,0,4.9,0,10,21,1069,817,252,76.43,23.57,9,808,0,252,9,1060,1.1,0,0.8,"Less than 25% P.O.C.","$49000 - $70000"
"17031170200","Census Tract 1702, Cook County, Illinois",3754,70625,2087,1,0,351,0,1315,55.6,0,0,9.4,0,35,44.4,1213,1020,193,84.09,15.91,207,813,0,193,207,1006,20.3,0,17.1,"25% - 50% P.O.C.","$70000 - $98000"
"17031170300","Census Tract 1703, Cook County, Illinois",5338,67298,3086,3,0,331,0,1907,57.8,0.1,0,6.2,0,35.7,42.2,1769,1220,549,68.97,31.03,157,1063,84,465,241,1528,12.9,15.3,13.6,"25% - 50% P.O.C.","$49000 - $70000"
"17031170400","Census Tract 1704, Cook County, Illinois",4189,63542,2672,112,0,187,0,1208,63.8,2.7,0,4.5,0,28.8,36.2,1544,1138,406,73.7,26.3,104,1034,47,359,151,1393,9.1,11.6,9.8,"25% - 50% P.O.C.","$49000 - $70000"
"17031170500","Census Tract 1705, Cook County, Illinois",5519,88684,3965,0,0,344,0,1174,71.8,0,0,6.2,0,21.3,28.2,2002,1608,394,80.32,19.68,84,1524,0,394,84,1918,5.2,0,4.2,"25% - 50% P.O.C.","$70000 - $98000"
"17031170600","Census Tract 1706, Cook County, Illinois",2487,69271,1950,39,0,47,0,418,78.4,1.6,0,1.9,0,16.8,21.6,967,826,141,85.42,14.58,72,754,5,136,77,890,8.7,3.5,8,"Less than 25% P.O.C.","$49000 - $70000"
"17031170700","Census Tract 1707, Cook County, Illinois",3295,65233,2248,0,0,223,0,824,68.2,0,0,6.8,0,25,31.8,1132,903,229,79.77,20.23,166,737,0,229,166,966,18.4,0,14.7,"25% - 50% P.O.C.","$49000 - $70000"
"17031170800","Census Tract 1708, Cook County, Illinois",4099,62955,2422,44,0,282,0,1351,59.1,1.1,0,6.9,0,33,40.9,1418,1073,345,75.67,24.33,104,969,29,316,133,1285,9.7,8.4,9.4,"25% - 50% P.O.C.","$49000 - $70000"
"17031170900","Census Tract 1709, Cook County, Illinois",1943,68958,967,89,0,59,0,828,49.8,4.6,0,3,0,42.6,50.2,651,424,227,65.13,34.87,63,361,28,199,91,560,14.9,12.3,14,"50% - 75% P.O.C.","$49000 - $70000"
"17031171000","Census Tract 1710, Cook County, Illinois",6877,79750,4164,296,0,338,0,1897,60.5,4.3,0,4.9,0,27.6,39.5,2452,1989,463,81.12,18.88,193,1796,102,361,295,2157,9.7,22,12,"25% - 50% P.O.C.","$70000 - $98000"
"17031171100","Census Tract 1711, Cook County, Illinois",4013,69330,1993,21,0,253,0,1739,49.7,0.5,0,6.3,0,43.3,50.3,1259,949,310,75.38,24.62,239,710,26,284,265,994,25.2,8.4,21,"50% - 75% P.O.C.","$49000 - $70000"
"17031180100","Census Tract 1801, Cook County, Illinois",6228,57813,2738,30,0,396,0,2997,44,0.5,0,6.4,0,48.1,56,2235,1684,551,75.35,24.65,139,1545,0,551,139,2096,8.3,0,6.2,"50% - 75% P.O.C.","$49000 - $70000"
"17031190100","Census Tract 1901, Cook County, Illinois",2453,41103,238,31,0,58,0,2126,9.7,1.3,0,2.4,0,86.7,90.3,807,231,576,28.62,71.38,65,166,51,525,116,691,28.1,8.9,14.4,"75% or more P.O.C.","Less than $49000"
"17031190200","Census Tract 1902, Cook County, Illinois",5838,58851,716,158,0,153,0,4716,12.3,2.7,0,2.6,0,80.8,87.7,1614,913,701,56.57,43.43,321,592,80,621,401,1213,35.2,11.4,24.8,"75% or more P.O.C.","$49000 - $70000"
"17031190300","Census Tract 1903, Cook County, Illinois",5518,54239,1619,52,0,96,0,3447,29.3,0.9,0,1.7,0,62.5,70.7,1788,857,931,47.93,52.07,260,597,38,893,298,1490,30.3,4.1,16.7,"50% - 75% P.O.C.","$49000 - $70000"
"17031190401","Census Tract 1904.01, Cook County, Illinois",4394,63750,1284,61,21,332,0,2696,29.2,1.4,0.5,7.6,0,61.4,70.8,1253,842,411,67.2,32.8,174,668,103,308,277,976,20.7,25.1,22.1,"50% - 75% P.O.C.","$49000 - $70000"
"17031190402","Census Tract 1904.02, Cook County, Illinois",5385,53021,1511,91,0,15,0,3756,28.1,1.7,0,0.3,0,69.7,71.9,1707,949,758,55.59,44.41,150,799,88,670,238,1469,15.8,11.6,13.9,"50% - 75% P.O.C.","$49000 - $70000"
"17031190601","Census Tract 1906.01, Cook County, Illinois",4976,56771,404,227,0,78,0,4267,8.1,4.6,0,1.6,0,85.8,91.9,1145,686,459,59.91,40.09,247,439,60,399,307,838,36,13.1,26.8,"75% or more P.O.C.","$49000 - $70000"
"17031190602","Census Tract 1906.02, Cook County, Illinois",5123,54688,777,156,7,95,0,4015,15.2,3,0.1,1.9,0,78.4,84.8,1414,1017,397,71.92,28.08,194,823,46,351,240,1174,19.1,11.6,17,"75% or more P.O.C.","$49000 - $70000"
"17031190701","Census Tract 1907.01, Cook County, Illinois",2735,42270,352,29,0,42,0,2279,12.9,1.1,0,1.5,0,83.3,87.1,779,298,481,38.25,61.75,76,222,90,391,166,613,25.5,18.7,21.3,"75% or more P.O.C.","Less than $49000"
"17031190702","Census Tract 1907.02, Cook County, Illinois",5056,41083,351,118,0,0,0,4575,6.9,2.3,0,0,0,90.5,93.1,1471,522,949,35.49,64.51,83,439,300,649,383,1088,15.9,31.6,26,"75% or more P.O.C.","Less than $49000"
"17031190800","Census Tract 1908, Cook County, Illinois",6951,51953,647,79,10,58,0,5961,9.3,1.1,0.1,0.8,0,85.8,90.7,1931,841,1090,43.55,56.45,259,582,144,946,403,1528,30.8,13.2,20.9,"75% or more P.O.C.","$49000 - $70000"
"17031190900","Census Tract 1909, Cook County, Illinois",2235,54750,175,76,0,0,0,1984,7.8,3.4,0,0,0,88.8,92.2,688,275,413,39.97,60.03,80,195,76,337,156,532,29.1,18.4,22.7,"75% or more P.O.C.","$49000 - $70000"
"17031191000","Census Tract 1910, Cook County, Illinois",2730,55081,172,54,0,148,0,2356,6.3,2,0,5.4,0,86.3,93.7,726,471,255,64.88,35.12,126,345,58,197,184,542,26.8,22.7,25.3,"75% or more P.O.C.","$49000 - $70000"
"17031191100","Census Tract 1911, Cook County, Illinois",6927,51421,374,303,0,130,0,5975,5.4,4.4,0,1.9,0,86.3,94.6,2016,1033,983,51.24,48.76,292,741,205,778,497,1519,28.3,20.9,24.7,"75% or more P.O.C.","$49000 - $70000"
"17031191200","Census Tract 1912, Cook County, Illinois",4053,50556,188,15,0,1,0,3849,4.6,0.4,0,0,0,95,95.4,1022,481,541,47.06,52.94,154,327,104,437,258,764,32,19.2,25.2,"75% or more P.O.C.","$49000 - $70000"
"17031191301","Census Tract 1913.01, Cook County, Illinois",5525,50046,130,169,0,147,0,5015,2.4,3.1,0,2.7,0,90.8,97.6,1505,675,830,44.85,55.15,216,459,192,638,408,1097,32,23.1,27.1,"75% or more P.O.C.","$49000 - $70000"
"17031191302","Census Tract 1913.02, Cook County, Illinois",5046,45962,494,65,0,0,0,4487,9.8,1.3,0,0,0,88.9,90.2,1378,662,716,48.04,51.96,196,466,118,598,314,1064,29.6,16.5,22.8,"75% or more P.O.C.","Less than $49000"
"17031200100","Census Tract 2001, Cook County, Illinois",3836,53718,795,94,0,166,0,2723,20.7,2.5,0,4.3,0,71,79.3,1316,675,641,51.29,48.71,151,524,0,641,151,1165,22.4,0,11.5,"75% or more P.O.C.","$49000 - $70000"
"17031200200","Census Tract 2002, Cook County, Illinois",4848,46625,499,216,0,71,11,4045,10.3,4.5,0,1.5,0.2,83.4,89.7,1633,790,843,48.38,51.62,160,630,22,821,182,1451,20.3,2.6,11.1,"75% or more P.O.C.","Less than $49000"
"17031200300","Census Tract 2003, Cook County, Illinois",1919,53798,154,33,0,31,0,1701,8,1.7,0,1.6,0,88.6,92,529,257,272,48.58,51.42,61,196,102,170,163,366,23.7,37.5,30.8,"75% or more P.O.C.","$49000 - $70000"
"17031200401","Census Tract 2004.01, Cook County, Illinois",3697,45074,349,117,16,27,0,3182,9.4,3.2,0.4,0.7,0,86.1,90.6,1009,468,541,46.38,53.62,165,303,63,478,228,781,35.3,11.6,22.6,"75% or more P.O.C.","Less than $49000"
"17031200402","Census Tract 2004.02, Cook County, Illinois",4477,51719,283,187,0,185,0,3741,6.3,4.2,0,4.1,0,83.6,93.7,1162,563,599,48.45,51.55,146,417,144,455,290,872,25.9,24,25,"75% or more P.O.C.","$49000 - $70000"
"17031210100","Census Tract 2101, Cook County, Illinois",4102,81875,1801,143,0,264,37,1757,43.9,3.5,0,6.4,0.9,42.8,56.1,1503,689,814,45.84,54.16,42,647,125,689,167,1336,6.1,15.4,11.1,"50% - 75% P.O.C.","$70000 - $98000"
"17031210400","Census Tract 2104, Cook County, Illinois",2580,51083,700,66,0,31,0,1719,27.1,2.6,0,1.2,0,66.6,72.9,951,378,573,39.75,60.25,45,333,67,506,112,839,11.9,11.7,11.8,"50% - 75% P.O.C.","$49000 - $70000"
"17031210501","Census Tract 2105.01, Cook County, Illinois",3033,50519,952,168,0,102,0,1723,31.4,5.5,0,3.4,0,56.8,68.6,1220,307,913,25.16,74.84,34,273,59,854,93,1127,11.1,6.5,7.6,"50% - 75% P.O.C.","$49000 - $70000"
"17031210502","Census Tract 2105.02, Cook County, Illinois",4470,56025,1166,160,0,80,0,2919,26.1,3.6,0,1.8,0,65.3,73.9,1468,445,1023,30.31,69.69,97,348,145,878,242,1226,21.8,14.2,16.5,"50% - 75% P.O.C.","$49000 - $70000"
"17031210601","Census Tract 2106.01, Cook County, Illinois",2841,75461,981,3,0,148,0,1647,34.5,0.1,0,5.2,0,58,65.5,983,426,557,43.34,56.66,57,369,67,490,124,859,13.4,12,12.6,"50% - 75% P.O.C.","$70000 - $98000"
"17031210602","Census Tract 2106.02, Cook County, Illinois",4092,74167,1240,9,0,231,0,2387,30.3,0.2,0,5.6,0,58.3,69.7,1542,633,909,41.05,58.95,55,578,67,842,122,1420,8.7,7.4,7.9,"50% - 75% P.O.C.","$70000 - $98000"
"17031210700","Census Tract 2107, Cook County, Illinois",4240,68220,1500,46,15,159,10,2353,35.4,1.1,0.4,3.8,0.2,55.5,64.6,1549,662,887,42.74,57.26,104,558,96,791,200,1349,15.7,10.8,12.9,"50% - 75% P.O.C.","$49000 - $70000"
"17031210800","Census Tract 2108, Cook County, Illinois",1165,60948,385,7,0,14,0,748,33,0.6,0,1.2,0,64.2,67,392,145,247,36.99,63.01,23,122,37,210,60,332,15.9,15,15.3,"50% - 75% P.O.C.","$49000 - $70000"
"17031210900","Census Tract 2109, Cook County, Illinois",3058,88167,1544,170,0,161,0,1090,50.5,5.6,0,5.3,0,35.6,49.5,1256,635,621,50.56,49.44,29,606,0,621,29,1227,4.6,0,2.3,"25% - 50% P.O.C.","$70000 - $98000"
"17031220300","Census Tract 2203, Cook County, Illinois",2068,98973,1323,30,9,115,0,513,64,1.5,0.4,5.6,0,24.8,36,879,438,441,49.83,50.17,33,405,10,431,43,836,7.5,2.3,4.9,"25% - 50% P.O.C.","$98000 or more"
"17031220400","Census Tract 2204, Cook County, Illinois",2747,103295,2046,33,0,194,0,397,74.5,1.2,0,7.1,0,14.5,25.5,1097,483,614,44.03,55.97,84,399,42,572,126,971,17.4,6.8,11.5,"25% - 50% P.O.C.","$98000 or more"
"17031220500","Census Tract 2205, Cook County, Illinois",2503,94844,1535,107,0,142,0,600,61.3,4.3,0,5.7,0,24,38.7,1236,508,728,41.1,58.9,10,498,11,717,21,1215,2,1.5,1.7,"25% - 50% P.O.C.","$70000 - $98000"
"17031220601","Census Tract 2206.01, Cook County, Illinois",1612,77619,898,31,8,29,0,556,55.7,1.9,0.5,1.8,0,34.5,44.3,714,251,463,35.15,64.85,23,228,8,455,31,683,9.2,1.7,4.3,"25% - 50% P.O.C.","$70000 - $98000"
"17031220602","Census Tract 2206.02, Cook County, Illinois",4916,52163,2606,202,0,269,0,1766,53,4.1,0,5.5,0,35.9,47,2464,481,1983,19.52,80.48,0,481,17,1966,17,2447,0,0.9,0.7,"25% - 50% P.O.C.","$49000 - $70000"
"17031220701","Census Tract 2207.01, Cook County, Illinois",3213,70568,792,117,0,47,0,2180,24.6,3.6,0,1.5,0,67.8,75.4,1063,481,582,45.25,54.75,23,458,94,488,117,946,4.8,16.2,11,"75% or more P.O.C.","$70000 - $98000"
"17031220702","Census Tract 2207.02, Cook County, Illinois",3902,64392,1060,139,0,104,0,2554,27.2,3.6,0,2.7,0,65.5,72.8,1406,471,935,33.5,66.5,73,398,88,847,161,1245,15.5,9.4,11.5,"50% - 75% P.O.C.","$49000 - $70000"
"17031220901","Census Tract 2209.01, Cook County, Illinois",2998,48438,639,225,0,28,0,2075,21.3,7.5,0,0.9,0,69.2,78.7,1014,386,628,38.07,61.93,46,340,64,564,110,904,11.9,10.2,10.8,"75% or more P.O.C.","Less than $49000"
"17031220902","Census Tract 2209.02, Cook County, Illinois",2808,57150,505,17,0,31,0,2215,18,0.6,0,1.1,0,78.9,82,959,393,566,40.98,59.02,36,357,124,442,160,799,9.2,21.9,16.7,"75% or more P.O.C.","$49000 - $70000"
"17031221000","Census Tract 2210, Cook County, Illinois",2771,56984,891,219,0,49,0,1585,32.2,7.9,0,1.8,0,57.2,67.8,1013,317,696,31.29,68.71,55,262,68,628,123,890,17.4,9.8,12.1,"50% - 75% P.O.C.","$49000 - $70000"
"17031221100","Census Tract 2211, Cook County, Illinois",4868,65938,2233,330,0,159,9,2028,45.9,6.8,0,3.3,0.2,41.7,54.1,1899,576,1323,30.33,69.67,62,514,88,1235,150,1749,10.8,6.7,7.9,"50% - 75% P.O.C.","$49000 - $70000"
"17031221200","Census Tract 2212, Cook County, Illinois",3174,101130,1845,116,0,79,0,934,58.1,3.7,0,2.5,0,29.4,41.9,1311,541,770,41.27,58.73,34,507,48,722,82,1229,6.3,6.2,6.3,"25% - 50% P.O.C.","$98000 or more"
"17031221300","Census Tract 2213, Cook County, Illinois",2879,71402,1412,66,0,155,0,1139,49,2.3,0,5.4,0,39.6,51,1270,302,968,23.78,76.22,0,302,73,895,73,1197,0,7.5,5.7,"50% - 75% P.O.C.","$70000 - $98000"
"17031221400","Census Tract 2214, Cook County, Illinois",3144,90592,1412,149,0,123,15,1347,44.9,4.7,0,3.9,0.5,42.8,55.1,1427,542,885,37.98,62.02,39,503,51,834,90,1337,7.2,5.8,6.3,"50% - 75% P.O.C.","$70000 - $98000"
"17031221500","Census Tract 2215, Cook County, Illinois",2726,61635,1393,185,0,220,0,900,51.1,6.8,0,8.1,0,33,48.9,1321,325,996,24.6,75.4,19,306,0,996,19,1302,5.8,0,1.4,"25% - 50% P.O.C.","$49000 - $70000"
"17031221600","Census Tract 2216, Cook County, Illinois",3268,137159,2347,107,0,148,0,591,71.8,3.3,0,4.5,0,18.1,28.2,1421,735,686,51.72,48.28,7,728,37,649,44,1377,1,5.4,3.1,"25% - 50% P.O.C.","$98000 or more"
"17031222200","Census Tract 2222, Cook County, Illinois",2327,150625,1668,87,0,152,0,326,71.7,3.7,0,6.5,0,14,28.3,954,473,481,49.58,50.42,30,443,13,468,43,911,6.3,2.7,4.5,"25% - 50% P.O.C.","$98000 or more"
"17031222500","Census Tract 2225, Cook County, Illinois",1692,90750,761,73,0,9,0,823,45,4.3,0,0.5,0,48.6,55,521,228,293,43.76,56.24,43,185,11,282,54,467,18.9,3.8,10.4,"50% - 75% P.O.C.","$70000 - $98000"
"17031222600","Census Tract 2226, Cook County, Illinois",1663,79231,1009,116,0,35,0,462,60.7,7,0,2.1,0,27.8,39.3,722,225,497,31.16,68.84,36,189,4,493,40,682,16,0.8,5.5,"25% - 50% P.O.C.","$70000 - $98000"
"17031222700","Census Tract 2227, Cook County, Illinois",2564,69063,855,173,0,34,0,1403,33.3,6.7,0,1.3,0,54.7,66.7,861,236,625,27.41,72.59,20,216,105,520,125,736,8.5,16.8,14.5,"50% - 75% P.O.C.","$49000 - $70000"
"17031222800","Census Tract 2228, Cook County, Illinois",1012,50313,294,56,0,0,0,645,29.1,5.5,0,0,0,63.7,70.9,364,106,258,29.12,70.88,28,78,24,234,52,312,26.4,9.3,14.3,"50% - 75% P.O.C.","$49000 - $70000"
"17031222900","Census Tract 2229, Cook County, Illinois",1005,49900,174,98,7,0,0,726,17.3,9.8,0.7,0,0,72.2,82.7,328,175,153,53.35,46.65,37,138,29,124,66,262,21.1,19,20.1,"75% or more P.O.C.","$49000 - $70000"
"17031230100","Census Tract 2301, Cook County, Illinois",1620,56563,574,104,0,50,0,877,35.4,6.4,0,3.1,0,54.1,64.6,645,212,433,32.87,67.13,33,179,7,426,40,605,15.6,1.6,6.2,"50% - 75% P.O.C.","$49000 - $70000"
"17031230200","Census Tract 2302, Cook County, Illinois",2258,57250,401,389,0,62,0,1378,17.8,17.2,0,2.7,0,61,82.2,665,251,414,37.74,62.26,83,168,56,358,139,526,33.1,13.5,20.9,"75% or more P.O.C.","$49000 - $70000"
"17031230300","Census Tract 2303, Cook County, Illinois",972,50242,110,101,0,0,0,757,11.3,10.4,0,0,0,77.9,88.7,284,106,178,37.32,62.68,33,73,13,165,46,238,31.1,7.3,16.2,"75% or more P.O.C.","$49000 - $70000"
"17031230400","Census Tract 2304, Cook County, Illinois",2090,57656,285,12,0,40,0,1728,13.6,0.6,0,1.9,0,82.7,86.4,661,324,337,49.02,50.98,38,286,61,276,99,562,11.7,18.1,15,"75% or more P.O.C.","$49000 - $70000"
"17031230500","Census Tract 2305, Cook County, Illinois",3327,24385,135,209,0,8,0,2975,4.1,6.3,0,0.2,0,89.4,95.9,1156,318,838,27.51,72.49,42,276,188,650,230,926,13.2,22.4,19.9,"75% or more P.O.C.","Less than $49000"
"17031230600","Census Tract 2306, Cook County, Illinois",6988,40675,171,1104,75,0,0,5611,2.4,15.8,1.1,0,0,80.3,97.6,2020,449,1571,22.23,77.77,86,363,335,1236,421,1599,19.2,21.3,20.8,"75% or more P.O.C.","Less than $49000"
"17031230700","Census Tract 2307, Cook County, Illinois",6252,39969,324,264,0,0,0,5560,5.2,4.2,0,0,0,88.9,94.8,1784,809,975,45.35,54.65,208,601,199,776,407,1377,25.7,20.4,22.8,"75% or more P.O.C.","Less than $49000"
"17031230800","Census Tract 2308, Cook County, Illinois",1232,55625,140,47,0,0,0,1045,11.4,3.8,0,0,0,84.8,88.6,338,202,136,59.76,40.24,79,123,35,101,114,224,39.1,25.7,33.7,"75% or more P.O.C.","$49000 - $70000"
"17031230900","Census Tract 2309, Cook County, Illinois",4808,55104,1061,541,0,82,0,3000,22.1,11.3,0,1.7,0,62.4,77.9,1797,666,1131,37.06,62.94,139,527,33,1098,172,1625,20.9,2.9,9.6,"75% or more P.O.C.","$49000 - $70000"
"17031231100","Census Tract 2311, Cook County, Illinois",1217,36250,49,680,0,0,0,463,4,55.9,0,0,0,38,96,358,163,195,45.53,54.47,38,125,29,166,67,291,23.3,14.9,18.7,"75% or more P.O.C.","Less than $49000"
"17031231200","Census Tract 2312, Cook County, Illinois",6504,33423,87,4011,13,0,0,2209,1.3,61.7,0.2,0,0,34,98.7,1934,678,1256,35.06,64.94,128,550,259,997,387,1547,18.9,20.6,20,"75% or more P.O.C.","Less than $49000"
"17031231500","Census Tract 2315, Cook County, Illinois",5586,30927,47,4599,0,0,28,912,0.8,82.3,0,0,0.5,16.3,99.2,1903,739,1164,38.83,61.17,71,668,106,1058,177,1726,9.6,9.1,9.3,"75% or more P.O.C.","Less than $49000"
"17031240200","Census Tract 2402, Cook County, Illinois",1633,148009,1204,23,0,93,0,249,73.7,1.4,0,5.7,0,15.2,26.3,809,408,401,50.43,49.57,16,392,6,395,22,787,3.9,1.5,2.7,"25% - 50% P.O.C.","$98000 or more"
"17031240300","Census Tract 2403, Cook County, Illinois",1215,125882,1005,62,0,64,0,60,82.7,5.1,0,5.3,0,4.9,17.3,586,299,287,51.02,48.98,5,294,0,287,5,581,1.7,0,0.9,"Less than 25% P.O.C.","$98000 or more"
"17031240500","Census Tract 2405, Cook County, Illinois",2425,150188,1985,42,0,183,0,164,81.9,1.7,0,7.5,0,6.8,18.1,1295,896,399,69.19,30.81,0,896,0,399,0,1295,0,0,0,"Less than 25% P.O.C.","$98000 or more"
"17031240600","Census Tract 2406, Cook County, Illinois",1725,102083,949,146,0,27,0,569,55,8.5,0,1.6,0,33,45,636,349,287,54.87,45.13,4,345,47,240,51,585,1.1,16.4,8,"25% - 50% P.O.C.","$98000 or more"
"17031240700","Census Tract 2407, Cook County, Illinois",1876,86667,644,56,0,53,0,1085,34.3,3,0,2.8,0,57.8,65.7,678,267,411,39.38,60.62,55,212,30,381,85,593,20.6,7.3,12.5,"50% - 75% P.O.C.","$70000 - $98000"
"17031240800","Census Tract 2408, Cook County, Illinois",1370,54632,627,74,0,55,0,570,45.8,5.4,0,4,0,41.6,54.2,615,260,355,42.28,57.72,16,244,13,342,29,586,6.2,3.7,4.7,"50% - 75% P.O.C.","$49000 - $70000"
"17031240900","Census Tract 2409, Cook County, Illinois",981,42717,307,99,0,88,0,463,31.3,10.1,0,9,0,47.2,68.7,490,111,379,22.65,77.35,6,105,13,366,19,471,5.4,3.4,3.9,"50% - 75% P.O.C.","Less than $49000"
"17031241000","Census Tract 2410, Cook County, Illinois",2097,71979,732,177,0,99,0,1041,34.9,8.4,0,4.7,0,49.6,65.1,758,180,578,23.75,76.25,11,169,15,563,26,732,6.1,2.6,3.4,"50% - 75% P.O.C.","$70000 - $98000"
"17031241100","Census Tract 2411, Cook County, Illinois",3758,80524,1740,374,0,159,0,1413,46.3,10,0,4.2,0,37.6,53.7,1525,430,1095,28.2,71.8,24,406,42,1053,66,1459,5.6,3.8,4.3,"50% - 75% P.O.C.","$70000 - $98000"
"17031241200","Census Tract 2412, Cook County, Illinois",1820,106875,1167,101,0,185,0,316,64.1,5.5,0,10.2,0,17.4,35.9,755,240,515,31.79,68.21,20,220,13,502,33,722,8.3,2.5,4.4,"25% - 50% P.O.C.","$98000 or more"
"17031241300","Census Tract 2413, Cook County, Illinois",1995,154792,1425,238,0,49,0,209,71.4,11.9,0,2.5,0,10.5,28.6,763,350,413,45.87,54.13,19,331,0,413,19,744,5.4,0,2.5,"25% - 50% P.O.C.","$98000 or more"
"17031241400","Census Tract 2414, Cook County, Illinois",5480,120833,4235,390,0,223,0,571,77.3,7.1,0,4.1,0,10.4,22.7,2538,830,1708,32.7,67.3,33,797,0,1708,33,2505,4,0,1.3,"Less than 25% P.O.C.","$98000 or more"
"17031241500","Census Tract 2415, Cook County, Illinois",2791,141983,2199,61,0,95,31,318,78.8,2.2,0,3.4,1.1,11.4,21.2,1308,549,759,41.97,58.03,39,510,7,752,46,1262,7.1,0.9,3.5,"Less than 25% P.O.C.","$98000 or more"
"17031241600","Census Tract 2416, Cook County, Illinois",3480,101615,2315,80,0,250,0,739,66.5,2.3,0,7.2,0,21.2,33.5,1604,483,1121,30.11,69.89,0,483,14,1107,14,1590,0,1.2,0.9,"25% - 50% P.O.C.","$98000 or more"
"17031242000","Census Tract 2420, Cook County, Illinois",4763,116066,2815,648,0,482,0,695,59.1,13.6,0,10.1,0,14.6,40.9,2060,481,1579,23.35,76.65,3,478,37,1542,40,2020,0.6,2.3,1.9,"25% - 50% P.O.C.","$98000 or more"
"17031242100","Census Tract 2421, Cook County, Illinois",3855,143547,2739,59,0,262,0,715,71.1,1.5,0,6.8,0,18.5,28.9,1720,860,860,50,50,38,822,5,855,43,1677,4.4,0.6,2.5,"25% - 50% P.O.C.","$98000 or more"
"17031242200","Census Tract 2422, Cook County, Illinois",3670,124107,2747,115,31,148,0,526,74.9,3.1,0.8,4,0,14.3,25.1,1733,678,1055,39.12,60.88,12,666,19,1036,31,1702,1.8,1.8,1.8,"25% - 50% P.O.C.","$98000 or more"
"17031242300","Census Tract 2423, Cook County, Illinois",3517,94639,2729,11,0,206,0,415,77.6,0.3,0,5.9,0,11.8,22.4,1655,725,930,43.81,56.19,49,676,8,922,57,1598,6.8,0.9,3.4,"Less than 25% P.O.C.","$70000 - $98000"
"17031242400","Census Tract 2424, Cook County, Illinois",2729,95357,2383,41,0,39,16,166,87.3,1.5,0,1.4,0.6,6.1,12.7,1322,359,963,27.16,72.84,42,317,0,963,42,1280,11.7,0,3.2,"Less than 25% P.O.C.","$70000 - $98000"
"17031242500","Census Tract 2425, Cook County, Illinois",3477,72400,1870,246,0,61,0,1180,53.8,7.1,0,1.8,0,33.9,46.2,1536,480,1056,31.25,68.75,55,425,59,997,114,1422,11.5,5.6,7.4,"25% - 50% P.O.C.","$70000 - $98000"
"17031242600","Census Tract 2426, Cook County, Illinois",5293,63009,2675,582,0,65,0,1876,50.5,11,0,1.2,0,35.4,49.5,2543,704,1839,27.68,72.32,37,667,0,1839,37,2506,5.3,0,1.5,"25% - 50% P.O.C.","$49000 - $70000"
"17031242700","Census Tract 2427, Cook County, Illinois",1682,52415,521,380,0,63,0,691,31,22.6,0,3.7,0,41.1,69,749,225,524,30.04,69.96,20,205,36,488,56,693,8.9,6.9,7.5,"50% - 75% P.O.C.","$49000 - $70000"
"17031242800","Census Tract 2428, Cook County, Illinois",1621,89688,1155,10,0,18,0,414,71.3,0.6,0,1.1,0,25.5,28.7,619,385,234,62.2,37.8,40,345,16,218,56,563,10.4,6.8,9,"25% - 50% P.O.C.","$70000 - $98000"
"17031242900","Census Tract 2429, Cook County, Illinois",1803,101216,1247,91,0,84,0,313,69.2,5,0,4.7,0,17.4,30.8,814,372,442,45.7,54.3,10,362,0,442,10,804,2.7,0,1.2,"25% - 50% P.O.C.","$98000 or more"
"17031243000","Census Tract 2430, Cook County, Illinois",2182,85362,1425,66,0,93,0,546,65.3,3,0,4.3,0,25,34.7,1050,442,608,42.1,57.9,0,442,16,592,16,1034,0,2.6,1.5,"25% - 50% P.O.C.","$70000 - $98000"
"17031243100","Census Tract 2431, Cook County, Illinois",2274,110385,1376,47,0,147,0,634,60.5,2.1,0,6.5,0,27.9,39.5,910,468,442,51.43,48.57,38,430,4,438,42,868,8.1,0.9,4.6,"25% - 50% P.O.C.","$98000 or more"
"17031243200","Census Tract 2432, Cook County, Illinois",2139,123942,1248,89,0,105,0,665,58.3,4.2,0,4.9,0,31.1,41.7,879,406,473,46.19,53.81,52,354,21,452,73,806,12.8,4.4,8.3,"25% - 50% P.O.C.","$98000 or more"
"17031243300","Census Tract 2433, Cook County, Illinois",2457,99038,1583,99,0,142,0,577,64.4,4,0,5.8,0,23.5,35.6,1148,551,597,48,52,38,513,30,567,68,1080,6.9,5,5.9,"25% - 50% P.O.C.","$98000 or more"
"17031243400","Census Tract 2434, Cook County, Illinois",2849,102625,1591,163,0,178,0,808,55.8,5.7,0,6.2,0,28.4,44.2,1337,655,682,48.99,51.01,1,654,52,630,53,1284,0.2,7.6,4,"25% - 50% P.O.C.","$98000 or more"
"17031243500","Census Tract 2435, Cook County, Illinois",3601,129028,2397,715,0,210,0,184,66.6,19.9,0,5.8,0,5.1,33.4,1891,854,1037,45.16,54.84,5,849,55,982,60,1831,0.6,5.3,3.2,"25% - 50% P.O.C.","$98000 or more"
"17031250200","Census Tract 2502, Cook County, Illinois",2866,47411,69,1268,0,32,0,1479,2.4,44.2,0,1.1,0,51.6,97.6,823,552,271,67.07,32.93,154,398,26,245,180,643,27.9,9.6,21.9,"75% or more P.O.C.","Less than $49000"
"17031250300","Census Tract 2503, Cook County, Illinois",5122,34141,18,3217,0,33,0,1810,0.4,62.8,0,0.6,0,35.3,99.6,1548,692,856,44.7,55.3,93,599,171,685,264,1284,13.4,20,17.1,"75% or more P.O.C.","Less than $49000"
"17031250400","Census Tract 2504, Cook County, Illinois",4769,46261,171,3498,43,0,0,1057,3.6,73.3,0.9,0,0,22.2,96.4,1827,955,872,52.27,47.73,119,836,20,852,139,1688,12.5,2.3,7.6,"75% or more P.O.C.","Less than $49000"
"17031250500","Census Tract 2505, Cook County, Illinois",7242,96920,2884,1997,13,157,0,1961,39.8,27.6,0.2,2.2,0,27.1,60.2,2758,2081,677,75.45,24.55,156,1925,98,579,254,2504,7.5,14.5,9.2,"50% - 75% P.O.C.","$70000 - $98000"
"17031250600","Census Tract 2506, Cook County, Illinois",4252,46184,62,3617,0,27,0,546,1.5,85.1,0,0.6,0,12.8,98.5,1304,952,352,73.01,26.99,158,794,52,300,210,1094,16.6,14.8,16.1,"75% or more P.O.C.","Less than $49000"
"17031250700","Census Tract 2507, Cook County, Illinois",5214,34941,0,3839,0,0,0,1180,0,73.6,0,0,0,22.6,100,2032,819,1213,40.31,59.69,163,656,23,1190,186,1846,19.9,1.9,9.2,"75% or more P.O.C.","Less than $49000"
"17031250800","Census Tract 2508, Cook County, Illinois",2621,36250,16,2355,0,0,0,243,0.6,89.9,0,0,0,9.3,99.4,807,516,291,63.94,36.06,84,432,29,262,113,694,16.3,10,14,"75% or more P.O.C.","Less than $49000"
"17031251000","Census Tract 2510, Cook County, Illinois",1022,29671,23,789,0,0,0,210,2.3,77.2,0,0,0,20.5,97.7,355,192,163,54.08,45.92,14,178,32,131,46,309,7.3,19.6,13,"75% or more P.O.C.","Less than $49000"
"17031251100","Census Tract 2511, Cook County, Illinois",4811,19938,87,4109,0,0,0,615,1.8,85.4,0,0,0,12.8,98.2,1548,445,1103,28.75,71.25,107,338,122,981,229,1319,24,11.1,14.8,"75% or more P.O.C.","Less than $49000"
"17031251200","Census Tract 2512, Cook County, Illinois",3807,45610,22,2935,0,69,0,781,0.6,77.1,0,1.8,0,20.5,99.4,1086,601,485,55.34,44.66,76,525,132,353,208,878,12.6,27.2,19.2,"75% or more P.O.C.","Less than $49000"
"17031251300","Census Tract 2513, Cook County, Illinois",4047,31663,128,3287,0,0,0,573,3.2,81.2,0,0,0,14.2,96.8,1403,764,639,54.45,45.55,94,670,54,585,148,1255,12.3,8.5,10.5,"75% or more P.O.C.","Less than $49000"
"17031251400","Census Tract 2514, Cook County, Illinois",4029,33625,656,3097,0,0,0,197,16.3,76.9,0,0,0,4.9,83.7,1690,478,1212,28.28,71.72,94,384,64,1148,158,1532,19.7,5.3,9.3,"75% or more P.O.C.","Less than $49000"
"17031251500","Census Tract 2515, Cook County, Illinois",4342,23933,56,3842,0,0,0,393,1.3,88.5,0,0,0,9.1,98.7,1402,348,1054,24.82,75.18,34,314,156,898,190,1212,9.8,14.8,13.6,"75% or more P.O.C.","Less than $49000"
"17031251600","Census Tract 2516, Cook County, Illinois",4261,30000,4,3754,0,0,0,484,0.1,88.1,0,0,0,11.4,99.9,1138,305,833,26.8,73.2,59,246,176,657,235,903,19.3,21.1,20.7,"75% or more P.O.C.","Less than $49000"
"17031251700","Census Tract 2517, Cook County, Illinois",1182,52857,43,933,0,0,0,206,3.6,78.9,0,0,0,17.4,96.4,370,200,170,54.05,45.95,41,159,26,144,67,303,20.5,15.3,18.1,"75% or more P.O.C.","$49000 - $70000"
"17031251800","Census Tract 2518, Cook County, Illinois",5300,24632,184,4810,0,0,14,179,3.5,90.8,0,0,0.3,3.4,96.5,1699,191,1508,11.24,88.76,9,182,311,1197,320,1379,4.7,20.6,18.8,"75% or more P.O.C.","Less than $49000"
"17031251900","Census Tract 2519, Cook County, Illinois",4653,21106,139,4295,0,0,0,194,3,92.3,0,0,0,4.2,97,1818,367,1451,20.19,79.81,45,322,191,1260,236,1582,12.3,13.2,13,"75% or more P.O.C.","Less than $49000"
"17031252000","Census Tract 2520, Cook County, Illinois",5259,19921,67,5043,0,0,0,101,1.3,95.9,0,0,0,1.9,98.7,2379,489,1890,20.55,79.45,66,423,38,1852,104,2275,13.5,2,4.4,"75% or more P.O.C.","Less than $49000"
"17031252101","Census Tract 2521.01, Cook County, Illinois",1270,17000,20,1239,0,0,0,11,1.6,97.6,0,0,0,0.9,98.4,652,138,514,21.17,78.83,0,138,36,478,36,616,0,7,5.5,"75% or more P.O.C.","Less than $49000"
"17031252102","Census Tract 2521.02, Cook County, Illinois",6864,38500,135,6247,0,0,0,482,2,91,0,0,0,7,98,2188,1116,1072,51.01,48.99,245,871,182,890,427,1761,22,17,19.5,"75% or more P.O.C.","Less than $49000"
"17031252201","Census Tract 2522.01, Cook County, Illinois",2646,32831,138,2405,0,17,0,86,5.2,90.9,0,0.6,0,3.3,94.8,953,311,642,32.63,67.37,54,257,42,600,96,857,17.4,6.5,10.1,"75% or more P.O.C.","Less than $49000"
"17031252202","Census Tract 2522.02, Cook County, Illinois",4127,28105,71,3890,0,57,0,109,1.7,94.3,0,1.4,0,2.6,98.3,1482,375,1107,25.3,74.7,27,348,121,986,148,1334,7.2,10.9,10,"75% or more P.O.C.","Less than $49000"
"17031260100","Census Tract 2601, Cook County, Illinois",1204,14505,104,1060,0,0,0,22,8.6,88,0,0,0,1.8,91.4,577,51,526,8.84,91.16,10,41,48,478,58,519,19.6,9.1,10.1,"75% or more P.O.C.","Less than $49000"
"17031260200","Census Tract 2602, Cook County, Illinois",960,35192,0,939,0,0,0,21,0,97.8,0,0,0,2.2,100,284,72,212,25.35,74.65,20,52,30,182,50,234,27.8,14.2,17.6,"75% or more P.O.C.","Less than $49000"
"17031260300","Census Tract 2603, Cook County, Illinois",1668,23289,24,1518,0,0,0,126,1.4,91,0,0,0,7.6,98.6,566,77,489,13.6,86.4,10,67,108,381,118,448,13,22.1,20.8,"75% or more P.O.C.","Less than $49000"
"17031260400","Census Tract 2604, Cook County, Illinois",1174,18750,12,1162,0,0,0,0,1,99,0,0,0,0,99,407,66,341,16.22,83.78,0,66,62,279,62,345,0,18.2,15.2,"75% or more P.O.C.","Less than $49000"
"17031260500","Census Tract 2605, Cook County, Illinois",1538,33026,4,1499,13,0,0,22,0.3,97.5,0.8,0,0,1.4,99.7,524,188,336,35.88,64.12,8,180,28,308,36,488,4.3,8.3,6.9,"75% or more P.O.C.","Less than $49000"
"17031260600","Census Tract 2606, Cook County, Illinois",2018,27273,10,1964,0,0,0,44,0.5,97.3,0,0,0,2.2,99.5,536,158,378,29.48,70.52,25,133,89,289,114,422,15.8,23.5,21.3,"75% or more P.O.C.","Less than $49000"
"17031260700","Census Tract 2607, Cook County, Illinois",1669,22222,7,1571,0,0,0,56,0.4,94.1,0,0,0,3.4,99.6,518,121,397,23.36,76.64,22,99,36,361,58,460,18.2,9.1,11.2,"75% or more P.O.C.","Less than $49000"
"17031260800","Census Tract 2608, Cook County, Illinois",2447,21613,109,2229,0,0,0,15,4.5,91.1,0,0,0,0.6,95.5,848,160,688,18.87,81.13,7,153,86,602,93,755,4.4,12.5,11,"75% or more P.O.C.","Less than $49000"
"17031260900","Census Tract 2609, Cook County, Illinois",1461,24714,123,1242,0,0,0,75,8.4,85,0,0,0,5.1,91.6,378,138,240,36.51,63.49,7,131,29,211,36,342,5.1,12.1,9.5,"75% or more P.O.C.","Less than $49000"
"17031261000","Census Tract 2610, Cook County, Illinois",2276,33350,14,2092,0,0,0,104,0.6,91.9,0,0,0,4.6,99.4,715,203,512,28.39,71.61,17,186,60,452,77,638,8.4,11.7,10.8,"75% or more P.O.C.","Less than $49000"
"17031270500","Census Tract 2705, Cook County, Illinois",1271,15571,0,1194,0,0,0,77,0,93.9,0,0,0,6.1,100,542,60,482,11.07,88.93,5,55,46,436,51,491,8.3,9.5,9.4,"75% or more P.O.C.","Less than $49000"
"17031271200","Census Tract 2712, Cook County, Illinois",1326,32159,89,1166,0,3,0,13,6.7,87.9,0,0.2,0,1,93.3,393,78,315,19.85,80.15,6,72,11,304,17,376,7.7,3.5,4.3,"75% or more P.O.C.","Less than $49000"
"17031271300","Census Tract 2713, Cook County, Illinois",1110,25345,0,1074,0,16,0,20,0,96.8,0,1.4,0,1.8,100,366,111,255,30.33,69.67,6,105,43,212,49,317,5.4,16.9,13.4,"75% or more P.O.C.","Less than $49000"
"17031271400","Census Tract 2714, Cook County, Illinois",1272,24050,51,1040,0,22,0,19,4,81.8,0,1.7,0,1.5,96,491,75,416,15.27,84.73,4,71,17,399,21,470,5.3,4.1,4.3,"75% or more P.O.C.","Less than $49000"
"17031271500","Census Tract 2715, Cook County, Illinois",1527,37109,67,1406,0,0,0,9,4.4,92.1,0,0,0,0.6,95.6,499,208,291,41.68,58.32,30,178,40,251,70,429,14.4,13.7,14,"75% or more P.O.C.","Less than $49000"
"17031271800","Census Tract 2718, Cook County, Illinois",730,18952,0,716,0,0,0,14,0,98.1,0,0,0,1.9,100,232,28,204,12.07,87.93,2,26,34,170,36,196,7.1,16.7,15.5,"75% or more P.O.C.","Less than $49000"
"17031280100","Census Tract 2801, Cook County, Illinois",6603,136389,4881,199,0,915,0,298,73.9,3,0,13.9,0,4.5,26.1,4222,1589,2633,37.64,62.36,0,1589,0,2633,0,4222,0,0,0,"25% - 50% P.O.C.","$98000 or more"
"17031280400","Census Tract 2804, Cook County, Illinois",1585,39544,190,1291,0,11,0,88,12,81.5,0,0.7,0,5.6,88,567,52,515,9.17,90.83,0,52,80,435,80,487,0,15.5,14.1,"75% or more P.O.C.","Less than $49000"
"17031280800","Census Tract 2808, Cook County, Illinois",786,18077,56,676,0,0,0,49,7.1,86,0,0,0,6.2,92.9,356,57,299,16.01,83.99,0,57,28,271,28,328,0,9.4,7.9,"75% or more P.O.C.","Less than $49000"
"17031280900","Census Tract 2809, Cook County, Illinois",890,17569,97,773,0,5,0,15,10.9,86.9,0,0.6,0,1.7,89.1,348,53,295,15.23,84.77,0,53,37,258,37,311,0,12.5,10.6,"75% or more P.O.C.","Less than $49000"
"17031281900","Census Tract 2819, Cook County, Illinois",6221,109104,2867,316,0,2422,0,431,46.1,5.1,0,38.9,0,6.9,53.9,3659,995,2664,27.19,72.81,0,995,38,2626,38,3621,0,1.4,1,"50% - 75% P.O.C.","$98000 or more"
"17031282700","Census Tract 2827, Cook County, Illinois",2285,74460,446,1033,0,217,0,531,19.5,45.2,0,9.5,0,23.2,80.5,825,381,444,46.18,53.82,32,349,40,404,72,753,8.4,9,8.7,"75% or more P.O.C.","$70000 - $98000"
"17031282800","Census Tract 2828, Cook County, Illinois",1607,58203,486,379,0,275,0,425,30.2,23.6,0,17.1,0,26.4,69.8,655,195,460,29.77,70.23,25,170,7,453,32,623,12.8,1.5,4.9,"50% - 75% P.O.C.","$49000 - $70000"
"17031283100","Census Tract 2831, Cook County, Illinois",3194,38705,789,939,0,1090,0,288,24.7,29.4,0,34.1,0,9,75.3,1123,191,932,17.01,82.99,17,174,70,862,87,1036,8.9,7.5,7.7,"75% or more P.O.C.","Less than $49000"
"17031283200","Census Tract 2832, Cook County, Illinois",1622,73558,506,638,0,234,0,171,31.2,39.3,0,14.4,0,10.5,68.8,660,245,415,37.12,62.88,16,229,34,381,50,610,6.5,8.2,7.6,"50% - 75% P.O.C.","$70000 - $98000"
"17031283800","Census Tract 2838, Cook County, Illinois",3668,76926,1390,1273,0,399,0,606,37.9,34.7,0,10.9,0,16.5,62.1,1641,705,936,42.96,57.04,40,665,73,863,113,1528,5.7,7.8,6.9,"50% - 75% P.O.C.","$70000 - $98000"
"17031290900","Census Tract 2909, Cook County, Illinois",3857,25542,0,3840,0,17,0,0,0,99.6,0,0.4,0,0,100,1241,258,983,20.79,79.21,31,227,217,766,248,993,12,22.1,20,"75% or more P.O.C.","Less than $49000"
"17031291200","Census Tract 2912, Cook County, Illinois",2124,22153,44,2024,0,0,0,56,2.1,95.3,0,0,0,2.6,97.9,763,145,618,19,81,5,140,36,582,41,722,3.4,5.8,5.4,"75% or more P.O.C.","Less than $49000"
"17031291600","Census Tract 2916, Cook County, Illinois",945,53750,193,88,0,0,0,664,20.4,9.3,0,0,0,70.3,79.6,285,95,190,33.33,66.67,17,78,30,160,47,238,17.9,15.8,16.5,"75% or more P.O.C.","$49000 - $70000"
"17031292200","Census Tract 2922, Cook County, Illinois",2506,34861,82,2151,0,12,0,261,3.3,85.8,0,0.5,0,10.4,96.7,864,246,618,28.47,71.53,15,231,103,515,118,746,6.1,16.7,13.7,"75% or more P.O.C.","Less than $49000"
"17031292400","Census Tract 2924, Cook County, Illinois",2000,32589,48,1916,0,1,0,35,2.4,95.8,0,0,0,1.8,97.6,625,159,466,25.44,74.56,27,132,56,410,83,542,17,12,13.3,"75% or more P.O.C.","Less than $49000"
"17031292500","Census Tract 2925, Cook County, Illinois",3595,40938,84,2969,85,0,0,260,2.3,82.6,2.4,0,0,7.2,97.7,1348,484,864,35.91,64.09,27,457,91,773,118,1230,5.6,10.5,8.8,"75% or more P.O.C.","Less than $49000"
"17031300500","Census Tract 3005, Cook County, Illinois",2916,40083,43,168,6,0,0,2699,1.5,5.8,0.2,0,0,92.6,98.5,850,271,579,31.88,68.12,58,213,89,490,147,703,21.4,15.4,17.3,"75% or more P.O.C.","Less than $49000"
"17031300600","Census Tract 3006, Cook County, Illinois",3035,43594,285,401,0,0,0,2326,9.4,13.2,0,0,0,76.6,90.6,777,314,463,40.41,59.59,92,222,119,344,211,566,29.3,25.7,27.2,"75% or more P.O.C.","Less than $49000"
"17031300700","Census Tract 3007, Cook County, Illinois",4841,40789,83,65,0,39,0,4654,1.7,1.3,0,0.8,0,96.1,98.3,1326,395,931,29.79,70.21,28,367,266,665,294,1032,7.1,28.6,22.2,"75% or more P.O.C.","Less than $49000"
"17031300800","Census Tract 3008, Cook County, Illinois",3960,30367,51,0,0,0,0,3897,1.3,0,0,0,0,98.4,98.7,1143,366,777,32.02,67.98,66,300,244,533,310,833,18,31.4,27.1,"75% or more P.O.C.","Less than $49000"
"17031300900","Census Tract 3009, Cook County, Illinois",4223,29098,232,2,0,0,0,3989,5.5,0,0,0,0,94.5,94.5,1268,268,1000,21.14,78.86,77,191,183,817,260,1008,28.7,18.3,20.5,"75% or more P.O.C.","Less than $49000"
"17031301100","Census Tract 3011, Cook County, Illinois",2217,31207,116,199,0,0,0,1879,5.2,9,0,0,0,84.8,94.8,784,215,569,27.42,72.58,7,208,99,470,106,678,3.3,17.4,13.5,"75% or more P.O.C.","Less than $49000"
"17031301200","Census Tract 3012, Cook County, Illinois",4417,35259,165,347,0,0,0,3891,3.7,7.9,0,0,0,88.1,96.3,1175,273,902,23.23,76.77,132,141,211,691,343,832,48.4,23.4,29.2,"75% or more P.O.C.","Less than $49000"
"17031301600","Census Tract 3016, Cook County, Illinois",4242,28484,87,113,0,0,0,4042,2.1,2.7,0,0,0,95.3,97.9,1302,620,682,47.62,52.38,138,482,106,576,244,1058,22.3,15.5,18.7,"75% or more P.O.C.","Less than $49000"
"17031301701","Census Tract 3017.01, Cook County, Illinois",3785,30742,41,1,0,0,0,3743,1.1,0,0,0,0,98.9,98.9,1105,400,705,36.2,63.8,146,254,144,561,290,815,36.5,20.4,26.2,"75% or more P.O.C.","Less than $49000"
"17031301702","Census Tract 3017.02, Cook County, Illinois",4645,43771,95,0,0,0,0,4526,2,0,0,0,0,97.4,98,1070,499,571,46.64,53.36,175,324,185,386,360,710,35.1,32.4,33.6,"75% or more P.O.C.","Less than $49000"
"17031301801","Census Tract 3018.01, Cook County, Illinois",3568,37000,175,2,1,0,0,3377,4.9,0.1,0,0,0,94.6,95.1,1100,385,715,35,65,87,298,141,574,228,872,22.6,19.7,20.7,"75% or more P.O.C.","Less than $49000"
"17031301802","Census Tract 3018.02, Cook County, Illinois",3421,31875,68,33,7,0,0,3313,2,1,0.2,0,0,96.8,98,885,308,577,34.8,65.2,109,199,149,428,258,627,35.4,25.8,29.2,"75% or more P.O.C.","Less than $49000"
"17031301803","Census Tract 3018.03, Cook County, Illinois",4423,32208,156,0,0,0,0,4267,3.5,0,0,0,0,96.5,96.5,1350,562,788,41.63,58.37,146,416,150,638,296,1054,26,19,21.9,"75% or more P.O.C.","Less than $49000"
"17031310200","Census Tract 3102, Cook County, Illinois",1765,75054,481,123,0,178,0,946,27.3,7,0,10.1,0,53.6,72.7,707,314,393,44.41,55.59,19,295,34,359,53,654,6.1,8.7,7.5,"50% - 75% P.O.C.","$70000 - $98000"
"17031310300","Census Tract 3103, Cook County, Illinois",1873,51607,546,67,0,113,0,1115,29.2,3.6,0,6,0,59.5,70.8,764,235,529,30.76,69.24,28,207,16,513,44,720,11.9,3,5.8,"50% - 75% P.O.C.","$49000 - $70000"
"17031310400","Census Tract 3104, Cook County, Illinois",1286,81618,445,79,0,133,0,595,34.6,6.1,0,10.3,0,46.3,65.4,550,199,351,36.18,63.82,15,184,14,337,29,521,7.5,4,5.3,"50% - 75% P.O.C.","$70000 - $98000"
"17031310500","Census Tract 3105, Cook County, Illinois",1491,45417,330,0,0,7,0,1154,22.1,0,0,0.5,0,77.4,77.9,496,128,368,25.81,74.19,4,124,38,330,42,454,3.1,10.3,8.5,"75% or more P.O.C.","Less than $49000"
"17031310600","Census Tract 3106, Cook County, Illinois",4555,47097,1262,201,52,276,0,2764,27.7,4.4,1.1,6.1,0,60.7,72.3,2112,541,1571,25.62,74.38,64,477,25,1546,89,2023,11.8,1.6,4.2,"50% - 75% P.O.C.","Less than $49000"
"17031310700","Census Tract 3107, Cook County, Illinois",1514,57774,352,37,0,112,0,967,23.2,2.4,0,7.4,0,63.9,76.8,561,188,373,33.51,66.49,23,165,34,339,57,504,12.2,9.1,10.2,"75% or more P.O.C.","$49000 - $70000"
"17031310800","Census Tract 3108, Cook County, Illinois",4421,56011,644,43,0,202,0,3459,14.6,1,0,4.6,0,78.2,85.4,1458,384,1074,26.34,73.66,74,310,121,953,195,1263,19.3,11.3,13.4,"75% or more P.O.C.","$49000 - $70000"
"17031310900","Census Tract 3109, Cook County, Illinois",5215,41929,632,91,0,61,0,4321,12.1,1.7,0,1.2,0,82.9,87.9,1688,580,1108,34.36,65.64,129,451,171,937,300,1388,22.2,15.4,17.8,"75% or more P.O.C.","Less than $49000"
"17031320100","Census Tract 3201, Cook County, Illinois",13568,109167,9199,295,75,2584,0,1097,67.8,2.2,0.6,19,0,8.1,32.2,8228,3093,5135,37.59,62.41,0,3093,0,5135,0,8228,0,0,0,"25% - 50% P.O.C.","$98000 or more"
"17031320400","Census Tract 3204, Cook County, Illinois",3150,168958,1916,290,0,518,0,283,60.8,9.2,0,16.4,0,9,39.2,687,410,277,59.68,40.32,7,403,0,277,7,680,1.7,0,1,"25% - 50% P.O.C.","$98000 or more"
"17031320600","Census Tract 3206, Cook County, Illinois",5183,102125,2816,567,0,1162,0,475,54.3,10.9,0,22.4,0,9.2,45.7,2991,1126,1865,37.65,62.35,40,1086,0,1865,40,2951,3.6,0,1.3,"25% - 50% P.O.C.","$98000 or more"
"17031330100","Census Tract 3301, Cook County, Illinois",20087,115484,11188,4402,0,2529,0,1279,55.7,21.9,0,12.6,0,6.4,44.3,12017,6612,5405,55.02,44.98,116,6496,0,5405,116,11901,1.8,0,1,"25% - 50% P.O.C.","$98000 or more"
"17031330200","Census Tract 3302, Cook County, Illinois",3599,81389,1638,1086,0,725,0,55,45.5,30.2,0,20.1,0,1.5,54.5,1870,1077,793,57.59,42.41,56,1021,13,780,69,1801,5.2,1.6,3.7,"50% - 75% P.O.C.","$70000 - $98000"
"17031340300","Census Tract 3403, Cook County, Illinois",1875,33333,210,7,0,1528,0,123,11.2,0.4,0,81.5,0,6.6,88.8,718,320,398,44.57,55.43,58,262,7,391,65,653,18.1,1.8,9.1,"75% or more P.O.C.","Less than $49000"
"17031340400","Census Tract 3404, Cook County, Illinois",1949,50256,240,72,0,1573,0,64,12.3,3.7,0,80.7,0,3.3,87.7,686,216,470,31.49,68.51,17,199,57,413,74,612,7.9,12.1,10.8,"75% or more P.O.C.","$49000 - $70000"
"17031340500","Census Tract 3405, Cook County, Illinois",1591,23854,660,55,8,619,0,245,41.5,3.5,0.5,38.9,0,15.4,58.5,851,221,630,25.97,74.03,0,221,0,630,0,851,0,0,0,"50% - 75% P.O.C.","Less than $49000"
"17031340600","Census Tract 3406, Cook County, Illinois",981,13625,10,957,0,0,0,0,1,97.6,0,0,0,0,99,415,0,415,0,100,0,0,34,381,34,381,NA,8.2,8.2,"75% or more P.O.C.","Less than $49000"
"17031350100","Census Tract 3501, Cook County, Illinois",2432,44896,170,894,22,1112,0,69,7,36.8,0.9,45.7,0,2.8,93,1525,0,1525,0,100,0,0,0,1525,0,1525,NA,0,0,"75% or more P.O.C.","Less than $49000"
"17031350400","Census Tract 3504, Cook County, Illinois",1979,13676,9,1970,0,0,0,0,0.5,99.5,0,0,0,0,99.5,672,0,672,0,100,0,0,73,599,73,599,NA,10.9,10.9,"75% or more P.O.C.","Less than $49000"
"17031351000","Census Tract 3510, Cook County, Illinois",3269,44770,230,2223,0,628,0,12,7,68,0,19.2,0,0.4,93,2215,114,2101,5.15,94.85,0,114,0,2101,0,2215,0,0,0,"75% or more P.O.C.","Less than $49000"
"17031351100","Census Tract 3511, Cook County, Illinois",2418,11523,44,2321,0,0,0,20,1.8,96,0,0,0,0.8,98.2,940,12,928,1.28,98.72,0,12,54,874,54,886,0,5.8,5.7,"75% or more P.O.C.","Less than $49000"
"17031351400","Census Tract 3514, Cook County, Illinois",1841,16607,64,1613,0,47,0,104,3.5,87.6,0,2.6,0,5.6,96.5,787,96,691,12.2,87.8,0,96,42,649,42,745,0,6.1,5.3,"75% or more P.O.C.","Less than $49000"
"17031351500","Census Tract 3515, Cook County, Illinois",731,16250,142,388,0,145,0,31,19.4,53.1,0,19.8,0,4.2,80.6,344,26,318,7.56,92.44,0,26,14,304,14,330,0,4.4,4.1,"75% or more P.O.C.","Less than $49000"
"17031360200","Census Tract 3602, Cook County, Illinois",1477,31674,11,1336,0,52,0,78,0.7,90.5,0,3.5,0,5.3,99.3,705,52,653,7.38,92.62,9,43,10,643,19,686,17.3,1.5,2.7,"75% or more P.O.C.","Less than $49000"
"17031380100","Census Tract 3801, Cook County, Illinois",1894,16736,115,1688,18,0,0,21,6.1,89.1,1,0,0,1.1,93.9,1071,317,754,29.6,70.4,0,317,0,754,0,1071,0,0,0,"75% or more P.O.C.","Less than $49000"
"17031380200","Census Tract 3802, Cook County, Illinois",1556,27724,29,1458,0,9,0,16,1.9,93.7,0,0.6,0,1,98.1,1149,209,940,18.19,81.81,0,209,7,933,7,1142,0,0.7,0.6,"75% or more P.O.C.","Less than $49000"
"17031380500","Census Tract 3805, Cook County, Illinois",856,20541,0,856,0,0,0,0,0,100,0,0,0,0,100,328,0,328,0,100,0,0,39,289,39,289,NA,11.9,11.9,"75% or more P.O.C.","Less than $49000"
"17031380700","Census Tract 3807, Cook County, Illinois",1330,43250,76,1218,6,0,0,17,5.7,91.6,0.5,0,0,1.3,94.3,427,46,381,10.77,89.23,8,38,28,353,36,391,17.4,7.3,8.4,"75% or more P.O.C.","Less than $49000"
"17031381200","Census Tract 3812, Cook County, Illinois",1852,37059,42,1687,41,0,0,15,2.3,91.1,2.2,0,0,0.8,97.7,946,240,706,25.37,74.63,50,190,0,706,50,896,20.8,0,5.3,"75% or more P.O.C.","Less than $49000"
"17031381400","Census Tract 3814, Cook County, Illinois",1415,42960,5,1345,0,65,0,0,0.4,95.1,0,4.6,0,0,99.6,689,172,517,24.96,75.04,10,162,22,495,32,657,5.8,4.3,4.6,"75% or more P.O.C.","Less than $49000"
"17031381500","Census Tract 3815, Cook County, Illinois",347,18906,14,321,0,0,0,0,4,92.5,0,0,0,0,96,226,31,195,13.72,86.28,0,31,10,185,10,216,0,5.1,4.4,"75% or more P.O.C.","Less than $49000"
"17031381700","Census Tract 3817, Cook County, Illinois",0,NA,0,0,0,0,0,0,NA,NA,NA,NA,NA,NA,NA,0,0,0,NA,NA,0,0,0,0,0,0,NA,NA,NA,"N/A","N/A"
"17031381800","Census Tract 3818, Cook County, Illinois",1252,40833,116,1094,0,33,0,0,9.3,87.4,0,2.6,0,0,90.7,648,192,456,29.63,70.37,0,192,14,442,14,634,0,3.1,2.2,"75% or more P.O.C.","Less than $49000"
"17031381900","Census Tract 3819, Cook County, Illinois",1129,52641,65,951,7,5,0,19,5.8,84.2,0.6,0.4,0,1.7,94.2,522,245,277,46.93,53.07,9,236,12,265,21,501,3.7,4.3,4,"75% or more P.O.C.","$49000 - $70000"
"17031390100","Census Tract 3901, Cook County, Illinois",1626,80234,82,1252,46,113,0,22,5,77,2.8,6.9,0,1.4,95,675,278,397,41.19,58.81,37,241,53,344,90,585,13.3,13.4,13.3,"75% or more P.O.C.","$70000 - $98000"
"17031390200","Census Tract 3902, Cook County, Illinois",2143,87500,324,1446,0,134,0,32,15.1,67.5,0,6.3,0,1.5,84.9,856,531,325,62.03,37.97,26,505,44,281,70,786,4.9,13.5,8.2,"75% or more P.O.C.","$70000 - $98000"
"17031390300","Census Tract 3903, Cook County, Illinois",2980,22451,361,2453,4,25,0,84,12.1,82.3,0.1,0.8,0,2.8,87.9,1540,231,1309,15,85,24,207,35,1274,59,1481,10.4,2.7,3.8,"75% or more P.O.C.","Less than $49000"
"17031390400","Census Tract 3904, Cook County, Illinois",2582,25553,361,2100,0,12,0,58,14,81.3,0,0.5,0,2.2,86,1549,414,1135,26.73,73.27,0,414,0,1135,0,1549,0,0,0,"75% or more P.O.C.","Less than $49000"
"17031390500","Census Tract 3905, Cook County, Illinois",1565,46442,345,889,0,162,0,147,22,56.8,0,10.4,0,9.4,78,807,204,603,25.28,74.72,27,177,22,581,49,758,13.2,3.6,6.1,"75% or more P.O.C.","Less than $49000"
"17031390600","Census Tract 3906, Cook County, Illinois",1686,51849,821,664,0,78,0,34,48.7,39.4,0,4.6,0,2,51.3,799,375,424,46.93,53.07,25,350,0,424,25,774,6.7,0,3.1,"50% - 75% P.O.C.","$49000 - $70000"
"17031390700","Census Tract 3907, Cook County, Illinois",5372,61193,1117,3304,0,721,0,58,20.8,61.5,0,13.4,0,1.1,79.2,3345,1275,2070,38.12,61.88,0,1275,0,2070,0,3345,0,0,0,"75% or more P.O.C.","$49000 - $70000"
"17031400300","Census Tract 4003, Cook County, Illinois",1329,29495,5,1209,0,0,0,115,0.4,91,0,0,0,8.7,99.6,613,65,548,10.6,89.4,0,65,24,524,24,589,0,4.4,3.9,"75% or more P.O.C.","Less than $49000"
"17031400400","Census Tract 4004, Cook County, Illinois",2084,36591,21,2051,0,0,0,0,1,98.4,0,0,0,0,99,792,167,625,21.09,78.91,16,151,80,545,96,696,9.6,12.8,12.1,"75% or more P.O.C.","Less than $49000"
"17031400500","Census Tract 4005, Cook County, Illinois",2102,22355,21,2044,10,0,0,8,1,97.2,0.5,0,0,0.4,99,831,119,712,14.32,85.68,9,110,58,654,67,764,7.6,8.1,8.1,"75% or more P.O.C.","Less than $49000"
"17031400800","Census Tract 4008, Cook County, Illinois",2452,18954,19,2303,0,0,0,38,0.8,93.9,0,0,0,1.5,99.2,1033,64,969,6.2,93.8,32,32,81,888,113,920,50,8.4,10.9,"75% or more P.O.C.","Less than $49000"
"17031410100","Census Tract 4101, Cook County, Illinois",2007,48194,654,782,0,167,0,280,32.6,39,0,8.3,0,14,67.4,1251,236,1015,18.86,81.14,0,236,8,1007,8,1243,0,0.8,0.6,"50% - 75% P.O.C.","Less than $49000"
"17031410200","Census Tract 4102, Cook County, Illinois",1475,41692,566,358,10,305,0,195,38.4,24.3,0.7,20.7,0,13.2,61.6,680,85,595,12.5,87.5,0,85,16,579,16,664,0,2.7,2.4,"50% - 75% P.O.C.","Less than $49000"
"17031410500","Census Tract 4105, Cook County, Illinois",2525,54079,1044,1053,0,296,0,63,41.3,41.7,0,11.7,0,2.5,58.7,1330,388,942,29.17,70.83,14,374,0,942,14,1316,3.6,0,1.1,"50% - 75% P.O.C.","$49000 - $70000"
"17031410600","Census Tract 4106, Cook County, Illinois",2516,41016,1124,628,0,293,0,313,44.7,25,0,11.6,0,12.4,55.3,1035,399,636,38.55,61.45,29,370,25,611,54,981,7.3,3.9,5.2,"50% - 75% P.O.C.","Less than $49000"
"17031410700","Census Tract 4107, Cook County, Illinois",2186,39514,1146,459,0,368,0,113,52.4,21,0,16.8,0,5.2,47.6,1092,332,760,30.4,69.6,22,310,15,745,37,1055,6.6,2,3.4,"25% - 50% P.O.C.","Less than $49000"
"17031410800","Census Tract 4108, Cook County, Illinois",2898,38412,1235,681,52,592,0,177,42.6,23.5,1.8,20.4,0,6.1,57.4,1731,425,1306,24.55,75.45,12,413,0,1306,12,1719,2.8,0,0.7,"50% - 75% P.O.C.","Less than $49000"
"17031410900","Census Tract 4109, Cook County, Illinois",3342,60353,1629,852,3,370,0,284,48.7,25.5,0.1,11.1,0,8.5,51.3,1845,778,1067,42.17,57.83,12,766,30,1037,42,1803,1.5,2.8,2.3,"50% - 75% P.O.C.","$49000 - $70000"
"17031411000","Census Tract 4110, Cook County, Illinois",3509,67346,1570,1369,0,259,0,219,44.7,39,0,7.4,0,6.2,55.3,1962,1038,924,52.91,47.09,49,989,16,908,65,1897,4.7,1.7,3.3,"50% - 75% P.O.C.","$49000 - $70000"
"17031411100","Census Tract 4111, Cook County, Illinois",2330,114583,1519,135,0,404,0,134,65.2,5.8,0,17.3,0,5.8,34.8,848,433,415,51.06,48.94,24,409,13,402,37,811,5.5,3.1,4.4,"25% - 50% P.O.C.","$98000 or more"
"17031411200","Census Tract 4112, Cook County, Illinois",1689,88571,1053,102,0,345,0,109,62.3,6,0,20.4,0,6.5,37.7,738,401,337,54.34,45.66,41,360,0,337,41,697,10.2,0,5.6,"25% - 50% P.O.C.","$70000 - $98000"
"17031420100","Census Tract 4201, Cook County, Illinois",1548,18411,45,1359,0,41,0,24,2.9,87.8,0,2.6,0,1.6,97.1,771,17,754,2.2,97.8,3,14,22,732,25,746,17.6,2.9,3.2,"75% or more P.O.C.","Less than $49000"
"17031420200","Census Tract 4202, Cook County, Illinois",1713,29205,415,1113,0,103,0,63,24.2,65,0,6,0,3.7,75.8,619,147,472,23.75,76.25,17,130,54,418,71,548,11.6,11.4,11.5,"75% or more P.O.C.","Less than $49000"
"17031420300","Census Tract 4203, Cook County, Illinois",2768,36719,938,1067,0,467,0,229,33.9,38.5,0,16.9,0,8.3,66.1,717,119,598,16.6,83.4,8,111,36,562,44,673,6.7,6,6.1,"50% - 75% P.O.C.","Less than $49000"
"17031420400","Census Tract 4204, Cook County, Illinois",1142,13676,191,645,0,173,0,109,16.7,56.5,0,15.1,0,9.5,83.3,696,119,577,17.1,82.9,0,119,8,569,8,688,0,1.4,1.1,"75% or more P.O.C.","Less than $49000"
"17031420500","Census Tract 4205, Cook County, Illinois",1735,28456,0,1588,0,26,0,121,0,91.5,0,1.5,0,7,100,815,111,704,13.62,86.38,5,106,36,668,41,774,4.5,5.1,5,"75% or more P.O.C.","Less than $49000"
"17031420600","Census Tract 4206, Cook County, Illinois",1894,20871,47,1712,0,0,0,69,2.5,90.4,0,0,0,3.6,97.5,927,145,782,15.64,84.36,16,129,0,782,16,911,11,0,1.7,"75% or more P.O.C.","Less than $49000"
"17031420700","Census Tract 4207, Cook County, Illinois",2674,19498,28,2529,25,0,0,52,1,94.6,0.9,0,0,1.9,99,1167,316,851,27.08,72.92,0,316,110,741,110,1057,0,12.9,9.4,"75% or more P.O.C.","Less than $49000"
"17031420800","Census Tract 4208, Cook County, Illinois",2377,39167,44,2137,0,26,0,33,1.9,89.9,0,1.1,0,1.4,98.1,852,224,628,26.29,73.71,28,196,65,563,93,759,12.5,10.4,10.9,"75% or more P.O.C.","Less than $49000"
"17031421200","Census Tract 4212, Cook County, Illinois",1126,19911,8,1064,20,0,0,25,0.7,94.5,1.8,0,0,2.2,99.3,460,123,337,26.74,73.26,35,88,33,304,68,392,28.5,9.8,14.8,"75% or more P.O.C.","Less than $49000"
"17031430101","Census Tract 4301.01, Cook County, Illinois",3199,32122,39,3105,0,0,0,55,1.2,97.1,0,0,0,1.7,98.8,1684,227,1457,13.48,86.52,8,219,40,1417,48,1636,3.5,2.7,2.9,"75% or more P.O.C.","Less than $49000"
"17031430102","Census Tract 4301.02, Cook County, Illinois",3120,30306,69,2883,0,31,0,68,2.2,92.4,0,1,0,2.2,97.8,1981,252,1729,12.72,87.28,0,252,34,1695,34,1947,0,2,1.7,"75% or more P.O.C.","Less than $49000"
"17031430200","Census Tract 4302, Cook County, Illinois",4863,22933,112,4387,66,0,0,275,2.3,90.2,1.4,0,0,5.7,97.7,2375,390,1985,16.42,83.58,0,390,132,1853,132,2243,0,6.6,5.6,"75% or more P.O.C.","Less than $49000"
"17031430300","Census Tract 4303, Cook County, Illinois",2450,18133,21,2380,0,9,0,38,0.9,97.1,0,0.4,0,1.6,99.1,962,127,835,13.2,86.8,0,127,41,794,41,921,0,4.9,4.3,"75% or more P.O.C.","Less than $49000"
"17031430400","Census Tract 4304, Cook County, Illinois",2765,33767,84,2602,0,0,0,38,3,94.1,0,0,0,1.4,97,1145,357,788,31.18,68.82,31,326,66,722,97,1048,8.7,8.4,8.5,"75% or more P.O.C.","Less than $49000"
"17031430500","Census Tract 4305, Cook County, Illinois",3481,18692,55,3340,0,0,0,52,1.6,95.9,0,0,0,1.5,98.4,1609,126,1483,7.83,92.17,20,106,118,1365,138,1471,15.9,8,8.6,"75% or more P.O.C.","Less than $49000"
"17031430600","Census Tract 4306, Cook County, Illinois",2168,36103,47,1995,0,9,0,82,2.2,92,0,0.4,0,3.8,97.8,750,250,500,33.33,66.67,108,142,12,488,120,630,43.2,2.4,16,"75% or more P.O.C.","Less than $49000"
"17031430700","Census Tract 4307, Cook County, Illinois",2682,24167,95,2521,0,0,0,28,3.5,94,0,0,0,1,96.5,1242,134,1108,10.79,89.21,0,134,64,1044,64,1178,0,5.8,5.2,"75% or more P.O.C.","Less than $49000"
"17031430800","Census Tract 4308, Cook County, Illinois",1957,48015,12,1865,0,0,0,60,0.6,95.3,0,0,0,3.1,99.4,727,251,476,34.53,65.47,16,235,21,455,37,690,6.4,4.4,5.1,"75% or more P.O.C.","Less than $49000"
"17031430900","Census Tract 4309, Cook County, Illinois",1481,40417,3,1468,0,1,0,0,0.2,99.1,0,0.1,0,0,99.8,709,260,449,36.67,63.33,37,223,0,449,37,672,14.2,0,5.2,"75% or more P.O.C.","Less than $49000"
"17031431200","Census Tract 4312, Cook County, Illinois",2696,55560,28,2619,0,0,0,9,1,97.1,0,0,0,0.3,99,1117,737,380,65.98,34.02,36,701,30,350,66,1051,4.9,7.9,5.9,"75% or more P.O.C.","$49000 - $70000"
"17031431301","Census Tract 4313.01, Cook County, Illinois",3236,27361,73,3049,0,26,0,59,2.3,94.2,0,0.8,0,1.8,97.7,1297,215,1082,16.58,83.42,0,215,77,1005,77,1220,0,7.1,5.9,"75% or more P.O.C.","Less than $49000"
"17031431302","Census Tract 4313.02, Cook County, Illinois",4329,29966,32,3922,0,0,0,366,0.7,90.6,0,0,0,8.5,99.3,1507,174,1333,11.55,88.45,17,157,183,1150,200,1307,9.8,13.7,13.3,"75% or more P.O.C.","Less than $49000"
"17031431400","Census Tract 4314, Cook County, Illinois",6924,30230,520,6114,8,22,0,98,7.5,88.3,0.1,0.3,0,1.4,92.5,3415,437,2978,12.8,87.2,0,437,73,2905,73,3342,0,2.5,2.1,"75% or more P.O.C.","Less than $49000"
"17031440101","Census Tract 4401.01, Cook County, Illinois",4088,20404,16,3966,0,0,0,14,0.4,97,0,0,0,0.3,99.6,1980,117,1863,5.91,94.09,0,117,109,1754,109,1871,0,5.9,5.5,"75% or more P.O.C.","Less than $49000"
"17031440102","Census Tract 4401.02, Cook County, Illinois",3473,32047,234,3138,0,0,0,80,6.7,90.4,0,0,0,2.3,93.3,1665,311,1354,18.68,81.32,28,283,49,1305,77,1588,9,3.6,4.6,"75% or more P.O.C.","Less than $49000"
"17031440201","Census Tract 4402.01, Cook County, Illinois",5198,28849,151,4933,0,0,0,0,2.9,94.9,0,0,0,0,97.1,2434,565,1869,23.21,76.79,37,528,102,1767,139,2295,6.5,5.5,5.7,"75% or more P.O.C.","Less than $49000"
"17031440202","Census Tract 4402.02, Cook County, Illinois",3012,35795,14,2851,0,56,0,82,0.5,94.7,0,1.9,0,2.7,99.5,1597,656,941,41.08,58.92,8,648,19,922,27,1570,1.2,2,1.7,"75% or more P.O.C.","Less than $49000"
"17031440300","Census Tract 4403, Cook County, Illinois",4706,54167,98,4514,0,0,0,0,2.1,95.9,0,0,0,0,97.9,2062,1304,758,63.24,36.76,101,1203,0,758,101,1961,7.7,0,4.9,"75% or more P.O.C.","$49000 - $70000"
"17031440600","Census Tract 4406, Cook County, Illinois",1786,68317,0,1751,0,0,0,26,0,98,0,0,0,1.5,100,737,588,149,79.78,20.22,15,573,42,107,57,680,2.6,28.2,7.7,"75% or more P.O.C.","$49000 - $70000"
"17031440700","Census Tract 4407, Cook County, Illinois",1469,40000,31,1433,0,0,0,0,2.1,97.5,0,0,0,0,97.9,564,372,192,65.96,34.04,53,319,5,187,58,506,14.2,2.6,10.3,"75% or more P.O.C.","Less than $49000"
"17031440800","Census Tract 4408, Cook County, Illinois",1820,24417,20,1742,0,15,0,43,1.1,95.7,0,0.8,0,2.4,98.9,736,191,545,25.95,74.05,17,174,51,494,68,668,8.9,9.4,9.2,"75% or more P.O.C.","Less than $49000"
"17031440900","Census Tract 4409, Cook County, Illinois",2333,30417,1,2305,12,0,0,0,0,98.8,0.5,0,0,0,100,887,407,480,45.89,54.11,53,354,40,440,93,794,13,8.3,10.5,"75% or more P.O.C.","Less than $49000"
"17031450300","Census Tract 4503, Cook County, Illinois",3733,49896,45,3586,0,0,0,0,1.2,96.1,0,0,0,0,98.8,1400,820,580,58.57,41.43,80,740,52,528,132,1268,9.8,9,9.4,"75% or more P.O.C.","$49000 - $70000"
"17031460100","Census Tract 4601, Cook County, Illinois",3523,41188,52,2958,0,51,0,422,1.5,84,0,1.4,0,12,98.5,1255,401,854,31.95,68.05,36,365,95,759,131,1124,9,11.1,10.4,"75% or more P.O.C.","Less than $49000"
"17031460200","Census Tract 4602, Cook County, Illinois",2468,28363,249,953,0,0,0,1266,10.1,38.6,0,0,0,51.3,89.9,847,332,515,39.2,60.8,81,251,34,481,115,732,24.4,6.6,13.6,"75% or more P.O.C.","Less than $49000"
"17031460301","Census Tract 4603.01, Cook County, Illinois",3634,34483,49,2524,13,8,0,1040,1.3,69.5,0.4,0.2,0,28.6,98.7,1154,513,641,44.45,55.55,33,480,162,479,195,959,6.4,25.3,16.9,"75% or more P.O.C.","Less than $49000"
"17031460302","Census Tract 4603.02, Cook County, Illinois",3322,28470,256,2808,0,0,0,237,7.7,84.5,0,0,0,7.1,92.3,1109,444,665,40.04,59.96,49,395,153,512,202,907,11,23,18.2,"75% or more P.O.C.","Less than $49000"
"17031460400","Census Tract 4604, Cook County, Illinois",3311,44545,15,3266,0,0,0,21,0.5,98.6,0,0,0,0.6,99.5,1168,525,643,44.95,55.05,43,482,97,546,140,1028,8.2,15.1,12,"75% or more P.O.C.","Less than $49000"
"17031460500","Census Tract 4605, Cook County, Illinois",5889,59755,29,5828,0,0,0,25,0.5,99,0,0,0,0.4,99.5,2450,1296,1154,52.9,47.1,17,1279,38,1116,55,2395,1.3,3.3,2.2,"75% or more P.O.C.","$49000 - $70000"
"17031460600","Census Tract 4606, Cook County, Illinois",1200,40110,4,876,0,0,0,313,0.3,73,0,0,0,26.1,99.7,389,210,179,53.98,46.02,33,177,24,155,57,332,15.7,13.4,14.7,"75% or more P.O.C.","Less than $49000"
"17031460700","Census Tract 4607, Cook County, Illinois",2651,24517,84,1481,0,20,0,1017,3.2,55.9,0,0.8,0,38.4,96.8,925,237,688,25.62,74.38,9,228,95,593,104,821,3.8,13.8,11.2,"75% or more P.O.C.","Less than $49000"
"17031461000","Census Tract 4610, Cook County, Illinois",1288,15956,79,759,0,0,0,446,6.1,58.9,0,0,0,34.6,93.9,719,91,628,12.66,87.34,26,65,14,614,40,679,28.6,2.2,5.6,"75% or more P.O.C.","Less than $49000"
"17031470100","Census Tract 4701, Cook County, Illinois",2006,28864,10,1931,0,0,0,39,0.5,96.3,0,0,0,1.9,99.5,888,433,455,48.76,51.24,43,390,8,447,51,837,9.9,1.8,5.7,"75% or more P.O.C.","Less than $49000"
"17031480100","Census Tract 4801, Cook County, Illinois",2175,60000,10,2141,0,0,7,7,0.5,98.4,0,0,0.3,0.3,99.5,954,685,269,71.8,28.2,41,644,0,269,41,913,6,0,4.3,"75% or more P.O.C.","$49000 - $70000"
"17031480200","Census Tract 4802, Cook County, Illinois",1146,47059,0,1052,0,0,0,10,0,91.8,0,0,0,0.9,100,510,292,218,57.25,42.75,22,270,9,209,31,479,7.5,4.1,6.1,"75% or more P.O.C.","Less than $49000"
"17031480300","Census Tract 4803, Cook County, Illinois",1109,37386,17,1054,10,0,0,28,1.5,95,0.9,0,0,2.5,98.5,555,307,248,55.32,44.68,4,303,0,248,4,551,1.3,0,0.7,"75% or more P.O.C.","Less than $49000"
"17031480400","Census Tract 4804, Cook County, Illinois",5446,53946,63,5305,19,0,0,59,1.2,97.4,0.3,0,0,1.1,98.8,2177,1834,343,84.24,15.76,120,1714,69,274,189,1988,6.5,20.1,8.7,"75% or more P.O.C.","$49000 - $70000"
"17031480500","Census Tract 4805, Cook County, Illinois",2939,32188,53,2504,0,9,0,373,1.8,85.2,0,0.3,0,12.7,98.2,1123,669,454,59.57,40.43,54,615,88,366,142,981,8.1,19.4,12.6,"75% or more P.O.C.","Less than $49000"
"17031490300","Census Tract 4903, Cook County, Illinois",2302,57301,72,2182,0,0,0,0,3.1,94.8,0,0,0,0,96.9,871,585,286,67.16,32.84,61,524,17,269,78,793,10.4,5.9,9,"75% or more P.O.C.","$49000 - $70000"
"17031490400","Census Tract 4904, Cook County, Illinois",742,56607,0,742,0,0,0,0,0,100,0,0,0,0,100,347,192,155,55.33,44.67,16,176,0,155,16,331,8.3,0,4.6,"75% or more P.O.C.","$49000 - $70000"
"17031490500","Census Tract 4905, Cook County, Illinois",2041,53190,48,1890,0,28,0,28,2.4,92.6,0,1.4,0,1.4,97.6,722,480,242,66.48,33.52,10,470,27,215,37,685,2.1,11.2,5.1,"75% or more P.O.C.","$49000 - $70000"
"17031490600","Census Tract 4906, Cook County, Illinois",1464,37176,104,1324,0,36,0,0,7.1,90.4,0,2.5,0,0,92.9,547,387,160,70.75,29.25,42,345,14,146,56,491,10.9,8.8,10.2,"75% or more P.O.C.","Less than $49000"
"17031490700","Census Tract 4907, Cook County, Illinois",2777,44745,0,2764,0,0,0,13,0,99.5,0,0,0,0.5,100,931,674,257,72.4,27.6,61,613,47,210,108,823,9.1,18.3,11.6,"75% or more P.O.C.","Less than $49000"
"17031490800","Census Tract 4908, Cook County, Illinois",4006,40186,55,3888,19,13,0,12,1.4,97.1,0.5,0.3,0,0.3,98.6,1452,941,511,64.81,35.19,72,869,71,440,143,1309,7.7,13.9,9.8,"75% or more P.O.C.","Less than $49000"
"17031490901","Census Tract 4909.01, Cook County, Illinois",3264,37045,2,3178,0,0,0,75,0.1,97.4,0,0,0,2.3,99.9,1358,481,877,35.42,64.58,31,450,79,798,110,1248,6.4,9,8.1,"75% or more P.O.C.","Less than $49000"
"17031490902","Census Tract 4909.02, Cook County, Illinois",4204,44932,7,4083,0,29,0,44,0.2,97.1,0,0.7,0,1,99.8,1811,942,869,52.02,47.98,49,893,66,803,115,1696,5.2,7.6,6.4,"75% or more P.O.C.","Less than $49000"
"17031491000","Census Tract 4910, Cook County, Illinois",3408,24481,4,3238,9,20,0,75,0.1,95,0.3,0.6,0,2.2,99.9,1009,526,483,52.13,47.87,75,451,128,355,203,806,14.3,26.5,20.1,"75% or more P.O.C.","Less than $49000"
"17031491100","Census Tract 4911, Cook County, Illinois",4256,42763,106,3983,0,0,0,109,2.5,93.6,0,0,0,2.6,97.5,1388,1046,342,75.36,24.64,100,946,31,311,131,1257,9.6,9.1,9.4,"75% or more P.O.C.","Less than $49000"
"17031491200","Census Tract 4912, Cook County, Illinois",1931,39234,68,1648,0,0,0,89,3.5,85.3,0,0,0,4.6,96.5,655,455,200,69.47,30.53,39,416,32,168,71,584,8.6,16,10.8,"75% or more P.O.C.","Less than $49000"
"17031491300","Census Tract 4913, Cook County, Illinois",2327,35250,3,2288,0,0,0,9,0.1,98.3,0,0,0,0.4,99.9,613,286,327,46.66,53.34,21,265,116,211,137,476,7.3,35.5,22.3,"75% or more P.O.C.","Less than $49000"
"17031491400","Census Tract 4914, Cook County, Illinois",3336,33290,74,3206,0,0,0,5,2.2,96.1,0,0,0,0.1,97.8,1131,247,884,21.84,78.16,32,215,65,819,97,1034,13,7.4,8.6,"75% or more P.O.C.","Less than $49000"
"17031500100","Census Tract 5001, Cook County, Illinois",3136,46476,45,3056,0,0,0,35,1.4,97.4,0,0,0,1.1,98.6,1517,752,765,49.57,50.43,16,736,8,757,24,1493,2.1,1,1.6,"75% or more P.O.C.","Less than $49000"
"17031500200","Census Tract 5002, Cook County, Illinois",2106,31410,45,1952,0,0,0,0,2.1,92.7,0,0,0,0,97.9,832,284,548,34.13,65.87,45,239,57,491,102,730,15.8,10.4,12.3,"75% or more P.O.C.","Less than $49000"
"17031500300","Census Tract 5003, Cook County, Illinois",1598,42543,592,536,0,9,0,342,37,33.5,0,0.6,0,21.4,63,798,333,465,41.73,58.27,13,320,0,465,13,785,3.9,0,1.6,"50% - 75% P.O.C.","Less than $49000"
"17031510100","Census Tract 5101, Cook County, Illinois",3325,43882,270,388,0,0,0,2664,8.1,11.7,0,0,0,80.1,91.9,1030,527,503,51.17,48.83,147,380,49,454,196,834,27.9,9.7,19,"75% or more P.O.C.","Less than $49000"
"17031510200","Census Tract 5102, Cook County, Illinois",4033,48864,137,3182,0,0,0,682,3.4,78.9,0,0,0,16.9,96.6,1148,849,299,73.95,26.05,134,715,91,208,225,923,15.8,30.4,19.6,"75% or more P.O.C.","Less than $49000"
"17031510300","Census Tract 5103, Cook County, Illinois",4817,28561,15,4768,0,0,0,34,0.3,99,0,0,0,0.7,99.7,2000,1003,997,50.15,49.85,90,913,99,898,189,1811,9,9.9,9.4,"75% or more P.O.C.","Less than $49000"
"17031520100","Census Tract 5201, Cook County, Illinois",2001,58036,159,79,0,0,0,1763,7.9,3.9,0,0,0,88.1,92.1,519,306,213,58.96,41.04,89,217,84,129,173,346,29.1,39.4,33.3,"75% or more P.O.C.","$49000 - $70000"
"17031520200","Census Tract 5202, Cook County, Illinois",3178,29630,304,385,0,15,0,2474,9.6,12.1,0,0.5,0,77.8,90.4,1000,333,667,33.3,66.7,28,305,145,522,173,827,8.4,21.7,17.3,"75% or more P.O.C.","Less than $49000"
"17031520300","Census Tract 5203, Cook County, Illinois",5902,41652,556,204,0,0,0,5142,9.4,3.5,0,0,0,87.1,90.6,1754,1210,544,68.99,31.01,313,897,144,400,457,1297,25.9,26.5,26.1,"75% or more P.O.C.","Less than $49000"
"17031520400","Census Tract 5204, Cook County, Illinois",4515,45729,464,94,0,7,0,3950,10.3,2.1,0,0.2,0,87.5,89.7,1300,851,449,65.46,34.54,248,603,121,328,369,931,29.1,26.9,28.4,"75% or more P.O.C.","Less than $49000"
"17031520500","Census Tract 5205, Cook County, Illinois",5275,63819,1199,105,0,47,0,3879,22.7,2,0,0.9,0,73.5,77.3,1578,1315,263,83.33,16.67,161,1154,74,189,235,1343,12.2,28.1,14.9,"75% or more P.O.C.","$49000 - $70000"
"17031520600","Census Tract 5206, Cook County, Illinois",2852,55325,576,0,0,38,0,2238,20.2,0,0,1.3,0,78.5,79.8,825,643,182,77.94,22.06,191,452,37,145,228,597,29.7,20.3,27.6,"75% or more P.O.C.","$49000 - $70000"
"17031530100","Census Tract 5301, Cook County, Illinois",2263,37200,10,855,0,0,0,1321,0.4,37.8,0,0,0,58.4,99.6,750,346,404,46.13,53.87,94,252,32,372,126,624,27.2,7.9,16.8,"75% or more P.O.C.","Less than $49000"
"17031530200","Census Tract 5302, Cook County, Illinois",4390,37829,31,4359,0,0,0,0,0.7,99.3,0,0,0,0,99.3,1372,710,662,51.75,48.25,145,565,101,561,246,1126,20.4,15.3,17.9,"75% or more P.O.C.","Less than $49000"
"17031530300","Census Tract 5303, Cook County, Illinois",4014,41076,32,3862,15,0,0,0,0.8,96.2,0.4,0,0,0,99.2,1533,1145,388,74.69,25.31,128,1017,39,349,167,1366,11.2,10.1,10.9,"75% or more P.O.C.","Less than $49000"
"17031530400","Census Tract 5304, Cook County, Illinois",2183,61903,29,2052,0,0,0,79,1.3,94,0,0,0,3.6,98.7,741,615,126,83,17,77,538,0,126,77,664,12.5,0,10.4,"75% or more P.O.C.","$49000 - $70000"
"17031530501","Census Tract 5305.01, Cook County, Illinois",4148,43143,89,3925,0,0,0,70,2.1,94.6,0,0,0,1.7,97.9,1478,872,606,59,41,100,772,70,536,170,1308,11.5,11.6,11.5,"75% or more P.O.C.","Less than $49000"
"17031530502","Census Tract 5305.02, Cook County, Illinois",1456,54883,0,1419,0,0,0,29,0,97.5,0,0,0,2,100,537,454,83,84.54,15.46,31,423,6,77,37,500,6.8,7.2,6.9,"75% or more P.O.C.","$49000 - $70000"
"17031530503","Census Tract 5305.03, Cook County, Illinois",6171,44056,9,5986,0,0,0,42,0.1,97,0,0,0,0.7,99.9,1772,1246,526,70.32,29.68,185,1061,182,344,367,1405,14.8,34.6,20.7,"75% or more P.O.C.","Less than $49000"
"17031530600","Census Tract 5306, Cook County, Illinois",2403,33099,12,2294,0,0,0,10,0.5,95.5,0,0,0,0.4,99.5,946,427,519,45.14,54.86,21,406,56,463,77,869,4.9,10.8,8.1,"75% or more P.O.C.","Less than $49000"
"17031540101","Census Tract 5401.01, Cook County, Illinois",4104,15523,24,3807,0,22,0,251,0.6,92.8,0,0.5,0,6.1,99.4,1512,77,1435,5.09,94.91,0,77,129,1306,129,1383,0,9,8.5,"75% or more P.O.C.","Less than $49000"
"17031540102","Census Tract 5401.02, Cook County, Illinois",3255,15293,65,3183,0,0,0,7,2,97.8,0,0,0,0.2,98,1129,111,1018,9.83,90.17,0,111,153,865,153,976,0,15,13.6,"75% or more P.O.C.","Less than $49000"
"17031550100","Census Tract 5501, Cook County, Illinois",6465,59313,2286,271,0,0,0,3886,35.4,4.2,0,0,0,60.1,64.6,2481,1747,734,70.42,29.58,313,1434,22,712,335,2146,17.9,3,13.5,"50% - 75% P.O.C.","$49000 - $70000"
"17031550200","Census Tract 5502, Cook County, Illinois",2624,48224,905,114,0,0,0,1605,34.5,4.3,0,0,0,61.2,65.5,1049,842,207,80.27,19.73,127,715,0,207,127,922,15.1,0,12.1,"50% - 75% P.O.C.","Less than $49000"
"17031560100","Census Tract 5601, Cook County, Illinois",1501,61905,144,211,0,134,0,1012,9.6,14.1,0,8.9,0,67.4,90.4,356,268,88,75.28,24.72,82,186,14,74,96,260,30.6,15.9,27,"75% or more P.O.C.","$49000 - $70000"
"17031560200","Census Tract 5602, Cook County, Illinois",1644,54453,68,1178,0,0,0,381,4.1,71.7,0,0,0,23.2,95.9,613,511,102,83.36,16.64,52,459,0,102,52,561,10.2,0,8.5,"75% or more P.O.C.","$49000 - $70000"
"17031560300","Census Tract 5603, Cook County, Illinois",3308,50781,860,44,0,59,0,2294,26,1.3,0,1.8,0,69.3,74,992,879,113,88.61,11.39,121,758,28,85,149,843,13.8,24.8,15,"50% - 75% P.O.C.","$49000 - $70000"
"17031560400","Census Tract 5604, Cook County, Illinois",1807,60581,373,54,0,93,0,1287,20.6,3,0,5.1,0,71.2,79.4,462,403,59,87.23,12.77,104,299,33,26,137,325,25.8,55.9,29.7,"75% or more P.O.C.","$49000 - $70000"
"17031560700","Census Tract 5607, Cook County, Illinois",3764,60764,1446,45,0,6,0,2256,38.4,1.2,0,0.2,0,59.9,61.6,1227,778,449,63.41,36.59,230,548,57,392,287,940,29.6,12.7,23.4,"50% - 75% P.O.C.","$49000 - $70000"
"17031560800","Census Tract 5608, Cook County, Illinois",5858,71563,2715,294,0,16,0,2796,46.3,5,0,0.3,0,47.7,53.7,2122,1655,467,77.99,22.01,228,1427,82,385,310,1812,13.8,17.6,14.6,"50% - 75% P.O.C.","$70000 - $98000"
"17031560900","Census Tract 5609, Cook County, Illinois",5381,96332,3215,19,0,49,0,2055,59.7,0.4,0,0.9,0,38.2,40.3,1879,1709,170,90.95,9.05,206,1503,53,117,259,1620,12.1,31.2,13.8,"25% - 50% P.O.C.","$70000 - $98000"
"17031561000","Census Tract 5610, Cook County, Illinois",6301,103188,3517,65,0,0,0,2604,55.8,1,0,0,0,41.3,44.2,2099,1812,287,86.33,13.67,216,1596,59,228,275,1824,11.9,20.6,13.1,"25% - 50% P.O.C.","$98000 or more"
"17031561100","Census Tract 5611, Cook County, Illinois",5650,91604,2637,8,0,22,0,2983,46.7,0.1,0,0.4,0,52.8,53.3,1885,1728,157,91.67,8.33,275,1453,24,133,299,1586,15.9,15.3,15.9,"50% - 75% P.O.C.","$70000 - $98000"
"17031570100","Census Tract 5701, Cook County, Illinois",1280,56008,238,0,0,84,0,940,18.6,0,0,6.6,0,73.4,81.4,405,283,122,69.88,30.12,73,210,32,90,105,300,25.8,26.2,25.9,"75% or more P.O.C.","$49000 - $70000"
"17031570200","Census Tract 5702, Cook County, Illinois",2236,58625,342,0,0,253,0,1641,15.3,0,0,11.3,0,73.4,84.7,625,538,87,86.08,13.92,156,382,11,76,167,458,29,12.6,26.7,"75% or more P.O.C.","$49000 - $70000"
"17031570300","Census Tract 5703, Cook County, Illinois",5916,48629,938,89,0,283,0,4596,15.9,1.5,0,4.8,0,77.7,84.1,1654,1032,622,62.39,37.61,301,731,174,448,475,1179,29.2,28,28.7,"75% or more P.O.C.","Less than $49000"
"17031570400","Census Tract 5704, Cook County, Illinois",1640,42332,211,1,0,48,0,1380,12.9,0.1,0,2.9,0,84.1,87.1,521,245,276,47.02,52.98,102,143,24,252,126,395,41.6,8.7,24.2,"75% or more P.O.C.","Less than $49000"
"17031570500","Census Tract 5705, Cook County, Illinois",2654,44934,380,41,0,151,0,2069,14.3,1.5,0,5.7,0,78,85.7,714,362,352,50.7,49.3,90,272,55,297,145,569,24.9,15.6,20.3,"75% or more P.O.C.","Less than $49000"
"17031580100","Census Tract 5801, Cook County, Illinois",2698,43750,87,107,14,769,0,1650,3.2,4,0.5,28.5,0,61.2,96.8,860,458,402,53.26,46.74,117,341,44,358,161,699,25.5,10.9,18.7,"75% or more P.O.C.","Less than $49000"
"17031580200","Census Tract 5802, Cook County, Illinois",3288,38018,223,9,0,380,0,2625,6.8,0.3,0,11.6,0,79.8,93.2,889,444,445,49.94,50.06,130,314,94,351,224,665,29.3,21.1,25.2,"75% or more P.O.C.","Less than $49000"
"17031580300","Census Tract 5803, Cook County, Illinois",2512,48110,107,68,0,352,0,1978,4.3,2.7,0,14,0,78.7,95.7,705,327,378,46.38,53.62,115,212,70,308,185,520,35.2,18.5,26.2,"75% or more P.O.C.","Less than $49000"
"17031580400","Census Tract 5804, Cook County, Illinois",4891,47056,376,23,0,611,0,3881,7.7,0.5,0,12.5,0,79.3,92.3,1537,804,733,52.31,47.69,204,600,81,652,285,1252,25.4,11.1,18.5,"75% or more P.O.C.","Less than $49000"
"17031580501","Census Tract 5805.01, Cook County, Illinois",4993,39520,530,14,0,369,0,4055,10.6,0.3,0,7.4,0,81.2,89.4,1497,556,941,37.14,62.86,75,481,222,719,297,1200,13.5,23.6,19.8,"75% or more P.O.C.","Less than $49000"
"17031580502","Census Tract 5805.02, Cook County, Illinois",5358,37943,429,21,0,579,0,4211,8,0.4,0,10.8,0,78.6,92,1504,666,838,44.28,55.72,207,459,124,714,331,1173,31.1,14.8,22,"75% or more P.O.C.","Less than $49000"
"17031580600","Census Tract 5806, Cook County, Illinois",5179,45684,518,126,0,395,0,4139,10,2.4,0,7.6,0,79.9,90,1481,729,752,49.22,50.78,213,516,153,599,366,1115,29.2,20.3,24.7,"75% or more P.O.C.","Less than $49000"
"17031580700","Census Tract 5807, Cook County, Illinois",5908,47000,423,161,0,522,0,4742,7.2,2.7,0,8.8,0,80.3,92.8,1544,942,602,61.01,38.99,244,698,171,431,415,1129,25.9,28.4,26.9,"75% or more P.O.C.","Less than $49000"
"17031580800","Census Tract 5808, Cook County, Illinois",2261,46000,31,0,0,27,0,2191,1.4,0,0,1.2,0,96.9,98.6,566,209,357,36.93,63.07,69,140,133,224,202,364,33,37.3,35.7,"75% or more P.O.C.","Less than $49000"
"17031590500","Census Tract 5905, Cook County, Illinois",1865,67250,356,42,0,510,0,923,19.1,2.3,0,27.3,0,49.5,80.9,651,382,269,58.68,41.32,89,293,26,243,115,536,23.3,9.7,17.7,"75% or more P.O.C.","$49000 - $70000"
"17031590600","Census Tract 5906, Cook County, Illinois",3419,46033,757,9,0,431,0,2119,22.1,0.3,0,12.6,0,62,77.9,1172,643,529,54.86,45.14,149,494,19,510,168,1004,23.2,3.6,14.3,"75% or more P.O.C.","Less than $49000"
"17031590700","Census Tract 5907, Cook County, Illinois",3276,48281,313,58,0,654,0,2248,9.6,1.8,0,20,0,68.6,90.4,1000,436,564,43.6,56.4,111,325,64,500,175,825,25.5,11.3,17.5,"75% or more P.O.C.","Less than $49000"
"17031600400","Census Tract 6004, Cook County, Illinois",4188,37786,989,137,0,2610,0,452,23.6,3.3,0,62.3,0,10.8,76.4,1613,730,883,45.26,54.74,151,579,34,849,185,1428,20.7,3.9,11.5,"75% or more P.O.C.","Less than $49000"
"17031600600","Census Tract 6006, Cook County, Illinois",3144,37670,615,39,0,1434,0,1056,19.6,1.2,0,45.6,0,33.6,80.4,1097,499,598,45.49,54.51,113,386,69,529,182,915,22.6,11.5,16.6,"75% or more P.O.C.","Less than $49000"
"17031600700","Census Tract 6007, Cook County, Illinois",2835,45294,1001,82,0,857,0,850,35.3,2.9,0,30.2,0,30,64.7,1084,543,541,50.09,49.91,23,520,33,508,56,1028,4.2,6.1,5.2,"50% - 75% P.O.C.","Less than $49000"
"17031600900","Census Tract 6009, Cook County, Illinois",3549,57788,1720,353,0,972,0,462,48.5,9.9,0,27.4,0,13,51.5,1436,477,959,33.22,66.78,65,412,59,900,124,1312,13.6,6.2,8.6,"50% - 75% P.O.C.","$49000 - $70000"
"17031610300","Census Tract 6103, Cook County, Illinois",5837,32679,219,110,0,310,0,5165,3.8,1.9,0,5.3,0,88.5,96.2,1712,616,1096,35.98,64.02,206,410,166,930,372,1340,33.4,15.1,21.7,"75% or more P.O.C.","Less than $49000"
"17031610400","Census Tract 6104, Cook County, Illinois",1951,40758,60,36,0,0,0,1855,3.1,1.8,0,0,0,95.1,96.9,594,160,434,26.94,73.06,53,107,52,382,105,489,33.1,12,17.7,"75% or more P.O.C.","Less than $49000"
"17031610800","Census Tract 6108, Cook County, Illinois",1611,53125,1018,0,40,44,0,410,63.2,0,2.5,2.7,0,25.5,36.8,572,291,281,50.87,49.13,35,256,9,272,44,528,12,3.2,7.7,"25% - 50% P.O.C.","$49000 - $70000"
"17031611000","Census Tract 6110, Cook County, Illinois",823,19975,45,524,0,11,0,243,5.5,63.7,0,1.3,0,29.5,94.5,269,70,199,26.02,73.98,6,64,20,179,26,243,8.6,10.1,9.7,"75% or more P.O.C.","Less than $49000"
"17031611100","Census Tract 6111, Cook County, Illinois",2552,28264,174,384,0,34,0,1943,6.8,15,0,1.3,0,76.1,93.2,779,265,514,34.02,65.98,69,196,70,444,139,640,26,13.6,17.8,"75% or more P.O.C.","Less than $49000"
"17031611200","Census Tract 6112, Cook County, Illinois",2340,27800,220,374,0,13,0,1726,9.4,16,0,0.6,0,73.8,90.6,778,197,581,25.32,74.68,25,172,45,536,70,708,12.7,7.7,9,"75% or more P.O.C.","Less than $49000"
"17031611300","Census Tract 6113, Cook County, Illinois",2650,26600,200,81,0,0,0,2369,7.5,3.1,0,0,0,89.4,92.5,898,223,675,24.83,75.17,27,196,87,588,114,784,12.1,12.9,12.7,"75% or more P.O.C.","Less than $49000"
"17031611400","Census Tract 6114, Cook County, Illinois",2846,36382,113,26,0,0,0,2663,4,0.9,0,0,0,93.6,96,905,302,603,33.37,66.63,77,225,63,540,140,765,25.5,10.4,15.5,"75% or more P.O.C.","Less than $49000"
"17031611500","Census Tract 6115, Cook County, Illinois",3210,34875,192,273,0,7,0,2738,6,8.5,0,0.2,0,85.3,94,964,241,723,25,75,86,155,139,584,225,739,35.7,19.2,23.3,"75% or more P.O.C.","Less than $49000"
"17031611600","Census Tract 6116, Cook County, Illinois",1589,25882,22,671,0,9,0,860,1.4,42.2,0,0.6,0,54.1,98.6,552,246,306,44.57,55.43,36,210,21,285,57,495,14.6,6.9,10.3,"75% or more P.O.C.","Less than $49000"
"17031611700","Census Tract 6117, Cook County, Illinois",2012,24444,0,719,0,0,0,1293,0,35.7,0,0,0,64.3,100,598,178,420,29.77,70.23,75,103,37,383,112,486,42.1,8.8,18.7,"75% or more P.O.C.","Less than $49000"
"17031611800","Census Tract 6118, Cook County, Illinois",2246,40870,35,1529,0,12,0,670,1.6,68.1,0,0.5,0,29.8,98.4,670,156,514,23.28,76.72,6,150,169,345,175,495,3.8,32.9,26.1,"75% or more P.O.C.","Less than $49000"
"17031611900","Census Tract 6119, Cook County, Illinois",1639,24507,26,1175,0,0,0,438,1.6,71.7,0,0,0,26.7,98.4,574,198,376,34.49,65.51,72,126,33,343,105,469,36.4,8.8,18.3,"75% or more P.O.C.","Less than $49000"
"17031612000","Census Tract 6120, Cook County, Illinois",1347,37981,49,1223,0,7,0,68,3.6,90.8,0,0.5,0,5,96.4,447,191,256,42.73,57.27,26,165,43,213,69,378,13.6,16.8,15.4,"75% or more P.O.C.","Less than $49000"
"17031612100","Census Tract 6121, Cook County, Illinois",1022,26815,0,873,0,0,0,149,0,85.4,0,0,0,14.6,100,351,125,226,35.61,64.39,21,104,25,201,46,305,16.8,11.1,13.1,"75% or more P.O.C.","Less than $49000"
"17031620100","Census Tract 6201, Cook County, Illinois",4785,65354,407,0,0,321,0,4057,8.5,0,0,6.7,0,84.8,91.5,1210,927,283,76.61,23.39,261,666,84,199,345,865,28.2,29.7,28.5,"75% or more P.O.C.","$49000 - $70000"
"17031620200","Census Tract 6202, Cook County, Illinois",2138,58382,559,0,0,71,0,1508,26.1,0,0,3.3,0,70.5,73.9,698,471,227,67.48,32.52,130,341,11,216,141,557,27.6,4.8,20.2,"50% - 75% P.O.C.","$49000 - $70000"
"17031620300","Census Tract 6203, Cook County, Illinois",7810,55779,1366,263,16,89,0,6076,17.5,3.4,0.2,1.1,0,77.8,82.5,2030,1438,592,70.84,29.16,552,886,117,475,669,1361,38.4,19.8,33,"75% or more P.O.C.","$49000 - $70000"
"17031620400","Census Tract 6204, Cook County, Illinois",4393,69764,438,57,0,57,0,3831,10,1.3,0,1.3,0,87.2,90,1239,991,248,79.98,20.02,307,684,63,185,370,869,31,25.4,29.9,"75% or more P.O.C.","$49000 - $70000"
"17031630100","Census Tract 6301, Cook County, Illinois",883,30435,38,218,0,0,0,627,4.3,24.7,0,0,0,71,95.7,296,110,186,37.16,62.84,31,79,16,170,47,249,28.2,8.6,15.9,"75% or more P.O.C.","Less than $49000"
"17031630200","Census Tract 6302, Cook County, Illinois",1825,37422,125,0,0,78,0,1622,6.8,0,0,4.3,0,88.9,93.2,575,281,294,48.87,51.13,57,224,81,213,138,437,20.3,27.6,24,"75% or more P.O.C.","Less than $49000"
"17031630300","Census Tract 6303, Cook County, Illinois",5483,51184,228,23,0,42,0,5190,4.2,0.4,0,0.8,0,94.7,95.8,1316,648,668,49.24,50.76,305,343,207,461,512,804,47.1,31,38.9,"75% or more P.O.C.","$49000 - $70000"
"17031630400","Census Tract 6304, Cook County, Illinois",6379,35194,232,67,0,33,0,6047,3.6,1.1,0,0.5,0,94.8,96.4,1751,949,802,54.2,45.8,395,554,158,644,553,1198,41.6,19.7,31.6,"75% or more P.O.C.","Less than $49000"
"17031630500","Census Tract 6305, Cook County, Illinois",5913,44885,173,141,0,0,0,5599,2.9,2.4,0,0,0,94.7,97.1,1575,743,832,47.17,52.83,301,442,231,601,532,1043,40.5,27.8,33.8,"75% or more P.O.C.","Less than $49000"
"17031630800","Census Tract 6308, Cook County, Illinois",6781,51419,376,107,0,17,0,6281,5.5,1.6,0,0.3,0,92.6,94.5,1714,1071,643,62.49,37.51,415,656,140,503,555,1159,38.7,21.8,32.4,"75% or more P.O.C.","$49000 - $70000"
"17031630900","Census Tract 6309, Cook County, Illinois",5167,45551,245,91,0,36,0,4774,4.7,1.8,0,0.7,0,92.4,95.3,1321,806,515,61.01,38.99,322,484,157,358,479,842,40,30.5,36.3,"75% or more P.O.C.","Less than $49000"
"17031640100","Census Tract 6401, Cook County, Illinois",1532,42895,403,37,0,10,0,1046,26.3,2.4,0,0.7,0,68.3,73.7,494,217,277,43.93,56.07,67,150,40,237,107,387,30.9,14.4,21.7,"50% - 75% P.O.C.","Less than $49000"
"17031640300","Census Tract 6403, Cook County, Illinois",6655,64590,2844,223,56,0,0,3514,42.7,3.4,0.8,0,0,52.8,57.3,2429,1582,847,65.13,34.87,196,1386,90,757,286,2143,12.4,10.6,11.8,"50% - 75% P.O.C.","$49000 - $70000"
"17031640400","Census Tract 6404, Cook County, Illinois",3559,59398,1958,134,0,0,0,1276,55,3.8,0,0,0,35.9,45,1173,973,200,82.95,17.05,221,752,0,200,221,952,22.7,0,18.8,"25% - 50% P.O.C.","$49000 - $70000"
"17031640500","Census Tract 6405, Cook County, Illinois",3902,85762,2026,33,0,41,0,1790,51.9,0.8,0,1.1,0,45.9,48.1,1513,1107,406,73.17,26.83,75,1032,0,406,75,1438,6.8,0,5,"25% - 50% P.O.C.","$70000 - $98000"
"17031640600","Census Tract 6406, Cook County, Illinois",4206,49375,1718,53,0,67,0,2349,40.8,1.3,0,1.6,0,55.8,59.2,1656,886,770,53.5,46.5,122,764,43,727,165,1491,13.8,5.6,10,"50% - 75% P.O.C.","$49000 - $70000"
"17031640700","Census Tract 6407, Cook County, Illinois",3385,56250,1157,45,0,0,0,2183,34.2,1.3,0,0,0,64.5,65.8,1016,779,237,76.67,23.33,113,666,83,154,196,820,14.5,35,19.3,"50% - 75% P.O.C.","$49000 - $70000"
"17031640800","Census Tract 6408, Cook County, Illinois",1737,51944,339,42,0,8,0,1344,19.5,2.4,0,0.5,0,77.4,80.5,556,452,104,81.29,18.71,71,381,0,104,71,485,15.7,0,12.8,"75% or more P.O.C.","$49000 - $70000"
"17031650100","Census Tract 6501, Cook County, Illinois",4389,43750,733,126,0,1,0,3520,16.7,2.9,0,0,0,80.2,83.3,1256,697,559,55.49,44.51,202,495,125,434,327,929,29,22.4,26,"75% or more P.O.C.","Less than $49000"
"17031650200","Census Tract 6502, Cook County, Illinois",7098,51658,1051,0,0,0,0,6047,14.8,0,0,0,0,85.2,85.2,2114,1264,850,59.79,40.21,366,898,151,699,517,1597,29,17.8,24.5,"75% or more P.O.C.","$49000 - $70000"
"17031650301","Census Tract 6503.01, Cook County, Illinois",4919,60802,890,66,25,25,0,3913,18.1,1.3,0.5,0.5,0,79.5,81.9,1524,1214,310,79.66,20.34,246,968,28,282,274,1250,20.3,9,18,"75% or more P.O.C.","$49000 - $70000"
"17031650302","Census Tract 6503.02, Cook County, Illinois",4213,49130,254,0,0,0,0,3941,6,0,0,0,0,93.5,94,1106,808,298,73.06,26.94,251,557,29,269,280,826,31.1,9.7,25.3,"75% or more P.O.C.","$49000 - $70000"
"17031650400","Census Tract 6504, Cook County, Illinois",6648,54327,325,234,0,97,0,5992,4.9,3.5,0,1.5,0,90.1,95.1,1758,1412,346,80.32,19.68,447,965,87,259,534,1224,31.7,25.1,30.4,"75% or more P.O.C.","$49000 - $70000"
"17031650500","Census Tract 6505, Cook County, Illinois",4619,68382,775,419,0,19,0,3362,16.8,9.1,0,0.4,0,72.8,83.2,1514,1200,314,79.26,20.74,334,866,32,282,366,1148,27.8,10.2,24.2,"75% or more P.O.C.","$49000 - $70000"
"17031660301","Census Tract 6603.01, Cook County, Illinois",1398,24230,29,402,0,0,0,956,2.1,28.8,0,0,0,68.4,97.9,533,170,363,31.89,68.11,34,136,23,340,57,476,20,6.3,10.7,"75% or more P.O.C.","Less than $49000"
"17031660302","Census Tract 6603.02, Cook County, Illinois",4999,30891,66,1306,0,42,0,3522,1.3,26.1,0,0.8,0,70.5,98.7,1489,504,985,33.85,66.15,254,250,167,818,421,1068,50.4,17,28.3,"75% or more P.O.C.","Less than $49000"
"17031660400","Census Tract 6604, Cook County, Illinois",5804,46289,346,106,0,0,0,5352,6,1.8,0,0,0,92.2,94,1481,885,596,59.76,40.24,290,595,131,465,421,1060,32.8,22,28.4,"75% or more P.O.C.","Less than $49000"
"17031660500","Census Tract 6605, Cook County, Illinois",4454,36657,221,372,0,32,0,3829,5,8.4,0,0.7,0,86,95,1315,593,722,45.1,54.9,216,377,75,647,291,1024,36.4,10.4,22.1,"75% or more P.O.C.","Less than $49000"
"17031660600","Census Tract 6606, Cook County, Illinois",5626,27012,150,2580,0,0,0,2840,2.7,45.9,0,0,0,50.5,97.3,2080,605,1475,29.09,70.91,125,480,93,1382,218,1862,20.7,6.3,10.5,"75% or more P.O.C.","Less than $49000"
"17031660700","Census Tract 6607, Cook County, Illinois",1477,23095,14,1317,0,0,0,146,0.9,89.2,0,0,0,9.9,99.1,610,311,299,50.98,49.02,19,292,6,293,25,585,6.1,2,4.1,"75% or more P.O.C.","Less than $49000"
"17031660800","Census Tract 6608, Cook County, Illinois",4867,35703,145,2290,0,61,0,2282,3,47.1,0,1.3,0,46.9,97,1650,544,1106,32.97,67.03,153,391,116,990,269,1381,28.1,10.5,16.3,"75% or more P.O.C.","Less than $49000"
"17031660900","Census Tract 6609, Cook County, Illinois",4593,34574,139,3601,0,27,0,524,3,78.4,0,0.6,0,11.4,97,1385,426,959,30.76,69.24,88,338,140,819,228,1157,20.7,14.6,16.5,"75% or more P.O.C.","Less than $49000"
"17031661000","Census Tract 6610, Cook County, Illinois",5434,34230,54,4515,0,0,0,732,1,83.1,0,0,0,13.5,99,1901,975,926,51.29,48.71,112,863,144,782,256,1645,11.5,15.6,13.5,"75% or more P.O.C.","Less than $49000"
"17031661100","Census Tract 6611, Cook County, Illinois",7115,59038,270,2821,0,17,0,3757,3.8,39.6,0,0.2,0,52.8,96.2,1934,1388,546,71.77,28.23,389,999,103,443,492,1442,28,18.9,25.4,"75% or more P.O.C.","$49000 - $70000"
"17031670100","Census Tract 6701, Cook County, Illinois",1001,27500,16,735,0,0,0,250,1.6,73.4,0,0,0,25,98.4,398,154,244,38.69,61.31,37,117,0,244,37,361,24,0,9.3,"75% or more P.O.C.","Less than $49000"
"17031670200","Census Tract 6702, Cook County, Illinois",930,28250,36,854,7,0,0,33,3.9,91.8,0.8,0,0,3.5,96.1,409,168,241,41.08,58.92,5,163,13,228,18,391,3,5.4,4.4,"75% or more P.O.C.","Less than $49000"
"17031670300","Census Tract 6703, Cook County, Illinois",1087,22395,52,836,0,7,0,155,4.8,76.9,0,0.6,0,14.3,95.2,417,190,227,45.56,54.44,39,151,0,227,39,378,20.5,0,9.4,"75% or more P.O.C.","Less than $49000"
"17031670400","Census Tract 6704, Cook County, Illinois",1689,28625,0,1302,0,0,0,387,0,77.1,0,0,0,22.9,100,528,257,271,48.67,51.33,57,200,25,246,82,446,22.2,9.2,15.5,"75% or more P.O.C.","Less than $49000"
"17031670500","Census Tract 6705, Cook County, Illinois",922,24200,6,649,11,0,0,256,0.7,70.4,1.2,0,0,27.8,99.3,350,153,197,43.71,56.29,26,127,15,182,41,309,17,7.6,11.7,"75% or more P.O.C.","Less than $49000"
"17031670600","Census Tract 6706, Cook County, Illinois",975,26250,4,827,0,0,0,144,0.4,84.8,0,0,0,14.8,99.6,336,207,129,61.61,38.39,60,147,7,122,67,269,29,5.4,19.9,"75% or more P.O.C.","Less than $49000"
"17031670700","Census Tract 6707, Cook County, Illinois",1113,27277,1,842,0,0,0,270,0.1,75.7,0,0,0,24.3,99.9,369,157,212,42.55,57.45,23,134,21,191,44,325,14.6,9.9,11.9,"75% or more P.O.C.","Less than $49000"
"17031670800","Census Tract 6708, Cook County, Illinois",1015,24597,0,984,0,0,0,31,0,96.9,0,0,0,3.1,100,520,166,354,31.92,68.08,11,155,0,354,11,509,6.6,0,2.1,"75% or more P.O.C.","Less than $49000"
"17031670900","Census Tract 6709, Cook County, Illinois",1290,33438,67,1088,0,0,0,85,5.2,84.3,0,0,0,6.6,94.8,471,194,277,41.19,58.81,0,194,41,236,41,430,0,14.8,8.7,"75% or more P.O.C.","Less than $49000"
"17031671100","Census Tract 6711, Cook County, Illinois",754,33571,4,725,0,0,0,7,0.5,96.2,0,0,0,0.9,99.5,266,100,166,37.59,62.41,8,92,33,133,41,225,8,19.9,15.4,"75% or more P.O.C.","Less than $49000"
"17031671200","Census Tract 6712, Cook County, Illinois",1019,24896,27,992,0,0,0,0,2.6,97.4,0,0,0,0,97.4,319,87,232,27.27,72.73,23,64,34,198,57,262,26.4,14.7,17.9,"75% or more P.O.C.","Less than $49000"
"17031671300","Census Tract 6713, Cook County, Illinois",2012,27882,0,1865,0,0,0,147,0,92.7,0,0,0,7.3,100,665,305,360,45.86,54.14,51,254,0,360,51,614,16.7,0,7.7,"75% or more P.O.C.","Less than $49000"
"17031671400","Census Tract 6714, Cook County, Illinois",1147,23029,0,1057,0,0,0,90,0,92.2,0,0,0,7.8,100,474,315,159,66.46,33.54,20,295,0,159,20,454,6.3,0,4.2,"75% or more P.O.C.","Less than $49000"
"17031671500","Census Tract 6715, Cook County, Illinois",2281,27125,30,1867,0,0,0,296,1.3,81.9,0,0,0,13,98.7,871,415,456,47.65,52.35,71,344,45,411,116,755,17.1,9.9,13.3,"75% or more P.O.C.","Less than $49000"
"17031671600","Census Tract 6716, Cook County, Illinois",1643,19132,101,1521,0,17,0,0,6.1,92.6,0,1,0,0,93.9,667,150,517,22.49,77.51,5,145,34,483,39,628,3.3,6.6,5.8,"75% or more P.O.C.","Less than $49000"
"17031671800","Census Tract 6718, Cook County, Illinois",1367,28036,2,1243,0,0,0,119,0.1,90.9,0,0,0,8.7,99.9,383,219,164,57.18,42.82,24,195,41,123,65,318,11,25,17,"75% or more P.O.C.","Less than $49000"
"17031671900","Census Tract 6719, Cook County, Illinois",1125,47400,30,953,0,0,0,142,2.7,84.7,0,0,0,12.6,97.3,290,206,84,71.03,28.97,41,165,17,67,58,232,19.9,20.2,20,"75% or more P.O.C.","Less than $49000"
"17031672000","Census Tract 6720, Cook County, Illinois",3533,36438,35,3371,0,0,0,54,1,95.4,0,0,0,1.5,99,1073,657,416,61.23,38.77,84,573,30,386,114,959,12.8,7.2,10.6,"75% or more P.O.C.","Less than $49000"
"17031680500","Census Tract 6805, Cook County, Illinois",1235,24335,36,1141,0,0,0,58,2.9,92.4,0,0,0,4.7,97.1,457,163,294,35.67,64.33,19,144,39,255,58,399,11.7,13.3,12.7,"75% or more P.O.C.","Less than $49000"
"17031680600","Census Tract 6806, Cook County, Illinois",1171,30244,2,1166,0,3,0,0,0.2,99.6,0,0.3,0,0,99.8,362,109,253,30.11,69.89,23,86,53,200,76,286,21.1,20.9,21,"75% or more P.O.C.","Less than $49000"
"17031680900","Census Tract 6809, Cook County, Illinois",3302,16411,50,3214,0,20,0,18,1.5,97.3,0,0.6,0,0.5,98.5,1795,221,1574,12.31,87.69,11,210,49,1525,60,1735,5,3.1,3.3,"75% or more P.O.C.","Less than $49000"
"17031681000","Census Tract 6810, Cook County, Illinois",2793,17118,12,2655,0,0,0,32,0.4,95.1,0,0,0,1.1,99.6,1042,308,734,29.56,70.44,50,258,94,640,144,898,16.2,12.8,13.8,"75% or more P.O.C.","Less than $49000"
"17031681100","Census Tract 6811, Cook County, Illinois",2595,22266,6,2347,0,1,0,230,0.2,90.4,0,0,0,8.9,99.8,863,224,639,25.96,74.04,12,212,111,528,123,740,5.4,17.4,14.3,"75% or more P.O.C.","Less than $49000"
"17031681200","Census Tract 6812, Cook County, Illinois",2472,19915,8,2265,9,0,0,158,0.3,91.6,0.4,0,0,6.4,99.7,799,131,668,16.4,83.6,44,87,78,590,122,677,33.6,11.7,15.3,"75% or more P.O.C.","Less than $49000"
"17031681300","Census Tract 6813, Cook County, Illinois",2418,25360,8,2364,0,39,0,7,0.3,97.8,0,1.6,0,0.3,99.7,769,195,574,25.36,74.64,35,160,107,467,142,627,17.9,18.6,18.5,"75% or more P.O.C.","Less than $49000"
"17031681400","Census Tract 6814, Cook County, Illinois",2407,43750,0,2324,19,0,0,64,0,96.6,0.8,0,0,2.7,100,833,390,443,46.82,53.18,63,327,51,392,114,719,16.2,11.5,13.7,"75% or more P.O.C.","Less than $49000"
"17031690300","Census Tract 6903, Cook County, Illinois",2443,19179,96,2316,5,0,0,5,3.9,94.8,0.2,0,0,0.2,96.1,778,32,746,4.11,95.89,23,9,28,718,51,727,71.9,3.8,6.6,"75% or more P.O.C.","Less than $49000"
"17031690400","Census Tract 6904, Cook County, Illinois",2939,23868,25,2867,0,0,0,25,0.9,97.6,0,0,0,0.9,99.1,1342,343,999,25.56,74.44,7,336,30,969,37,1305,2,3,2.8,"75% or more P.O.C.","Less than $49000"
"17031690500","Census Tract 6905, Cook County, Illinois",632,26154,0,632,0,0,0,0,0,100,0,0,0,0,100,308,61,247,19.81,80.19,0,61,25,222,25,283,0,10.1,8.1,"75% or more P.O.C.","Less than $49000"
"17031690900","Census Tract 6909, Cook County, Illinois",4273,32875,26,4081,0,0,0,14,0.6,95.5,0,0,0,0.3,99.4,1624,534,1090,32.88,67.12,31,503,106,984,137,1487,5.8,9.7,8.4,"75% or more P.O.C.","Less than $49000"
"17031691000","Census Tract 6910, Cook County, Illinois",2256,42538,5,2240,0,0,0,11,0.2,99.3,0,0,0,0.5,99.8,1023,422,601,41.25,58.75,34,388,16,585,50,973,8.1,2.7,4.9,"75% or more P.O.C.","Less than $49000"
"17031691100","Census Tract 6911, Cook County, Illinois",2811,24750,51,2668,0,0,0,40,1.8,94.9,0,0,0,1.4,98.2,1050,334,716,31.81,68.19,38,296,17,699,55,995,11.4,2.4,5.2,"75% or more P.O.C.","Less than $49000"
"17031691200","Census Tract 6912, Cook County, Illinois",2735,32241,14,2648,0,0,24,0,0.5,96.8,0,0,0.9,0,99.5,1038,247,791,23.8,76.2,0,247,109,682,109,929,0,13.8,10.5,"75% or more P.O.C.","Less than $49000"
"17031691300","Census Tract 6913, Cook County, Illinois",2452,43676,12,2155,0,0,0,247,0.5,87.9,0,0,0,10.1,99.5,1070,506,564,47.29,52.71,74,432,0,564,74,996,14.6,0,6.9,"75% or more P.O.C.","Less than $49000"
"17031691400","Census Tract 6914, Cook County, Illinois",3160,36363,0,3053,0,4,0,26,0,96.6,0,0.1,0,0.8,100,1321,602,719,45.57,54.43,56,546,37,682,93,1228,9.3,5.1,7,"75% or more P.O.C.","Less than $49000"
"17031691500","Census Tract 6915, Cook County, Illinois",1968,17011,46,1872,0,0,0,50,2.3,95.1,0,0,0,2.5,97.7,775,212,563,27.35,72.65,23,189,54,509,77,698,10.8,9.6,9.9,"75% or more P.O.C.","Less than $49000"
"17031700100","Census Tract 7001, Cook County, Illinois",3605,68902,37,2051,0,3,0,1451,1,56.9,0,0.1,0,40.2,99,1001,707,294,70.63,29.37,127,580,87,207,214,787,18,29.6,21.4,"75% or more P.O.C.","$49000 - $70000"
"17031700200","Census Tract 7002, Cook County, Illinois",6521,70863,657,1033,0,136,0,4611,10.1,15.8,0,2.1,0,70.7,89.9,1911,1676,235,87.7,12.3,323,1353,97,138,420,1491,19.3,41.3,22,"75% or more P.O.C.","$70000 - $98000"
"17031700301","Census Tract 7003.01, Cook County, Illinois",6530,69620,999,680,19,115,0,4670,15.3,10.4,0.3,1.8,0,71.5,84.7,1741,1523,218,87.48,12.52,371,1152,42,176,413,1328,24.4,19.3,23.7,"75% or more P.O.C.","$49000 - $70000"
"17031700302","Census Tract 7003.02, Cook County, Illinois",5836,66250,1178,1118,0,7,0,3522,20.2,19.2,0,0.1,0,60.3,79.8,1774,1456,318,82.07,17.93,327,1129,54,264,381,1393,22.5,17,21.5,"75% or more P.O.C.","$49000 - $70000"
"17031700401","Census Tract 7004.01, Cook County, Illinois",6337,65000,309,3721,13,91,0,2007,4.9,58.7,0.2,1.4,0,31.7,95.1,1922,1603,319,83.4,16.6,271,1332,33,286,304,1618,16.9,10.3,15.8,"75% or more P.O.C.","$49000 - $70000"
"17031700402","Census Tract 7004.02, Cook County, Illinois",4484,70072,526,2830,0,0,0,1128,11.7,63.1,0,0,0,25.2,88.3,1289,1102,187,85.49,14.51,218,884,35,152,253,1036,19.8,18.7,19.6,"75% or more P.O.C.","$70000 - $98000"
"17031700501","Census Tract 7005.01, Cook County, Illinois",6594,65847,181,5410,0,58,0,416,2.7,82,0,0.9,0,6.3,97.3,2454,1920,534,78.24,21.76,79,1841,0,534,79,2375,4.1,0,3.2,"75% or more P.O.C.","$49000 - $70000"
"17031700502","Census Tract 7005.02, Cook County, Illinois",3449,102125,223,3045,0,0,0,113,6.5,88.3,0,0,0,3.3,93.5,1032,996,36,96.51,3.49,120,876,0,36,120,912,12,0,11.6,"75% or more P.O.C.","$98000 or more"
"17031710100","Census Tract 7101, Cook County, Illinois",1250,17841,0,1196,0,0,0,49,0,95.7,0,0,0,3.9,100,533,91,442,17.07,82.93,31,60,25,417,56,477,34.1,5.7,10.5,"75% or more P.O.C.","Less than $49000"
"17031710200","Census Tract 7102, Cook County, Illinois",4335,25288,90,4119,0,11,0,95,2.1,95,0,0.3,0,2.2,97.9,1752,562,1190,32.08,67.92,117,445,41,1149,158,1594,20.8,3.4,9,"75% or more P.O.C.","Less than $49000"
"17031710300","Census Tract 7103, Cook County, Illinois",1544,35568,0,1350,21,0,0,152,0,87.4,1.4,0,0,9.8,100,513,125,388,24.37,75.63,20,105,41,347,61,452,16,10.6,11.9,"75% or more P.O.C.","Less than $49000"
"17031710400","Census Tract 7104, Cook County, Illinois",5608,39659,52,5321,0,0,0,203,0.9,94.9,0,0,0,3.6,99.1,1904,1011,893,53.1,46.9,257,754,142,751,399,1505,25.4,15.9,21,"75% or more P.O.C.","Less than $49000"
"17031710500","Census Tract 7105, Cook County, Illinois",4336,30177,19,4131,0,9,0,107,0.4,95.3,0,0.2,0,2.5,99.6,1587,576,1011,36.29,63.71,69,507,43,968,112,1475,12,4.3,7.1,"75% or more P.O.C.","Less than $49000"
"17031710600","Census Tract 7106, Cook County, Illinois",1719,33287,55,1624,0,0,0,0,3.2,94.5,0,0,0,0,96.8,671,210,461,31.3,68.7,23,187,50,411,73,598,11,10.8,10.9,"75% or more P.O.C.","Less than $49000"
"17031710700","Census Tract 7107, Cook County, Illinois",3192,19467,13,3168,0,0,0,11,0.4,99.2,0,0,0,0.3,99.6,1333,412,921,30.91,69.09,45,367,103,818,148,1185,10.9,11.2,11.1,"75% or more P.O.C.","Less than $49000"
"17031710800","Census Tract 7108, Cook County, Illinois",4694,23162,4,4614,28,48,0,0,0.1,98.3,0.6,1,0,0,99.9,1945,530,1415,27.25,72.75,122,408,0,1415,122,1823,23,0,6.3,"75% or more P.O.C.","Less than $49000"
"17031710900","Census Tract 7109, Cook County, Illinois",1972,32064,0,1812,0,0,0,140,0,91.9,0,0,0,7.1,100,761,335,426,44.02,55.98,12,323,26,400,38,723,3.6,6.1,5,"75% or more P.O.C.","Less than $49000"
"17031711000","Census Tract 7110, Cook County, Illinois",3301,43855,229,3009,0,55,0,0,6.9,91.2,0,1.7,0,0,93.1,1110,641,469,57.75,42.25,69,572,34,435,103,1007,10.8,7.2,9.3,"75% or more P.O.C.","Less than $49000"
"17031711100","Census Tract 7111, Cook County, Illinois",2351,39208,0,2282,8,0,0,61,0,97.1,0.3,0,0,2.6,100,889,584,305,65.69,34.31,68,516,16,289,84,805,11.6,5.2,9.4,"75% or more P.O.C.","Less than $49000"
"17031711200","Census Tract 7112, Cook County, Illinois",4949,45298,15,4748,0,0,0,53,0.3,95.9,0,0,0,1.1,99.7,1931,1243,688,64.37,35.63,63,1180,15,673,78,1853,5.1,2.2,4,"75% or more P.O.C.","Less than $49000"
"17031711300","Census Tract 7113, Cook County, Illinois",1583,41188,45,1493,0,18,0,27,2.8,94.3,0,1.1,0,1.7,97.2,609,248,361,40.72,59.28,0,248,48,313,48,561,0,13.3,7.9,"75% or more P.O.C.","Less than $49000"
"17031711400","Census Tract 7114, Cook County, Illinois",2572,43500,2,2447,0,0,0,91,0.1,95.1,0,0,0,3.5,99.9,814,521,293,64,36,76,445,48,245,124,690,14.6,16.4,15.2,"75% or more P.O.C.","Less than $49000"
"17031711500","Census Tract 7115, Cook County, Illinois",2503,44851,0,2477,0,0,0,12,0,99,0,0,0,0.5,100,809,570,239,70.46,29.54,69,501,7,232,76,733,12.1,2.9,9.4,"75% or more P.O.C.","Less than $49000"
"17031720100","Census Tract 7201, Cook County, Illinois",3381,149605,2010,1121,0,33,0,122,59.4,33.2,0,1,0,3.6,40.6,1184,1115,69,94.17,5.83,153,962,0,69,153,1031,13.7,0,12.9,"25% - 50% P.O.C.","$98000 or more"
"17031720200","Census Tract 7202, Cook County, Illinois",3791,71979,1489,2016,0,35,13,114,39.3,53.2,0,0.9,0.3,3,60.7,1636,1268,368,77.51,22.49,72,1196,0,368,72,1564,5.7,0,4.4,"50% - 75% P.O.C.","$70000 - $98000"
"17031720300","Census Tract 7203, Cook County, Illinois",3929,115536,2229,1165,0,17,0,359,56.7,29.7,0,0.4,0,9.1,43.3,1335,1290,45,96.63,3.37,112,1178,20,25,132,1203,8.7,44.4,9.9,"25% - 50% P.O.C.","$98000 or more"
"17031720400","Census Tract 7204, Cook County, Illinois",1935,102857,1722,121,0,3,0,65,89,6.3,0,0.2,0,3.4,11,672,619,53,92.11,7.89,106,513,12,41,118,554,17.1,22.6,17.6,"Less than 25% P.O.C.","$98000 or more"
"17031720500","Census Tract 7205, Cook County, Illinois",1909,111667,1677,25,0,23,0,184,87.8,1.3,0,1.2,0,9.6,12.2,750,704,46,93.87,6.13,85,619,0,46,85,665,12.1,0,11.3,"Less than 25% P.O.C.","$98000 or more"
"17031720600","Census Tract 7206, Cook County, Illinois",1768,113964,1202,498,0,0,0,58,68,28.2,0,0,0,3.3,32,617,531,86,86.06,13.94,59,472,29,57,88,529,11.1,33.7,14.3,"25% - 50% P.O.C.","$98000 or more"
"17031720700","Census Tract 7207, Cook County, Illinois",3078,67438,1054,1828,0,49,0,76,34.2,59.4,0,1.6,0,2.5,65.8,1287,668,619,51.9,48.1,107,561,43,576,150,1137,16,6.9,11.7,"50% - 75% P.O.C.","$49000 - $70000"
"17031730100","Census Tract 7301, Cook County, Illinois",2703,53125,14,2664,0,0,0,12,0.5,98.6,0,0,0,0.4,99.5,888,746,142,84.01,15.99,112,634,39,103,151,737,15,27.5,17,"75% or more P.O.C.","$49000 - $70000"
"17031730201","Census Tract 7302.01, Cook County, Illinois",5262,26731,112,4926,0,24,0,200,2.1,93.6,0,0.5,0,3.8,97.9,2258,994,1264,44.02,55.98,65,929,19,1245,84,2174,6.5,1.5,3.7,"75% or more P.O.C.","Less than $49000"
"17031730202","Census Tract 7302.02, Cook County, Illinois",3098,57143,63,3003,0,5,0,5,2,96.9,0,0.2,0,0.2,98,1038,757,281,72.93,27.07,103,654,51,230,154,884,13.6,18.1,14.8,"75% or more P.O.C.","$49000 - $70000"
"17031730300","Census Tract 7303, Cook County, Illinois",1103,47969,0,1080,0,14,0,0,0,97.9,0,1.3,0,0,100,400,266,134,66.5,33.5,34,232,11,123,45,355,12.8,8.2,11.2,"75% or more P.O.C.","Less than $49000"
"17031730400","Census Tract 7304, Cook County, Illinois",4141,80787,119,3862,16,0,0,53,2.9,93.3,0.4,0,0,1.3,97.1,1339,975,364,72.82,27.18,134,841,69,295,203,1136,13.7,19,15.2,"75% or more P.O.C.","$70000 - $98000"
"17031730500","Census Tract 7305, Cook County, Illinois",4233,57357,20,4103,0,0,0,1,0.5,96.9,0,0,0,0,99.5,1428,1114,314,78.01,21.99,121,993,64,250,185,1243,10.9,20.4,13,"75% or more P.O.C.","$49000 - $70000"
"17031730600","Census Tract 7306, Cook County, Illinois",3758,43274,12,3720,13,0,0,13,0.3,99,0.3,0,0,0.3,99.7,1184,807,377,68.16,31.84,138,669,104,273,242,942,17.1,27.6,20.4,"75% or more P.O.C.","Less than $49000"
"17031730700","Census Tract 7307, Cook County, Illinois",2444,51957,20,2340,0,0,0,21,0.8,95.7,0,0,0,0.9,99.2,752,632,120,84.04,15.96,117,515,18,102,135,617,18.5,15,18,"75% or more P.O.C.","$49000 - $70000"
"17031740100","Census Tract 7401, Cook County, Illinois",3136,93217,2627,0,0,39,0,411,83.8,0,0,1.2,0,13.1,16.2,1149,1003,146,87.29,12.71,124,879,10,136,134,1015,12.4,6.8,11.7,"Less than 25% P.O.C.","$70000 - $98000"
"17031740200","Census Tract 7402, Cook County, Illinois",6640,105655,5726,78,0,111,0,653,86.2,1.2,0,1.7,0,9.8,13.8,1937,1816,121,93.75,6.25,382,1434,0,121,382,1555,21,0,19.7,"Less than 25% P.O.C.","$98000 or more"
"17031740300","Census Tract 7403, Cook County, Illinois",4949,127069,4252,153,0,0,0,466,85.9,3.1,0,0,0,9.4,14.1,1768,1584,184,89.59,10.41,215,1369,0,184,215,1553,13.6,0,12.2,"Less than 25% P.O.C.","$98000 or more"
"17031740400","Census Tract 7404, Cook County, Illinois",4465,85064,3294,447,0,204,0,480,73.8,10,0,4.6,0,10.8,26.2,1838,1336,502,72.69,27.31,177,1159,0,502,177,1661,13.2,0,9.6,"25% - 50% P.O.C.","$70000 - $98000"
"17031750100","Census Tract 7501, Cook County, Illinois",3743,43277,18,3532,0,0,0,138,0.5,94.4,0,0,0,3.7,99.5,1414,1013,401,71.64,28.36,53,960,71,330,124,1290,5.2,17.7,8.8,"75% or more P.O.C.","Less than $49000"
"17031750200","Census Tract 7502, Cook County, Illinois",2903,80561,1142,1493,11,0,0,135,39.3,51.4,0.4,0,0,4.7,60.7,1286,914,372,71.07,28.93,50,864,7,365,57,1229,5.5,1.9,4.4,"50% - 75% P.O.C.","$70000 - $98000"
"17031750300","Census Tract 7503, Cook County, Illinois",2526,100595,2216,143,0,22,0,105,87.7,5.7,0,0.9,0,4.2,12.3,966,790,176,81.78,18.22,93,697,0,176,93,873,11.8,0,9.6,"Less than 25% P.O.C.","$98000 or more"
"17031750400","Census Tract 7504, Cook County, Illinois",3096,97305,1879,940,21,34,0,222,60.7,30.4,0.7,1.1,0,7.2,39.3,1201,953,248,79.35,20.65,24,929,29,219,53,1148,2.5,11.7,4.4,"25% - 50% P.O.C.","$70000 - $98000"
"17031750500","Census Tract 7505, Cook County, Illinois",5376,55750,1003,3938,0,5,0,276,18.7,73.3,0,0.1,0,5.1,81.3,1978,1236,742,62.49,37.51,83,1153,56,686,139,1839,6.7,7.5,7,"75% or more P.O.C.","$49000 - $70000"
"17031750600","Census Tract 7506, Cook County, Illinois",3406,42949,48,3168,0,0,0,23,1.4,93,0,0,0,0.7,98.6,1256,905,351,72.05,27.95,70,835,71,280,141,1115,7.7,20.2,11.2,"75% or more P.O.C.","Less than $49000"
"17031760801","Census Tract 7608.01, Cook County, Illinois",4520,68159,2384,141,0,1160,0,689,52.7,3.1,0,25.7,0,15.2,47.3,2199,407,1792,18.51,81.49,17,390,22,1770,39,2160,4.2,1.2,1.8,"25% - 50% P.O.C.","$49000 - $70000"
"17031760802","Census Tract 7608.02, Cook County, Illinois",2553,54177,2360,15,0,10,0,168,92.4,0.6,0,0.4,0,6.6,7.6,1113,882,231,79.25,20.75,83,799,0,231,83,1030,9.4,0,7.5,"Less than 25% P.O.C.","$49000 - $70000"
"17031760803","Census Tract 7608.03, Cook County, Illinois",5788,44918,4677,100,0,409,0,497,80.8,1.7,0,7.1,0,8.6,19.2,2808,1148,1660,40.88,59.12,0,1148,36,1624,36,2772,0,2.2,1.3,"Less than 25% P.O.C.","Less than $49000"
"17031770201","Census Tract 7702.01, Cook County, Illinois",6075,64215,4335,198,0,698,0,699,71.4,3.3,0,11.5,0,11.5,28.6,2861,1437,1424,50.23,49.77,78,1359,91,1333,169,2692,5.4,6.4,5.9,"25% - 50% P.O.C.","$49000 - $70000"
"17031770202","Census Tract 7702.02, Cook County, Illinois",4749,66672,4074,1,14,109,0,551,85.8,0,0.3,2.3,0,11.6,14.2,2158,2034,124,94.25,5.75,131,1903,0,124,131,2027,6.4,0,6.1,"Less than 25% P.O.C.","$49000 - $70000"
"17031770300","Census Tract 7703, Cook County, Illinois",6924,82196,5352,125,0,455,0,856,77.3,1.8,0,6.6,0,12.4,22.7,2811,1994,817,70.94,29.06,37,1957,22,795,59,2752,1.9,2.7,2.1,"Less than 25% P.O.C.","$70000 - $98000"
"17031770400","Census Tract 7704, Cook County, Illinois",4503,77205,2698,140,0,394,0,1163,59.9,3.1,0,8.7,0,25.8,40.1,1749,996,753,56.95,43.05,49,947,82,671,131,1618,4.9,10.9,7.5,"25% - 50% P.O.C.","$70000 - $98000"
"17031770500","Census Tract 7705, Cook County, Illinois",4030,41663,638,0,0,0,0,3368,15.8,0,0,0,0,83.6,84.2,1053,728,325,69.14,30.86,183,545,103,222,286,767,25.1,31.7,27.2,"75% or more P.O.C.","Less than $49000"
"17031770601","Census Tract 7706.01, Cook County, Illinois",3234,96442,2166,53,0,856,0,115,67,1.6,0,26.5,0,3.6,33,1055,965,90,91.47,8.53,79,886,14,76,93,962,8.2,15.6,8.8,"25% - 50% P.O.C.","$70000 - $98000"
"17031770602","Census Tract 7706.02, Cook County, Illinois",5198,71103,1731,118,0,493,0,2808,33.3,2.3,0,9.5,0,54,66.7,1591,679,912,42.68,57.32,81,598,164,748,245,1346,11.9,18,15.4,"50% - 75% P.O.C.","$70000 - $98000"
"17031770700","Census Tract 7707, Cook County, Illinois",2301,57368,1902,5,0,39,0,335,82.7,0.2,0,1.7,0,14.6,17.3,1040,463,577,44.52,55.48,9,454,44,533,53,987,1.9,7.6,5.1,"Less than 25% P.O.C.","$49000 - $70000"
"17031770800","Census Tract 7708, Cook County, Illinois",5248,58147,3520,135,0,216,0,1377,67.1,2.6,0,4.1,0,26.2,32.9,1943,1263,680,65,35,68,1195,67,613,135,1808,5.4,9.9,6.9,"25% - 50% P.O.C.","$49000 - $70000"
"17031770901","Census Tract 7709.01, Cook County, Illinois",4948,75519,4007,0,0,420,0,491,81,0,0,8.5,0,9.9,19,1945,1705,240,87.66,12.34,164,1541,0,240,164,1781,9.6,0,8.4,"Less than 25% P.O.C.","$70000 - $98000"
"17031770902","Census Tract 7709.02, Cook County, Illinois",3309,61466,2800,2,0,187,13,252,84.6,0.1,0,5.7,0.4,7.6,15.4,1353,993,360,73.39,26.61,81,912,26,334,107,1246,8.2,7.2,7.9,"Less than 25% P.O.C.","$49000 - $70000"
"17031800100","Census Tract 8001, Cook County, Illinois",2304,250001,2127,0,0,91,0,43,92.3,0,0,3.9,0,1.9,7.7,833,816,17,97.96,2.04,117,699,3,14,120,713,14.3,17.6,14.4,"Less than 25% P.O.C.","$98000 or more"
"17031800200","Census Tract 8002, Cook County, Illinois",6584,224766,5634,259,0,367,0,279,85.6,3.9,0,5.6,0,4.2,14.4,2379,2226,153,93.57,6.43,190,2036,0,153,190,2189,8.5,0,8,"Less than 25% P.O.C.","$98000 or more"
"17031800300","Census Tract 8003, Cook County, Illinois",3334,207500,3023,0,0,133,0,100,90.7,0,0,4,0,3,9.3,1178,1020,158,86.59,13.41,145,875,22,136,167,1011,14.2,13.9,14.2,"Less than 25% P.O.C.","$98000 or more"
"17031800400","Census Tract 8004, Cook County, Illinois",3637,250001,3167,0,0,204,0,91,87.1,0,0,5.6,0,2.5,12.9,1203,1078,125,89.61,10.39,174,904,9,116,183,1020,16.1,7.2,15.2,"Less than 25% P.O.C.","$98000 or more"
"17031800500","Census Tract 8005, Cook County, Illinois",5400,237604,4938,14,50,152,0,195,91.4,0.3,0.9,2.8,0,3.6,8.6,1697,1539,158,90.69,9.31,355,1184,0,158,355,1342,23.1,0,20.9,"Less than 25% P.O.C.","$98000 or more"
"17031800600","Census Tract 8006, Cook County, Illinois",2351,238182,2165,0,0,115,0,54,92.1,0,0,4.9,0,2.3,7.9,742,717,25,96.63,3.37,176,541,0,25,176,566,24.5,0,23.7,"Less than 25% P.O.C.","$98000 or more"
"17031800700","Census Tract 8007, Cook County, Illinois",4779,200852,4060,40,0,468,0,75,85,0.8,0,9.8,0,1.6,15,1653,1584,69,95.83,4.17,178,1406,22,47,200,1453,11.2,31.9,12.1,"Less than 25% P.O.C.","$98000 or more"
"17031800800","Census Tract 8008, Cook County, Illinois",2281,98125,1813,27,0,149,0,284,79.5,1.2,0,6.5,0,12.5,20.5,969,849,120,87.62,12.38,67,782,0,120,67,902,7.9,0,6.9,"Less than 25% P.O.C.","$98000 or more"
"17031800900","Census Tract 8009, Cook County, Illinois",4399,122857,2661,100,0,1228,0,273,60.5,2.3,0,27.9,0,6.2,39.5,1444,1245,199,86.22,13.78,170,1075,34,165,204,1240,13.7,17.1,14.1,"25% - 50% P.O.C.","$98000 or more"
"17031801000","Census Tract 8010, Cook County, Illinois",5159,122743,4135,9,0,823,0,59,80.2,0.2,0,16,0,1.1,19.8,1955,1610,345,82.35,17.65,158,1452,0,345,158,1797,9.8,0,8.1,"Less than 25% P.O.C.","$98000 or more"
"17031801100","Census Tract 8011, Cook County, Illinois",4913,184375,4298,1,0,344,0,116,87.5,0,0,7,0,2.4,12.5,1672,1475,197,88.22,11.78,174,1301,0,197,174,1498,11.8,0,10.4,"Less than 25% P.O.C.","$98000 or more"
"17031801200","Census Tract 8012, Cook County, Illinois",3578,226563,3178,18,0,199,0,127,88.8,0.5,0,5.6,0,3.5,11.2,1290,1251,39,96.98,3.02,167,1084,0,39,167,1123,13.3,0,12.9,"Less than 25% P.O.C.","$98000 or more"
"17031801300","Census Tract 8013, Cook County, Illinois",4310,164306,3664,46,24,332,0,84,85,1.1,0.6,7.7,0,1.9,15,1645,1266,379,76.96,23.04,227,1039,11,368,238,1407,17.9,2.9,14.5,"Less than 25% P.O.C.","$98000 or more"
"17031801400","Census Tract 8014, Cook County, Illinois",3138,134803,2298,35,11,521,0,204,73.2,1.1,0.4,16.6,0,6.5,26.8,1091,1003,88,91.93,8.07,71,932,8,80,79,1012,7.1,9.1,7.2,"25% - 50% P.O.C.","$98000 or more"
"17031801500","Census Tract 8015, Cook County, Illinois",6115,98942,5209,334,27,405,0,66,85.2,5.5,0.4,6.6,0,1.1,14.8,2477,1991,486,80.38,19.62,143,1848,26,460,169,2308,7.2,5.3,6.8,"Less than 25% P.O.C.","$98000 or more"
"17031801601","Census Tract 8016.01, Cook County, Illinois",4449,111082,3653,69,0,638,0,45,82.1,1.6,0,14.3,0,1,17.9,1789,1390,399,77.7,22.3,73,1317,0,399,73,1716,5.3,0,4.1,"Less than 25% P.O.C.","$98000 or more"
"17031801603","Census Tract 8016.03, Cook County, Illinois",4097,52951,1876,460,0,978,0,706,45.8,11.2,0,23.9,0,17.2,54.2,1568,588,980,37.5,62.5,39,549,78,902,117,1451,6.6,8,7.5,"50% - 75% P.O.C.","$49000 - $70000"
"17031801605","Census Tract 8016.05, Cook County, Illinois",5512,136094,4221,15,0,1073,0,126,76.6,0.3,0,19.5,0,2.3,23.4,2228,2128,100,95.51,4.49,110,2018,0,100,110,2118,5.2,0,4.9,"Less than 25% P.O.C.","$98000 or more"
"17031801606","Census Tract 8016.06, Cook County, Illinois",6082,119113,4904,25,0,988,0,90,80.6,0.4,0,16.2,0,1.5,19.4,2568,2232,336,86.92,13.08,165,2067,0,336,165,2403,7.4,0,6.4,"Less than 25% P.O.C.","$98000 or more"
"17031801607","Census Tract 8016.07, Cook County, Illinois",5204,94808,3380,29,0,1586,0,169,65,0.6,0,30.5,0,3.2,35,2054,1445,609,70.35,29.65,101,1344,41,568,142,1912,7,6.7,6.9,"25% - 50% P.O.C.","$70000 - $98000"
"17031801608","Census Tract 8016.08, Cook County, Illinois",7067,116432,4886,27,0,2045,0,66,69.1,0.4,0,28.9,0,0.9,30.9,2947,2313,634,78.49,21.51,173,2140,0,634,173,2774,7.5,0,5.9,"25% - 50% P.O.C.","$98000 or more"
"17031801701","Census Tract 8017.01, Cook County, Illinois",3890,186111,3102,0,0,656,0,98,79.7,0,0,16.9,0,2.5,20.3,1230,1152,78,93.66,6.34,175,977,0,78,175,1055,15.2,0,14.2,"Less than 25% P.O.C.","$98000 or more"
"17031801702","Census Tract 8017.02, Cook County, Illinois",4602,120529,3741,23,0,547,0,224,81.3,0.5,0,11.9,0,4.9,18.7,1627,1466,161,90.1,9.9,142,1324,20,141,162,1465,9.7,12.4,10,"Less than 25% P.O.C.","$98000 or more"
"17031801800","Census Tract 8018, Cook County, Illinois",5703,151136,4868,58,0,700,0,62,85.4,1,0,12.3,0,1.1,14.6,2298,2035,263,88.56,11.44,113,1922,38,225,151,2147,5.6,14.4,6.6,"Less than 25% P.O.C.","$98000 or more"
"17031801901","Census Tract 8019.01, Cook County, Illinois",4280,93207,3218,18,0,368,0,630,75.2,0.4,0,8.6,0,14.7,24.8,1844,1525,319,82.7,17.3,110,1415,23,296,133,1711,7.2,7.2,7.2,"Less than 25% P.O.C.","$70000 - $98000"
"17031801902","Census Tract 8019.02, Cook County, Illinois",3474,163649,2995,5,0,330,0,43,86.2,0.1,0,9.5,0,1.2,13.8,1146,1044,102,91.1,8.9,159,885,7,95,166,980,15.2,6.9,14.5,"Less than 25% P.O.C.","$98000 or more"
"17031802002","Census Tract 8020.02, Cook County, Illinois",5444,126250,4231,111,0,566,0,484,77.7,2,0,10.4,0,8.9,22.3,1673,1537,136,91.87,8.13,241,1296,56,80,297,1376,15.7,41.2,17.8,"Less than 25% P.O.C.","$98000 or more"
"17031802003","Census Tract 8020.03, Cook County, Illinois",2581,105066,1473,40,0,490,0,532,57.1,1.5,0,19,0,20.6,42.9,865,749,116,86.59,13.41,79,670,40,76,119,746,10.5,34.5,13.8,"25% - 50% P.O.C.","$98000 or more"
"17031802004","Census Tract 8020.04, Cook County, Illinois",5029,37406,2814,222,0,1365,0,593,56,4.4,0,27.1,0,11.8,44,2140,1485,655,69.39,30.61,15,1470,91,564,106,2034,1,13.9,5,"25% - 50% P.O.C.","Less than $49000"
"17031802100","Census Tract 8021, Cook County, Illinois",3466,151094,2934,16,0,279,0,46,84.7,0.5,0,8,0,1.3,15.3,1158,943,215,81.43,18.57,109,834,37,178,146,1012,11.6,17.2,12.6,"Less than 25% P.O.C.","$98000 or more"
"17031802200","Census Tract 8022, Cook County, Illinois",4769,125375,4420,79,0,103,0,138,92.7,1.7,0,2.2,0,2.9,7.3,1837,1507,330,82.04,17.96,215,1292,11,319,226,1611,14.3,3.3,12.3,"Less than 25% P.O.C.","$98000 or more"
"17031802300","Census Tract 8023, Cook County, Illinois",5513,126765,4307,32,0,811,0,184,78.1,0.6,0,14.7,0,3.3,21.9,2290,1412,878,61.66,38.34,172,1240,9,869,181,2109,12.2,1,7.9,"Less than 25% P.O.C.","$98000 or more"
"17031802402","Census Tract 8024.02, Cook County, Illinois",5977,63575,3023,199,0,808,0,1770,50.6,3.3,0,13.5,0,29.6,49.4,2271,1419,852,62.48,37.52,59,1360,93,759,152,2119,4.2,10.9,6.7,"25% - 50% P.O.C.","$49000 - $70000"
"17031802403","Census Tract 8024.03, Cook County, Illinois",1340,70511,1134,14,0,103,0,69,84.6,1,0,7.7,0,5.1,15.4,827,664,163,80.29,19.71,12,652,0,163,12,815,1.8,0,1.5,"Less than 25% P.O.C.","$70000 - $98000"
"17031802404","Census Tract 8024.04, Cook County, Illinois",7463,55441,3120,117,0,1052,0,3157,41.8,1.6,0,14.1,0,42.3,58.2,2756,1583,1173,57.44,42.56,151,1432,166,1007,317,2439,9.5,14.2,11.5,"50% - 75% P.O.C.","$49000 - $70000"
"17031802503","Census Tract 8025.03, Cook County, Illinois",6302,81543,3506,0,141,1740,0,611,55.6,0,2.2,27.6,0,9.7,44.4,2378,1695,683,71.28,28.72,146,1549,41,642,187,2191,8.6,6,7.9,"25% - 50% P.O.C.","$70000 - $98000"
"17031802504","Census Tract 8025.04, Cook County, Illinois",6610,83463,2992,52,0,642,0,2816,45.3,0.8,0,9.7,0,42.6,54.7,2031,1751,280,86.21,13.79,232,1519,136,144,368,1663,13.2,48.6,18.1,"50% - 75% P.O.C.","$70000 - $98000"
"17031802505","Census Tract 8025.05, Cook County, Illinois",6579,56479,1964,246,0,929,0,3352,29.9,3.7,0,14.1,0,50.9,70.1,2411,981,1430,40.69,59.31,127,854,298,1132,425,1986,12.9,20.8,17.6,"50% - 75% P.O.C.","$49000 - $70000"
"17031802506","Census Tract 8025.06, Cook County, Illinois",2476,85648,869,38,23,341,0,1154,35.1,1.5,0.9,13.8,0,46.6,64.9,758,455,303,60.03,39.97,107,348,62,241,169,589,23.5,20.5,22.3,"50% - 75% P.O.C.","$70000 - $98000"
"17031802605","Census Tract 8026.05, Cook County, Illinois",6916,98769,4948,136,0,1582,0,204,71.5,2,0,22.9,0,2.9,28.5,2778,2092,686,75.31,24.69,147,1945,0,686,147,2631,7,0,5.3,"25% - 50% P.O.C.","$98000 or more"
"17031802607","Census Tract 8026.07, Cook County, Illinois",1253,123889,1098,29,0,75,0,40,87.6,2.3,0,6,0,3.2,12.4,438,422,16,96.35,3.65,31,391,5,11,36,402,7.3,31.2,8.2,"Less than 25% P.O.C.","$98000 or more"
"17031802608","Census Tract 8026.08, Cook County, Illinois",6383,66208,5517,154,0,458,0,199,86.4,2.4,0,7.2,0,3.1,13.6,2967,2575,392,86.79,13.21,47,2528,0,392,47,2920,1.8,0,1.6,"Less than 25% P.O.C.","$49000 - $70000"
"17031802609","Census Tract 8026.09, Cook County, Illinois",6299,55354,2239,109,0,910,0,2974,35.5,1.7,0,14.4,0,47.2,64.5,2314,1141,1173,49.31,50.69,89,1052,175,998,264,2050,7.8,14.9,11.4,"50% - 75% P.O.C.","$49000 - $70000"
"17031802610","Census Tract 8026.10, Cook County, Illinois",1655,93194,1360,5,0,215,0,36,82.2,0.3,0,13,0,2.2,17.8,630,587,43,93.17,6.83,39,548,0,43,39,591,6.6,0,6.2,"Less than 25% P.O.C.","$70000 - $98000"
"17031802701","Census Tract 8027.01, Cook County, Illinois",6911,94709,4157,55,15,1267,0,1326,60.2,0.8,0.2,18.3,0,19.2,39.8,2249,1816,433,80.75,19.25,209,1607,128,305,337,1912,11.5,29.6,15,"25% - 50% P.O.C.","$70000 - $98000"
"17031802702","Census Tract 8027.02, Cook County, Illinois",4763,86034,3385,12,0,1049,0,186,71.1,0.3,0,22,0,3.9,28.9,1832,1437,395,78.44,21.56,189,1248,7,388,196,1636,13.2,1.8,10.7,"25% - 50% P.O.C.","$70000 - $98000"
"17031802801","Census Tract 8028.01, Cook County, Illinois",4812,107571,4027,48,0,338,0,337,83.7,1,0,7,0,7,16.3,1928,1663,265,86.26,13.74,108,1555,20,245,128,1800,6.5,7.5,6.6,"Less than 25% P.O.C.","$98000 or more"
"17031802802","Census Tract 8028.02, Cook County, Illinois",6578,109223,4954,289,26,556,0,711,75.3,4.4,0.4,8.5,0,10.8,24.7,2277,2153,124,94.55,5.45,264,1889,42,82,306,1971,12.3,33.9,13.4,"Less than 25% P.O.C.","$98000 or more"
"17031802900","Census Tract 8029, Cook County, Illinois",6111,142900,5288,14,0,289,0,285,86.5,0.2,0,4.7,0,4.7,13.5,2068,1982,86,95.84,4.16,235,1747,38,48,273,1795,11.9,44.2,13.2,"Less than 25% P.O.C.","$98000 or more"
"17031803005","Census Tract 8030.05, Cook County, Illinois",2475,74375,2223,11,0,178,0,63,89.8,0.4,0,7.2,0,2.5,10.2,1034,689,345,66.63,33.37,83,606,12,333,95,939,12,3.5,9.2,"Less than 25% P.O.C.","$70000 - $98000"
"17031803007","Census Tract 8030.07, Cook County, Illinois",4909,106838,3843,75,0,581,0,379,78.3,1.5,0,11.8,0,7.7,21.7,2033,1688,345,83.03,16.97,98,1590,34,311,132,1901,5.8,9.9,6.5,"Less than 25% P.O.C.","$98000 or more"
"17031803008","Census Tract 8030.08, Cook County, Illinois",4583,113179,3638,76,0,405,0,337,79.4,1.7,0,8.8,0,7.4,20.6,1663,1479,184,88.94,11.06,99,1380,10,174,109,1554,6.7,5.4,6.6,"Less than 25% P.O.C.","$98000 or more"
"17031803010","Census Tract 8030.10, Cook County, Illinois",5444,113750,3844,62,0,526,0,939,70.6,1.1,0,9.7,0,17.2,29.4,1985,1820,165,91.69,8.31,138,1682,0,165,138,1847,7.6,0,7,"25% - 50% P.O.C.","$98000 or more"
"17031803012","Census Tract 8030.12, Cook County, Illinois",2050,74750,1447,44,0,169,0,361,70.6,2.1,0,8.2,0,17.6,29.4,899,475,424,52.84,47.16,31,444,13,411,44,855,6.5,3.1,4.9,"25% - 50% P.O.C.","$70000 - $98000"
"17031803013","Census Tract 8030.13, Cook County, Illinois",5423,90098,4158,29,0,148,23,738,76.7,0.5,0,2.7,0.4,13.6,23.3,2150,1817,333,84.51,15.49,184,1633,13,320,197,1953,10.1,3.9,9.2,"Less than 25% P.O.C.","$70000 - $98000"
"17031803014","Census Tract 8030.14, Cook County, Illinois",3560,70505,2322,54,0,333,0,785,65.2,1.5,0,9.4,0,22.1,34.8,1385,905,480,65.34,34.66,36,869,8,472,44,1341,4,1.7,3.2,"25% - 50% P.O.C.","$70000 - $98000"
"17031803015","Census Tract 8030.15, Cook County, Illinois",4402,79596,3269,315,8,352,0,432,74.3,7.2,0.2,8,0,9.8,25.7,1879,1511,368,80.42,19.58,88,1423,36,332,124,1755,5.8,9.8,6.6,"25% - 50% P.O.C.","$70000 - $98000"
"17031803016","Census Tract 8030.16, Cook County, Illinois",2616,102679,1029,6,14,1436,0,107,39.3,0.2,0.5,54.9,0,4.1,60.7,927,360,567,38.83,61.17,29,331,17,550,46,881,8.1,3,5,"50% - 75% P.O.C.","$98000 or more"
"17031803017","Census Tract 8030.17, Cook County, Illinois",6051,93279,4133,21,0,811,0,924,68.3,0.3,0,13.4,0,15.3,31.7,2638,1507,1131,57.13,42.87,30,1477,48,1083,78,2560,2,4.2,3,"25% - 50% P.O.C.","$70000 - $98000"
"17031803100","Census Tract 8031, Cook County, Illinois",3416,121875,3102,12,0,130,0,98,90.8,0.4,0,3.8,0,2.9,9.2,1224,1140,84,93.14,6.86,136,1004,8,76,144,1080,11.9,9.5,11.8,"Less than 25% P.O.C.","$98000 or more"
"17031803200","Census Tract 8032, Cook County, Illinois",5310,91009,4652,19,0,186,0,453,87.6,0.4,0,3.5,0,8.5,12.4,2200,1863,337,84.68,15.32,110,1753,0,337,110,2090,5.9,0,5,"Less than 25% P.O.C.","$70000 - $98000"
"17031803300","Census Tract 8033, Cook County, Illinois",5633,108891,4411,50,0,716,0,426,78.3,0.9,0,12.7,0,7.6,21.7,2617,1467,1150,56.06,43.94,64,1403,44,1106,108,2509,4.4,3.8,4.1,"Less than 25% P.O.C.","$98000 or more"
"17031803400","Census Tract 8034, Cook County, Illinois",6364,125899,5757,3,0,249,0,215,90.5,0,0,3.9,0,3.4,9.5,2281,1958,323,85.84,14.16,161,1797,0,323,161,2120,8.2,0,7.1,"Less than 25% P.O.C.","$98000 or more"
"17031803500","Census Tract 8035, Cook County, Illinois",5765,114375,5438,25,0,139,0,133,94.3,0.4,0,2.4,0,2.3,5.7,2271,1862,409,81.99,18.01,203,1659,0,409,203,2068,10.9,0,8.9,"Less than 25% P.O.C.","$98000 or more"
"17031803603","Census Tract 8036.03, Cook County, Illinois",6924,169425,5308,79,0,1364,0,0,76.7,1.1,0,19.7,0,0,23.3,2358,2143,215,90.88,9.12,271,1872,0,215,271,2087,12.6,0,11.5,"Less than 25% P.O.C.","$98000 or more"
"17031803604","Census Tract 8036.04, Cook County, Illinois",4243,79853,3279,63,0,408,0,386,77.3,1.5,0,9.6,0,9.1,22.7,1840,1295,545,70.38,29.62,72,1223,30,515,102,1738,5.6,5.5,5.5,"Less than 25% P.O.C.","$70000 - $98000"
"17031803605","Census Tract 8036.05, Cook County, Illinois",7266,78611,4867,391,0,705,0,1205,67,5.4,0,9.7,0,16.6,33,2646,1903,743,71.92,28.08,55,1848,69,674,124,2522,2.9,9.3,4.7,"25% - 50% P.O.C.","$70000 - $98000"
"17031803606","Census Tract 8036.06, Cook County, Illinois",9148,51429,2211,111,0,704,0,6033,24.2,1.2,0,7.7,0,65.9,75.8,2808,840,1968,29.91,70.09,141,699,409,1559,550,2258,16.8,20.8,19.6,"75% or more P.O.C.","$49000 - $70000"
"17031803607","Census Tract 8036.07, Cook County, Illinois",4912,109516,4056,6,0,249,0,493,82.6,0.1,0,5.1,0,10,17.4,1793,1672,121,93.25,6.75,137,1535,28,93,165,1628,8.2,23.1,9.2,"Less than 25% P.O.C.","$98000 or more"
"17031803608","Census Tract 8036.08, Cook County, Illinois",7141,67380,4635,283,0,741,0,1192,64.9,4,0,10.4,0,16.7,35.1,2813,1578,1235,56.1,43.9,55,1523,160,1075,215,2598,3.5,13,7.6,"25% - 50% P.O.C.","$49000 - $70000"
"17031803610","Census Tract 8036.10, Cook County, Illinois",7195,65569,4520,356,28,984,0,1159,62.8,4.9,0.4,13.7,0,16.1,37.2,3183,1905,1278,59.85,40.15,46,1859,114,1164,160,3023,2.4,8.9,5,"25% - 50% P.O.C.","$49000 - $70000"
"17031803611","Census Tract 8036.11, Cook County, Illinois",5784,68184,1981,347,0,448,0,2819,34.2,6,0,7.7,0,48.7,65.8,2031,1381,650,68,32,102,1279,114,536,216,1815,7.4,17.5,10.6,"50% - 75% P.O.C.","$49000 - $70000"
"17031803612","Census Tract 8036.12, Cook County, Illinois",3517,61426,977,103,0,410,0,1940,27.8,2.9,0,11.7,0,55.2,72.2,1259,313,946,24.86,75.14,2,311,138,808,140,1119,0.6,14.6,11.1,"50% - 75% P.O.C.","$49000 - $70000"
"17031803701","Census Tract 8037.01, Cook County, Illinois",2766,89896,2127,16,0,295,0,279,76.9,0.6,0,10.7,0,10.1,23.1,1386,937,449,67.6,32.4,24,913,0,449,24,1362,2.6,0,1.7,"Less than 25% P.O.C.","$70000 - $98000"
"17031803702","Census Tract 8037.02, Cook County, Illinois",5950,109234,4701,42,0,664,0,375,79,0.7,0,11.2,0,6.3,21,2537,1994,543,78.6,21.4,109,1885,35,508,144,2393,5.5,6.4,5.7,"Less than 25% P.O.C.","$98000 or more"
"17031803800","Census Tract 8038, Cook County, Illinois",4514,93262,3588,93,0,306,0,472,79.5,2.1,0,6.8,0,10.5,20.5,1783,1584,199,88.84,11.16,143,1441,0,199,143,1640,9,0,8,"Less than 25% P.O.C.","$70000 - $98000"
"17031803901","Census Tract 8039.01, Cook County, Illinois",3687,70976,3031,67,0,370,0,157,82.2,1.8,0,10,0,4.3,17.8,1912,1601,311,83.73,16.27,34,1567,0,311,34,1878,2.1,0,1.8,"Less than 25% P.O.C.","$70000 - $98000"
"17031803902","Census Tract 8039.02, Cook County, Illinois",3374,90750,2432,24,0,61,4,783,72.1,0.7,0,1.8,0.1,23.2,27.9,1238,1066,172,86.11,13.89,77,989,24,148,101,1137,7.2,14,8.2,"25% - 50% P.O.C.","$70000 - $98000"
"17031804000","Census Tract 8040, Cook County, Illinois",4545,77188,3399,60,0,197,0,825,74.8,1.3,0,4.3,0,18.2,25.2,1929,1636,293,84.81,15.19,120,1516,8,285,128,1801,7.3,2.7,6.6,"25% - 50% P.O.C.","$70000 - $98000"
"17031804102","Census Tract 8041.02, Cook County, Illinois",7263,141786,5752,102,0,1047,0,260,79.2,1.4,0,14.4,0,3.6,20.8,2494,2420,74,97.03,2.97,194,2226,0,74,194,2300,8,0,7.8,"Less than 25% P.O.C.","$98000 or more"
"17031804104","Census Tract 8041.04, Cook County, Illinois",4790,116466,2893,107,0,1320,0,285,60.4,2.2,0,27.6,0,5.9,39.6,1712,1404,308,82.01,17.99,78,1326,61,247,139,1573,5.6,19.8,8.1,"25% - 50% P.O.C.","$98000 or more"
"17031804105","Census Tract 8041.05, Cook County, Illinois",3875,131821,2929,17,0,520,0,304,75.6,0.4,0,13.4,0,7.8,24.4,1279,1260,19,98.51,1.49,117,1143,10,9,127,1152,9.3,52.6,9.9,"Less than 25% P.O.C.","$98000 or more"
"17031804106","Census Tract 8041.06, Cook County, Illinois",6982,116667,4610,37,0,1662,0,345,66,0.5,0,23.8,0,4.9,34,2690,2252,438,83.72,16.28,134,2118,16,422,150,2540,6,3.7,5.6,"25% - 50% P.O.C.","$98000 or more"
"17031804108","Census Tract 8041.08, Cook County, Illinois",3931,91616,1362,202,0,1653,0,542,34.6,5.1,0,42.1,0,13.8,65.4,1759,234,1525,13.3,86.7,9,225,20,1505,29,1730,3.8,1.3,1.6,"50% - 75% P.O.C.","$70000 - $98000"
"17031804109","Census Tract 8041.09, Cook County, Illinois",2793,117794,2007,132,0,306,0,219,71.9,4.7,0,11,0,7.8,28.1,1076,830,246,77.14,22.86,53,777,0,246,53,1023,6.4,0,4.9,"25% - 50% P.O.C.","$98000 or more"
"17031804201","Census Tract 8042.01, Cook County, Illinois",8743,142521,5926,139,0,1982,146,351,67.8,1.6,0,22.7,1.7,4,32.2,2835,2596,239,91.57,8.43,436,2160,25,214,461,2374,16.8,10.5,16.3,"25% - 50% P.O.C.","$98000 or more"
"17031804202","Census Tract 8042.02, Cook County, Illinois",7278,132377,5146,27,0,1407,0,586,70.7,0.4,0,19.3,0,8.1,29.3,2619,2231,388,85.19,14.81,210,2021,84,304,294,2325,9.4,21.6,11.2,"25% - 50% P.O.C.","$98000 or more"
"17031804305","Census Tract 8043.05, Cook County, Illinois",7041,76556,3512,366,0,471,0,2588,49.9,5.2,0,6.7,0,36.8,50.1,2463,1974,489,80.15,19.85,260,1714,151,338,411,2052,13.2,30.9,16.7,"50% - 75% P.O.C.","$70000 - $98000"
"17031804306","Census Tract 8043.06, Cook County, Illinois",5771,69500,2471,77,0,309,0,2844,42.8,1.3,0,5.4,0,49.3,57.2,1714,1395,319,81.39,18.61,180,1215,138,181,318,1396,12.9,43.3,18.6,"50% - 75% P.O.C.","$49000 - $70000"
"17031804308","Census Tract 8043.08, Cook County, Illinois",7012,75948,2608,463,0,1534,0,2238,37.2,6.6,0,21.9,0,31.9,62.8,2567,1782,785,69.42,30.58,133,1649,151,634,284,2283,7.5,19.2,11.1,"50% - 75% P.O.C.","$70000 - $98000"
"17031804309","Census Tract 8043.09, Cook County, Illinois",3086,81926,1123,250,0,244,0,1395,36.4,8.1,0,7.9,0,45.2,63.6,943,768,175,81.44,18.56,133,635,63,112,196,747,17.3,36,20.8,"50% - 75% P.O.C.","$70000 - $98000"
"17031804310","Census Tract 8043.10, Cook County, Illinois",8918,96274,4723,51,7,1827,0,2198,53,0.6,0.1,20.5,0,24.6,47,3145,2756,389,87.63,12.37,200,2556,0,389,200,2945,7.3,0,6.4,"25% - 50% P.O.C.","$70000 - $98000"
"17031804311","Census Tract 8043.11, Cook County, Illinois",8211,106212,3748,356,0,2236,0,1785,45.6,4.3,0,27.2,0,21.7,54.4,2739,2390,349,87.26,12.74,482,1908,50,299,532,2207,20.2,14.3,19.4,"50% - 75% P.O.C.","$98000 or more"
"17031804403","Census Tract 8044.03, Cook County, Illinois",6696,79260,2996,284,0,721,16,2518,44.7,4.2,0,10.8,0.2,37.6,55.3,2449,1767,682,72.15,27.85,71,1696,134,548,205,2244,4,19.6,8.4,"50% - 75% P.O.C.","$70000 - $98000"
"17031804404","Census Tract 8044.04, Cook County, Illinois",5834,76964,1433,153,0,330,0,3828,24.6,2.6,0,5.7,0,65.6,75.4,1589,1426,163,89.74,10.26,370,1056,69,94,439,1150,25.9,42.3,27.6,"75% or more P.O.C.","$70000 - $98000"
"17031804405","Census Tract 8044.05, Cook County, Illinois",3507,59965,398,560,0,394,0,1995,11.3,16,0,11.2,0,56.9,88.7,1083,469,614,43.31,56.69,126,343,124,490,250,833,26.9,20.2,23.1,"75% or more P.O.C.","$49000 - $70000"
"17031804406","Census Tract 8044.06, Cook County, Illinois",6646,72734,1838,386,0,673,0,3685,27.7,5.8,0,10.1,0,55.4,72.3,1965,1619,346,82.39,17.61,406,1213,102,244,508,1457,25.1,29.5,25.9,"50% - 75% P.O.C.","$70000 - $98000"
"17031804505","Census Tract 8045.05, Cook County, Illinois",3445,71438,2368,178,0,236,0,565,68.7,5.2,0,6.9,0,16.4,31.3,1517,1035,482,68.23,31.77,45,990,29,453,74,1443,4.3,6,4.9,"25% - 50% P.O.C.","$70000 - $98000"
"17031804506","Census Tract 8045.06, Cook County, Illinois",5133,96458,3539,37,0,919,0,489,68.9,0.7,0,17.9,0,9.5,31.1,1805,1595,210,88.37,11.63,156,1439,11,199,167,1638,9.8,5.2,9.3,"25% - 50% P.O.C.","$70000 - $98000"
"17031804507","Census Tract 8045.07, Cook County, Illinois",11526,105240,6316,492,50,2687,0,1621,54.8,4.3,0.4,23.3,0,14.1,45.2,4259,3428,831,80.49,19.51,295,3133,67,764,362,3897,8.6,8.1,8.5,"25% - 50% P.O.C.","$98000 or more"
"17031804508","Census Tract 8045.08, Cook County, Illinois",2399,61148,673,29,0,397,0,1147,28.1,1.2,0,16.5,0,47.8,71.9,747,344,403,46.05,53.95,32,312,103,300,135,612,9.3,25.6,18.1,"50% - 75% P.O.C.","$49000 - $70000"
"17031804509","Census Tract 8045.09, Cook County, Illinois",6201,84375,1391,365,0,683,0,3574,22.4,5.9,0,11,0,57.6,77.6,1603,1380,223,86.09,13.91,315,1065,135,88,450,1153,22.8,60.5,28.1,"75% or more P.O.C.","$70000 - $98000"
"17031804510","Census Tract 8045.10, Cook County, Illinois",6287,72411,1018,214,0,306,0,4709,16.2,3.4,0,4.9,0,74.9,83.8,1426,906,520,63.53,36.47,269,637,227,293,496,930,29.7,43.7,34.8,"75% or more P.O.C.","$70000 - $98000"
"17031804511","Census Tract 8045.11, Cook County, Illinois",2483,58203,530,205,0,373,0,1375,21.3,8.3,0,15,0,55.4,78.7,724,298,426,41.16,58.84,93,205,94,332,187,537,31.2,22.1,25.8,"75% or more P.O.C.","$49000 - $70000"
"17031804603","Census Tract 8046.03, Cook County, Illinois",6137,66367,2696,128,0,1695,0,1491,43.9,2.1,0,27.6,0,24.3,56.1,2701,788,1913,29.17,70.83,71,717,188,1725,259,2442,9,9.8,9.6,"50% - 75% P.O.C.","$49000 - $70000"
"17031804606","Census Tract 8046.06, Cook County, Illinois",6888,113083,5170,95,0,943,0,508,75.1,1.4,0,13.7,0,7.4,24.9,2469,2228,241,90.24,9.76,205,2023,32,209,237,2232,9.2,13.3,9.6,"Less than 25% P.O.C.","$98000 or more"
"17031804607","Census Tract 8046.07, Cook County, Illinois",7239,98984,5357,29,0,1061,0,405,74,0.4,0,14.7,0,5.6,26,2494,1980,514,79.39,20.61,210,1770,65,449,275,2219,10.6,12.6,11,"25% - 50% P.O.C.","$98000 or more"
"17031804608","Census Tract 8046.08, Cook County, Illinois",3429,88149,2003,34,0,821,0,427,58.4,1,0,23.9,0,12.5,41.6,1441,1147,294,79.6,20.4,74,1073,48,246,122,1319,6.5,16.3,8.5,"25% - 50% P.O.C.","$70000 - $98000"
"17031804609","Census Tract 8046.09, Cook County, Illinois",5695,98004,2862,150,33,2297,0,64,50.3,2.6,0.6,40.3,0,1.1,49.7,2285,1429,856,62.54,37.46,166,1263,12,844,178,2107,11.6,1.4,7.8,"25% - 50% P.O.C.","$98000 or more"
"17031804610","Census Tract 8046.10, Cook County, Illinois",2305,67319,1601,26,0,480,0,128,69.5,1.1,0,20.8,0,5.6,30.5,1124,816,308,72.6,27.4,29,787,0,308,29,1095,3.6,0,2.6,"25% - 50% P.O.C.","$49000 - $70000"
"17031804611","Census Tract 8046.11, Cook County, Illinois",4418,88482,3229,48,0,662,0,398,73.1,1.1,0,15,0,9,26.9,1831,1513,318,82.63,17.37,103,1410,11,307,114,1717,6.8,3.5,6.2,"25% - 50% P.O.C.","$70000 - $98000"
"17031804701","Census Tract 8047.01, Cook County, Illinois",6122,69472,2226,616,0,1501,0,1632,36.4,10.1,0,24.5,0,26.7,63.6,2461,1367,1094,55.55,44.45,157,1210,25,1069,182,2279,11.5,2.3,7.4,"50% - 75% P.O.C.","$49000 - $70000"
"17031804705","Census Tract 8047.05, Cook County, Illinois",4470,63277,1893,381,93,866,0,1135,42.3,8.5,2.1,19.4,0,25.4,57.7,1593,1142,451,71.69,28.31,160,982,65,386,225,1368,14,14.4,14.1,"50% - 75% P.O.C.","$49000 - $70000"
"17031804706","Census Tract 8047.06, Cook County, Illinois",2441,115500,1568,22,0,339,0,390,64.2,0.9,0,13.9,0,16,35.8,760,714,46,93.95,6.05,109,605,0,46,109,651,15.3,0,14.3,"25% - 50% P.O.C.","$98000 or more"
"17031804709","Census Tract 8047.09, Cook County, Illinois",6003,67027,2723,219,0,1340,0,1577,45.4,3.6,0,22.3,0,26.3,54.6,2328,1362,966,58.51,41.49,139,1223,59,907,198,2130,10.2,6.1,8.5,"50% - 75% P.O.C.","$49000 - $70000"
"17031804710","Census Tract 8047.10, Cook County, Illinois",3767,86333,2650,175,19,539,0,262,70.3,4.6,0.5,14.3,0,7,29.7,1508,1204,304,79.84,20.16,58,1146,6,298,64,1444,4.8,2,4.2,"25% - 50% P.O.C.","$70000 - $98000"
"17031804711","Census Tract 8047.11, Cook County, Illinois",7733,75377,3011,519,11,2722,0,1445,38.9,6.7,0.1,35.2,0,18.7,61.1,2961,1594,1367,53.83,46.17,154,1440,64,1303,218,2743,9.7,4.7,7.4,"50% - 75% P.O.C.","$70000 - $98000"
"17031804712","Census Tract 8047.12, Cook County, Illinois",5225,97348,3089,385,0,1039,0,580,59.1,7.4,0,19.9,0,11.1,40.9,1807,1276,531,70.61,29.39,172,1104,25,506,197,1610,13.5,4.7,10.9,"25% - 50% P.O.C.","$70000 - $98000"
"17031804713","Census Tract 8047.13, Cook County, Illinois",5873,91913,2594,477,21,1968,0,755,44.2,8.1,0.4,33.5,0,12.9,55.8,2064,861,1203,41.72,58.28,238,623,82,1121,320,1744,27.6,6.8,15.5,"50% - 75% P.O.C.","$70000 - $98000"
"17031804714","Census Tract 8047.14, Cook County, Illinois",3169,81181,2222,0,10,510,0,291,70.1,0,0.3,16.1,0,9.2,29.9,1224,1078,146,88.07,11.93,39,1039,16,130,55,1169,3.6,11,4.5,"25% - 50% P.O.C.","$70000 - $98000"
"17031804715","Census Tract 8047.15, Cook County, Illinois",3178,51169,808,143,0,830,0,1331,25.4,4.5,0,26.1,0,41.9,74.6,1071,625,446,58.36,41.64,27,598,93,353,120,951,4.3,20.9,11.2,"50% - 75% P.O.C.","$49000 - $70000"
"17031804716","Census Tract 8047.16, Cook County, Illinois",4675,96667,2108,171,0,1665,0,565,45.1,3.7,0,35.6,0,12.1,54.9,1572,1284,288,81.68,18.32,155,1129,57,231,212,1360,12.1,19.8,13.5,"50% - 75% P.O.C.","$70000 - $98000"
"17031804803","Census Tract 8048.03, Cook County, Illinois",6037,76280,3888,122,48,1102,0,787,64.4,2,0.8,18.3,0,13,35.6,2132,1573,559,73.78,26.22,152,1421,71,488,223,1909,9.7,12.7,10.5,"25% - 50% P.O.C.","$70000 - $98000"
"17031804804","Census Tract 8048.04, Cook County, Illinois",6331,80568,2817,392,173,1734,0,1214,44.5,6.2,2.7,27.4,0,19.2,55.5,2476,1590,886,64.22,35.78,161,1429,11,875,172,2304,10.1,1.2,6.9,"50% - 75% P.O.C.","$70000 - $98000"
"17031804805","Census Tract 8048.05, Cook County, Illinois",6481,85905,4062,112,0,1083,0,995,62.7,1.7,0,16.7,0,15.4,37.3,2367,2143,224,90.54,9.46,196,1947,48,176,244,2123,9.1,21.4,10.3,"25% - 50% P.O.C.","$70000 - $98000"
"17031804806","Census Tract 8048.06, Cook County, Illinois",3930,76058,1942,203,0,269,0,1303,49.4,5.2,0,6.8,0,33.2,50.6,1061,814,247,76.72,23.28,237,577,15,232,252,809,29.1,6.1,23.8,"50% - 75% P.O.C.","$70000 - $98000"
"17031804807","Census Tract 8048.07, Cook County, Illinois",5397,88605,3441,106,0,652,0,1098,63.8,2,0,12.1,0,20.3,36.2,1756,1560,196,88.84,11.16,243,1317,20,176,263,1493,15.6,10.2,15,"25% - 50% P.O.C.","$70000 - $98000"
"17031804808","Census Tract 8048.08, Cook County, Illinois",2618,107931,1594,90,0,322,0,512,60.9,3.4,0,12.3,0,19.6,39.1,828,807,21,97.46,2.54,108,699,8,13,116,712,13.4,38.1,14,"25% - 50% P.O.C.","$98000 or more"
"17031804809","Census Tract 8048.09, Cook County, Illinois",4165,92188,3357,201,0,516,0,19,80.6,4.8,0,12.4,0,0.5,19.4,1482,1320,162,89.07,10.93,153,1167,0,162,153,1329,11.6,0,10.3,"Less than 25% P.O.C.","$70000 - $98000"
"17031804810","Census Tract 8048.10, Cook County, Illinois",6818,76799,4600,122,0,1175,186,722,67.5,1.8,0,17.2,2.7,10.6,32.5,2441,1806,635,73.99,26.01,111,1695,70,565,181,2260,6.1,11,7.4,"25% - 50% P.O.C.","$70000 - $98000"
"17031804901","Census Tract 8049.01, Cook County, Illinois",6649,109539,5514,168,0,249,52,242,82.9,2.5,0,3.7,0.8,3.6,17.1,2466,2138,328,86.7,13.3,146,1992,21,307,167,2299,6.8,6.4,6.8,"Less than 25% P.O.C.","$98000 or more"
"17031804902","Census Tract 8049.02, Cook County, Illinois",5303,93086,4085,15,0,487,0,620,77,0.3,0,9.2,0,11.7,23,1843,1621,222,87.95,12.05,144,1477,0,222,144,1699,8.9,0,7.8,"Less than 25% P.O.C.","$70000 - $98000"
"17031805001","Census Tract 8050.01, Cook County, Illinois",4918,115094,4502,0,18,73,0,325,91.5,0,0.4,1.5,0,6.6,8.5,1831,1725,106,94.21,5.79,159,1566,0,106,159,1672,9.2,0,8.7,"Less than 25% P.O.C.","$98000 or more"
"17031805002","Census Tract 8050.02, Cook County, Illinois",7042,43704,3479,255,77,1082,0,1792,49.4,3.6,1.1,15.4,0,25.4,50.6,3036,1177,1859,38.77,61.23,73,1104,58,1801,131,2905,6.2,3.1,4.3,"50% - 75% P.O.C.","Less than $49000"
"17031805105","Census Tract 8051.05, Cook County, Illinois",7186,55743,2252,637,0,709,0,3514,31.3,8.9,0,9.9,0,48.9,68.7,2337,1099,1238,47.03,52.97,164,935,250,988,414,1923,14.9,20.2,17.7,"50% - 75% P.O.C.","$49000 - $70000"
"17031805106","Census Tract 8051.06, Cook County, Illinois",2994,72022,2299,51,0,427,0,163,76.8,1.7,0,14.3,0,5.4,23.2,1211,1024,187,84.56,15.44,76,948,32,155,108,1103,7.4,17.1,8.9,"Less than 25% P.O.C.","$70000 - $98000"
"17031805107","Census Tract 8051.07, Cook County, Illinois",6246,52858,2046,615,0,1143,0,2293,32.8,9.8,0,18.3,0,36.7,67.2,2857,617,2240,21.6,78.4,16,601,232,2008,248,2609,2.6,10.4,8.7,"50% - 75% P.O.C.","$49000 - $70000"
"17031805108","Census Tract 8051.08, Cook County, Illinois",6435,60435,2913,738,0,1145,0,1595,45.3,11.5,0,17.8,0,24.8,54.7,2478,845,1633,34.1,65.9,28,817,64,1569,92,2386,3.3,3.9,3.7,"50% - 75% P.O.C.","$49000 - $70000"
"17031805109","Census Tract 8051.09, Cook County, Illinois",4178,90417,3436,114,0,374,16,238,82.2,2.7,0,9,0.4,5.7,17.8,1685,1432,253,84.99,15.01,109,1323,0,253,109,1576,7.6,0,6.5,"Less than 25% P.O.C.","$70000 - $98000"
"17031805110","Census Tract 8051.10, Cook County, Illinois",4462,81346,3975,0,0,278,0,131,89.1,0,0,6.2,0,2.9,10.9,1958,1376,582,70.28,29.72,69,1307,9,573,78,1880,5,1.5,4,"Less than 25% P.O.C.","$70000 - $98000"
"17031805111","Census Tract 8051.11, Cook County, Illinois",7354,61787,3256,119,24,1078,0,2778,44.3,1.6,0.3,14.7,0,37.8,55.7,2700,970,1730,35.93,64.07,193,777,51,1679,244,2456,19.9,2.9,9,"50% - 75% P.O.C.","$49000 - $70000"
"17031805112","Census Tract 8051.12, Cook County, Illinois",3294,59180,1722,23,0,996,0,499,52.3,0.7,0,30.2,0,15.1,47.7,1229,855,374,69.57,30.43,184,671,18,356,202,1027,21.5,4.8,16.4,"25% - 50% P.O.C.","$49000 - $70000"
"17031805201","Census Tract 8052.01, Cook County, Illinois",3963,94891,2676,66,0,768,0,408,67.5,1.7,0,19.4,0,10.3,32.5,1212,1099,113,90.68,9.32,179,920,35,78,214,998,16.3,31,17.7,"25% - 50% P.O.C.","$70000 - $98000"
"17031805202","Census Tract 8052.02, Cook County, Illinois",4376,82351,3148,121,0,789,0,176,71.9,2.8,0,18,0,4,28.1,1643,1207,436,73.46,26.54,229,978,21,415,250,1393,19,4.8,15.2,"25% - 50% P.O.C.","$70000 - $98000"
"17031805301","Census Tract 8053.01, Cook County, Illinois",3161,66250,1667,214,0,1037,0,34,52.7,6.8,0,32.8,0,1.1,47.3,1157,993,164,85.83,14.17,79,914,29,135,108,1049,8,17.7,9.3,"25% - 50% P.O.C.","$49000 - $70000"
"17031805302","Census Tract 8053.02, Cook County, Illinois",3722,86833,1943,9,0,1280,0,244,52.2,0.2,0,34.4,0,6.6,47.8,1346,1201,145,89.23,10.77,117,1084,33,112,150,1196,9.7,22.8,11.1,"25% - 50% P.O.C.","$70000 - $98000"
"17031805401","Census Tract 8054.01, Cook County, Illinois",3877,82900,2645,92,0,482,0,471,68.2,2.4,0,12.4,0,12.1,31.8,1372,1067,305,77.77,22.23,118,949,28,277,146,1226,11.1,9.2,10.6,"25% - 50% P.O.C.","$70000 - $98000"
"17031805402","Census Tract 8054.02, Cook County, Illinois",4973,85980,3958,57,15,574,0,322,79.6,1.1,0.3,11.5,0,6.5,20.4,1814,1628,186,89.75,10.25,87,1541,9,177,96,1718,5.3,4.8,5.3,"Less than 25% P.O.C.","$70000 - $98000"
"17031805501","Census Tract 8055.01, Cook County, Illinois",3712,112813,2906,110,0,182,105,300,78.3,3,0,4.9,2.8,8.1,21.7,1497,1084,413,72.41,27.59,37,1047,22,391,59,1438,3.4,5.3,3.9,"Less than 25% P.O.C.","$98000 or more"
"17031805502","Census Tract 8055.02, Cook County, Illinois",3950,141339,3648,12,0,81,0,108,92.4,0.3,0,2.1,0,2.7,7.6,1545,1279,266,82.78,17.22,102,1177,0,266,102,1443,8,0,6.6,"Less than 25% P.O.C.","$98000 or more"
"17031805600","Census Tract 8056, Cook County, Illinois",4470,143824,4073,39,0,269,0,79,91.1,0.9,0,6,0,1.8,8.9,1478,1423,55,96.28,3.72,150,1273,0,55,150,1328,10.5,0,10.1,"Less than 25% P.O.C.","$98000 or more"
"17031805701","Census Tract 8057.01, Cook County, Illinois",5001,117500,4579,0,0,104,0,282,91.6,0,0,2.1,0,5.6,8.4,1936,1578,358,81.51,18.49,165,1413,9,349,174,1762,10.5,2.5,9,"Less than 25% P.O.C.","$98000 or more"
"17031805702","Census Tract 8057.02, Cook County, Illinois",1939,122813,1793,1,0,43,0,67,92.5,0.1,0,2.2,0,3.5,7.5,692,650,42,93.93,6.07,62,588,5,37,67,625,9.5,11.9,9.7,"Less than 25% P.O.C.","$98000 or more"
"17031805801","Census Tract 8058.01, Cook County, Illinois",2465,95733,2057,3,0,140,0,77,83.4,0.1,0,5.7,0,3.1,16.6,979,919,60,93.87,6.13,48,871,0,60,48,931,5.2,0,4.9,"Less than 25% P.O.C.","$70000 - $98000"
"17031805802","Census Tract 8058.02, Cook County, Illinois",4799,95469,4298,14,0,144,0,238,89.6,0.3,0,3,0,5,10.4,1861,1534,327,82.43,17.57,152,1382,0,327,152,1709,9.9,0,8.2,"Less than 25% P.O.C.","$70000 - $98000"
"17031805901","Census Tract 8059.01, Cook County, Illinois",4060,81250,2908,49,0,565,0,474,71.6,1.2,0,13.9,0,11.7,28.4,1794,1353,441,75.42,24.58,44,1309,11,430,55,1739,3.3,2.5,3.1,"25% - 50% P.O.C.","$70000 - $98000"
"17031805902","Census Tract 8059.02, Cook County, Illinois",6139,113036,4703,68,0,894,0,342,76.6,1.1,0,14.6,0,5.6,23.4,2086,1654,432,79.29,20.71,213,1441,43,389,256,1830,12.9,10,12.3,"Less than 25% P.O.C.","$98000 or more"
"17031806001","Census Tract 8060.01, Cook County, Illinois",5501,51684,2019,364,0,2012,0,898,36.7,6.6,0,36.6,0,16.3,63.3,2356,895,1461,37.99,62.01,20,875,130,1331,150,2206,2.2,8.9,6.4,"50% - 75% P.O.C.","$49000 - $70000"
"17031806002","Census Tract 8060.02, Cook County, Illinois",7347,58362,3228,474,184,2221,0,1216,43.9,6.5,2.5,30.2,0,16.6,56.1,2528,1511,1017,59.77,40.23,132,1379,14,1003,146,2382,8.7,1.4,5.8,"50% - 75% P.O.C.","$49000 - $70000"
"17031806003","Census Tract 8060.03, Cook County, Illinois",8183,68018,2610,100,0,3835,0,1534,31.9,1.2,0,46.9,0,18.7,68.1,2811,1697,1114,60.37,39.63,322,1375,78,1036,400,2411,19,7,14.2,"50% - 75% P.O.C.","$49000 - $70000"
"17031806004","Census Tract 8060.04, Cook County, Illinois",7182,47763,3432,295,0,2025,0,1346,47.8,4.1,0,28.2,0,18.7,52.2,2688,1590,1098,59.15,40.85,120,1470,0,1098,120,2568,7.5,0,4.5,"50% - 75% P.O.C.","Less than $49000"
"17031806102","Census Tract 8061.02, Cook County, Illinois",3739,90365,2524,68,0,399,0,727,67.5,1.8,0,10.7,0,19.4,32.5,1404,1213,191,86.4,13.6,120,1093,0,191,120,1284,9.9,0,8.5,"25% - 50% P.O.C.","$70000 - $98000"
"17031806103","Census Tract 8061.03, Cook County, Illinois",4849,90833,3296,34,12,658,10,647,68,0.7,0.2,13.6,0.2,13.3,32,1848,1630,218,88.2,11.8,126,1504,38,180,164,1684,7.7,17.4,8.9,"25% - 50% P.O.C.","$70000 - $98000"
"17031806104","Census Tract 8061.04, Cook County, Illinois",4202,47753,1736,608,50,1114,0,562,41.3,14.5,1.2,26.5,0,13.4,58.7,1714,551,1163,32.15,67.85,25,526,61,1102,86,1628,4.5,5.2,5,"50% - 75% P.O.C.","Less than $49000"
"17031806201","Census Tract 8062.01, Cook County, Illinois",4845,49054,2875,105,0,732,0,1109,59.3,2.2,0,15.1,0,22.9,40.7,2341,1546,795,66.04,33.96,5,1541,100,695,105,2236,0.3,12.6,4.5,"25% - 50% P.O.C.","$49000 - $70000"
"17031806202","Census Tract 8062.02, Cook County, Illinois",4838,54139,3708,229,0,356,0,381,76.6,4.7,0,7.4,0,7.9,23.4,2544,1603,941,63.01,36.99,54,1549,31,910,85,2459,3.4,3.3,3.3,"Less than 25% P.O.C.","$49000 - $70000"
"17031806300","Census Tract 8063, Cook County, Illinois",4644,94028,3362,55,0,123,21,885,72.4,1.2,0,2.6,0.5,19.1,27.6,1748,1476,272,84.44,15.56,127,1349,19,253,146,1602,8.6,7,8.4,"25% - 50% P.O.C.","$70000 - $98000"
"17031806400","Census Tract 8064, Cook County, Illinois",2507,93750,1913,0,0,93,0,466,76.3,0,0,3.7,0,18.6,23.7,886,697,189,78.67,21.33,97,600,19,170,116,770,13.9,10.1,13.1,"Less than 25% P.O.C.","$70000 - $98000"
"17031806501","Census Tract 8065.01, Cook County, Illinois",2349,51156,978,187,17,388,0,759,41.6,8,0.7,16.5,0,32.3,58.4,725,482,243,66.48,33.52,90,392,26,217,116,609,18.7,10.7,16,"50% - 75% P.O.C.","$49000 - $70000"
"17031806502","Census Tract 8065.02, Cook County, Illinois",4529,74063,2574,95,0,239,0,1437,56.8,2.1,0,5.3,0,31.7,43.2,1506,1384,122,91.9,8.1,255,1129,0,122,255,1251,18.4,0,16.9,"25% - 50% P.O.C.","$70000 - $98000"
"17031806600","Census Tract 8066, Cook County, Illinois",3541,79338,2122,14,0,430,0,885,59.9,0.4,0,12.1,0,25,40.1,1265,1151,114,90.99,9.01,186,965,14,100,200,1065,16.2,12.3,15.8,"25% - 50% P.O.C.","$70000 - $98000"
"17031806700","Census Tract 8067, Cook County, Illinois",3921,122743,2726,229,29,627,0,256,69.5,5.8,0.7,16,0,6.5,30.5,1441,1424,17,98.82,1.18,154,1270,0,17,154,1287,10.8,0,10.7,"25% - 50% P.O.C.","$98000 or more"
"17031806801","Census Tract 8068.01, Cook County, Illinois",4129,71250,2153,268,0,1241,0,258,52.1,6.5,0,30.1,0,6.2,47.9,1412,985,427,69.76,30.24,112,873,25,402,137,1275,11.4,5.9,9.7,"25% - 50% P.O.C.","$70000 - $98000"
"17031806802","Census Tract 8068.02, Cook County, Illinois",3030,68294,1413,490,12,767,0,308,46.6,16.2,0.4,25.3,0,10.2,53.4,1080,651,429,60.28,39.72,61,590,107,322,168,912,9.4,24.9,15.6,"50% - 75% P.O.C.","$49000 - $70000"
"17031806900","Census Tract 8069, Cook County, Illinois",5056,71915,2213,343,0,1607,0,541,43.8,6.8,0,31.8,0,10.7,56.2,2104,1488,616,70.72,29.28,131,1357,89,527,220,1884,8.8,14.4,10.5,"50% - 75% P.O.C.","$70000 - $98000"
"17031807000","Census Tract 8070, Cook County, Illinois",5851,64604,2263,523,0,1932,0,844,38.7,8.9,0,33,0,14.4,61.3,1947,837,1110,42.99,57.01,155,682,102,1008,257,1690,18.5,9.2,13.2,"50% - 75% P.O.C.","$49000 - $70000"
"17031807100","Census Tract 8071, Cook County, Illinois",3522,117177,2205,471,0,346,24,384,62.6,13.4,0,9.8,0.7,10.9,37.4,1160,948,212,81.72,18.28,165,783,60,152,225,935,17.4,28.3,19.4,"25% - 50% P.O.C.","$98000 or more"
"17031807200","Census Tract 8072, Cook County, Illinois",5313,85526,2471,812,0,1349,0,532,46.5,15.3,0,25.4,0,10,53.5,1848,1621,227,87.72,12.28,180,1441,12,215,192,1656,11.1,5.3,10.4,"50% - 75% P.O.C.","$70000 - $98000"
"17031807300","Census Tract 8073, Cook County, Illinois",7811,65441,3001,578,0,2446,0,997,38.4,7.4,0,31.3,0,12.8,61.6,2828,1620,1208,57.28,42.72,163,1457,236,972,399,2429,10.1,19.5,14.1,"50% - 75% P.O.C.","$49000 - $70000"
"17031807400","Census Tract 8074, Cook County, Illinois",6962,63136,3336,591,0,1651,63,1039,47.9,8.5,0,23.7,0.9,14.9,52.1,2205,1214,991,55.06,44.94,130,1084,126,865,256,1949,10.7,12.7,11.6,"50% - 75% P.O.C.","$49000 - $70000"
"17031807500","Census Tract 8075, Cook County, Illinois",3358,116000,1692,73,0,1117,0,374,50.4,2.2,0,33.3,0,11.1,49.6,1078,964,114,89.42,10.58,115,849,20,94,135,943,11.9,17.5,12.5,"25% - 50% P.O.C.","$98000 or more"
"17031807600","Census Tract 8076, Cook County, Illinois",6228,64625,2518,396,0,2342,0,668,40.4,6.4,0,37.6,0,10.7,59.6,2016,1705,311,84.57,15.43,285,1420,25,286,310,1706,16.7,8,15.4,"50% - 75% P.O.C.","$49000 - $70000"
"17031807700","Census Tract 8077, Cook County, Illinois",5228,48338,3096,88,0,1199,0,774,59.2,1.7,0,22.9,0,14.8,40.8,2119,1307,812,61.68,38.32,131,1176,18,794,149,1970,10,2.2,7,"25% - 50% P.O.C.","Less than $49000"
"17031807800","Census Tract 8078, Cook County, Illinois",2589,106473,1605,9,0,641,1,275,62,0.3,0,24.8,0,10.6,38,811,774,37,95.44,4.56,124,650,12,25,136,675,16,32.4,16.8,"25% - 50% P.O.C.","$98000 or more"
"17031807900","Census Tract 8079, Cook County, Illinois",4093,100833,2553,61,14,1140,0,325,62.4,1.5,0.3,27.9,0,7.9,37.6,1406,1359,47,96.66,3.34,177,1182,24,23,201,1205,13,51.1,14.3,"25% - 50% P.O.C.","$98000 or more"
"17031808001","Census Tract 8080.01, Cook County, Illinois",3693,101384,1861,6,0,1305,0,325,50.4,0.2,0,35.3,0,8.8,49.6,1244,1074,170,86.33,13.67,100,974,58,112,158,1086,9.3,34.1,12.7,"25% - 50% P.O.C.","$98000 or more"
"17031808002","Census Tract 8080.02, Cook County, Illinois",4648,79741,2466,173,0,1034,0,535,53.1,3.7,0,22.2,0,11.5,46.9,1648,1147,501,69.6,30.4,186,961,52,449,238,1410,16.2,10.4,14.4,"25% - 50% P.O.C.","$70000 - $98000"
"17031808100","Census Tract 8081, Cook County, Illinois",3686,50047,2931,217,17,375,0,118,79.5,5.9,0.5,10.2,0,3.2,20.5,1536,1101,435,71.68,28.32,25,1076,17,418,42,1494,2.3,3.9,2.7,"Less than 25% P.O.C.","$49000 - $70000"
"17031808200","Census Tract 8082, Cook County, Illinois",5367,74129,3306,2,0,1466,0,520,61.6,0,0,27.3,0,9.7,38.4,1789,1513,276,84.57,15.43,281,1232,29,247,310,1479,18.6,10.5,17.3,"25% - 50% P.O.C.","$70000 - $98000"
"17031808301","Census Tract 8083.01, Cook County, Illinois",5805,71500,3561,248,0,1506,0,395,61.3,4.3,0,25.9,0,6.8,38.7,2342,1883,459,80.4,19.6,150,1733,42,417,192,2150,8,9.2,8.2,"25% - 50% P.O.C.","$70000 - $98000"
"17031808302","Census Tract 8083.02, Cook County, Illinois",3937,88750,2153,61,0,1344,0,323,54.7,1.5,0,34.1,0,8.2,45.3,1510,1328,182,87.95,12.05,108,1220,16,166,124,1386,8.1,8.8,8.2,"25% - 50% P.O.C.","$70000 - $98000"
"17031808400","Census Tract 8084, Cook County, Illinois",4289,94402,2517,134,0,1134,0,266,58.7,3.1,0,26.4,0,6.2,41.3,1393,1279,114,91.82,8.18,206,1073,16,98,222,1171,16.1,14,15.9,"25% - 50% P.O.C.","$70000 - $98000"
"17031808500","Census Tract 8085, Cook County, Illinois",4017,95071,2407,56,0,1109,0,379,59.9,1.4,0,27.6,0,9.4,40.1,1334,1291,43,96.78,3.22,154,1137,9,34,163,1171,11.9,20.9,12.2,"25% - 50% P.O.C.","$70000 - $98000"
"17031808600","Census Tract 8086, Cook County, Illinois",2080,168750,1867,8,4,97,0,72,89.8,0.4,0.2,4.7,0,3.5,10.2,700,578,122,82.57,17.43,93,485,6,116,99,601,16.1,4.9,14.1,"Less than 25% P.O.C.","$98000 or more"
"17031808702","Census Tract 8087.02, Cook County, Illinois",5225,70179,3012,384,0,1096,0,540,57.6,7.3,0,21,0,10.3,42.4,363,302,61,83.2,16.8,11,291,6,55,17,346,3.6,9.8,4.7,"25% - 50% P.O.C.","$70000 - $98000"
"17031808800","Census Tract 8088, Cook County, Illinois",3866,144853,3142,109,0,331,0,134,81.3,2.8,0,8.6,0,3.5,18.7,1374,1088,286,79.18,20.82,108,980,7,279,115,1259,9.9,2.4,8.4,"Less than 25% P.O.C.","$98000 or more"
"17031808900","Census Tract 8089, Cook County, Illinois",4200,150175,3813,12,0,145,0,136,90.8,0.3,0,3.5,0,3.2,9.2,1583,1383,200,87.37,12.63,116,1267,20,180,136,1447,8.4,10,8.6,"Less than 25% P.O.C.","$98000 or more"
"17031809000","Census Tract 8090, Cook County, Illinois",3976,149583,3405,241,0,146,0,48,85.6,6.1,0,3.7,0,1.2,14.4,1447,1183,264,81.76,18.24,89,1094,0,264,89,1358,7.5,0,6.2,"Less than 25% P.O.C.","$98000 or more"
"17031809100","Census Tract 8091, Cook County, Illinois",3193,106103,2638,206,0,151,0,122,82.6,6.5,0,4.7,0,3.8,17.4,1383,972,411,70.28,29.72,84,888,8,403,92,1291,8.6,1.9,6.7,"Less than 25% P.O.C.","$98000 or more"
"17031809200","Census Tract 8092, Cook County, Illinois",4401,44458,487,2379,0,121,0,1069,11.1,54.1,0,2.7,0,24.3,88.9,1449,644,805,44.44,55.56,116,528,86,719,202,1247,18,10.7,13.9,"75% or more P.O.C.","Less than $49000"
"17031809300","Census Tract 8093, Cook County, Illinois",4521,30774,2827,342,0,861,0,281,62.5,7.6,0,19,0,6.2,37.5,1769,617,1152,34.88,65.12,55,562,43,1109,98,1671,8.9,3.7,5.5,"25% - 50% P.O.C.","Less than $49000"
"17031809400","Census Tract 8094, Cook County, Illinois",5273,60031,3272,152,0,1273,0,507,62.1,2.9,0,24.1,0,9.6,37.9,2652,1034,1618,38.99,61.01,69,965,14,1604,83,2569,6.7,0.9,3.1,"25% - 50% P.O.C.","$49000 - $70000"
"17031809500","Census Tract 8095, Cook County, Illinois",4119,73516,2518,408,0,719,0,388,61.1,9.9,0,17.5,0,9.4,38.9,2000,801,1199,40.05,59.95,56,745,0,1199,56,1944,7,0,2.8,"25% - 50% P.O.C.","$70000 - $98000"
"17031809600","Census Tract 8096, Cook County, Illinois",3110,74233,1137,1006,0,91,0,763,36.6,32.3,0,2.9,0,24.5,63.4,1025,827,198,80.68,19.32,128,699,12,186,140,885,15.5,6.1,13.7,"50% - 75% P.O.C.","$70000 - $98000"
"17031809700","Census Tract 8097, Cook County, Illinois",3792,99464,1557,1027,9,75,0,814,41.1,27.1,0.2,2,0,21.5,58.9,1185,856,329,72.24,27.76,133,723,37,292,170,1015,15.5,11.2,14.3,"50% - 75% P.O.C.","$98000 or more"
"17031809800","Census Tract 8098, Cook County, Illinois",2660,95156,2016,192,0,140,0,178,75.8,7.2,0,5.3,0,6.7,24.2,1022,534,488,52.25,47.75,50,484,7,481,57,965,9.4,1.4,5.6,"Less than 25% P.O.C.","$70000 - $98000"
"17031809900","Census Tract 8099, Cook County, Illinois",2846,130208,2042,93,0,262,0,309,71.7,3.3,0,9.2,0,10.9,28.3,1293,755,538,58.39,41.61,40,715,24,514,64,1229,5.3,4.5,4.9,"25% - 50% P.O.C.","$98000 or more"
"17031810000","Census Tract 8100, Cook County, Illinois",5112,92590,4044,161,0,285,0,392,79.1,3.1,0,5.6,0,7.7,20.9,2694,1270,1424,47.14,52.86,18,1252,17,1407,35,2659,1.4,1.2,1.3,"Less than 25% P.O.C.","$70000 - $98000"
"17031810100","Census Tract 8101, Cook County, Illinois",4349,73438,2709,705,0,319,0,336,62.3,16.2,0,7.3,0,7.7,37.7,1936,818,1118,42.25,57.75,0,818,63,1055,63,1873,0,5.6,3.3,"25% - 50% P.O.C.","$70000 - $98000"
"17031810200","Census Tract 8102, Cook County, Illinois",6428,62416,2307,2091,0,675,0,1201,35.9,32.5,0,10.5,0,18.7,64.1,2606,940,1666,36.07,63.93,51,889,151,1515,202,2404,5.4,9.1,7.8,"50% - 75% P.O.C.","$49000 - $70000"
"17031810301","Census Tract 8103.01, Cook County, Illinois",4429,79850,1506,1511,0,177,0,1159,34,34.1,0,4,0,26.2,66,1459,1030,429,70.6,29.4,187,843,35,394,222,1237,18.2,8.2,15.2,"50% - 75% P.O.C.","$70000 - $98000"
"17031810302","Census Tract 8103.02, Cook County, Illinois",3087,83750,1734,823,0,115,0,339,56.2,26.7,0,3.7,0,11,43.8,1112,742,370,66.73,33.27,68,674,36,334,104,1008,9.2,9.7,9.4,"25% - 50% P.O.C.","$70000 - $98000"
"17031810400","Census Tract 8104, Cook County, Illinois",5481,111310,5052,50,0,137,0,118,92.2,0.9,0,2.5,0,2.2,7.8,2073,1838,235,88.66,11.34,185,1653,0,235,185,1888,10.1,0,8.9,"Less than 25% P.O.C.","$98000 or more"
"17031810501","Census Tract 8105.01, Cook County, Illinois",5268,81152,4622,16,0,158,0,426,87.7,0.3,0,3,0,8.1,12.3,1945,1652,293,84.94,15.06,189,1463,19,274,208,1737,11.4,6.5,10.7,"Less than 25% P.O.C.","$70000 - $98000"
"17031810502","Census Tract 8105.02, Cook County, Illinois",5490,58669,4379,68,6,503,0,513,79.8,1.2,0.1,9.2,0,9.3,20.2,1947,1469,478,75.45,24.55,138,1331,0,478,138,1809,9.4,0,7.1,"Less than 25% P.O.C.","$49000 - $70000"
"17031810600","Census Tract 8106, Cook County, Illinois",4386,55038,3073,53,0,416,0,844,70.1,1.2,0,9.5,0,19.2,29.9,1755,945,810,53.85,46.15,92,853,24,786,116,1639,9.7,3,6.6,"25% - 50% P.O.C.","$49000 - $70000"
"17031810701","Census Tract 8107.01, Cook County, Illinois",4981,54201,2588,3,0,248,0,2122,52,0.1,0,5,0,42.6,48,1813,918,895,50.63,49.37,139,779,89,806,228,1585,15.1,9.9,12.6,"25% - 50% P.O.C.","$49000 - $70000"
"17031810702","Census Tract 8107.02, Cook County, Illinois",3801,56964,1962,107,12,130,0,1543,51.6,2.8,0.3,3.4,0,40.6,48.4,1399,640,759,45.75,54.25,82,558,96,663,178,1221,12.8,12.6,12.7,"25% - 50% P.O.C.","$49000 - $70000"
"17031810800","Census Tract 8108, Cook County, Illinois",5242,76294,3538,79,0,156,0,1294,67.5,1.5,0,3,0,24.7,32.5,1661,1371,290,82.54,17.46,201,1170,46,244,247,1414,14.7,15.9,14.9,"25% - 50% P.O.C.","$70000 - $98000"
"17031810900","Census Tract 8109, Cook County, Illinois",6375,52171,3593,363,0,298,0,2121,56.4,5.7,0,4.7,0,33.3,43.6,2510,1547,963,61.63,38.37,148,1399,16,947,164,2346,9.6,1.7,6.5,"25% - 50% P.O.C.","$49000 - $70000"
"17031811000","Census Tract 8110, Cook County, Illinois",4069,82750,3102,55,0,237,0,579,76.2,1.4,0,5.8,0,14.2,23.8,1634,1461,173,89.41,10.59,120,1341,0,173,120,1514,8.2,0,7.3,"Less than 25% P.O.C.","$70000 - $98000"
"17031811100","Census Tract 8111, Cook County, Illinois",6152,51763,4138,3,0,21,0,1897,67.3,0,0,0.3,0,30.8,32.7,2367,1234,1133,52.13,47.87,97,1137,93,1040,190,2177,7.9,8.2,8,"25% - 50% P.O.C.","$49000 - $70000"
"17031811200","Census Tract 8112, Cook County, Illinois",4957,69021,3203,128,0,118,0,1438,64.6,2.6,0,2.4,0,29,35.4,1711,1464,247,85.56,14.44,172,1292,54,193,226,1485,11.7,21.9,13.2,"25% - 50% P.O.C.","$49000 - $70000"
"17031811301","Census Tract 8113.01, Cook County, Illinois",4510,68125,1170,106,0,73,0,3101,25.9,2.4,0,1.6,0,68.8,74.1,1461,1123,338,76.87,23.13,278,845,22,316,300,1161,24.8,6.5,20.5,"50% - 75% P.O.C.","$49000 - $70000"
"17031811302","Census Tract 8113.02, Cook County, Illinois",4154,40556,577,172,0,0,0,3367,13.9,4.1,0,0,0,81.1,86.1,1200,444,756,37,63,159,285,201,555,360,840,35.8,26.6,30,"75% or more P.O.C.","Less than $49000"
"17031811401","Census Tract 8114.01, Cook County, Illinois",4490,69097,2290,29,0,329,0,1779,51,0.6,0,7.3,0,39.6,49,1603,1193,410,74.42,25.58,126,1067,10,400,136,1467,10.6,2.4,8.5,"25% - 50% P.O.C.","$49000 - $70000"
"17031811402","Census Tract 8114.02, Cook County, Illinois",4158,59196,1787,13,14,122,0,2177,43,0.3,0.3,2.9,0,52.4,57,1442,1081,361,74.97,25.03,131,950,37,324,168,1274,12.1,10.2,11.7,"50% - 75% P.O.C.","$49000 - $70000"
"17031811500","Census Tract 8115, Cook County, Illinois",6441,76618,3365,0,0,88,0,2892,52.2,0,0,1.4,0,44.9,47.8,1996,1683,313,84.32,15.68,405,1278,58,255,463,1533,24.1,18.5,23.2,"25% - 50% P.O.C.","$70000 - $98000"
"17031811600","Census Tract 8116, Cook County, Illinois",6373,49455,3691,75,0,406,0,2090,57.9,1.2,0,6.4,0,32.8,42.1,2361,1273,1088,53.92,46.08,87,1186,139,949,226,2135,6.8,12.8,9.6,"25% - 50% P.O.C.","$49000 - $70000"
"17031811701","Census Tract 8117.01, Cook County, Illinois",3870,54272,857,64,0,73,0,2876,22.1,1.7,0,1.9,0,74.3,77.9,1195,477,718,39.92,60.08,60,417,173,545,233,962,12.6,24.1,19.5,"75% or more P.O.C.","$49000 - $70000"
"17031811702","Census Tract 8117.02, Cook County, Illinois",5274,50852,1701,154,13,178,0,3228,32.3,2.9,0.2,3.4,0,61.2,67.7,1728,1154,574,66.78,33.22,132,1022,0,574,132,1596,11.4,0,7.6,"50% - 75% P.O.C.","$49000 - $70000"
"17031811800","Census Tract 8118, Cook County, Illinois",5130,75625,2016,73,0,48,0,2985,39.3,1.4,0,0.9,0,58.2,60.7,1575,1277,298,81.08,18.92,360,917,54,244,414,1161,28.2,18.1,26.3,"50% - 75% P.O.C.","$70000 - $98000"
"17031811900","Census Tract 8119, Cook County, Illinois",5841,135750,4587,440,0,295,0,377,78.5,7.5,0,5.1,0,6.5,21.5,1852,1656,196,89.42,10.58,92,1564,0,196,92,1760,5.6,0,5,"Less than 25% P.O.C.","$98000 or more"
"17031812000","Census Tract 8120, Cook County, Illinois",5129,121503,4433,167,0,97,0,250,86.4,3.3,0,1.9,0,4.9,13.6,2119,1869,250,88.2,11.8,144,1725,0,250,144,1975,7.7,0,6.8,"Less than 25% P.O.C.","$98000 or more"
"17031812100","Census Tract 8121, Cook County, Illinois",4721,124667,2723,1336,0,182,0,219,57.7,28.3,0,3.9,0,4.6,42.3,1566,1214,352,77.52,22.48,116,1098,0,352,116,1450,9.6,0,7.4,"25% - 50% P.O.C.","$98000 or more"
"17031812200","Census Tract 8122, Cook County, Illinois",3790,216375,2811,449,0,105,0,221,74.2,11.8,0,2.8,0,5.8,25.8,1243,1137,106,91.47,8.53,110,1027,0,106,110,1133,9.7,0,8.8,"25% - 50% P.O.C.","$98000 or more"
"17031812301","Census Tract 8123.01, Cook County, Illinois",4153,86363,2663,599,36,359,0,342,64.1,14.4,0.9,8.6,0,8.2,35.9,2361,789,1572,33.42,66.58,3,786,0,1572,3,2358,0.4,0,0.1,"25% - 50% P.O.C.","$70000 - $98000"
"17031812302","Census Tract 8123.02, Cook County, Illinois",2790,141111,1775,405,6,105,0,360,63.6,14.5,0.2,3.8,0,12.9,36.4,932,752,180,80.69,19.31,61,691,16,164,77,855,8.1,8.9,8.3,"25% - 50% P.O.C.","$98000 or more"
"17031812400","Census Tract 8124, Cook County, Illinois",3188,206184,2578,169,0,199,14,106,80.9,5.3,0,6.2,0.4,3.3,19.1,1070,982,88,91.78,8.22,144,838,4,84,148,922,14.7,4.5,13.8,"Less than 25% P.O.C.","$98000 or more"
"17031812500","Census Tract 8125, Cook County, Illinois",3173,65438,1941,740,0,139,0,218,61.2,23.3,0,4.4,0,6.9,38.8,1527,652,875,42.7,57.3,57,595,26,849,83,1444,8.7,3,5.4,"25% - 50% P.O.C.","$49000 - $70000"
"17031812600","Census Tract 8126, Cook County, Illinois",3291,59808,1775,929,0,185,0,282,53.9,28.2,0,5.6,0,8.6,46.1,1752,679,1073,38.76,61.24,11,668,13,1060,24,1728,1.6,1.2,1.4,"25% - 50% P.O.C.","$49000 - $70000"
"17031812700","Census Tract 8127, Cook County, Illinois",3285,65313,1826,713,0,123,0,342,55.6,21.7,0,3.7,0,10.4,44.4,1552,738,814,47.55,52.45,38,700,31,783,69,1483,5.1,3.8,4.4,"25% - 50% P.O.C.","$49000 - $70000"
"17031812801","Census Tract 8128.01, Cook County, Illinois",3367,68466,1915,835,0,194,0,164,56.9,24.8,0,5.8,0,4.9,43.1,1801,780,1021,43.31,56.69,25,755,10,1011,35,1766,3.2,1,1.9,"25% - 50% P.O.C.","$49000 - $70000"
"17031812802","Census Tract 8128.02, Cook County, Illinois",2538,60238,1523,521,0,160,0,171,60,20.5,0,6.3,0,6.7,40,1308,545,763,41.67,58.33,28,517,0,763,28,1280,5.1,0,2.1,"25% - 50% P.O.C.","$49000 - $70000"
"17031812900","Census Tract 8129, Cook County, Illinois",4670,128182,3551,503,0,128,0,353,76,10.8,0,2.7,0,7.6,24,1726,1422,304,82.39,17.61,128,1294,8,296,136,1590,9,2.6,7.9,"Less than 25% P.O.C.","$98000 or more"
"17031813000","Census Tract 8130, Cook County, Illinois",4051,114333,2562,811,0,78,0,547,63.2,20,0,1.9,0,13.5,36.8,1430,961,469,67.2,32.8,131,830,10,459,141,1289,13.6,2.1,9.9,"25% - 50% P.O.C.","$98000 or more"
"17031813100","Census Tract 8131, Cook County, Illinois",4954,99808,2549,967,0,312,0,859,51.5,19.5,0,6.3,0,17.3,48.5,1792,1101,691,61.44,38.56,81,1020,0,691,81,1711,7.4,0,4.5,"25% - 50% P.O.C.","$98000 or more"
"17031813200","Census Tract 8132, Cook County, Illinois",4262,135121,2835,357,0,163,0,478,66.5,8.4,0,3.8,0,11.2,33.5,1543,1100,443,71.29,28.71,101,999,28,415,129,1414,9.2,6.3,8.4,"25% - 50% P.O.C.","$98000 or more"
"17031813301","Census Tract 8133.01, Cook County, Illinois",3229,41589,80,128,0,0,0,3021,2.5,4,0,0,0,93.6,97.5,851,237,614,27.85,72.15,81,156,142,472,223,628,34.2,23.1,26.2,"75% or more P.O.C.","Less than $49000"
"17031813302","Census Tract 8133.02, Cook County, Illinois",3057,41250,140,118,0,0,0,2795,4.6,3.9,0,0,0,91.4,95.4,887,359,528,40.47,59.53,119,240,94,434,213,674,33.1,17.8,24,"75% or more P.O.C.","Less than $49000"
"17031813400","Census Tract 8134, Cook County, Illinois",7660,50426,465,130,0,0,0,7008,6.1,1.7,0,0,0,91.5,93.9,1821,1014,807,55.68,44.32,366,648,271,536,637,1184,36.1,33.6,35,"75% or more P.O.C.","$49000 - $70000"
"17031813500","Census Tract 8135, Cook County, Illinois",6434,59228,282,322,0,132,0,5646,4.4,5,0,2.1,0,87.8,95.6,1822,875,947,48.02,51.98,304,571,157,790,461,1361,34.7,16.6,25.3,"75% or more P.O.C.","$49000 - $70000"
"17031813600","Census Tract 8136, Cook County, Illinois",5422,55117,125,91,0,41,0,5165,2.3,1.7,0,0.8,0,95.3,97.7,1465,782,683,53.38,46.62,292,490,135,548,427,1038,37.3,19.8,29.1,"75% or more P.O.C.","$49000 - $70000"
"17031813701","Census Tract 8137.01, Cook County, Illinois",3710,48731,129,141,0,0,0,3440,3.5,3.8,0,0,0,92.7,96.5,991,361,630,36.43,63.57,146,215,178,452,324,667,40.4,28.3,32.7,"75% or more P.O.C.","Less than $49000"
"17031813702","Census Tract 8137.02, Cook County, Illinois",3900,50487,82,270,0,10,0,3528,2.1,6.9,0,0.3,0,90.5,97.9,1085,481,604,44.33,55.67,180,301,105,499,285,800,37.4,17.4,26.3,"75% or more P.O.C.","$49000 - $70000"
"17031813801","Census Tract 8138.01, Cook County, Illinois",2717,47244,35,13,0,0,0,2669,1.3,0.5,0,0,0,98.2,98.7,743,358,385,48.18,51.82,84,274,81,304,165,578,23.5,21,22.2,"75% or more P.O.C.","Less than $49000"
"17031813802","Census Tract 8138.02, Cook County, Illinois",4973,41723,282,198,21,106,0,4366,5.7,4,0.4,2.1,0,87.8,94.3,1359,495,864,36.42,63.58,108,387,150,714,258,1101,21.8,17.4,19,"75% or more P.O.C.","Less than $49000"
"17031813900","Census Tract 8139, Cook County, Illinois",6493,43159,579,261,8,70,0,5575,8.9,4,0.1,1.1,0,85.9,91.1,1596,771,825,48.31,51.69,283,488,265,560,548,1048,36.7,32.1,34.3,"75% or more P.O.C.","Less than $49000"
"17031814000","Census Tract 8140, Cook County, Illinois",4573,50481,341,125,0,8,0,4098,7.5,2.7,0,0.2,0,89.6,92.5,1318,782,536,59.33,40.67,232,550,65,471,297,1021,29.7,12.1,22.5,"75% or more P.O.C.","$49000 - $70000"
"17031814100","Census Tract 8141, Cook County, Illinois",4257,41972,114,248,0,11,0,3820,2.7,5.8,0,0.3,0,89.7,97.3,1241,493,748,39.73,60.27,65,428,210,538,275,966,13.2,28.1,22.2,"75% or more P.O.C.","Less than $49000"
"17031814200","Census Tract 8142, Cook County, Illinois",7032,47622,488,216,29,8,0,6269,6.9,3.1,0.4,0.1,0,89.1,93.1,1968,874,1094,44.41,55.59,313,561,152,942,465,1503,35.8,13.9,23.6,"75% or more P.O.C.","Less than $49000"
"17031814300","Census Tract 8143, Cook County, Illinois",5065,45625,253,57,0,17,0,4738,5,1.1,0,0.3,0,93.5,95,1334,755,579,56.6,43.4,285,470,168,411,453,881,37.7,29,34,"75% or more P.O.C.","Less than $49000"
"17031814400","Census Tract 8144, Cook County, Illinois",8066,46696,1154,40,0,101,0,6758,14.3,0.5,0,1.3,0,83.8,85.7,2391,1407,984,58.85,41.15,418,989,171,813,589,1802,29.7,17.4,24.6,"75% or more P.O.C.","Less than $49000"
"17031814500","Census Tract 8145, Cook County, Illinois",5742,64842,626,109,15,30,0,4950,10.9,1.9,0.3,0.5,0,86.2,89.1,1474,1056,418,71.64,28.36,288,768,53,365,341,1133,27.3,12.7,23.1,"75% or more P.O.C.","$49000 - $70000"
"17031814600","Census Tract 8146, Cook County, Illinois",5722,64464,1489,407,0,74,0,3684,26,7.1,0,1.3,0,64.4,74,1690,1141,549,67.51,32.49,165,976,113,436,278,1412,14.5,20.6,16.4,"50% - 75% P.O.C.","$49000 - $70000"
"17031814700","Census Tract 8147, Cook County, Illinois",5320,76735,1320,91,0,278,0,3547,24.8,1.7,0,5.2,0,66.7,75.2,1558,1183,375,75.93,24.07,273,910,24,351,297,1261,23.1,6.4,19.1,"75% or more P.O.C.","$70000 - $98000"
"17031814800","Census Tract 8148, Cook County, Illinois",5921,58475,1492,856,0,518,0,3032,25.2,14.5,0,8.7,0,51.2,74.8,2008,1164,844,57.97,42.03,271,893,20,824,291,1717,23.3,2.4,14.5,"50% - 75% P.O.C.","$49000 - $70000"
"17031814900","Census Tract 8149, Cook County, Illinois",6502,55156,1596,1041,0,39,0,3808,24.5,16,0,0.6,0,58.6,75.5,2199,757,1442,34.42,65.58,222,535,123,1319,345,1854,29.3,8.5,15.7,"75% or more P.O.C.","$49000 - $70000"
"17031815000","Census Tract 8150, Cook County, Illinois",3806,60395,749,421,42,94,0,2462,19.7,11.1,1.1,2.5,0,64.7,80.3,1216,511,705,42.02,57.98,132,379,112,593,244,972,25.8,15.9,20.1,"75% or more P.O.C.","$49000 - $70000"
"17031815100","Census Tract 8151, Cook County, Illinois",4507,74676,690,166,0,124,0,3516,15.3,3.7,0,2.8,0,78,84.7,1313,849,464,64.66,35.34,251,598,42,422,293,1020,29.6,9.1,22.3,"75% or more P.O.C.","$70000 - $98000"
"17031815200","Census Tract 8152, Cook County, Illinois",6718,52819,1375,221,0,99,0,4941,20.5,3.3,0,1.5,0,73.5,79.5,2216,1284,932,57.94,42.06,344,940,124,808,468,1748,26.8,13.3,21.1,"75% or more P.O.C.","$49000 - $70000"
"17031815300","Census Tract 8153, Cook County, Illinois",3335,73750,1223,42,0,121,0,1927,36.7,1.3,0,3.6,0,57.8,63.3,1217,920,297,75.6,24.4,117,803,12,285,129,1088,12.7,4,10.6,"50% - 75% P.O.C.","$70000 - $98000"
"17031815400","Census Tract 8154, Cook County, Illinois",5124,47025,2091,193,0,96,0,2646,40.8,3.8,0,1.9,0,51.6,59.2,2019,798,1221,39.52,60.48,151,647,73,1148,224,1795,18.9,6,11.1,"50% - 75% P.O.C.","Less than $49000"
"17031815500","Census Tract 8155, Cook County, Illinois",8452,70917,1943,103,0,50,0,6261,23,1.2,0,0.6,0,74.1,77,2433,1762,671,72.42,27.58,440,1322,184,487,624,1809,25,27.4,25.6,"75% or more P.O.C.","$70000 - $98000"
"17031815600","Census Tract 8156, Cook County, Illinois",4979,63974,3113,143,0,43,0,1604,62.5,2.9,0,0.9,0,32.2,37.5,1932,1494,438,77.33,22.67,170,1324,4,434,174,1758,11.4,0.9,9,"25% - 50% P.O.C.","$49000 - $70000"
"17031815701","Census Tract 8157.01, Cook County, Illinois",3595,128444,2910,7,0,29,0,612,80.9,0.2,0,0.8,0,17,19.1,1268,1114,154,87.85,12.15,83,1031,0,154,83,1185,7.5,0,6.5,"Less than 25% P.O.C.","$98000 or more"
"17031815702","Census Tract 8157.02, Cook County, Illinois",5111,86819,3802,148,0,221,0,853,74.4,2.9,0,4.3,0,16.7,25.6,1903,1249,654,65.63,34.37,102,1147,54,600,156,1747,8.2,8.3,8.2,"25% - 50% P.O.C.","$70000 - $98000"
"17031815800","Census Tract 8158, Cook County, Illinois",1626,95096,1343,11,0,13,0,234,82.6,0.7,0,0.8,0,14.4,17.4,577,425,152,73.66,26.34,84,341,0,152,84,493,19.8,0,14.6,"Less than 25% P.O.C.","$70000 - $98000"
"17031815900","Census Tract 8159, Cook County, Illinois",4930,58859,2437,1452,0,363,0,517,49.4,29.5,0,7.4,0,10.5,50.6,2851,1230,1621,43.14,56.86,13,1217,0,1621,13,2838,1.1,0,0.5,"50% - 75% P.O.C.","$49000 - $70000"
"17031816000","Census Tract 8160, Cook County, Illinois",3205,76587,2080,683,0,170,0,183,64.9,21.3,0,5.3,0,5.7,35.1,1664,785,879,47.18,52.82,45,740,15,864,60,1604,5.7,1.7,3.6,"25% - 50% P.O.C.","$70000 - $98000"
"17031816100","Census Tract 8161, Cook County, Illinois",5792,62163,2960,1751,14,309,0,580,51.1,30.2,0.2,5.3,0,10,48.9,2481,1598,883,64.41,35.59,167,1431,0,883,167,2314,10.5,0,6.7,"25% - 50% P.O.C.","$49000 - $70000"
"17031816200","Census Tract 8162, Cook County, Illinois",4219,61695,1389,604,0,140,0,2020,32.9,14.3,0,3.3,0,47.9,67.1,1614,1024,590,63.44,36.56,118,906,37,553,155,1459,11.5,6.3,9.6,"50% - 75% P.O.C.","$49000 - $70000"
"17031816300","Census Tract 8163, Cook County, Illinois",4915,64073,1093,184,0,23,0,3615,22.2,3.7,0,0.5,0,73.6,77.8,1602,1119,483,69.85,30.15,204,915,84,399,288,1314,18.2,17.4,18,"75% or more P.O.C.","$49000 - $70000"
"17031816401","Census Tract 8164.01, Cook County, Illinois",5186,51850,453,200,0,0,0,4523,8.7,3.9,0,0,0,87.2,91.3,1372,440,932,32.07,67.93,81,359,253,679,334,1038,18.4,27.1,24.3,"75% or more P.O.C.","$49000 - $70000"
"17031816402","Census Tract 8164.02, Cook County, Illinois",4254,53611,811,154,0,0,0,3289,19.1,3.6,0,0,0,77.3,80.9,1150,540,610,46.96,53.04,158,382,128,482,286,864,29.3,21,24.9,"75% or more P.O.C.","$49000 - $70000"
"17031816500","Census Tract 8165, Cook County, Illinois",4209,32667,617,146,0,5,0,3441,14.7,3.5,0,0.1,0,81.8,85.3,1296,699,597,53.94,46.06,119,580,114,483,233,1063,17,19.1,18,"75% or more P.O.C.","Less than $49000"
"17031816600","Census Tract 8166, Cook County, Illinois",4704,59940,221,125,0,109,0,4212,4.7,2.7,0,2.3,0,89.5,95.3,1231,699,532,56.78,43.22,172,527,168,364,340,891,24.6,31.6,27.6,"75% or more P.O.C.","$49000 - $70000"
"17031816700","Census Tract 8167, Cook County, Illinois",2809,48506,442,238,0,11,0,2085,15.7,8.5,0,0.4,0,74.2,84.3,837,470,367,56.15,43.85,186,284,56,311,242,595,39.6,15.3,28.9,"75% or more P.O.C.","Less than $49000"
"17031816800","Census Tract 8168, Cook County, Illinois",5277,61192,1637,1502,27,124,0,1920,31,28.5,0.5,2.3,0,36.4,69,1933,1534,399,79.36,20.64,205,1329,0,399,205,1728,13.4,0,10.6,"50% - 75% P.O.C.","$49000 - $70000"
"17031816900","Census Tract 8169, Cook County, Illinois",6042,61923,227,3974,0,107,0,1674,3.8,65.8,0,1.8,0,27.7,96.2,1756,1442,314,82.12,17.88,278,1164,52,262,330,1426,19.3,16.6,18.8,"75% or more P.O.C.","$49000 - $70000"
"17031817000","Census Tract 8170, Cook County, Illinois",4977,49468,402,3239,12,0,0,1322,8.1,65.1,0.2,0,0,26.6,91.9,1701,1177,524,69.19,30.81,198,979,56,468,254,1447,16.8,10.7,14.9,"75% or more P.O.C.","$49000 - $70000"
"17031817101","Census Tract 8171.01, Cook County, Illinois",4757,42466,218,4103,0,62,0,273,4.6,86.3,0,1.3,0,5.7,95.4,1724,943,781,54.7,45.3,107,836,98,683,205,1519,11.3,12.5,11.9,"75% or more P.O.C.","Less than $49000"
"17031817102","Census Tract 8171.02, Cook County, Illinois",3220,74521,60,2754,0,0,0,263,1.9,85.5,0,0,0,8.2,98.1,1040,735,305,70.67,29.33,131,604,0,305,131,909,17.8,0,12.6,"75% or more P.O.C.","$70000 - $98000"
"17031817200","Census Tract 8172, Cook County, Illinois",4275,48450,54,3195,0,12,0,923,1.3,74.7,0,0.3,0,21.6,98.7,1537,771,766,50.16,49.84,150,621,46,720,196,1341,19.5,6,12.8,"75% or more P.O.C.","Less than $49000"
"17031817300","Census Tract 8173, Cook County, Illinois",2622,43542,95,1930,0,0,0,523,3.6,73.6,0,0,0,19.9,96.4,814,366,448,44.96,55.04,66,300,54,394,120,694,18,12.1,14.7,"75% or more P.O.C.","Less than $49000"
"17031817400","Census Tract 8174, Cook County, Illinois",4052,56678,497,915,0,2,0,2581,12.3,22.6,0,0,0,63.7,87.7,1206,843,363,69.9,30.1,172,671,45,318,217,989,20.4,12.4,18,"75% or more P.O.C.","$49000 - $70000"
"17031817500","Census Tract 8175, Cook County, Illinois",3509,40417,96,2656,0,74,0,683,2.7,75.7,0,2.1,0,19.5,97.3,1305,566,739,43.37,56.63,85,481,37,702,122,1183,15,5,9.3,"75% or more P.O.C.","Less than $49000"
"17031817600","Census Tract 8176, Cook County, Illinois",3964,46181,112,3078,15,0,0,759,2.8,77.6,0.4,0,0,19.1,97.2,1262,785,477,62.2,37.8,100,685,53,424,153,1109,12.7,11.1,12.1,"75% or more P.O.C.","Less than $49000"
"17031817700","Census Tract 8177, Cook County, Illinois",5156,65510,148,4113,0,32,0,863,2.9,79.8,0,0.6,0,16.7,97.1,1671,1426,245,85.34,14.66,178,1248,29,216,207,1464,12.5,11.8,12.4,"75% or more P.O.C.","$49000 - $70000"
"17031817900","Census Tract 8179, Cook County, Illinois",5756,53118,643,4466,0,46,0,499,11.2,77.6,0,0.8,0,8.7,88.8,2267,1384,883,61.05,38.95,96,1288,19,864,115,2152,6.9,2.2,5.1,"75% or more P.O.C.","$49000 - $70000"
"17031818000","Census Tract 8180, Cook County, Illinois",3968,52321,1064,1963,0,430,0,485,26.8,49.5,0,10.8,0,12.2,73.2,1529,1092,437,71.42,28.58,84,1008,47,390,131,1398,7.7,10.8,8.6,"50% - 75% P.O.C.","$49000 - $70000"
"17031818100","Census Tract 8181, Cook County, Illinois",2329,102656,1218,379,0,84,0,592,52.3,16.3,0,3.6,0,25.4,47.7,848,812,36,95.75,4.25,60,752,7,29,67,781,7.4,19.4,7.9,"25% - 50% P.O.C.","$98000 or more"
"17031818200","Census Tract 8182, Cook County, Illinois",4540,80764,1699,1487,15,92,0,1177,37.4,32.8,0.3,2,0,25.9,62.6,1697,1416,281,83.44,16.56,199,1217,18,263,217,1480,14.1,6.4,12.8,"50% - 75% P.O.C.","$70000 - $98000"
"17031818300","Census Tract 8183, Cook County, Illinois",6014,60205,955,2520,0,64,0,2424,15.9,41.9,0,1.1,0,40.3,84.1,1746,1119,627,64.09,35.91,277,842,94,533,371,1375,24.8,15,21.2,"75% or more P.O.C.","$49000 - $70000"
"17031818401","Census Tract 8184.01, Cook County, Illinois",3421,68355,1491,868,0,137,0,876,43.6,25.4,0,4,0,25.6,56.4,1273,1116,157,87.67,12.33,98,1018,0,157,98,1175,8.8,0,7.7,"50% - 75% P.O.C.","$49000 - $70000"
"17031818402","Census Tract 8184.02, Cook County, Illinois",3131,74789,1686,577,0,98,0,514,53.8,18.4,0,3.1,0,16.4,46.2,1357,1006,351,74.13,25.87,84,922,0,351,84,1273,8.3,0,6.2,"25% - 50% P.O.C.","$70000 - $98000"
"17031818500","Census Tract 8185, Cook County, Illinois",5413,85989,3854,447,0,275,0,822,71.2,8.3,0,5.1,0,15.2,28.8,2331,2212,119,94.89,5.11,108,2104,0,119,108,2223,4.9,0,4.6,"25% - 50% P.O.C.","$70000 - $98000"
"17031818600","Census Tract 8186, Cook County, Illinois",4958,90587,3801,328,0,152,0,658,76.7,6.6,0,3.1,0,13.3,23.3,1933,1319,614,68.24,31.76,82,1237,53,561,135,1798,6.2,8.6,7,"Less than 25% P.O.C.","$70000 - $98000"
"17031818700","Census Tract 8187, Cook County, Illinois",3769,89387,2800,137,0,77,0,708,74.3,3.6,0,2,0,18.8,25.7,1388,1245,143,89.7,10.3,140,1105,0,143,140,1248,11.2,0,10.1,"25% - 50% P.O.C.","$70000 - $98000"
"17031818800","Census Tract 8188, Cook County, Illinois",5240,92719,4054,88,0,151,0,823,77.4,1.7,0,2.9,0,15.7,22.6,2029,1860,169,91.67,8.33,118,1742,29,140,147,1882,6.3,17.2,7.2,"Less than 25% P.O.C.","$70000 - $98000"
"17031818900","Census Tract 8189, Cook County, Illinois",4333,92031,3324,157,0,121,0,629,76.7,3.6,0,2.8,0,14.5,23.3,1790,1153,637,64.41,35.59,128,1025,18,619,146,1644,11.1,2.8,8.2,"Less than 25% P.O.C.","$70000 - $98000"
"17031819000","Census Tract 8190, Cook County, Illinois",4573,147569,4426,13,0,18,0,108,96.8,0.3,0,0.4,0,2.4,3.2,1509,1306,203,86.55,13.45,204,1102,7,196,211,1298,15.6,3.4,14,"Less than 25% P.O.C.","$98000 or more"
"17031819100","Census Tract 8191, Cook County, Illinois",4132,46758,1898,280,0,0,0,1901,45.9,6.8,0,0,0,46,54.1,1719,787,932,45.78,54.22,60,727,62,870,122,1597,7.6,6.7,7.1,"50% - 75% P.O.C.","Less than $49000"
"17031819200","Census Tract 8192, Cook County, Illinois",6391,66426,2599,156,0,74,0,3487,40.7,2.4,0,1.2,0,54.6,59.3,2050,1492,558,72.78,27.22,241,1251,121,437,362,1688,16.2,21.7,17.7,"50% - 75% P.O.C.","$49000 - $70000"
"17031819300","Census Tract 8193, Cook County, Illinois",2694,74792,1800,77,0,23,0,786,66.8,2.9,0,0.9,0,29.2,33.2,1027,752,275,73.22,26.78,64,688,0,275,64,963,8.5,0,6.2,"25% - 50% P.O.C.","$70000 - $98000"
"17031819400","Census Tract 8194, Cook County, Illinois",5406,76418,2819,656,18,130,0,1735,52.1,12.1,0.3,2.4,0,32.1,47.9,2017,1324,693,65.64,34.36,50,1274,28,665,78,1939,3.8,4,3.9,"25% - 50% P.O.C.","$70000 - $98000"
"17031819500","Census Tract 8195, Cook County, Illinois",3365,86898,2166,689,0,18,0,400,64.4,20.5,0,0.5,0,11.9,35.6,1374,870,504,63.32,36.68,89,781,0,504,89,1285,10.2,0,6.5,"25% - 50% P.O.C.","$70000 - $98000"
"17031819600","Census Tract 8196, Cook County, Illinois",3745,153914,3564,30,0,9,0,107,95.2,0.8,0,0.2,0,2.9,4.8,1229,1127,102,91.7,8.3,120,1007,20,82,140,1089,10.6,19.6,11.4,"Less than 25% P.O.C.","$98000 or more"
"17031819700","Census Tract 8197, Cook County, Illinois",5656,169306,5195,67,0,89,0,129,91.8,1.2,0,1.6,0,2.3,8.2,1854,1769,85,95.42,4.58,312,1457,0,85,312,1542,17.6,0,16.8,"Less than 25% P.O.C.","$98000 or more"
"17031819801","Census Tract 8198.01, Cook County, Illinois",5543,178500,5013,87,0,45,0,305,90.4,1.6,0,0.8,0,5.5,9.6,1650,1572,78,95.27,4.73,220,1352,27,51,247,1403,14,34.6,15,"Less than 25% P.O.C.","$98000 or more"
"17031819802","Census Tract 8198.02, Cook County, Illinois",2586,153393,2416,15,23,5,0,127,93.4,0.6,0.9,0.2,0,4.9,6.6,931,901,30,96.78,3.22,125,776,0,30,125,806,13.9,0,13.4,"Less than 25% P.O.C.","$98000 or more"
"17031819900","Census Tract 8199, Cook County, Illinois",3298,189531,3109,0,0,62,0,127,94.3,0,0,1.9,0,3.9,5.7,1092,1067,25,97.71,2.29,228,839,7,18,235,857,21.4,28,21.5,"Less than 25% P.O.C.","$98000 or more"
"17031820000","Census Tract 8200, Cook County, Illinois",2215,228125,1627,19,0,349,0,179,73.5,0.9,0,15.8,0,8.1,26.5,656,572,84,87.2,12.8,81,491,36,48,117,539,14.2,42.9,17.8,"25% - 50% P.O.C.","$98000 or more"
"17031820101","Census Tract 8201.01, Cook County, Illinois",7220,112944,6003,134,0,609,0,369,83.1,1.9,0,8.4,0,5.1,16.9,2908,2705,203,93.02,6.98,150,2555,0,203,150,2758,5.5,0,5.2,"Less than 25% P.O.C.","$98000 or more"
"17031820103","Census Tract 8201.03, Cook County, Illinois",4286,71588,2970,143,0,37,0,1038,69.3,3.3,0,0.9,0,24.2,30.7,1465,1016,449,69.35,30.65,134,882,0,449,134,1331,13.2,0,9.1,"25% - 50% P.O.C.","$70000 - $98000"
"17031820104","Census Tract 8201.04, Cook County, Illinois",4138,75603,3007,166,0,33,0,875,72.7,4,0,0.8,0,21.1,27.3,1708,1238,470,72.48,27.52,86,1152,21,449,107,1601,6.9,4.5,6.3,"25% - 50% P.O.C.","$70000 - $98000"
"17031820201","Census Tract 8202.01, Cook County, Illinois",7405,109803,5614,78,0,392,0,1010,75.8,1.1,0,5.3,0,13.6,24.2,3125,2732,393,87.42,12.58,147,2585,15,378,162,2963,5.4,3.8,5.2,"Less than 25% P.O.C.","$98000 or more"
"17031820202","Census Tract 8202.02, Cook County, Illinois",3137,54194,1929,93,0,21,0,1085,61.5,3,0,0.7,0,34.6,38.5,1242,899,343,72.38,27.62,64,835,26,317,90,1152,7.1,7.6,7.2,"25% - 50% P.O.C.","$49000 - $70000"
"17031820300","Census Tract 8203, Cook County, Illinois",5617,59637,1154,81,0,317,0,3964,20.5,1.4,0,5.6,0,70.6,79.5,1689,1017,672,60.21,39.79,294,723,119,553,413,1276,28.9,17.7,24.5,"75% or more P.O.C.","$49000 - $70000"
"17031820400","Census Tract 8204, Cook County, Illinois",5643,41325,386,764,0,56,0,4409,6.8,13.5,0,1,0,78.1,93.2,1637,668,969,40.81,59.19,229,439,198,771,427,1210,34.3,20.4,26.1,"75% or more P.O.C.","Less than $49000"
"17031820501","Census Tract 8205.01, Cook County, Illinois",5875,66480,4315,207,0,55,0,1298,73.4,3.5,0,0.9,0,22.1,26.6,2030,1602,428,78.92,21.08,274,1328,15,413,289,1741,17.1,3.5,14.2,"25% - 50% P.O.C.","$49000 - $70000"
"17031820502","Census Tract 8205.02, Cook County, Illinois",5282,56996,3495,250,0,261,0,1169,66.2,4.7,0,4.9,0,22.1,33.8,1711,1080,631,63.12,36.88,150,930,59,572,209,1502,13.9,9.4,12.2,"25% - 50% P.O.C.","$49000 - $70000"
"17031820603","Census Tract 8206.03, Cook County, Illinois",5880,59717,3380,339,0,191,0,1895,57.5,5.8,0,3.2,0,32.2,42.5,1887,1381,506,73.18,26.82,220,1161,134,372,354,1533,15.9,26.5,18.8,"25% - 50% P.O.C.","$49000 - $70000"
"17031820604","Census Tract 8206.04, Cook County, Illinois",3933,43723,3089,32,0,0,0,775,78.5,0.8,0,0,0,19.7,21.5,1449,656,793,45.27,54.73,35,621,60,733,95,1354,5.3,7.6,6.6,"Less than 25% P.O.C.","Less than $49000"
"17031820605","Census Tract 8206.05, Cook County, Illinois",4625,43214,1278,2565,0,100,0,641,27.6,55.5,0,2.2,0,13.9,72.4,1836,401,1435,21.84,78.16,54,347,109,1326,163,1673,13.5,7.6,8.9,"50% - 75% P.O.C.","Less than $49000"
"17031820606","Census Tract 8206.06, Cook County, Illinois",3846,72143,2995,157,0,32,0,612,77.9,4.1,0,0.8,0,15.9,22.1,1486,1077,409,72.48,27.52,87,990,72,337,159,1327,8.1,17.6,10.7,"Less than 25% P.O.C.","$70000 - $98000"
"17031820700","Census Tract 8207, Cook County, Illinois",6679,65257,2359,34,0,20,0,4102,35.3,0.5,0,0.3,0,61.4,64.7,2251,1755,496,77.97,22.03,306,1449,0,496,306,1945,17.4,0,13.6,"50% - 75% P.O.C.","$49000 - $70000"
"17031820800","Census Tract 8208, Cook County, Illinois",3882,71758,1584,0,0,13,0,2249,40.8,0,0,0.3,0,57.9,59.2,1161,975,186,83.98,16.02,207,768,44,142,251,910,21.2,23.7,21.6,"50% - 75% P.O.C.","$70000 - $98000"
"17031820901","Census Tract 8209.01, Cook County, Illinois",5452,60672,3206,79,83,89,0,1966,58.8,1.4,1.5,1.6,0,36.1,41.2,1870,1146,724,61.28,38.72,159,987,78,646,237,1633,13.9,10.8,12.7,"25% - 50% P.O.C.","$49000 - $70000"
"17031820902","Census Tract 8209.02, Cook County, Illinois",5076,87443,2399,275,0,109,0,2273,47.3,5.4,0,2.1,0,44.8,52.7,1481,1259,222,85.01,14.99,225,1034,45,177,270,1211,17.9,20.3,18.2,"50% - 75% P.O.C.","$70000 - $98000"
"17031821001","Census Tract 8210.01, Cook County, Illinois",4787,54620,3007,274,0,100,0,1321,62.8,5.7,0,2.1,0,27.6,37.2,1647,1077,570,65.39,34.61,178,899,63,507,241,1406,16.5,11.1,14.6,"25% - 50% P.O.C.","$49000 - $70000"
"17031821002","Census Tract 8210.02, Cook County, Illinois",5404,58828,3491,77,0,0,0,1825,64.6,1.4,0,0,0,33.8,35.4,1784,1434,350,80.38,19.62,168,1266,104,246,272,1512,11.7,29.7,15.2,"25% - 50% P.O.C.","$49000 - $70000"
"17031821101","Census Tract 8211.01, Cook County, Illinois",4735,64652,2998,60,0,91,0,1450,63.3,1.3,0,1.9,0,30.6,36.7,1461,1208,253,82.68,17.32,170,1038,100,153,270,1191,14.1,39.5,18.5,"25% - 50% P.O.C.","$49000 - $70000"
"17031821102","Census Tract 8211.02, Cook County, Illinois",4394,61645,2594,84,0,70,0,1504,59,1.9,0,1.6,0,34.2,41,1346,1118,228,83.06,16.94,195,923,28,200,223,1123,17.4,12.3,16.6,"25% - 50% P.O.C.","$49000 - $70000"
"17031821200","Census Tract 8212, Cook County, Illinois",6327,45846,441,3049,30,0,0,2752,7,48.2,0.5,0,0,43.5,93,2155,933,1222,43.29,56.71,247,686,74,1148,321,1834,26.5,6.1,14.9,"75% or more P.O.C.","Less than $49000"
"17031821300","Census Tract 8213, Cook County, Illinois",5470,45607,752,1882,0,1,0,2778,13.7,34.4,0,0,0,50.8,86.3,1950,850,1100,43.59,56.41,244,606,92,1008,336,1614,28.7,8.4,17.2,"75% or more P.O.C.","Less than $49000"
"17031821401","Census Tract 8214.01, Cook County, Illinois",3881,45457,73,3291,0,0,0,383,1.9,84.8,0,0,0,9.9,98.1,1479,825,654,55.78,44.22,49,776,60,594,109,1370,5.9,9.2,7.4,"75% or more P.O.C.","Less than $49000"
"17031821402","Census Tract 8214.02, Cook County, Illinois",2992,48091,78,2827,0,0,0,11,2.6,94.5,0,0,0,0.4,97.4,1469,919,550,62.56,37.44,67,852,0,550,67,1402,7.3,0,4.6,"75% or more P.O.C.","Less than $49000"
"17031821500","Census Tract 8215, Cook County, Illinois",1792,26815,56,1662,0,0,0,23,3.1,92.7,0,0,0,1.3,96.9,703,244,459,34.71,65.29,26,218,41,418,67,636,10.7,8.9,9.5,"75% or more P.O.C.","Less than $49000"
"17031821600","Census Tract 8216, Cook County, Illinois",4401,70497,1673,1896,20,63,0,623,38,43.1,0.5,1.4,0,14.2,62,1617,1245,372,76.99,23.01,98,1147,46,326,144,1473,7.9,12.4,8.9,"50% - 75% P.O.C.","$70000 - $98000"
"17031821700","Census Tract 8217, Cook County, Illinois",4623,85278,3233,859,0,0,0,531,69.9,18.6,0,0,0,11.5,30.1,1662,1298,364,78.1,21.9,143,1155,70,294,213,1449,11,19.2,12.8,"25% - 50% P.O.C.","$70000 - $98000"
"17031821800","Census Tract 8218, Cook County, Illinois",5412,71540,2816,1537,0,2,0,989,52,28.4,0,0,0,18.3,48,1973,1448,525,73.39,26.61,175,1273,32,493,207,1766,12.1,6.1,10.5,"25% - 50% P.O.C.","$70000 - $98000"
"17031821900","Census Tract 8219, Cook County, Illinois",5043,82450,3464,835,0,98,0,557,68.7,16.6,0,1.9,0,11,31.3,1729,1451,278,83.92,16.08,268,1183,0,278,268,1461,18.5,0,15.5,"25% - 50% P.O.C.","$70000 - $98000"
"17031822000","Census Tract 8220, Cook County, Illinois",4272,50548,2936,47,0,37,0,1120,68.7,1.1,0,0.9,0,26.2,31.3,1697,1396,301,82.26,17.74,133,1263,0,301,133,1564,9.5,0,7.8,"25% - 50% P.O.C.","$49000 - $70000"
"17031822101","Census Tract 8221.01, Cook County, Illinois",4309,65486,3259,246,0,20,0,750,75.6,5.7,0,0.5,0,17.4,24.4,1582,1275,307,80.59,19.41,148,1127,12,295,160,1422,11.6,3.9,10.1,"Less than 25% P.O.C.","$49000 - $70000"
"17031822102","Census Tract 8221.02, Cook County, Illinois",4343,57137,2097,711,0,226,0,1136,48.3,16.4,0,5.2,0,26.2,51.7,1857,1288,569,69.36,30.64,106,1182,19,550,125,1732,8.2,3.3,6.7,"50% - 75% P.O.C.","$49000 - $70000"
"17031822200","Census Tract 8222, Cook County, Illinois",3965,94211,2688,103,0,45,0,1037,67.8,2.6,0,1.1,0,26.2,32.2,1252,1119,133,89.38,10.62,137,982,35,98,172,1080,12.2,26.3,13.7,"25% - 50% P.O.C.","$70000 - $98000"
"17031822301","Census Tract 8223.01, Cook County, Illinois",3539,60284,2759,0,0,34,0,718,78,0,0,1,0,20.3,22,1159,1088,71,93.87,6.13,132,956,14,57,146,1013,12.1,19.7,12.6,"Less than 25% P.O.C.","$49000 - $70000"
"17031822302","Census Tract 8223.02, Cook County, Illinois",4123,54904,2858,235,0,176,0,795,69.3,5.7,0,4.3,0,19.3,30.7,1518,1110,408,73.12,26.88,112,998,0,408,112,1406,10.1,0,7.4,"25% - 50% P.O.C.","$49000 - $70000"
"17031822400","Census Tract 8224, Cook County, Illinois",5949,45438,4292,213,46,85,0,1313,72.1,3.6,0.8,1.4,0,22.1,27.9,1985,1282,703,64.58,35.42,157,1125,143,560,300,1685,12.2,20.3,15.1,"25% - 50% P.O.C.","Less than $49000"
"17031822500","Census Tract 8225, Cook County, Illinois",4366,76054,3001,363,0,53,0,868,68.7,8.3,0,1.2,0,19.9,31.3,1601,1245,356,77.76,22.24,155,1090,18,338,173,1428,12.4,5.1,10.8,"25% - 50% P.O.C.","$70000 - $98000"
"17031822601","Census Tract 8226.01, Cook County, Illinois",4731,85556,3544,42,0,53,0,1066,74.9,0.9,0,1.1,0,22.5,25.1,1688,1589,99,94.14,5.86,161,1428,12,87,173,1515,10.1,12.1,10.2,"25% - 50% P.O.C.","$70000 - $98000"
"17031822602","Census Tract 8226.02, Cook County, Illinois",7086,64861,4137,669,0,1050,0,1165,58.4,9.4,0,14.8,0,16.4,41.6,2757,2130,627,77.26,22.74,281,1849,96,531,377,2380,13.2,15.3,13.7,"25% - 50% P.O.C.","$49000 - $70000"
"17031822701","Census Tract 8227.01, Cook County, Illinois",4524,55313,2645,435,0,89,0,1336,58.5,9.6,0,2,0,29.5,41.5,1984,1635,349,82.41,17.59,82,1553,0,349,82,1902,5,0,4.1,"25% - 50% P.O.C.","$49000 - $70000"
"17031822702","Census Tract 8227.02, Cook County, Illinois",3674,61342,2497,365,0,51,0,726,68,9.9,0,1.4,0,19.8,32,1449,1078,371,74.4,25.6,103,975,35,336,138,1311,9.6,9.4,9.5,"25% - 50% P.O.C.","$49000 - $70000"
"17031822801","Census Tract 8228.01, Cook County, Illinois",3147,62010,1928,234,0,177,0,797,61.3,7.4,0,5.6,0,25.3,38.7,1502,1065,437,70.91,29.09,51,1014,0,437,51,1451,4.8,0,3.4,"25% - 50% P.O.C.","$49000 - $70000"
"17031822802","Census Tract 8228.02, Cook County, Illinois",3488,64844,2529,158,0,79,0,712,72.5,4.5,0,2.3,0,20.4,27.5,1253,1097,156,87.55,12.45,140,957,30,126,170,1083,12.8,19.2,13.6,"25% - 50% P.O.C.","$49000 - $70000"
"17031822900","Census Tract 8229, Cook County, Illinois",1921,51917,1375,42,0,21,0,408,71.6,2.2,0,1.1,0,21.2,28.4,652,553,99,84.82,15.18,103,450,25,74,128,524,18.6,25.3,19.6,"25% - 50% P.O.C.","$49000 - $70000"
"17031823001","Census Tract 8230.01, Cook County, Illinois",6496,49034,3872,1199,0,177,0,1233,59.6,18.5,0,2.7,0,19,40.4,2511,1192,1319,47.47,52.53,62,1130,223,1096,285,2226,5.2,16.9,11.4,"25% - 50% P.O.C.","$49000 - $70000"
"17031823002","Census Tract 8230.02, Cook County, Illinois",5981,51995,4950,291,0,141,0,561,82.8,4.9,0,2.4,0,9.4,17.2,2211,1430,781,64.68,35.32,166,1264,13,768,179,2032,11.6,1.7,8.1,"Less than 25% P.O.C.","$49000 - $70000"
"17031823101","Census Tract 8231.01, Cook County, Illinois",4380,51298,3606,235,0,48,0,404,82.3,5.4,0,1.1,0,9.2,17.7,1630,1080,550,66.26,33.74,163,917,2,548,165,1465,15.1,0.4,10.1,"Less than 25% P.O.C.","$49000 - $70000"
"17031823102","Census Tract 8231.02, Cook County, Illinois",3588,73464,3025,31,0,8,0,470,84.3,0.9,0,0.2,0,13.1,15.7,1259,853,406,67.75,32.25,183,670,32,374,215,1044,21.5,7.9,17.1,"Less than 25% P.O.C.","$70000 - $98000"
"17031823200","Census Tract 8232, Cook County, Illinois",4847,66639,3314,258,0,134,0,1096,68.4,5.3,0,2.8,0,22.6,31.6,1833,1587,246,86.58,13.42,137,1450,45,201,182,1651,8.6,18.3,9.9,"25% - 50% P.O.C.","$49000 - $70000"
"17031823302","Census Tract 8233.02, Cook County, Illinois",5787,57997,2645,2126,22,52,0,916,45.7,36.7,0.4,0.9,0,15.8,54.3,2441,1130,1311,46.29,53.71,138,992,160,1151,298,2143,12.2,12.2,12.2,"50% - 75% P.O.C.","$49000 - $70000"
"17031823303","Census Tract 8233.03, Cook County, Illinois",4495,71544,2653,629,0,0,0,1158,59,14,0,0,0,25.8,41,1667,1110,557,66.59,33.41,106,1004,48,509,154,1513,9.5,8.6,9.2,"25% - 50% P.O.C.","$70000 - $98000"
"17031823304","Census Tract 8233.04, Cook County, Illinois",6064,51450,2861,1355,0,78,0,1749,47.2,22.3,0,1.3,0,28.8,52.8,2385,1426,959,59.79,40.21,237,1189,43,916,280,2105,16.6,4.5,11.7,"50% - 75% P.O.C.","$49000 - $70000"
"17031823400","Census Tract 8234, Cook County, Illinois",4985,50619,1218,1044,0,18,0,2362,24.4,20.9,0,0.4,0,47.4,75.6,1810,1195,615,66.02,33.98,147,1048,41,574,188,1622,12.3,6.7,10.4,"75% or more P.O.C.","$49000 - $70000"
"17031823500","Census Tract 8235, Cook County, Illinois",4623,60156,1935,704,0,27,0,1843,41.9,15.2,0,0.6,0,39.9,58.1,1571,851,720,54.17,45.83,163,688,50,670,213,1358,19.2,6.9,13.6,"50% - 75% P.O.C.","$49000 - $70000"
"17031823602","Census Tract 8236.02, Cook County, Illinois",6280,67143,5384,196,2,140,0,558,85.7,3.1,0,2.2,0,8.9,14.3,2812,2191,621,77.92,22.08,130,2061,48,573,178,2634,5.9,7.7,6.3,"Less than 25% P.O.C.","$49000 - $70000"
"17031823603","Census Tract 8236.03, Cook County, Illinois",2313,38047,48,795,0,0,0,1434,2.1,34.4,0,0,0,62,97.9,563,326,237,57.9,42.1,127,199,35,202,162,401,39,14.8,28.8,"75% or more P.O.C.","Less than $49000"
"17031823604","Census Tract 8236.04, Cook County, Illinois",3676,86771,3149,36,0,94,0,378,85.7,1,0,2.6,0,10.3,14.3,1355,1281,74,94.54,5.46,143,1138,33,41,176,1179,11.2,44.6,13,"Less than 25% P.O.C.","$70000 - $98000"
"17031823605","Census Tract 8236.05, Cook County, Illinois",4210,62500,3651,207,0,96,4,244,86.7,4.9,0,2.3,0.1,5.8,13.3,1508,1309,199,86.8,13.2,130,1179,39,160,169,1339,9.9,19.6,11.2,"Less than 25% P.O.C.","$49000 - $70000"
"17031823702","Census Tract 8237.02, Cook County, Illinois",6148,59546,4074,824,0,248,0,849,66.3,13.4,0,4,0,13.8,33.7,2413,1359,1054,56.32,43.68,154,1205,74,980,228,2185,11.3,7,9.4,"25% - 50% P.O.C.","$49000 - $70000"
"17031823703","Census Tract 8237.03, Cook County, Illinois",8642,55389,6117,89,0,608,0,1796,70.8,1,0,7,0,20.8,29.2,3087,2102,985,68.09,31.91,405,1697,97,888,502,2585,19.3,9.8,16.3,"25% - 50% P.O.C.","$49000 - $70000"
"17031823704","Census Tract 8237.04, Cook County, Illinois",3922,91250,3210,158,13,38,0,503,81.8,4,0.3,1,0,12.8,18.2,1241,1145,96,92.26,7.74,159,986,36,60,195,1046,13.9,37.5,15.7,"Less than 25% P.O.C.","$70000 - $98000"
"17031823705","Census Tract 8237.05, Cook County, Illinois",4509,59018,3208,311,0,24,11,882,71.1,6.9,0,0.5,0.2,19.6,28.9,1632,1068,564,65.44,34.56,169,899,62,502,231,1401,15.8,11,14.2,"25% - 50% P.O.C.","$49000 - $70000"
"17031823801","Census Tract 8238.01, Cook County, Illinois",5530,103160,4588,126,0,183,0,513,83,2.3,0,3.3,0,9.3,17,2206,1924,282,87.22,12.78,231,1693,0,282,231,1975,12,0,10.5,"Less than 25% P.O.C.","$98000 or more"
"17031823803","Census Tract 8238.03, Cook County, Illinois",6510,70909,5873,40,0,126,0,464,90.2,0.6,0,1.9,0,7.1,9.8,2324,2016,308,86.75,13.25,285,1731,23,285,308,2016,14.1,7.5,13.3,"Less than 25% P.O.C.","$70000 - $98000"
"17031823805","Census Tract 8238.05, Cook County, Illinois",2916,54392,2301,32,0,103,0,419,78.9,1.1,0,3.5,0,14.4,21.1,1386,1305,81,94.16,5.84,33,1272,12,69,45,1341,2.5,14.8,3.2,"Less than 25% P.O.C.","$49000 - $70000"
"17031823806","Census Tract 8238.06, Cook County, Illinois",3766,48050,3009,116,0,95,0,467,79.9,3.1,0,2.5,0,12.4,20.1,1602,988,614,61.67,38.33,33,955,15,599,48,1554,3.3,2.4,3,"Less than 25% P.O.C.","Less than $49000"
"17031823901","Census Tract 8239.01, Cook County, Illinois",3839,90536,3408,54,0,167,13,83,88.8,1.4,0,4.4,0.3,2.2,11.2,1609,1511,98,93.91,6.09,102,1409,0,98,102,1507,6.8,0,6.3,"Less than 25% P.O.C.","$70000 - $98000"
"17031823903","Census Tract 8239.03, Cook County, Illinois",4569,88819,4067,138,0,0,0,289,89,3,0,0,0,6.3,11,1658,1597,61,96.32,3.68,134,1463,25,36,159,1499,8.4,41,9.6,"Less than 25% P.O.C.","$70000 - $98000"
"17031823904","Census Tract 8239.04, Cook County, Illinois",3964,95156,3818,1,49,45,0,51,96.3,0,1.2,1.1,0,1.3,3.7,1597,1498,99,93.8,6.2,113,1385,14,85,127,1470,7.5,14.1,8,"Less than 25% P.O.C.","$70000 - $98000"
"17031824003","Census Tract 8240.03, Cook County, Illinois",6124,96194,5606,0,0,133,0,354,91.5,0,0,2.2,0,5.8,8.5,2106,1830,276,86.89,13.11,130,1700,123,153,253,1853,7.1,44.6,12,"Less than 25% P.O.C.","$70000 - $98000"
"17031824004","Census Tract 8240.04, Cook County, Illinois",5462,86029,4833,182,0,221,0,226,88.5,3.3,0,4,0,4.1,11.5,2044,1379,665,67.47,32.53,159,1220,64,601,223,1821,11.5,9.6,10.9,"Less than 25% P.O.C.","$70000 - $98000"
"17031824005","Census Tract 8240.05, Cook County, Illinois",5749,112125,5215,23,8,117,0,298,90.7,0.4,0.1,2,0,5.2,9.3,2027,1721,306,84.9,15.1,158,1563,14,292,172,1855,9.2,4.6,8.5,"Less than 25% P.O.C.","$98000 or more"
"17031824006","Census Tract 8240.06, Cook County, Illinois",4728,129667,4279,37,0,172,0,208,90.5,0.8,0,3.6,0,4.4,9.5,1528,1430,98,93.59,6.41,178,1252,30,68,208,1320,12.4,30.6,13.6,"Less than 25% P.O.C.","$98000 or more"
"17031824105","Census Tract 8241.05, Cook County, Illinois",6686,111494,5722,45,0,226,0,563,85.6,0.7,0,3.4,0,8.4,14.4,2391,2296,95,96.03,3.97,269,2027,19,76,288,2103,11.7,20,12,"Less than 25% P.O.C.","$98000 or more"
"17031824106","Census Tract 8241.06, Cook County, Illinois",6849,94764,5872,193,0,139,0,555,85.7,2.8,0,2,0,8.1,14.3,2617,2293,324,87.62,12.38,144,2149,26,298,170,2447,6.3,8,6.5,"Less than 25% P.O.C.","$70000 - $98000"
"17031824107","Census Tract 8241.07, Cook County, Illinois",6847,72289,5689,335,0,117,0,619,83.1,4.9,0,1.7,0,9,16.9,2668,2379,289,89.17,10.83,312,2067,0,289,312,2356,13.1,0,11.7,"Less than 25% P.O.C.","$70000 - $98000"
"17031824108","Census Tract 8241.08, Cook County, Illinois",8101,94020,5618,826,0,698,0,932,69.3,10.2,0,8.6,0,11.5,30.7,2689,2126,563,79.06,20.94,234,1892,106,457,340,2349,11,18.8,12.6,"25% - 50% P.O.C.","$70000 - $98000"
"17031824113","Census Tract 8241.13, Cook County, Illinois",7070,97365,5588,146,0,349,24,826,79,2.1,0,4.9,0.3,11.7,21,2347,2250,97,95.87,4.13,326,1924,0,97,326,2021,14.5,0,13.9,"Less than 25% P.O.C.","$70000 - $98000"
"17031824114","Census Tract 8241.14, Cook County, Illinois",5186,108933,4360,251,0,348,0,167,84.1,4.8,0,6.7,0,3.2,15.9,1897,1736,161,91.51,8.49,134,1602,10,151,144,1753,7.7,6.2,7.6,"Less than 25% P.O.C.","$98000 or more"
"17031824115","Census Tract 8241.15, Cook County, Illinois",4053,74318,3202,343,0,167,0,332,79,8.5,0,4.1,0,8.2,21,1400,1074,326,76.71,23.29,81,993,0,326,81,1319,7.5,0,5.8,"Less than 25% P.O.C.","$70000 - $98000"
"17031824116","Census Tract 8241.16, Cook County, Illinois",5373,68125,3837,588,0,237,0,648,71.4,10.9,0,4.4,0,12.1,28.6,2202,1161,1041,52.72,47.28,104,1057,67,974,171,2031,9,6.4,7.8,"25% - 50% P.O.C.","$49000 - $70000"
"17031824117","Census Tract 8241.17, Cook County, Illinois",9453,102696,7552,80,0,1165,0,565,79.9,0.8,0,12.3,0,6,20.1,3379,3305,74,97.81,2.19,316,2989,48,26,364,3015,9.6,64.9,10.8,"Less than 25% P.O.C.","$98000 or more"
"17031824119","Census Tract 8241.19, Cook County, Illinois",5655,106607,4793,58,0,392,0,373,84.8,1,0,6.9,0,6.6,15.2,2091,2038,53,97.47,2.53,237,1801,0,53,237,1854,11.6,0,11.3,"Less than 25% P.O.C.","$98000 or more"
"17031824120","Census Tract 8241.20, Cook County, Illinois",8970,100911,7738,103,0,473,0,506,86.3,1.1,0,5.3,0,5.6,13.7,3409,3228,181,94.69,5.31,226,3002,22,159,248,3161,7,12.2,7.3,"Less than 25% P.O.C.","$98000 or more"
"17031824121","Census Tract 8241.21, Cook County, Illinois",3153,81570,2722,11,0,131,0,289,86.3,0.3,0,4.2,0,9.2,13.7,1212,1156,56,95.38,4.62,84,1072,0,56,84,1128,7.3,0,6.9,"Less than 25% P.O.C.","$70000 - $98000"
"17031824122","Census Tract 8241.22, Cook County, Illinois",6526,92476,5586,247,0,186,0,436,85.6,3.8,0,2.9,0,6.7,14.4,2343,2204,139,94.07,5.93,227,1977,15,124,242,2101,10.3,10.8,10.3,"Less than 25% P.O.C.","$70000 - $98000"
"17031824123","Census Tract 8241.23, Cook County, Illinois",7348,71671,6401,163,0,70,0,650,87.1,2.2,0,1,0,8.8,12.9,2801,2386,415,85.18,14.82,170,2216,43,372,213,2588,7.1,10.4,7.6,"Less than 25% P.O.C.","$70000 - $98000"
"17031824300","Census Tract 8243, Cook County, Illinois",4778,31480,285,4146,0,21,0,246,6,86.8,0,0.4,0,5.1,94,1520,862,658,56.71,43.29,198,664,38,620,236,1284,23,5.8,15.5,"75% or more P.O.C.","Less than $49000"
"17031824400","Census Tract 8244, Cook County, Illinois",1968,39080,1048,627,0,23,12,258,53.3,31.9,0,1.2,0.6,13.1,46.7,757,392,365,51.78,48.22,41,351,12,353,53,704,10.5,3.3,7,"25% - 50% P.O.C.","Less than $49000"
"17031824503","Census Tract 8245.03, Cook County, Illinois",7047,70133,5616,591,0,214,0,571,79.7,8.4,0,3,0,8.1,20.3,2865,2471,394,86.25,13.75,225,2246,17,377,242,2623,9.1,4.3,8.4,"Less than 25% P.O.C.","$70000 - $98000"
"17031824505","Census Tract 8245.05, Cook County, Illinois",6364,79904,4598,433,0,578,0,688,72.3,6.8,0,9.1,0,10.8,27.7,2493,1694,799,67.95,32.05,240,1454,15,784,255,2238,14.2,1.9,10.2,"25% - 50% P.O.C.","$70000 - $98000"
"17031824506","Census Tract 8245.06, Cook County, Illinois",6897,64908,5951,153,0,41,0,682,86.3,2.2,0,0.6,0,9.9,13.7,3161,2606,555,82.44,17.56,196,2410,37,518,233,2928,7.5,6.7,7.4,"Less than 25% P.O.C.","$49000 - $70000"
"17031824507","Census Tract 8245.07, Cook County, Illinois",4153,65682,3407,190,0,99,0,387,82,4.6,0,2.4,0,9.3,18,1700,1266,434,74.47,25.53,104,1162,0,434,104,1596,8.2,0,6.1,"Less than 25% P.O.C.","$49000 - $70000"
"17031824601","Census Tract 8246.01, Cook County, Illinois",4556,78444,3578,198,0,58,0,599,78.5,4.3,0,1.3,0,13.1,21.5,1716,1435,281,83.62,16.38,101,1334,0,281,101,1615,7,0,5.9,"Less than 25% P.O.C.","$70000 - $98000"
"17031824602","Census Tract 8246.02, Cook County, Illinois",6490,62096,4562,464,0,352,0,1040,70.3,7.1,0,5.4,0,16,29.7,2404,1952,452,81.2,18.8,272,1680,28,424,300,2104,13.9,6.2,12.5,"25% - 50% P.O.C.","$49000 - $70000"
"17031824701","Census Tract 8247.01, Cook County, Illinois",4122,67682,2487,258,0,6,0,1188,60.3,6.3,0,0.1,0,28.8,39.7,1396,1050,346,75.21,24.79,261,789,9,337,270,1126,24.9,2.6,19.3,"25% - 50% P.O.C.","$49000 - $70000"
"17031824702","Census Tract 8247.02, Cook County, Illinois",5488,51038,2915,690,0,48,0,1706,53.1,12.6,0,0.9,0,31.1,46.9,2025,1432,593,70.72,29.28,199,1233,31,562,230,1795,13.9,5.2,11.4,"25% - 50% P.O.C.","$49000 - $70000"
"17031824800","Census Tract 8248, Cook County, Illinois",7846,38281,1317,2053,0,119,0,4237,16.8,26.2,0,1.5,0,54,83.2,2445,1702,743,69.61,30.39,447,1255,100,643,547,1898,26.3,13.5,22.4,"75% or more P.O.C.","Less than $49000"
"17031824900","Census Tract 8249, Cook County, Illinois",3395,41090,465,2154,0,4,0,750,13.7,63.4,0,0.1,0,22.1,86.3,1157,895,262,77.36,22.64,123,772,35,227,158,999,13.7,13.4,13.7,"75% or more P.O.C.","Less than $49000"
"17031825000","Census Tract 8250, Cook County, Illinois",4792,63581,3015,391,0,438,0,776,62.9,8.2,0,9.1,0,16.2,37.1,1949,1074,875,55.11,44.89,121,953,24,851,145,1804,11.3,2.7,7.4,"25% - 50% P.O.C.","$49000 - $70000"
"17031825200","Census Tract 8252, Cook County, Illinois",2200,79688,984,353,0,33,0,812,44.7,16,0,1.5,0,36.9,55.3,708,672,36,94.92,5.08,63,609,20,16,83,625,9.4,55.6,11.7,"50% - 75% P.O.C.","$70000 - $98000"
"17031825302","Census Tract 8253.02, Cook County, Illinois",6585,70341,4565,875,0,377,0,733,69.3,13.3,0,5.7,0,11.1,30.7,2346,1570,776,66.92,33.08,141,1429,0,776,141,2205,9,0,6,"25% - 50% P.O.C.","$70000 - $98000"
"17031825303","Census Tract 8253.03, Cook County, Illinois",4010,66684,3187,200,16,38,0,506,79.5,5,0.4,0.9,0,12.6,20.5,1539,920,619,59.78,40.22,149,771,24,595,173,1366,16.2,3.9,11.2,"Less than 25% P.O.C.","$49000 - $70000"
"17031825304","Census Tract 8253.04, Cook County, Illinois",4338,70781,3244,0,0,122,0,958,74.8,0,0,2.8,0,22.1,25.2,1640,1299,341,79.21,20.79,71,1228,10,331,81,1559,5.5,2.9,4.9,"25% - 50% P.O.C.","$70000 - $98000"
"17031825400","Census Tract 8254, Cook County, Illinois",5269,63606,4183,203,0,325,0,558,79.4,3.9,0,6.2,0,10.6,20.6,2281,1724,557,75.58,24.42,111,1613,0,557,111,2170,6.4,0,4.9,"Less than 25% P.O.C.","$49000 - $70000"
"17031825501","Census Tract 8255.01, Cook County, Illinois",5626,56976,520,5020,47,0,0,39,9.2,89.2,0.8,0,0,0.7,90.8,1995,1178,817,59.05,40.95,181,997,97,720,278,1717,15.4,11.9,13.9,"75% or more P.O.C.","$49000 - $70000"
"17031825503","Census Tract 8255.03, Cook County, Illinois",6283,56250,793,5247,0,90,0,4,12.6,83.5,0,1.4,0,0.1,87.4,2379,1678,701,70.53,29.47,185,1493,136,565,321,2058,11,19.4,13.5,"75% or more P.O.C.","$49000 - $70000"
"17031825504","Census Tract 8255.04, Cook County, Illinois",3511,51875,220,3170,0,0,0,81,6.3,90.3,0,0,0,2.3,93.7,1349,808,541,59.9,40.1,121,687,40,501,161,1188,15,7.4,11.9,"75% or more P.O.C.","$49000 - $70000"
"17031825505","Census Tract 8255.05, Cook County, Illinois",5878,56509,225,5418,0,210,0,25,3.8,92.2,0,3.6,0,0.4,96.2,1834,1471,363,80.21,19.79,256,1215,53,310,309,1525,17.4,14.6,16.8,"75% or more P.O.C.","$49000 - $70000"
"17031825600","Census Tract 8256, Cook County, Illinois",5245,48967,597,3970,0,102,0,469,11.4,75.7,0,1.9,0,8.9,88.6,1658,1196,462,72.14,27.86,170,1026,133,329,303,1355,14.2,28.8,18.3,"75% or more P.O.C.","Less than $49000"
"17031825700","Census Tract 8257, Cook County, Illinois",4158,46394,539,2570,0,0,0,1029,13,61.8,0,0,0,24.7,87,1450,904,546,62.34,37.66,134,770,23,523,157,1293,14.8,4.2,10.8,"75% or more P.O.C.","Less than $49000"
"17031825801","Census Tract 8258.01, Cook County, Illinois",3377,44470,162,3083,0,7,0,114,4.8,91.3,0,0.2,0,3.4,95.2,1337,486,851,36.35,63.65,16,470,87,764,103,1234,3.3,10.2,7.7,"75% or more P.O.C.","Less than $49000"
"17031825802","Census Tract 8258.02, Cook County, Illinois",6522,46627,218,5697,33,0,0,574,3.3,87.4,0.5,0,0,8.8,96.7,2237,1334,903,59.63,40.37,184,1150,112,791,296,1941,13.8,12.4,13.2,"75% or more P.O.C.","Less than $49000"
"17031825803","Census Tract 8258.03, Cook County, Illinois",6238,51217,406,5375,0,0,0,425,6.5,86.2,0,0,0,6.8,93.5,2450,1382,1068,56.41,43.59,100,1282,23,1045,123,2327,7.2,2.2,5,"75% or more P.O.C.","$49000 - $70000"
"17031825900","Census Tract 8259, Cook County, Illinois",3488,50761,334,2332,0,0,0,800,9.6,66.9,0,0,0,22.9,90.4,1148,717,431,62.46,37.54,139,578,52,379,191,957,19.4,12.1,16.6,"75% or more P.O.C.","$49000 - $70000"
"17031826000","Census Tract 8260, Cook County, Illinois",2923,45833,287,1551,0,0,0,1085,9.8,53.1,0,0,0,37.1,90.2,846,358,488,42.32,57.68,119,239,138,350,257,589,33.2,28.3,30.4,"75% or more P.O.C.","Less than $49000"
"17031826100","Census Tract 8261, Cook County, Illinois",5786,41792,1022,3290,0,0,0,1440,17.7,56.9,0,0,0,24.9,82.3,2091,1118,973,53.47,46.53,71,1047,154,819,225,1866,6.4,15.8,10.8,"75% or more P.O.C.","Less than $49000"
"17031826201","Census Tract 8262.01, Cook County, Illinois",3270,34808,480,2737,0,0,0,53,14.7,83.7,0,0,0,1.6,85.3,1836,804,1032,43.79,56.21,18,786,8,1024,26,1810,2.2,0.8,1.4,"75% or more P.O.C.","Less than $49000"
"17031826202","Census Tract 8262.02, Cook County, Illinois",5761,39852,821,3644,0,0,0,1235,14.3,63.3,0,0,0,21.4,85.7,2069,1490,579,72.02,27.98,111,1379,114,465,225,1844,7.4,19.7,10.9,"75% or more P.O.C.","Less than $49000"
"17031826301","Census Tract 8263.01, Cook County, Illinois",3864,54347,217,3316,0,24,0,284,5.6,85.8,0,0.6,0,7.3,94.4,1407,953,454,67.73,32.27,117,836,12,442,129,1278,12.3,2.6,9.2,"75% or more P.O.C.","$49000 - $70000"
"17031826303","Census Tract 8263.03, Cook County, Illinois",4291,51186,198,4019,0,0,0,31,4.6,93.7,0,0,0,0.7,95.4,1305,1005,300,77.01,22.99,116,889,102,198,218,1087,11.5,34,16.7,"75% or more P.O.C.","$49000 - $70000"
"17031826304","Census Tract 8263.04, Cook County, Illinois",2848,35799,85,2653,0,0,0,0,3,93.2,0,0,0,0,97,1235,718,517,58.14,41.86,20,698,0,517,20,1215,2.8,0,1.6,"75% or more P.O.C.","Less than $49000"
"17031826401","Census Tract 8264.01, Cook County, Illinois",3990,53229,59,3859,12,14,0,46,1.5,96.7,0.3,0.4,0,1.2,98.5,1445,924,521,63.94,36.06,81,843,66,455,147,1298,8.8,12.7,10.2,"75% or more P.O.C.","$49000 - $70000"
"17031826402","Census Tract 8264.02, Cook County, Illinois",4947,55753,152,4390,0,66,0,192,3.1,88.7,0,1.3,0,3.9,96.9,1602,1047,555,65.36,34.64,125,922,91,464,216,1386,11.9,16.4,13.5,"75% or more P.O.C.","$49000 - $70000"
"17031826500","Census Tract 8265, Cook County, Illinois",6031,40258,345,5356,0,41,0,157,5.7,88.8,0,0.7,0,2.6,94.3,2005,1305,700,65.09,34.91,104,1201,172,528,276,1729,8,24.6,13.8,"75% or more P.O.C.","Less than $49000"
"17031826600","Census Tract 8266, Cook County, Illinois",5888,39266,165,5037,0,16,0,430,2.8,85.5,0,0.3,0,7.3,97.2,2087,1181,906,56.59,43.41,178,1003,32,874,210,1877,15.1,3.5,10.1,"75% or more P.O.C.","Less than $49000"
"17031826700","Census Tract 8267, Cook County, Illinois",5113,34510,339,4631,34,1,0,108,6.6,90.6,0.7,0,0,2.1,93.4,2078,810,1268,38.98,61.02,112,698,46,1222,158,1920,13.8,3.6,7.6,"75% or more P.O.C.","Less than $49000"
"17031826800","Census Tract 8268, Cook County, Illinois",5175,47602,422,2450,0,0,0,2135,8.2,47.3,0,0,0,41.3,91.8,1664,785,879,47.18,52.82,173,612,129,750,302,1362,22,14.7,18.1,"75% or more P.O.C.","Less than $49000"
"17031826901","Census Tract 8269.01, Cook County, Illinois",1822,30292,68,1233,0,0,0,516,3.7,67.7,0,0,0,28.3,96.3,642,373,269,58.1,41.9,24,349,30,239,54,588,6.4,11.2,8.4,"75% or more P.O.C.","Less than $49000"
"17031826902","Census Tract 8269.02, Cook County, Illinois",1625,29211,26,1377,0,0,0,222,1.6,84.7,0,0,0,13.7,98.4,546,277,269,50.73,49.27,57,220,27,242,84,462,20.6,10,15.4,"75% or more P.O.C.","Less than $49000"
"17031827000","Census Tract 8270, Cook County, Illinois",3995,28763,41,3576,0,8,0,293,1,89.5,0,0.2,0,7.3,99,1384,780,604,56.36,43.64,101,679,86,518,187,1197,12.9,14.2,13.5,"75% or more P.O.C.","Less than $49000"
"17031827100","Census Tract 8271, Cook County, Illinois",2452,27667,57,1984,0,116,0,243,2.3,80.9,0,4.7,0,9.9,97.7,990,441,549,44.55,55.45,35,406,19,530,54,936,7.9,3.5,5.5,"75% or more P.O.C.","Less than $49000"
"17031827200","Census Tract 8272, Cook County, Illinois",4169,44068,284,2739,0,0,0,1082,6.8,65.7,0,0,0,26,93.2,1376,915,461,66.5,33.5,156,759,27,434,183,1193,17,5.9,13.3,"75% or more P.O.C.","Less than $49000"
"17031827300","Census Tract 8273, Cook County, Illinois",2549,22500,105,1543,0,235,0,377,4.1,60.5,0,9.2,0,14.8,95.9,894,433,461,48.43,51.57,82,351,114,347,196,698,18.9,24.7,21.9,"75% or more P.O.C.","Less than $49000"
"17031827400","Census Tract 8274, Cook County, Illinois",4074,22561,125,3167,0,54,0,710,3.1,77.7,0,1.3,0,17.4,96.9,1480,730,750,49.32,50.68,90,640,56,694,146,1334,12.3,7.5,9.9,"75% or more P.O.C.","Less than $49000"
"17031827500","Census Tract 8275, Cook County, Illinois",5160,39179,418,2539,11,4,0,2151,8.1,49.2,0.2,0.1,0,41.7,91.9,1616,917,699,56.75,43.25,243,674,122,577,365,1251,26.5,17.5,22.6,"75% or more P.O.C.","Less than $49000"
"17031827600","Census Tract 8276, Cook County, Illinois",3479,37654,27,3374,59,0,0,19,0.8,97,1.7,0,0,0.5,99.2,1184,793,391,66.98,33.02,80,713,66,325,146,1038,10.1,16.9,12.3,"75% or more P.O.C.","Less than $49000"
"17031827700","Census Tract 8277, Cook County, Illinois",2844,42939,270,2075,8,20,0,437,9.5,73,0.3,0.7,0,15.4,90.5,927,535,392,57.71,42.29,102,433,70,322,172,755,19.1,17.9,18.6,"75% or more P.O.C.","Less than $49000"
"17031827801","Census Tract 8278.01, Cook County, Illinois",5246,60379,705,4417,6,5,0,100,13.4,84.2,0.1,0.1,0,1.9,86.6,1523,1186,337,77.87,22.13,237,949,111,226,348,1175,20,32.9,22.8,"75% or more P.O.C.","$49000 - $70000"
"17031827802","Census Tract 8278.02, Cook County, Illinois",3626,73409,285,3073,0,0,0,238,7.9,84.7,0,0,0,6.6,92.1,1066,942,124,88.37,11.63,209,733,46,78,255,811,22.2,37.1,23.9,"75% or more P.O.C.","$70000 - $98000"
"17031827804","Census Tract 8278.04, Cook County, Illinois",2969,71563,342,2375,0,8,0,196,11.5,80,0,0.3,0,6.6,88.5,1086,978,108,90.06,9.94,87,891,0,108,87,999,8.9,0,8,"75% or more P.O.C.","$70000 - $98000"
"17031827805","Census Tract 8278.05, Cook County, Illinois",2934,59427,375,2435,0,0,0,108,12.8,83,0,0,0,3.7,87.2,1039,981,58,94.42,5.58,72,909,19,39,91,948,7.3,32.8,8.8,"75% or more P.O.C.","$49000 - $70000"
"17031827901","Census Tract 8279.01, Cook County, Illinois",2357,83125,220,2020,0,40,0,0,9.3,85.7,0,1.7,0,0,90.7,844,785,59,93.01,6.99,34,751,18,41,52,792,4.3,30.5,6.2,"75% or more P.O.C.","$70000 - $98000"
"17031827902","Census Tract 8279.02, Cook County, Illinois",4381,53288,954,2280,0,0,0,997,21.8,52,0,0,0,22.8,78.2,1705,974,731,57.13,42.87,81,893,65,666,146,1559,8.3,8.9,8.6,"75% or more P.O.C.","$49000 - $70000"
"17031828000","Census Tract 8280, Cook County, Illinois",4947,46250,2160,1722,9,63,0,853,43.7,34.8,0.2,1.3,0,17.2,56.3,1882,1153,729,61.26,38.74,106,1047,51,678,157,1725,9.2,7,8.3,"50% - 75% P.O.C.","Less than $49000"
"17031828100","Census Tract 8281, Cook County, Illinois",5292,51967,2404,1720,0,73,0,1095,45.4,32.5,0,1.4,0,20.7,54.6,1940,1451,489,74.79,25.21,233,1218,115,374,348,1592,16.1,23.5,17.9,"50% - 75% P.O.C.","$49000 - $70000"
"17031828201","Census Tract 8282.01, Cook County, Illinois",4167,54245,1322,2136,0,0,0,590,31.7,51.3,0,0,0,14.2,68.3,1581,1037,544,65.59,34.41,160,877,0,544,160,1421,15.4,0,10.1,"50% - 75% P.O.C.","$49000 - $70000"
"17031828202","Census Tract 8282.02, Cook County, Illinois",4512,63750,1710,2181,0,66,0,499,37.9,48.3,0,1.5,0,11.1,62.1,1814,1121,693,61.8,38.2,179,942,45,648,224,1590,16,6.5,12.3,"50% - 75% P.O.C.","$49000 - $70000"
"17031828300","Census Tract 8283, Cook County, Illinois",3203,63418,1826,932,0,38,0,365,57,29.1,0,1.2,0,11.4,43,1440,1155,285,80.21,19.79,74,1081,5,280,79,1361,6.4,1.8,5.5,"25% - 50% P.O.C.","$49000 - $70000"
"17031828401","Census Tract 8284.01, Cook County, Illinois",3645,71336,1959,1109,0,44,0,394,53.7,30.4,0,1.2,0,10.8,46.3,1500,955,545,63.67,36.33,62,893,49,496,111,1389,6.5,9,7.4,"25% - 50% P.O.C.","$70000 - $98000"
"17031828402","Census Tract 8284.02, Cook County, Illinois",3799,52381,1550,1737,0,52,0,390,40.8,45.7,0,1.4,0,10.3,59.2,1714,1158,556,67.56,32.44,63,1095,10,546,73,1641,5.4,1.8,4.3,"50% - 75% P.O.C.","$49000 - $70000"
"17031828503","Census Tract 8285.03, Cook County, Illinois",4152,37514,850,2721,0,39,0,542,20.5,65.5,0,0.9,0,13.1,79.5,1405,738,667,52.53,47.47,104,634,85,582,189,1216,14.1,12.7,13.5,"75% or more P.O.C.","Less than $49000"
"17031828504","Census Tract 8285.04, Cook County, Illinois",6343,44375,1145,4016,15,17,0,822,18.1,63.3,0.2,0.3,0,13,81.9,1888,879,1009,46.56,53.44,44,835,282,727,326,1562,5,27.9,17.3,"75% or more P.O.C.","Less than $49000"
"17031828505","Census Tract 8285.05, Cook County, Illinois",6517,58214,2334,3049,64,51,0,936,35.8,46.8,1,0.8,0,14.4,64.2,2618,1972,646,75.32,24.68,114,1858,32,614,146,2472,5.8,5,5.6,"50% - 75% P.O.C.","$49000 - $70000"
"17031828506","Census Tract 8285.06, Cook County, Illinois",8891,56471,1597,5923,0,19,0,1147,18,66.6,0,0.2,0,12.9,82,3284,2429,855,73.96,26.04,242,2187,47,808,289,2995,10,5.5,8.8,"75% or more P.O.C.","$49000 - $70000"
"17031828601","Census Tract 8286.01, Cook County, Illinois",4026,81832,2416,1084,0,69,0,374,60,26.9,0,1.7,0,9.3,40,1543,1336,207,86.58,13.42,91,1245,18,189,109,1434,6.8,8.7,7.1,"25% - 50% P.O.C.","$70000 - $98000"
"17031828602","Census Tract 8286.02, Cook County, Illinois",4546,93000,1548,2536,0,74,0,199,34.1,55.8,0,1.6,0,4.4,65.9,1470,1238,232,84.22,15.78,171,1067,42,190,213,1257,13.8,18.1,14.5,"50% - 75% P.O.C.","$70000 - $98000"
"17031828701","Census Tract 8287.01, Cook County, Illinois",4198,76875,820,3093,0,23,0,188,19.5,73.7,0,0.5,0,4.5,80.5,1272,908,364,71.38,28.62,164,744,0,364,164,1108,18.1,0,12.9,"75% or more P.O.C.","$70000 - $98000"
"17031828702","Census Tract 8287.02, Cook County, Illinois",4874,52600,935,3169,0,4,0,425,19.2,65,0,0.1,0,8.7,80.8,1642,1043,599,63.52,36.48,120,923,95,504,215,1427,11.5,15.9,13.1,"75% or more P.O.C.","$49000 - $70000"
"17031828801","Census Tract 8288.01, Cook County, Illinois",5610,96373,2062,2474,0,142,0,657,36.8,44.1,0,2.5,0,11.7,63.2,1833,1647,186,89.85,10.15,195,1452,23,163,218,1615,11.8,12.4,11.9,"50% - 75% P.O.C.","$70000 - $98000"
"17031828802","Census Tract 8288.02, Cook County, Illinois",3233,73510,999,890,0,0,0,1291,30.9,27.5,0,0,0,39.9,69.1,1179,1083,96,91.86,8.14,104,979,0,96,104,1075,9.6,0,8.8,"50% - 75% P.O.C.","$70000 - $98000"
"17031828900","Census Tract 8289, Cook County, Illinois",3658,53315,506,1493,0,9,0,1583,13.8,40.8,0,0.2,0,43.3,86.2,1142,571,571,50,50,145,426,108,463,253,889,25.4,18.9,22.2,"75% or more P.O.C.","$49000 - $70000"
"17031829000","Census Tract 8290, Cook County, Illinois",1316,21192,6,1295,0,0,0,15,0.5,98.4,0,0,0,1.1,99.5,419,135,284,32.22,67.78,0,135,48,236,48,371,0,16.9,11.5,"75% or more P.O.C.","Less than $49000"
"17031829100","Census Tract 8291, Cook County, Illinois",3528,30862,246,799,0,0,0,2483,7,22.6,0,0,0,70.4,93,1196,477,719,39.88,60.12,97,380,78,641,175,1021,20.3,10.8,14.6,"75% or more P.O.C.","Less than $49000"
"17031829200","Census Tract 8292, Cook County, Illinois",5541,46875,1206,1416,0,9,0,2679,21.8,25.6,0,0.2,0,48.3,78.2,1901,1265,636,66.54,33.46,167,1098,51,585,218,1683,13.2,8,11.5,"75% or more P.O.C.","Less than $49000"
"17031829301","Census Tract 8293.01, Cook County, Illinois",4127,75708,1426,1625,0,41,0,707,34.6,39.4,0,1,0,17.1,65.4,1411,1279,132,90.64,9.36,167,1112,29,103,196,1215,13.1,22,13.9,"50% - 75% P.O.C.","$70000 - $98000"
"17031829302","Census Tract 8293.02, Cook County, Illinois",3871,32000,257,1541,0,2,0,1933,6.6,39.8,0,0.1,0,49.9,93.4,1294,457,837,35.32,64.68,112,345,91,746,203,1091,24.5,10.9,15.7,"75% or more P.O.C.","Less than $49000"
"17031829401","Census Tract 8294.01, Cook County, Illinois",1096,30091,8,907,0,0,0,181,0.7,82.8,0,0,0,16.5,99.3,387,281,106,72.61,27.39,14,267,21,85,35,352,5,19.8,9,"75% or more P.O.C.","Less than $49000"
"17031829402","Census Tract 8294.02, Cook County, Illinois",3270,41578,845,2147,0,0,0,112,25.8,65.7,0,0,0,3.4,74.2,1483,1076,407,72.56,27.44,102,974,68,339,170,1313,9.5,16.7,11.5,"50% - 75% P.O.C.","Less than $49000"
"17031829500","Census Tract 8295, Cook County, Illinois",4076,41138,1223,1000,11,0,0,1724,30,24.5,0.3,0,0,42.3,70,1467,984,483,67.08,32.92,167,817,30,453,197,1270,17,6.2,13.4,"50% - 75% P.O.C.","Less than $49000"
"17031829600","Census Tract 8296, Cook County, Illinois",2847,53911,1710,344,0,9,0,773,60.1,12.1,0,0.3,0,27.2,39.9,1211,964,247,79.6,20.4,98,866,21,226,119,1092,10.2,8.5,9.8,"25% - 50% P.O.C.","$49000 - $70000"
"17031829700","Census Tract 8297, Cook County, Illinois",4247,40432,640,2974,0,48,0,374,15.1,70,0,1.1,0,8.8,84.9,1523,900,623,59.09,40.91,28,872,112,511,140,1383,3.1,18,9.2,"75% or more P.O.C.","Less than $49000"
"17031829800","Census Tract 8298, Cook County, Illinois",6220,103417,2573,3220,0,80,0,238,41.4,51.8,0,1.3,0,3.8,58.6,2489,2163,326,86.9,13.1,85,2078,0,326,85,2404,3.9,0,3.4,"50% - 75% P.O.C.","$98000 or more"
"17031829901","Census Tract 8299.01, Cook County, Illinois",8977,79772,2058,5713,0,172,0,864,22.9,63.6,0,1.9,0,9.6,77.1,3483,3084,399,88.54,11.46,154,2930,0,399,154,3329,5,0,4.4,"75% or more P.O.C.","$70000 - $98000"
"17031829902","Census Tract 8299.02, Cook County, Illinois",6418,76409,974,5102,0,238,18,86,15.2,79.5,0,3.7,0.3,1.3,84.8,2474,2084,390,84.24,15.76,136,1948,180,210,316,2158,6.5,46.2,12.8,"75% or more P.O.C.","$70000 - $98000"
"17031830001","Census Tract 8300.01, Cook County, Illinois",2300,47250,1483,125,0,54,0,610,64.5,5.4,0,2.3,0,26.5,35.5,1082,988,94,91.31,8.69,38,950,0,94,38,1044,3.8,0,3.5,"25% - 50% P.O.C.","Less than $49000"
"17031830003","Census Tract 8300.03, Cook County, Illinois",7940,96379,616,7149,0,0,0,23,7.8,90,0,0,0,0.3,92.2,2873,2322,551,80.82,19.18,249,2073,52,499,301,2572,10.7,9.4,10.5,"75% or more P.O.C.","$70000 - $98000"
"17031830004","Census Tract 8300.04, Cook County, Illinois",6895,88003,480,5776,0,117,0,353,7,83.8,0,1.7,0,5.1,93,2431,2019,412,83.05,16.95,233,1786,0,412,233,2198,11.5,0,9.6,"75% or more P.O.C.","$70000 - $98000"
"17031830005","Census Tract 8300.05, Cook County, Illinois",4163,97000,877,3137,0,67,0,0,21.1,75.4,0,1.6,0,0,78.9,1612,1326,286,82.26,17.74,139,1187,0,286,139,1473,10.5,0,8.6,"75% or more P.O.C.","$70000 - $98000"
"17031830006","Census Tract 8300.06, Cook County, Illinois",3055,56009,699,1904,0,111,0,255,22.9,62.3,0,3.6,0,8.3,77.1,1201,779,422,64.86,35.14,89,690,69,353,158,1043,11.4,16.4,13.2,"75% or more P.O.C.","$49000 - $70000"
"17031830007","Census Tract 8300.07, Cook County, Illinois",4924,47466,557,4120,0,3,0,234,11.3,83.7,0,0.1,0,4.8,88.7,1643,807,836,49.12,50.88,93,714,88,748,181,1462,11.5,10.5,11,"75% or more P.O.C.","Less than $49000"
"17031830008","Census Tract 8300.08, Cook County, Illinois",4400,85156,209,3907,10,0,0,75,4.8,88.8,0.2,0,0,1.7,95.2,1433,1293,140,90.23,9.77,233,1060,0,140,233,1200,18,0,16.3,"75% or more P.O.C.","$70000 - $98000"
"17031830100","Census Tract 8301, Cook County, Illinois",3399,76548,511,2600,0,0,0,31,15,76.5,0,0,0,0.9,85,1064,816,248,76.69,23.31,98,718,96,152,194,870,12,38.7,18.2,"75% or more P.O.C.","$70000 - $98000"
"17031830201","Census Tract 8302.01, Cook County, Illinois",5324,59662,741,4368,0,111,0,77,13.9,82,0,2.1,0,1.4,86.1,2169,874,1295,40.3,59.7,74,800,14,1281,88,2081,8.5,1.1,4.1,"75% or more P.O.C.","$49000 - $70000"
"17031830202","Census Tract 8302.02, Cook County, Illinois",3563,87901,726,2337,0,20,0,324,20.4,65.6,0,0.6,0,9.1,79.6,1119,848,271,75.78,24.22,16,832,62,209,78,1041,1.9,22.9,7,"75% or more P.O.C.","$70000 - $98000"
"17031830300","Census Tract 8303, Cook County, Illinois",4473,38043,1074,3315,0,61,0,22,24,74.1,0,1.4,0,0.5,76,2314,944,1370,40.8,59.2,78,866,21,1349,99,2215,8.3,1.5,4.3,"75% or more P.O.C.","Less than $49000"
"17031830400","Census Tract 8304, Cook County, Illinois",4335,53920,1244,2547,0,0,0,401,28.7,58.8,0,0,0,9.3,71.3,1539,1003,536,65.17,34.83,127,876,109,427,236,1303,12.7,20.3,15.3,"50% - 75% P.O.C.","$49000 - $70000"
"17031830500","Census Tract 8305, Cook County, Illinois",3901,37917,34,0,0,0,0,3867,0.9,0,0,0,0,99.1,99.1,1086,721,365,66.39,33.61,196,525,73,292,269,817,27.2,20,24.8,"75% or more P.O.C.","Less than $49000"
"17031830600","Census Tract 8306, Cook County, Illinois",4733,47227,1709,719,10,305,0,1687,36.1,15.2,0.2,6.4,0,35.6,63.9,1974,480,1494,24.32,75.68,24,456,120,1374,144,1830,5,8,7.3,"50% - 75% P.O.C.","Less than $49000"
"17031830700","Census Tract 8307, Cook County, Illinois",3814,55236,1559,1476,7,228,0,519,40.9,38.7,0.2,6,0,13.6,59.1,1808,478,1330,26.44,73.56,3,475,76,1254,79,1729,0.6,5.7,4.4,"50% - 75% P.O.C.","$49000 - $70000"
"17031830800","Census Tract 8308, Cook County, Illinois",2522,79405,1948,11,0,142,0,376,77.2,0.4,0,5.6,0,14.9,22.8,1348,287,1061,21.29,78.71,9,278,0,1061,9,1339,3.1,0,0.7,"Less than 25% P.O.C.","$70000 - $98000"
"17031830900","Census Tract 8309, Cook County, Illinois",2993,102246,1664,86,0,176,0,982,55.6,2.9,0,5.9,0,32.8,44.4,1284,600,684,46.73,53.27,30,570,19,665,49,1235,5,2.8,3.8,"25% - 50% P.O.C.","$98000 or more"
"17031831000","Census Tract 8310, Cook County, Illinois",2177,149722,1840,19,0,106,0,186,84.5,0.9,0,4.9,0,8.5,15.5,1056,722,334,68.37,31.63,17,705,0,334,17,1039,2.4,0,1.6,"Less than 25% P.O.C.","$98000 or more"
"17031831100","Census Tract 8311, Cook County, Illinois",8537,60540,2965,23,0,401,0,5128,34.7,0.3,0,4.7,0,60.1,65.3,2775,1293,1482,46.59,53.41,160,1133,226,1256,386,2389,12.4,15.2,13.9,"50% - 75% P.O.C.","$49000 - $70000"
"17031831200","Census Tract 8312, Cook County, Illinois",4704,39180,433,263,0,38,0,3970,9.2,5.6,0,0.8,0,84.4,90.8,1463,591,872,40.4,59.6,131,460,133,739,264,1199,22.2,15.3,18,"75% or more P.O.C.","Less than $49000"
"17031831300","Census Tract 8313, Cook County, Illinois",995,46333,27,468,0,19,0,464,2.7,47,0,1.9,0,46.6,97.3,380,239,141,62.89,37.11,8,231,14,127,22,358,3.3,9.9,5.8,"75% or more P.O.C.","Less than $49000"
"17031831400","Census Tract 8314, Cook County, Illinois",3026,33776,268,1952,7,29,10,752,8.9,64.5,0.2,1,0.3,24.9,91.1,1018,362,656,35.56,64.44,32,330,51,605,83,935,8.8,7.8,8.2,"75% or more P.O.C.","Less than $49000"
"17031831500","Census Tract 8315, Cook County, Illinois",3656,58798,984,182,0,102,0,2302,26.9,5,0,2.8,0,63,73.1,1232,781,451,63.39,36.61,90,691,65,386,155,1077,11.5,14.4,12.6,"50% - 75% P.O.C.","$49000 - $70000"
"17031831600","Census Tract 8316, Cook County, Illinois",8039,47042,1750,357,84,62,0,5555,21.8,4.4,1,0.8,0,69.1,78.2,2325,1329,996,57.16,42.84,528,801,25,971,553,1772,39.7,2.5,23.8,"75% or more P.O.C.","Less than $49000"
"17031831700","Census Tract 8317, Cook County, Illinois",2459,62130,789,22,0,221,0,1392,32.1,0.9,0,9,0,56.6,67.9,772,376,396,48.7,51.3,69,307,54,342,123,649,18.4,13.6,15.9,"50% - 75% P.O.C.","$49000 - $70000"
"17031831800","Census Tract 8318, Cook County, Illinois",6493,55368,2881,100,0,1438,0,1750,44.4,1.5,0,22.1,0,27,55.6,2217,980,1237,44.2,55.8,153,827,75,1162,228,1989,15.6,6.1,10.3,"50% - 75% P.O.C.","$49000 - $70000"
"17031831900","Census Tract 8319, Cook County, Illinois",3228,131500,2589,55,0,162,0,293,80.2,1.7,0,5,0,9.1,19.8,1408,609,799,43.25,56.75,52,557,34,765,86,1322,8.5,4.3,6.1,"Less than 25% P.O.C.","$98000 or more"
"17031832000","Census Tract 8320, Cook County, Illinois",1621,121500,1268,52,0,212,0,69,78.2,3.2,0,13.1,0,4.3,21.8,790,343,447,43.42,56.58,0,343,0,447,0,790,0,0,0,"Less than 25% P.O.C.","$98000 or more"
"17031832100","Census Tract 8321, Cook County, Illinois",3602,76193,2261,850,0,128,0,288,62.8,23.6,0,3.6,0,8,37.2,1843,493,1350,26.75,73.25,0,493,63,1287,63,1780,0,4.7,3.4,"25% - 50% P.O.C.","$70000 - $98000"
"17031832200","Census Tract 8322, Cook County, Illinois",3180,109701,2435,13,0,101,0,451,76.6,0.4,0,3.2,0,14.2,23.4,1490,493,997,33.09,66.91,13,480,65,932,78,1412,2.6,6.5,5.2,"Less than 25% P.O.C.","$98000 or more"
"17031832300","Census Tract 8323, Cook County, Illinois",1938,120052,1235,35,0,172,0,397,63.7,1.8,0,8.9,0,20.5,36.3,881,377,504,42.79,57.21,27,350,6,498,33,848,7.2,1.2,3.7,"25% - 50% P.O.C.","$98000 or more"
"17031832400","Census Tract 8324, Cook County, Illinois",3129,100972,2116,104,0,173,0,692,67.6,3.3,0,5.5,0,22.1,32.4,1295,639,656,49.34,50.66,43,596,32,624,75,1220,6.7,4.9,5.8,"25% - 50% P.O.C.","$98000 or more"
"17031832500","Census Tract 8325, Cook County, Illinois",3390,148802,2777,175,0,86,0,241,81.9,5.2,0,2.5,0,7.1,18.1,1387,766,621,55.23,44.77,49,717,0,621,49,1338,6.4,0,3.5,"Less than 25% P.O.C.","$98000 or more"
"17031832600","Census Tract 8326, Cook County, Illinois",3918,152328,3463,1,0,196,0,147,88.4,0,0,5,0,3.8,11.6,1694,947,747,55.9,44.1,45,902,7,740,52,1642,4.8,0.9,3.1,"Less than 25% P.O.C.","$98000 or more"
"17031832900","Census Tract 8329, Cook County, Illinois",2082,63527,1455,73,0,482,0,39,69.9,3.5,0,23.2,0,1.9,30.1,813,280,533,34.44,65.56,0,280,0,533,0,813,0,0,0,"25% - 50% P.O.C.","$49000 - $70000"
"17031833000","Census Tract 8330, Cook County, Illinois",4480,151028,3103,512,0,394,0,181,69.3,11.4,0,8.8,0,4,30.7,2498,886,1612,35.47,64.53,32,854,40,1572,72,2426,3.6,2.5,2.9,"25% - 50% P.O.C.","$98000 or more"
"17031833100","Census Tract 8331, Cook County, Illinois",7436,132391,4580,913,0,1417,0,358,61.6,12.3,0,19.1,0,4.8,38.4,3850,2303,1547,59.82,40.18,38,2265,0,1547,38,3812,1.7,0,1,"25% - 50% P.O.C.","$98000 or more"
"17031833300","Census Tract 8333, Cook County, Illinois",2728,56136,1167,116,0,1106,0,250,42.8,4.3,0,40.5,0,9.2,57.2,1010,324,686,32.08,67.92,28,296,35,651,63,947,8.6,5.1,6.2,"50% - 75% P.O.C.","$49000 - $70000"
"17031833900","Census Tract 8339, Cook County, Illinois",2650,32237,25,1442,25,25,0,1127,0.9,54.4,0.9,0.9,0,42.5,99.1,818,169,649,20.66,79.34,22,147,75,574,97,721,13,11.6,11.9,"75% or more P.O.C.","Less than $49000"
"17031834000","Census Tract 8340, Cook County, Illinois",3104,45822,14,2866,0,39,0,0,0.5,92.3,0,1.3,0,0,99.5,1168,181,987,15.5,84.5,6,175,66,921,72,1096,3.3,6.7,6.2,"75% or more P.O.C.","Less than $49000"
"17031834200","Census Tract 8342, Cook County, Illinois",4914,65459,27,4808,0,0,0,11,0.5,97.8,0,0,0,0.2,99.5,1786,739,1047,41.38,58.62,67,672,127,920,194,1592,9.1,12.1,10.9,"75% or more P.O.C.","$49000 - $70000"
"17031834300","Census Tract 8343, Cook County, Illinois",5980,42517,48,5795,0,70,0,9,0.8,96.9,0,1.2,0,0.2,99.2,2607,1751,856,67.17,32.83,76,1675,54,802,130,2477,4.3,6.3,5,"75% or more P.O.C.","Less than $49000"
"17031834400","Census Tract 8344, Cook County, Illinois",4437,55341,50,4251,0,0,0,73,1.1,95.8,0,0,0,1.6,98.9,1693,665,1028,39.28,60.72,107,558,66,962,173,1520,16.1,6.4,10.2,"75% or more P.O.C.","$49000 - $70000"
"17031834500","Census Tract 8345, Cook County, Illinois",1105,32756,2,992,0,0,0,0,0.2,89.8,0,0,0,0,99.8,469,35,434,7.46,92.54,0,35,31,403,31,438,0,7.1,6.6,"75% or more P.O.C.","Less than $49000"
"17031834600","Census Tract 8346, Cook County, Illinois",1681,27631,14,1522,0,0,0,145,0.8,90.5,0,0,0,8.6,99.2,831,187,644,22.5,77.5,40,147,29,615,69,762,21.4,4.5,8.3,"75% or more P.O.C.","Less than $49000"
"17031834700","Census Tract 8347, Cook County, Illinois",1258,23125,4,1240,0,3,0,11,0.3,98.6,0,0.2,0,0.9,99.7,518,71,447,13.71,86.29,0,71,27,420,27,491,0,6,5.2,"75% or more P.O.C.","Less than $49000"
"17031834800","Census Tract 8348, Cook County, Illinois",1589,18636,0,1454,10,2,0,123,0,91.5,0.6,0.1,0,7.7,100,714,141,573,19.75,80.25,26,115,38,535,64,650,18.4,6.6,9,"75% or more P.O.C.","Less than $49000"
"17031834900","Census Tract 8349, Cook County, Illinois",1443,17522,14,1386,0,0,0,2,1,96,0,0,0,0.1,99,677,125,552,18.46,81.54,6,119,19,533,25,652,4.8,3.4,3.7,"75% or more P.O.C.","Less than $49000"
"17031835000","Census Tract 8350, Cook County, Illinois",5585,27849,91,2867,0,86,0,2541,1.6,51.3,0,1.5,0,45.5,98.4,1990,679,1311,34.12,65.88,159,520,171,1140,330,1660,23.4,13,16.6,"75% or more P.O.C.","Less than $49000"
"17031835100","Census Tract 8351, Cook County, Illinois",5047,41938,58,850,0,26,0,4082,1.1,16.8,0,0.5,0,80.9,98.9,1280,770,510,60.16,39.84,183,587,123,387,306,974,23.8,24.1,23.9,"75% or more P.O.C.","Less than $49000"
"17031835200","Census Tract 8352, Cook County, Illinois",1993,50900,583,36,0,71,0,1303,29.3,1.8,0,3.6,0,65.4,70.7,666,447,219,67.12,32.88,55,392,19,200,74,592,12.3,8.7,11.1,"50% - 75% P.O.C.","$49000 - $70000"
"17031835500","Census Tract 8355, Cook County, Illinois",1434,23922,45,1360,0,0,0,29,3.1,94.8,0,0,0,2,96.9,698,192,506,27.51,72.49,0,192,37,469,37,661,0,7.3,5.3,"75% or more P.O.C.","Less than $49000"
"17031835600","Census Tract 8356, Cook County, Illinois",896,23571,0,800,0,0,0,90,0,89.3,0,0,0,10,100,430,64,366,14.88,85.12,7,57,17,349,24,406,10.9,4.6,5.6,"75% or more P.O.C.","Less than $49000"
"17031835700","Census Tract 8357, Cook County, Illinois",434,49880,0,419,0,0,15,0,0,96.5,0,0,3.5,0,100,129,0,129,0,100,0,0,17,112,17,112,NA,13.2,13.2,"75% or more P.O.C.","$49000 - $70000"
"17031835800","Census Tract 8358, Cook County, Illinois",1744,66944,24,1601,0,0,0,53,1.4,91.8,0,0,0,3,98.6,656,237,419,36.13,63.87,8,229,73,346,81,575,3.4,17.4,12.3,"75% or more P.O.C.","$49000 - $70000"
"17031835900","Census Tract 8359, Cook County, Illinois",3112,20139,179,2809,0,19,0,94,5.8,90.3,0,0.6,0,3,94.2,1531,291,1240,19.01,80.99,0,291,83,1157,83,1448,0,6.7,5.4,"75% or more P.O.C.","Less than $49000"
"17031836000","Census Tract 8360, Cook County, Illinois",2824,65463,53,2680,0,0,0,48,1.9,94.9,0,0,0,1.7,98.1,976,512,464,52.46,47.54,19,493,93,371,112,864,3.7,20,11.5,"75% or more P.O.C.","$49000 - $70000"
"17031836100","Census Tract 8361, Cook County, Illinois",1897,25451,53,1547,0,0,0,102,2.8,81.5,0,0,0,5.4,97.2,788,135,653,17.13,82.87,0,135,81,572,81,707,0,12.4,10.3,"75% or more P.O.C.","Less than $49000"
"17031836200","Census Tract 8362, Cook County, Illinois",1492,NA,979,94,0,249,0,147,65.6,6.3,0,16.7,0,9.9,34.4,113,70,43,61.95,38.05,0,70,0,43,0,113,0,0,0,"25% - 50% P.O.C.","N/A"
"17031836300","Census Tract 8363, Cook County, Illinois",1513,52440,637,755,0,71,0,13,42.1,49.9,0,4.7,0,0.9,57.9,663,192,471,28.96,71.04,22,170,25,446,47,616,11.5,5.3,7.1,"50% - 75% P.O.C.","$49000 - $70000"
"17031836400","Census Tract 8364, Cook County, Illinois",3787,27210,151,3349,0,19,0,222,4,88.4,0,0.5,0,5.9,96,1802,480,1322,26.64,73.36,38,442,17,1305,55,1747,7.9,1.3,3.1,"75% or more P.O.C.","Less than $49000"
"17031836500","Census Tract 8365, Cook County, Illinois",1963,45930,44,1895,0,0,0,0,2.2,96.5,0,0,0,0,97.8,726,85,641,11.71,88.29,34,51,33,608,67,659,40,5.1,9.2,"75% or more P.O.C.","Less than $49000"
"17031836600","Census Tract 8366, Cook County, Illinois",2337,48313,425,733,0,18,0,1149,18.2,31.4,0,0.8,0,49.2,81.8,879,307,572,34.93,65.07,43,264,54,518,97,782,14,9.4,11,"75% or more P.O.C.","Less than $49000"
"17031836700","Census Tract 8367, Cook County, Illinois",2308,30783,127,1776,0,7,0,394,5.5,76.9,0,0.3,0,17.1,94.5,918,236,682,25.71,74.29,2,234,96,586,98,820,0.8,14.1,10.7,"75% or more P.O.C.","Less than $49000"
"17031836800","Census Tract 8368, Cook County, Illinois",2397,12905,186,2211,0,0,0,0,7.8,92.2,0,0,0,0,92.2,871,168,703,19.29,80.71,16,152,96,607,112,759,9.5,13.7,12.9,"75% or more P.O.C.","Less than $49000"
"17031836900","Census Tract 8369, Cook County, Illinois",1163,27904,121,913,0,12,0,92,10.4,78.5,0,1,0,7.9,89.6,501,92,409,18.36,81.64,11,81,16,393,27,474,12,3.9,5.4,"75% or more P.O.C.","Less than $49000"
"17031837000","Census Tract 8370, Cook County, Illinois",1804,32083,147,1517,0,0,0,72,8.1,84.1,0,0,0,4,91.9,694,168,526,24.21,75.79,0,168,99,427,99,595,0,18.8,14.3,"75% or more P.O.C.","Less than $49000"
"17031837100","Census Tract 8371, Cook County, Illinois",1319,21507,176,982,9,18,0,118,13.3,74.5,0.7,1.4,0,8.9,86.7,690,169,521,24.49,75.51,9,160,10,511,19,671,5.3,1.9,2.8,"75% or more P.O.C.","Less than $49000"
"17031837300","Census Tract 8373, Cook County, Illinois",2762,27656,129,2536,0,40,0,42,4.7,91.8,0,1.4,0,1.5,95.3,785,235,550,29.94,70.06,16,219,85,465,101,684,6.8,15.5,12.9,"75% or more P.O.C.","Less than $49000"
"17031837400","Census Tract 8374, Cook County, Illinois",2259,39231,162,1978,0,8,0,61,7.2,87.6,0,0.4,0,2.7,92.8,730,135,595,18.49,81.51,5,130,53,542,58,672,3.7,8.9,7.9,"75% or more P.O.C.","Less than $49000"
"17031837800","Census Tract 8378, Cook County, Illinois",2627,59915,426,1802,0,154,0,211,16.2,68.6,0,5.9,0,8,83.8,891,180,711,20.2,79.8,10,170,81,630,91,800,5.6,11.4,10.2,"75% or more P.O.C.","$49000 - $70000"
"17031838000","Census Tract 8380, Cook County, Illinois",2589,26971,384,1689,0,35,0,366,14.8,65.2,0,1.4,0,14.1,85.2,1203,343,860,28.51,71.49,26,317,47,813,73,1130,7.6,5.5,6.1,"75% or more P.O.C.","Less than $49000"
"17031838100","Census Tract 8381, Cook County, Illinois",1614,15755,389,812,0,205,0,199,24.1,50.3,0,12.7,0,12.3,75.9,1078,151,927,14.01,85.99,0,151,0,927,0,1078,0,0,0,"75% or more P.O.C.","Less than $49000"
"17031838200","Census Tract 8382, Cook County, Illinois",2058,61458,813,434,0,300,2,417,39.5,21.1,0,14.6,0.1,20.3,60.5,401,205,196,51.12,48.88,21,184,0,196,21,380,10.2,0,5.2,"50% - 75% P.O.C.","$49000 - $70000"
"17031838300","Census Tract 8383, Cook County, Illinois",1710,95139,783,490,0,300,0,53,45.8,28.7,0,17.5,0,3.1,54.2,776,217,559,27.96,72.04,0,217,38,521,38,738,0,6.8,4.9,"50% - 75% P.O.C.","$70000 - $98000"
"17031838600","Census Tract 8386, Cook County, Illinois",1728,16829,29,1538,0,0,0,136,1.7,89,0,0,0,7.9,98.3,617,54,563,8.75,91.25,14,40,58,505,72,545,25.9,10.3,11.7,"75% or more P.O.C.","Less than $49000"
"17031838700","Census Tract 8387, Cook County, Illinois",3934,25701,97,3624,0,0,0,213,2.5,92.1,0,0,0,5.4,97.5,1478,276,1202,18.67,81.33,10,266,77,1125,87,1391,3.6,6.4,5.9,"75% or more P.O.C.","Less than $49000"
"17031838800","Census Tract 8388, Cook County, Illinois",3300,27160,165,1739,0,0,0,1387,5,52.7,0,0,0,42,95,1128,423,705,37.5,62.5,99,324,81,624,180,948,23.4,11.5,16,"75% or more P.O.C.","Less than $49000"
"17031839000","Census Tract 8390, Cook County, Illinois",9209,105094,5811,1074,31,1053,0,887,63.1,11.7,0.3,11.4,0,9.6,36.9,5037,1620,3417,32.16,67.84,0,1620,23,3394,23,5014,0,0.7,0.5,"25% - 50% P.O.C.","$98000 or more"
"17031839100","Census Tract 8391, Cook County, Illinois",7545,101000,4113,774,20,1794,0,656,54.5,10.3,0.3,23.8,0,8.7,45.5,3780,1112,2668,29.42,70.58,0,1112,0,2668,0,3780,0,0,0,"25% - 50% P.O.C.","$98000 or more"
"17031839200","Census Tract 8392, Cook County, Illinois",2405,35707,301,1382,0,449,0,98,12.5,57.5,0,18.7,0,4.1,87.5,1425,561,864,39.37,60.63,17,544,0,864,17,1408,3,0,1.2,"75% or more P.O.C.","Less than $49000"
"17031839500","Census Tract 8395, Cook County, Illinois",1461,19950,265,992,0,72,0,53,18.1,67.9,0,4.9,0,3.6,81.9,724,292,432,40.33,59.67,18,274,0,432,18,706,6.2,0,2.5,"75% or more P.O.C.","Less than $49000"
"17031839600","Census Tract 8396, Cook County, Illinois",1653,32401,53,1466,0,0,0,122,3.2,88.7,0,0,0,7.4,96.8,773,314,459,40.62,59.38,17,297,0,459,17,756,5.4,0,2.2,"75% or more P.O.C.","Less than $49000"
"17031839700","Census Tract 8397, Cook County, Illinois",4913,58974,1827,13,22,1367,0,1624,37.2,0.3,0.4,27.8,0,33.1,62.8,1862,862,1000,46.29,53.71,151,711,84,916,235,1627,17.5,8.4,12.6,"50% - 75% P.O.C.","$49000 - $70000"
"17031839800","Census Tract 8398, Cook County, Illinois",2738,60590,1365,79,0,737,0,536,49.9,2.9,0,26.9,0,19.6,50.1,1159,448,711,38.65,61.35,48,400,17,694,65,1094,10.7,2.4,5.6,"50% - 75% P.O.C.","$49000 - $70000"
"17031839900","Census Tract 8399, Cook County, Illinois",4452,64912,2047,218,0,855,0,1258,46,4.9,0,19.2,0,28.3,54,1818,1014,804,55.78,44.22,98,916,32,772,130,1688,9.7,4,7.2,"50% - 75% P.O.C.","$49000 - $70000"
"17031840000","Census Tract 8400, Cook County, Illinois",2794,85143,998,9,0,1173,0,606,35.7,0.3,0,42,0,21.7,64.3,976,601,375,61.58,38.42,117,484,22,353,139,837,19.5,5.9,14.2,"50% - 75% P.O.C.","$70000 - $98000"
"17031840100","Census Tract 8401, Cook County, Illinois",3508,50469,733,58,0,2277,0,328,20.9,1.7,0,64.9,0,9.4,79.1,1118,439,679,39.27,60.73,87,352,86,593,173,945,19.8,12.7,15.5,"75% or more P.O.C.","$49000 - $70000"
"17031840200","Census Tract 8402, Cook County, Illinois",2419,61806,530,51,0,1393,0,386,21.9,2.1,0,57.6,0,16,78.1,831,530,301,63.78,36.22,101,429,9,292,110,721,19.1,3,13.2,"75% or more P.O.C.","$49000 - $70000"
"17031840300","Census Tract 8403, Cook County, Illinois",3511,50607,569,111,0,623,0,2208,16.2,3.2,0,17.7,0,62.9,83.8,1205,800,405,66.39,33.61,148,652,33,372,181,1024,18.5,8.1,15,"75% or more P.O.C.","$49000 - $70000"
"17031840400","Census Tract 8404, Cook County, Illinois",3106,44550,630,1,0,1407,0,1054,20.3,0,0,45.3,0,33.9,79.7,1147,775,372,67.57,32.43,143,632,0,372,143,1004,18.5,0,12.5,"75% or more P.O.C.","Less than $49000"
"17031840700","Census Tract 8407, Cook County, Illinois",3592,43207,345,265,0,29,0,2899,9.6,7.4,0,0.8,0,80.7,90.4,1085,420,665,38.71,61.29,111,309,89,576,200,885,26.4,13.4,18.4,"75% or more P.O.C.","Less than $49000"
"17031840800","Census Tract 8408, Cook County, Illinois",3151,34773,16,31,0,0,0,3104,0.5,1,0,0,0,98.5,99.5,838,292,546,34.84,65.16,121,171,74,472,195,643,41.4,13.6,23.3,"75% or more P.O.C.","Less than $49000"
"17031841000","Census Tract 8410, Cook County, Illinois",1043,98320,345,408,0,216,0,43,33.1,39.1,0,20.7,0,4.1,66.9,595,323,272,54.29,45.71,0,323,0,272,0,595,0,0,0,"50% - 75% P.O.C.","$98000 or more"
"17031841100","Census Tract 8411, Cook County, Illinois",7142,35723,758,44,0,6166,0,153,10.6,0.6,0,86.3,0,2.1,89.4,2726,1099,1627,40.32,59.68,167,932,182,1445,349,2377,15.2,11.2,12.8,"75% or more P.O.C.","Less than $49000"
"17031841200","Census Tract 8412, Cook County, Illinois",4586,45700,774,248,16,153,0,3395,16.9,5.4,0.3,3.3,0,74,83.1,1636,358,1278,21.88,78.12,57,301,158,1120,215,1421,15.9,12.4,13.1,"75% or more P.O.C.","Less than $49000"
"17031841300","Census Tract 8413, Cook County, Illinois",4122,54275,916,163,0,82,0,2916,22.2,4,0,2,0,70.7,77.8,1569,646,923,41.17,58.83,74,572,29,894,103,1466,11.5,3.1,6.6,"75% or more P.O.C.","$49000 - $70000"
"17031841400","Census Tract 8414, Cook County, Illinois",897,43145,31,755,0,0,0,111,3.5,84.2,0,0,0,12.4,96.5,430,162,268,37.67,62.33,6,156,12,256,18,412,3.7,4.5,4.2,"75% or more P.O.C.","Less than $49000"
"17031841500","Census Tract 8415, Cook County, Illinois",2689,31944,33,2545,0,11,0,100,1.2,94.6,0,0.4,0,3.7,98.8,868,245,623,28.23,71.77,18,227,74,549,92,776,7.3,11.9,10.6,"75% or more P.O.C.","Less than $49000"
"17031841600","Census Tract 8416, Cook County, Illinois",579,24848,3,417,0,0,0,159,0.5,72,0,0,0,27.5,99.5,243,54,189,22.22,77.78,0,54,13,176,13,230,0,6.9,5.3,"75% or more P.O.C.","Less than $49000"
"17031841700","Census Tract 8417, Cook County, Illinois",1651,18810,66,854,0,0,0,729,4,51.7,0,0,0,44.2,96,649,118,531,18.18,81.82,10,108,58,473,68,581,8.5,10.9,10.5,"75% or more P.O.C.","Less than $49000"
"17031841800","Census Tract 8418, Cook County, Illinois",2428,37176,27,2276,0,0,0,87,1.1,93.7,0,0,0,3.6,98.9,937,434,503,46.32,53.68,16,418,47,456,63,874,3.7,9.3,6.7,"75% or more P.O.C.","Less than $49000"
"17031841900","Census Tract 8419, Cook County, Illinois",6539,114350,2998,1214,17,1405,16,730,45.8,18.6,0.3,21.5,0.2,11.2,54.2,1633,1026,607,62.83,37.17,61,965,0,607,61,1572,5.9,0,3.7,"50% - 75% P.O.C.","$98000 or more"
"17031842000","Census Tract 8420, Cook County, Illinois",3164,99583,1162,963,0,715,0,221,36.7,30.4,0,22.6,0,7,63.3,362,272,90,75.14,24.86,17,255,0,90,17,345,6.2,0,4.7,"50% - 75% P.O.C.","$98000 or more"
"17031842100","Census Tract 8421, Cook County, Illinois",7865,38603,329,3127,0,80,0,4260,4.2,39.8,0,1,0,54.2,95.8,2176,1117,1059,51.33,48.67,276,841,192,867,468,1708,24.7,18.1,21.5,"75% or more P.O.C.","Less than $49000"
"17031842200","Census Tract 8422, Cook County, Illinois",3362,86250,2164,501,0,174,0,465,64.4,14.9,0,5.2,0,13.8,35.6,2075,638,1437,30.75,69.25,0,638,0,1437,0,2075,0,0,0,"25% - 50% P.O.C.","$70000 - $98000"
"17031842300","Census Tract 8423, Cook County, Illinois",3199,142550,2060,442,0,199,0,395,64.4,13.8,0,6.2,0,12.3,35.6,1493,841,652,56.33,43.67,25,816,29,623,54,1439,3,4.4,3.6,"25% - 50% P.O.C.","$98000 or more"
"17031842400","Census Tract 8424, Cook County, Illinois",3082,47669,20,2992,0,53,0,17,0.6,97.1,0,1.7,0,0.6,99.4,1245,888,357,71.33,28.67,116,772,22,335,138,1107,13.1,6.2,11.1,"75% or more P.O.C.","Less than $49000"
"17031842500","Census Tract 8425, Cook County, Illinois",2052,11146,2,2031,0,0,0,19,0.1,99,0,0,0,0.9,99.9,868,74,794,8.53,91.47,9,65,52,742,61,807,12.2,6.5,7,"75% or more P.O.C.","Less than $49000"
"17031842600","Census Tract 8426, Cook County, Illinois",4313,76616,2336,129,1,212,0,1584,54.2,3,0,4.9,0,36.7,45.8,1449,815,634,56.25,43.75,122,693,68,566,190,1259,15,10.7,13.1,"25% - 50% P.O.C.","$70000 - $98000"
"17031842800","Census Tract 8428, Cook County, Illinois",7068,36439,290,0,0,510,0,6248,4.1,0,0,7.2,0,88.4,95.9,1998,795,1203,39.79,60.21,191,604,334,869,525,1473,24,27.8,26.3,"75% or more P.O.C.","Less than $49000"
"17031842900","Census Tract 8429, Cook County, Illinois",2556,20068,264,1803,11,180,0,186,10.3,70.5,0.4,7,0,7.3,89.7,1181,179,1002,15.16,84.84,0,179,0,1002,0,1181,0,0,0,"75% or more P.O.C.","Less than $49000"
"17031843000","Census Tract 8430, Cook County, Illinois",2457,19792,127,2252,0,0,0,48,5.2,91.7,0,0,0,2,94.8,917,149,768,16.25,83.75,5,144,117,651,122,795,3.4,15.2,13.3,"75% or more P.O.C.","Less than $49000"
"17031843100","Census Tract 8431, Cook County, Illinois",1575,22566,167,1269,0,0,0,104,10.6,80.6,0,0,0,6.6,89.4,465,84,381,18.06,81.94,16,68,81,300,97,368,19,21.3,20.9,"75% or more P.O.C.","Less than $49000"
"17031843200","Census Tract 8432, Cook County, Illinois",2375,49451,562,88,0,10,0,1695,23.7,3.7,0,0.4,0,71.4,76.3,924,267,657,28.9,71.1,38,229,32,625,70,854,14.2,4.9,7.6,"75% or more P.O.C.","$49000 - $70000"
"17031843300","Census Tract 8433, Cook County, Illinois",1877,50486,150,1272,0,8,0,442,8,67.8,0,0.4,0,23.5,92,419,112,307,26.73,73.27,6,106,0,307,6,413,5.4,0,1.4,"75% or more P.O.C.","$49000 - $70000"
"17031843400","Census Tract 8434, Cook County, Illinois",1310,29028,71,862,0,0,0,377,5.4,65.8,0,0,0,28.8,94.6,512,202,310,39.45,60.55,13,189,37,273,50,462,6.4,11.9,9.8,"75% or more P.O.C.","Less than $49000"
"17031843500","Census Tract 8435, Cook County, Illinois",10169,29375,1054,6417,0,27,0,2671,10.4,63.1,0,0.3,0,26.3,89.6,285,99,186,34.74,65.26,30,69,65,121,95,190,30.3,34.9,33.3,"75% or more P.O.C.","Less than $49000"
"17031843600","Census Tract 8436, Cook County, Illinois",2898,39167,98,2431,0,26,0,230,3.4,83.9,0,0.9,0,7.9,96.6,1404,307,1097,21.87,78.13,0,307,32,1065,32,1372,0,2.9,2.3,"75% or more P.O.C.","Less than $49000"
"17031843700","Census Tract 8437, Cook County, Illinois",2527,114886,1485,96,0,170,0,650,58.8,3.8,0,6.7,0,25.7,41.2,992,627,365,63.21,36.79,76,551,21,344,97,895,12.1,5.8,9.8,"25% - 50% P.O.C.","$98000 or more"
"17031843800","Census Tract 8438, Cook County, Illinois",1520,36042,324,971,0,111,0,106,21.3,63.9,0,7.3,0,7,78.7,683,364,319,53.29,46.71,22,342,0,319,22,661,6,0,3.2,"75% or more P.O.C.","Less than $49000"
"17031843900","Census Tract 8439, Cook County, Illinois",3430,33028,171,3089,11,59,0,38,5,90.1,0.3,1.7,0,1.1,95,1935,584,1351,30.18,69.82,2,582,10,1341,12,1923,0.3,0.7,0.6,"75% or more P.O.C.","Less than $49000"
"17031980000","Census Tract 9800, Cook County, Illinois",0,NA,0,0,0,0,0,0,NA,NA,NA,NA,NA,NA,NA,0,0,0,NA,NA,0,0,0,0,0,0,NA,NA,NA,"N/A","N/A"
"17031980100","Census Tract 9801, Cook County, Illinois",0,NA,0,0,0,0,0,0,NA,NA,NA,NA,NA,NA,NA,0,0,0,NA,NA,0,0,0,0,0,0,NA,NA,NA,"N/A","N/A"
"17031990000","Census Tract 9900, Cook County, Illinois",0,NA,0,0,0,0,0,0,NA,NA,NA,NA,NA,NA,NA,0,0,0,NA,NA,0,0,0,0,0,0,NA,NA,NA,"N/A","N/A"
"17043840000","Census Tract 8400, DuPage County, Illinois",2812,64009,955,88,0,93,0,1645,34,3.1,0,3.3,0,58.5,66,848,528,320,62.26,37.74,123,405,37,283,160,688,23.3,11.6,18.9,"50% - 75% P.O.C.","$49000 - $70000"
"17043840101","Census Tract 8401.01, DuPage County, Illinois",5516,73276,3045,35,0,200,0,2172,55.2,0.6,0,3.6,0,39.4,44.8,1806,1511,295,83.67,16.33,207,1304,42,253,249,1557,13.7,14.2,13.8,"25% - 50% P.O.C.","$70000 - $98000"
"17043840102","Census Tract 8401.02, DuPage County, Illinois",4381,64886,2927,217,0,305,0,883,66.8,5,0,7,0,20.2,33.2,1631,1127,504,69.1,30.9,89,1038,8,496,97,1534,7.9,1.6,5.9,"25% - 50% P.O.C.","$49000 - $70000"
"17043840103","Census Tract 8401.03, DuPage County, Illinois",6325,85203,4058,42,0,1092,0,1004,64.2,0.7,0,17.3,0,15.9,35.8,2252,1819,433,80.77,19.23,220,1599,47,386,267,1985,12.1,10.9,11.9,"25% - 50% P.O.C.","$70000 - $98000"
"17043840104","Census Tract 8401.04, DuPage County, Illinois",5690,49547,1947,157,0,0,13,3461,34.2,2.8,0,0,0.2,60.8,65.8,2001,1034,967,51.67,48.33,112,922,107,860,219,1782,10.8,11.1,10.9,"50% - 75% P.O.C.","$49000 - $70000"
"17043840201","Census Tract 8402.01, DuPage County, Illinois",6479,107133,5202,81,0,578,0,564,80.3,1.3,0,8.9,0,8.7,19.7,2566,2152,414,83.87,16.13,56,2096,0,414,56,2510,2.6,0,2.2,"Less than 25% P.O.C.","$98000 or more"
"17043840202","Census Tract 8402.02, DuPage County, Illinois",5681,99327,4146,10,0,512,0,947,73,0.2,0,9,0,16.7,27,1850,1798,52,97.19,2.81,222,1576,10,42,232,1618,12.3,19.2,12.5,"25% - 50% P.O.C.","$98000 or more"
"17043840303","Census Tract 8403.03, DuPage County, Illinois",3779,59000,1864,88,0,194,0,1633,49.3,2.3,0,5.1,0,43.2,50.7,1530,859,671,56.14,43.86,65,794,108,563,173,1357,7.6,16.1,11.3,"50% - 75% P.O.C.","$49000 - $70000"
"17043840304","Census Tract 8403.04, DuPage County, Illinois",3906,91011,3138,1,0,292,0,401,80.3,0,0,7.5,0,10.3,19.7,1468,1246,222,84.88,15.12,76,1170,0,222,76,1392,6.1,0,5.2,"Less than 25% P.O.C.","$70000 - $98000"
"17043840600","Census Tract 8406, DuPage County, Illinois",5287,119471,4538,21,0,149,0,479,85.8,0.4,0,2.8,0,9.1,14.2,1801,1340,461,74.4,25.6,168,1172,30,431,198,1603,12.5,6.5,11,"Less than 25% P.O.C.","$98000 or more"
"17043840703","Census Tract 8407.03, DuPage County, Illinois",4207,61567,1893,218,0,273,0,1792,45,5.2,0,6.5,0,42.6,55,1707,616,1091,36.09,63.91,35,581,55,1036,90,1617,5.7,5,5.3,"50% - 75% P.O.C.","$49000 - $70000"
"17043840704","Census Tract 8407.04, DuPage County, Illinois",3152,56425,1549,107,0,71,11,1414,49.1,3.4,0,2.3,0.3,44.9,50.9,1145,486,659,42.45,57.55,88,398,52,607,140,1005,18.1,7.9,12.2,"50% - 75% P.O.C.","$49000 - $70000"
"17043840705","Census Tract 8407.05, DuPage County, Illinois",4064,98636,2447,88,0,470,0,957,60.2,2.2,0,11.6,0,23.5,39.8,1266,1070,196,84.52,15.48,159,911,15,181,174,1092,14.9,7.7,13.7,"25% - 50% P.O.C.","$98000 or more"
"17043840706","Census Tract 8407.06, DuPage County, Illinois",3420,101406,2297,125,0,466,0,429,67.2,3.7,0,13.6,0,12.5,32.8,1167,1037,130,88.86,11.14,128,909,6,124,134,1033,12.3,4.6,11.5,"25% - 50% P.O.C.","$98000 or more"
"17043840801","Census Tract 8408.01, DuPage County, Illinois",2592,36125,1235,20,0,114,0,1223,47.6,0.8,0,4.4,0,47.2,52.4,909,487,422,53.58,46.42,61,426,22,400,83,826,12.5,5.2,9.1,"50% - 75% P.O.C.","Less than $49000"
"17043840802","Census Tract 8408.02, DuPage County, Illinois",5739,77557,2490,123,13,212,0,2821,43.4,2.1,0.2,3.7,0,49.2,56.6,2019,1312,707,64.98,35.02,265,1047,8,699,273,1746,20.2,1.1,13.5,"50% - 75% P.O.C.","$70000 - $98000"
"17043840901","Census Tract 8409.01, DuPage County, Illinois",3811,85784,2814,162,9,169,0,583,73.8,4.3,0.2,4.4,0,15.3,26.2,1526,914,612,59.9,40.1,104,810,53,559,157,1369,11.4,8.7,10.3,"25% - 50% P.O.C.","$70000 - $98000"
"17043840904","Census Tract 8409.04, DuPage County, Illinois",4302,49656,1321,595,0,719,0,1560,30.7,13.8,0,16.7,0,36.3,69.3,1737,525,1212,30.22,69.78,77,448,86,1126,163,1574,14.7,7.1,9.4,"50% - 75% P.O.C.","$49000 - $70000"
"17043840906","Census Tract 8409.06, DuPage County, Illinois",2940,59205,1298,689,32,517,0,336,44.1,23.4,1.1,17.6,0,11.4,55.9,1065,520,545,48.83,51.17,66,454,78,467,144,921,12.7,14.3,13.5,"50% - 75% P.O.C.","$49000 - $70000"
"17043840907","Census Tract 8409.07, DuPage County, Illinois",4419,60139,2240,108,0,1086,0,963,50.7,2.4,0,24.6,0,21.8,49.3,1721,975,746,56.65,43.35,156,819,28,718,184,1537,16,3.8,10.7,"25% - 50% P.O.C.","$49000 - $70000"
"17043840908","Census Tract 8409.08, DuPage County, Illinois",4155,75438,1621,234,0,720,0,1443,39,5.6,0,17.3,0,34.7,61,1382,1035,347,74.89,25.11,155,880,45,302,200,1182,15,13,14.5,"50% - 75% P.O.C.","$70000 - $98000"
"17043840910","Census Tract 8409.10, DuPage County, Illinois",5051,64602,2105,392,0,645,0,1684,41.7,7.8,0,12.8,0,33.3,58.3,1615,1284,331,79.5,20.5,216,1068,76,255,292,1323,16.8,23,18.1,"50% - 75% P.O.C.","$49000 - $70000"
"17043840911","Census Tract 8409.11, DuPage County, Illinois",3154,83125,1181,7,24,653,0,1192,37.4,0.2,0.8,20.7,0,37.8,62.6,897,785,112,87.51,12.49,179,606,32,80,211,686,22.8,28.6,23.5,"50% - 75% P.O.C.","$70000 - $98000"
"17043841002","Census Tract 8410.02, DuPage County, Illinois",3056,117143,2624,32,0,313,0,70,85.9,1,0,10.2,0,2.3,14.1,1164,1036,128,89,11,73,963,0,128,73,1091,7,0,6.3,"Less than 25% P.O.C.","$98000 or more"
"17043841003","Census Tract 8410.03, DuPage County, Illinois",3489,74227,2736,248,0,157,0,291,78.4,7.1,0,4.5,0,8.3,21.6,1394,1063,331,76.26,23.74,110,953,0,331,110,1284,10.3,0,7.9,"Less than 25% P.O.C.","$70000 - $98000"
"17043841004","Census Tract 8410.04, DuPage County, Illinois",3506,85163,3077,38,0,64,13,268,87.8,1.1,0,1.8,0.4,7.6,12.2,1457,944,513,64.79,35.21,143,801,0,513,143,1314,15.1,0,9.8,"Less than 25% P.O.C.","$70000 - $98000"
"17043841102","Census Tract 8411.02, DuPage County, Illinois",6145,74128,3940,500,0,647,0,970,64.1,8.1,0,10.5,0,15.8,35.9,2333,1551,782,66.48,33.52,154,1397,83,699,237,2096,9.9,10.6,10.2,"25% - 50% P.O.C.","$70000 - $98000"
"17043841103","Census Tract 8411.03, DuPage County, Illinois",3714,87171,2784,221,0,213,0,462,75,6,0,5.7,0,12.4,25,1353,1208,145,89.28,10.72,58,1150,8,137,66,1287,4.8,5.5,4.9,"25% - 50% P.O.C.","$70000 - $98000"
"17043841104","Census Tract 8411.04, DuPage County, Illinois",4471,98661,3754,4,0,301,0,295,84,0.1,0,6.7,0,6.6,16,1462,1350,112,92.34,7.66,200,1150,7,105,207,1255,14.8,6.2,14.2,"Less than 25% P.O.C.","$98000 or more"
"17043841108","Census Tract 8411.08, DuPage County, Illinois",4725,79292,1451,1001,0,774,0,1404,30.7,21.2,0,16.4,0,29.7,69.3,1441,1098,343,76.2,23.8,204,894,118,225,322,1119,18.6,34.4,22.3,"50% - 75% P.O.C.","$70000 - $98000"
"17043841109","Census Tract 8411.09, DuPage County, Illinois",3978,67199,2218,333,0,464,0,885,55.8,8.4,0,11.7,0,22.2,44.2,1459,1009,450,69.16,30.84,123,886,48,402,171,1288,12.2,10.7,11.7,"25% - 50% P.O.C.","$49000 - $70000"
"17043841110","Census Tract 8411.10, DuPage County, Illinois",3357,96250,2738,131,0,235,0,210,81.6,3.9,0,7,0,6.3,18.4,1157,1029,128,88.94,11.06,70,959,21,107,91,1066,6.8,16.4,7.9,"Less than 25% P.O.C.","$70000 - $98000"
"17043841111","Census Tract 8411.11, DuPage County, Illinois",3506,74706,2764,21,20,477,19,161,78.8,0.6,0.6,13.6,0.5,4.6,21.2,1562,1304,258,83.48,16.52,43,1261,4,254,47,1515,3.3,1.6,3,"Less than 25% P.O.C.","$70000 - $98000"
"17043841112","Census Tract 8411.12, DuPage County, Illinois",3156,100511,2164,150,11,512,0,217,68.6,4.8,0.3,16.2,0,6.9,31.4,1138,695,443,61.07,38.93,148,547,24,419,172,966,21.3,5.4,15.1,"25% - 50% P.O.C.","$98000 or more"
"17043841113","Census Tract 8411.13, DuPage County, Illinois",3795,103403,2053,124,0,568,0,867,54.1,3.3,0,15,0,22.8,45.9,1263,896,367,70.94,29.06,129,767,98,269,227,1036,14.4,26.7,18,"25% - 50% P.O.C.","$98000 or more"
"17043841114","Census Tract 8411.14, DuPage County, Illinois",4370,99474,2739,282,13,789,0,486,62.7,6.5,0.3,18.1,0,11.1,37.3,1662,1029,633,61.91,38.09,121,908,21,612,142,1520,11.8,3.3,8.5,"25% - 50% P.O.C.","$98000 or more"
"17043841204","Census Tract 8412.04, DuPage County, Illinois",6013,86146,2159,742,0,1494,12,1198,35.9,12.3,0,24.8,0.2,19.9,64.1,1857,1591,266,85.68,14.32,188,1403,77,189,265,1592,11.8,28.9,14.3,"50% - 75% P.O.C.","$70000 - $98000"
"17043841205","Census Tract 8412.05, DuPage County, Illinois",4692,87994,2811,118,0,964,0,754,59.9,2.5,0,20.5,0,16.1,40.1,1483,1277,206,86.11,13.89,138,1139,45,161,183,1300,10.8,21.8,12.3,"25% - 50% P.O.C.","$70000 - $98000"
"17043841206","Census Tract 8412.06, DuPage County, Illinois",5124,87432,3306,223,0,570,0,997,64.5,4.4,0,11.1,0,19.5,35.5,1801,1219,582,67.68,32.32,154,1065,89,493,243,1558,12.6,15.3,13.5,"25% - 50% P.O.C.","$70000 - $98000"
"17043841207","Census Tract 8412.07, DuPage County, Illinois",3003,67405,1122,131,0,508,30,1177,37.4,4.4,0,16.9,1,39.2,62.6,883,844,39,95.58,4.42,157,687,21,18,178,705,18.6,53.8,20.2,"50% - 75% P.O.C.","$49000 - $70000"
"17043841208","Census Tract 8412.08, DuPage County, Illinois",5692,80570,2420,293,0,1016,0,1732,42.5,5.1,0,17.8,0,30.4,57.5,1978,1100,878,55.61,44.39,237,863,112,766,349,1629,21.5,12.8,17.6,"50% - 75% P.O.C.","$70000 - $98000"
"17043841209","Census Tract 8412.09, DuPage County, Illinois",3735,100795,1951,365,0,919,0,413,52.2,9.8,0,24.6,0,11.1,47.8,1347,1211,136,89.9,10.1,97,1114,42,94,139,1208,8,30.9,10.3,"25% - 50% P.O.C.","$98000 or more"
"17043841210","Census Tract 8412.10, DuPage County, Illinois",4536,69886,2008,516,0,1149,0,848,44.3,11.4,0,25.3,0,18.7,55.7,1753,617,1136,35.2,64.8,49,568,118,1018,167,1586,7.9,10.4,9.5,"50% - 75% P.O.C.","$49000 - $70000"
"17043841307","Census Tract 8413.07, DuPage County, Illinois",5959,108598,4431,184,0,592,0,644,74.4,3.1,0,9.9,0,10.8,25.6,2032,1990,42,97.93,2.07,193,1797,0,42,193,1839,9.7,0,9.5,"25% - 50% P.O.C.","$98000 or more"
"17043841308","Census Tract 8413.08, DuPage County, Illinois",4276,126886,3173,34,0,641,0,394,74.2,0.8,0,15,0,9.2,25.8,1367,1336,31,97.73,2.27,219,1117,0,31,219,1148,16.4,0,16,"25% - 50% P.O.C.","$98000 or more"
"17043841310","Census Tract 8413.10, DuPage County, Illinois",3739,156204,2760,41,0,739,0,179,73.8,1.1,0,19.8,0,4.8,26.2,1084,1078,6,99.45,0.55,182,896,0,6,182,902,16.9,0,16.8,"25% - 50% P.O.C.","$98000 or more"
"17043841312","Census Tract 8413.12, DuPage County, Illinois",3879,73500,1367,15,0,910,0,1573,35.2,0.4,0,23.5,0,40.6,64.8,1216,640,576,52.63,47.37,114,526,47,529,161,1055,17.8,8.2,13.2,"50% - 75% P.O.C.","$70000 - $98000"
"17043841313","Census Tract 8413.13, DuPage County, Illinois",2868,92563,2277,128,0,98,0,345,79.4,4.5,0,3.4,0,12,20.6,1099,884,215,80.44,19.56,62,822,13,202,75,1024,7,6,6.8,"Less than 25% P.O.C.","$70000 - $98000"
"17043841314","Census Tract 8413.14, DuPage County, Illinois",6523,122011,4358,218,0,763,0,1033,66.8,3.3,0,11.7,0,15.8,33.2,2043,1872,171,91.63,8.37,277,1595,45,126,322,1721,14.8,26.3,15.8,"25% - 50% P.O.C.","$98000 or more"
"17043841315","Census Tract 8413.15, DuPage County, Illinois",3591,79452,1512,339,0,663,0,894,42.1,9.4,0,18.5,0,24.9,57.9,1196,638,558,53.34,46.66,83,555,107,451,190,1006,13,19.2,15.9,"50% - 75% P.O.C.","$70000 - $98000"
"17043841316","Census Tract 8413.16, DuPage County, Illinois",3347,112404,2768,6,0,230,0,245,82.7,0.2,0,6.9,0,7.3,17.3,1145,1106,39,96.59,3.41,110,996,0,39,110,1035,9.9,0,9.6,"Less than 25% P.O.C.","$98000 or more"
"17043841318","Census Tract 8413.18, DuPage County, Illinois",2853,103807,1834,9,0,478,0,447,64.3,0.3,0,16.8,0,15.7,35.7,952,923,29,96.95,3.05,132,791,0,29,132,820,14.3,0,13.9,"25% - 50% P.O.C.","$98000 or more"
"17043841320","Census Tract 8413.20, DuPage County, Illinois",2583,73526,871,94,0,684,0,874,33.7,3.6,0,26.5,0,33.8,66.3,884,655,229,74.1,25.9,71,584,49,180,120,764,10.8,21.4,13.6,"50% - 75% P.O.C.","$70000 - $98000"
"17043841321","Census Tract 8413.21, DuPage County, Illinois",2621,114861,1677,45,0,656,0,160,64,1.7,0,25,0,6.1,36,857,790,67,92.18,7.82,111,679,0,67,111,746,14.1,0,13,"25% - 50% P.O.C.","$98000 or more"
"17043841322","Census Tract 8413.22, DuPage County, Illinois",4905,97674,2006,388,20,1536,47,764,40.9,7.9,0.4,31.3,1,15.6,59.1,1450,1217,233,83.93,16.07,211,1006,92,141,303,1147,17.3,39.5,20.9,"50% - 75% P.O.C.","$70000 - $98000"
"17043841323","Census Tract 8413.23, DuPage County, Illinois",2925,94408,1784,81,0,610,0,319,61,2.8,0,20.9,0,10.9,39,1086,927,159,85.36,14.64,111,816,18,141,129,957,12,11.3,11.9,"25% - 50% P.O.C.","$70000 - $98000"
"17043841324","Census Tract 8413.24, DuPage County, Illinois",2974,126410,1560,52,0,741,0,569,52.5,1.7,0,24.9,0,19.1,47.5,892,861,31,96.52,3.48,117,744,6,25,123,769,13.6,19.4,13.8,"25% - 50% P.O.C.","$98000 or more"
"17043841325","Census Tract 8413.25, DuPage County, Illinois",6000,106321,3773,17,0,1282,0,854,62.9,0.3,0,21.4,0,14.2,37.1,1983,1846,137,93.09,6.91,262,1584,32,105,294,1689,14.2,23.4,14.8,"25% - 50% P.O.C.","$98000 or more"
"17043841326","Census Tract 8413.26, DuPage County, Illinois",3318,142283,2823,60,0,215,0,167,85.1,1.8,0,6.5,0,5,14.9,1154,1040,114,90.12,9.88,137,903,2,112,139,1015,13.2,1.8,12,"Less than 25% P.O.C.","$98000 or more"
"17043841327","Census Tract 8413.27, DuPage County, Illinois",4369,132921,3752,7,0,531,7,34,85.9,0.2,0,12.2,0.2,0.8,14.1,1389,1346,43,96.9,3.1,217,1129,0,43,217,1172,16.1,0,15.6,"Less than 25% P.O.C.","$98000 or more"
"17043841401","Census Tract 8414.01, DuPage County, Illinois",6661,88558,3799,34,0,313,0,2397,57,0.5,0,4.7,0,36,43,2241,1783,458,79.56,20.44,252,1531,87,371,339,1902,14.1,19,15.1,"25% - 50% P.O.C.","$70000 - $98000"
"17043841403","Census Tract 8414.03, DuPage County, Illinois",3977,108417,3235,17,0,115,0,548,81.3,0.4,0,2.9,0,13.8,18.7,1577,1445,132,91.63,8.37,93,1352,17,115,110,1467,6.4,12.9,7,"Less than 25% P.O.C.","$98000 or more"
"17043841404","Census Tract 8414.04, DuPage County, Illinois",3249,107444,3020,14,0,87,0,114,93,0.4,0,2.7,0,3.5,7,1276,1209,67,94.75,5.25,107,1102,0,67,107,1169,8.9,0,8.4,"Less than 25% P.O.C.","$98000 or more"
"17043841501","Census Tract 8415.01, DuPage County, Illinois",6323,64605,1794,9,0,261,0,4179,28.4,0.1,0,4.1,0,66.1,71.6,1630,1210,420,74.23,25.77,377,833,135,285,512,1118,31.2,32.1,31.4,"50% - 75% P.O.C.","$49000 - $70000"
"17043841503","Census Tract 8415.03, DuPage County, Illinois",3922,85525,512,74,0,0,0,3336,13.1,1.9,0,0,0,85.1,86.9,875,791,84,90.4,9.6,372,419,35,49,407,468,47,41.7,46.5,"75% or more P.O.C.","$70000 - $98000"
"17043841504","Census Tract 8415.04, DuPage County, Illinois",3223,68569,1182,142,0,23,0,1832,36.7,4.4,0,0.7,0,56.8,63.3,965,532,433,55.13,44.87,137,395,115,318,252,713,25.8,26.6,26.1,"50% - 75% P.O.C.","$49000 - $70000"
"17043841603","Census Tract 8416.03, DuPage County, Illinois",4249,66224,2234,64,0,112,0,1825,52.6,1.5,0,2.6,0,43,47.4,1558,1086,472,69.7,30.3,67,1019,133,339,200,1358,6.2,28.2,12.8,"25% - 50% P.O.C.","$49000 - $70000"
"17043841604","Census Tract 8416.04, DuPage County, Illinois",4307,93942,2931,373,0,242,0,580,68.1,8.7,0,5.6,0,13.5,31.9,1386,844,542,60.89,39.11,182,662,128,414,310,1076,21.6,23.6,22.4,"25% - 50% P.O.C.","$70000 - $98000"
"17043841605","Census Tract 8416.05, DuPage County, Illinois",4091,66136,2188,116,0,224,0,1500,53.5,2.8,0,5.5,0,36.7,46.5,1284,958,326,74.61,25.39,82,876,138,188,220,1064,8.6,42.3,17.1,"25% - 50% P.O.C.","$49000 - $70000"
"17043841606","Census Tract 8416.06, DuPage County, Illinois",2168,101875,1899,93,0,93,0,42,87.6,4.3,0,4.3,0,1.9,12.4,956,657,299,68.72,31.28,51,606,0,299,51,905,7.8,0,5.3,"Less than 25% P.O.C.","$98000 or more"
"17043841607","Census Tract 8416.07, DuPage County, Illinois",4517,86509,3227,151,0,312,0,752,71.4,3.3,0,6.9,0,16.6,28.6,1667,1416,251,84.94,15.06,126,1290,72,179,198,1469,8.9,28.7,11.9,"25% - 50% P.O.C.","$70000 - $98000"
"17043841703","Census Tract 8417.03, DuPage County, Illinois",6999,41214,3376,1023,0,1231,0,1125,48.2,14.6,0,17.6,0,16.1,51.8,2881,786,2095,27.28,72.72,73,713,229,1866,302,2579,9.3,10.9,10.5,"50% - 75% P.O.C.","Less than $49000"
"17043841704","Census Tract 8417.04, DuPage County, Illinois",4379,143185,3556,201,6,334,0,195,81.2,4.6,0.1,7.6,0,4.5,18.8,1449,1237,212,85.37,14.63,128,1109,23,189,151,1298,10.3,10.8,10.4,"Less than 25% P.O.C.","$98000 or more"
"17043841705","Census Tract 8417.05, DuPage County, Illinois",6006,69955,3098,402,48,1725,0,515,51.6,6.7,0.8,28.7,0,8.6,48.4,2051,1393,658,67.92,32.08,132,1261,133,525,265,1786,9.5,20.2,12.9,"25% - 50% P.O.C.","$49000 - $70000"
"17043841706","Census Tract 8417.06, DuPage County, Illinois",4368,70278,1269,390,23,1572,0,1017,29.1,8.9,0.5,36,0,23.3,70.9,1558,682,876,43.77,56.23,82,600,138,738,220,1338,12,15.8,14.1,"50% - 75% P.O.C.","$70000 - $98000"
"17043841801","Census Tract 8418.01, DuPage County, Illinois",5221,110052,4130,329,0,266,0,264,79.1,6.3,0,5.1,0,5.1,20.9,1811,1428,383,78.85,21.15,222,1206,58,325,280,1531,15.5,15.1,15.5,"Less than 25% P.O.C.","$98000 or more"
"17043841802","Census Tract 8418.02, DuPage County, Illinois",5244,128527,4620,143,13,251,0,170,88.1,2.7,0.2,4.8,0,3.2,11.9,1769,1630,139,92.14,7.86,242,1388,17,122,259,1510,14.8,12.2,14.6,"Less than 25% P.O.C.","$98000 or more"
"17043841901","Census Tract 8419.01, DuPage County, Illinois",2574,150927,2310,0,0,176,0,81,89.7,0,0,6.8,0,3.1,10.3,839,822,17,97.97,2.03,143,679,7,10,150,689,17.4,41.2,17.9,"Less than 25% P.O.C.","$98000 or more"
"17043841902","Census Tract 8419.02, DuPage County, Illinois",4362,97292,3400,242,0,290,0,292,77.9,5.5,0,6.6,0,6.7,22.1,770,489,281,63.51,36.49,63,426,17,264,80,690,12.9,6,10.4,"Less than 25% P.O.C.","$70000 - $98000"
"17043842000","Census Tract 8420, DuPage County, Illinois",4156,164167,3609,28,0,84,0,273,86.8,0.7,0,2,0,6.6,13.2,1444,1368,76,94.74,5.26,172,1196,7,69,179,1265,12.6,9.2,12.4,"Less than 25% P.O.C.","$98000 or more"
"17043842100","Census Tract 8421, DuPage County, Illinois",6093,129145,5191,319,16,199,0,280,85.2,5.2,0.3,3.3,0,4.6,14.8,2297,1687,610,73.44,26.56,250,1437,30,580,280,2017,14.8,4.9,12.2,"Less than 25% P.O.C.","$98000 or more"
"17043842200","Census Tract 8422, DuPage County, Illinois",4703,86389,4248,130,0,107,0,85,90.3,2.8,0,2.3,0,1.8,9.7,2018,1376,642,68.19,31.81,168,1208,0,642,168,1850,12.2,0,8.3,"Less than 25% P.O.C.","$70000 - $98000"
"17043842300","Census Tract 8423, DuPage County, Illinois",3538,154952,3304,58,0,80,0,69,93.4,1.6,0,2.3,0,2,6.6,1219,1111,108,91.14,8.86,190,921,13,95,203,1016,17.1,12,16.7,"Less than 25% P.O.C.","$98000 or more"
"17043842400","Census Tract 8424, DuPage County, Illinois",5059,84239,3567,365,0,635,0,376,70.5,7.2,0,12.6,0,7.4,29.5,1740,1222,518,70.23,29.77,201,1021,28,490,229,1511,16.4,5.4,13.2,"25% - 50% P.O.C.","$70000 - $98000"
"17043842500","Census Tract 8425, DuPage County, Illinois",3396,123163,3045,108,0,24,0,149,89.7,3.2,0,0.7,0,4.4,10.3,1408,829,579,58.88,41.12,49,780,0,579,49,1359,5.9,0,3.5,"Less than 25% P.O.C.","$98000 or more"
"17043842601","Census Tract 8426.01, DuPage County, Illinois",4066,156964,3432,22,0,306,0,169,84.4,0.5,0,7.5,0,4.2,15.6,1372,1141,231,83.16,16.84,179,962,0,231,179,1193,15.7,0,13,"Less than 25% P.O.C.","$98000 or more"
"17043842602","Census Tract 8426.02, DuPage County, Illinois",4033,171964,3649,1,0,171,0,96,90.5,0,0,4.2,0,2.4,9.5,1320,1306,14,98.94,1.06,214,1092,0,14,214,1106,16.4,0,16.2,"Less than 25% P.O.C.","$98000 or more"
"17043842603","Census Tract 8426.03, DuPage County, Illinois",3716,96279,3071,156,0,242,0,205,82.6,4.2,0,6.5,0,5.5,17.4,1314,777,537,59.13,40.87,123,654,12,525,135,1179,15.8,2.2,10.3,"Less than 25% P.O.C.","$70000 - $98000"
"17043842604","Census Tract 8426.04, DuPage County, Illinois",4242,69046,3543,239,0,137,0,137,83.5,5.6,0,3.2,0,3.2,16.5,1929,1450,479,75.17,24.83,106,1344,18,461,124,1805,7.3,3.8,6.4,"Less than 25% P.O.C.","$49000 - $70000"
"17043842605","Census Tract 8426.05, DuPage County, Illinois",4275,105552,3436,153,8,129,0,444,80.4,3.6,0.2,3,0,10.4,19.6,1631,1386,245,84.98,15.02,140,1246,75,170,215,1416,10.1,30.6,13.2,"Less than 25% P.O.C.","$98000 or more"
"17043842702","Census Tract 8427.02, DuPage County, Illinois",4738,88854,3801,157,0,257,28,317,80.2,3.3,0,5.4,0.6,6.7,19.8,1938,997,941,51.44,48.56,118,879,33,908,151,1787,11.8,3.5,7.8,"Less than 25% P.O.C.","$70000 - $98000"
"17043842703","Census Tract 8427.03, DuPage County, Illinois",3982,117656,3323,122,0,178,0,238,83.5,3.1,0,4.5,0,6,16.5,1409,1280,129,90.84,9.16,135,1145,29,100,164,1245,10.5,22.5,11.6,"Less than 25% P.O.C.","$98000 or more"
"17043842704","Census Tract 8427.04, DuPage County, Illinois",5592,73764,3622,471,0,623,0,675,64.8,8.4,0,11.1,0,12.1,35.2,2266,1462,804,64.52,35.48,136,1326,8,796,144,2122,9.3,1,6.4,"25% - 50% P.O.C.","$70000 - $98000"
"17043842706","Census Tract 8427.06, DuPage County, Illinois",4422,102813,3620,49,0,441,0,147,81.9,1.1,0,10,0,3.3,18.1,1741,1468,273,84.32,15.68,113,1355,0,273,113,1628,7.7,0,6.5,"Less than 25% P.O.C.","$98000 or more"
"17043842708","Census Tract 8427.08, DuPage County, Illinois",2617,142708,2171,13,0,184,0,175,83,0.5,0,7,0,6.7,17,911,884,27,97.04,2.96,106,778,0,27,106,805,12,0,11.6,"Less than 25% P.O.C.","$98000 or more"
"17043842709","Census Tract 8427.09, DuPage County, Illinois",3743,94800,2701,85,0,441,0,411,72.2,2.3,0,11.8,0,11,27.8,1230,933,297,75.85,24.15,145,788,67,230,212,1018,15.5,22.6,17.2,"25% - 50% P.O.C.","$70000 - $98000"
"17043842710","Census Tract 8427.10, DuPage County, Illinois",3818,71012,2874,318,0,319,0,225,75.3,8.3,0,8.4,0,5.9,24.7,1729,1154,575,66.74,33.26,58,1096,30,545,88,1641,5,5.2,5.1,"Less than 25% P.O.C.","$70000 - $98000"
"17043842711","Census Tract 8427.11, DuPage County, Illinois",2445,142609,1974,9,0,263,0,88,80.7,0.4,0,10.8,0,3.6,19.3,916,870,46,94.98,5.02,40,830,0,46,40,876,4.6,0,4.4,"Less than 25% P.O.C.","$98000 or more"
"17043842800","Census Tract 8428, DuPage County, Illinois",4635,124010,3799,9,26,196,0,493,82,0.2,0.6,4.2,0,10.6,18,1591,1395,196,87.68,12.32,168,1227,0,196,168,1423,12,0,10.6,"Less than 25% P.O.C.","$98000 or more"
"17043842900","Census Tract 8429, DuPage County, Illinois",5769,119583,4942,96,0,252,0,378,85.7,1.7,0,4.4,0,6.6,14.3,2038,1302,736,63.89,36.11,151,1151,0,736,151,1887,11.6,0,7.4,"Less than 25% P.O.C.","$98000 or more"
"17043843000","Census Tract 8430, DuPage County, Illinois",4446,99777,3515,70,0,416,0,258,79.1,1.6,0,9.4,0,5.8,20.9,1627,1257,370,77.26,22.74,131,1126,40,330,171,1456,10.4,10.8,10.5,"Less than 25% P.O.C.","$98000 or more"
"17043843100","Census Tract 8431, DuPage County, Illinois",3948,54602,2643,274,0,177,0,851,66.9,6.9,0,4.5,0,21.6,33.1,1497,818,679,54.64,45.36,90,728,57,622,147,1350,11,8.4,9.8,"25% - 50% P.O.C.","$49000 - $70000"
"17043843200","Census Tract 8432, DuPage County, Illinois",5234,71492,2786,431,25,86,0,1847,53.2,8.2,0.5,1.6,0,35.3,46.8,1902,1344,558,70.66,29.34,116,1228,168,390,284,1618,8.6,30.1,14.9,"25% - 50% P.O.C.","$70000 - $98000"
"17043843301","Census Tract 8433.01, DuPage County, Illinois",4347,86544,2746,148,0,159,0,1246,63.2,3.4,0,3.7,0,28.7,36.8,1376,1023,353,74.35,25.65,103,920,72,281,175,1201,10.1,20.4,12.7,"25% - 50% P.O.C.","$70000 - $98000"
"17043843302","Census Tract 8433.02, DuPage County, Illinois",2815,86364,2206,168,0,150,0,265,78.4,6,0,5.3,0,9.4,21.6,1112,1026,86,92.27,7.73,72,954,9,77,81,1031,7,10.5,7.3,"Less than 25% P.O.C.","$70000 - $98000"
"17043843400","Census Tract 8434, DuPage County, Illinois",3452,96328,2568,45,0,303,0,434,74.4,1.3,0,8.8,0,12.6,25.6,1227,1009,218,82.23,17.77,92,917,35,183,127,1100,9.1,16.1,10.4,"25% - 50% P.O.C.","$70000 - $98000"
"17043843500","Census Tract 8435, DuPage County, Illinois",5534,73611,4319,124,0,197,0,722,78,2.2,0,3.6,0,13,22,2288,1525,763,66.65,33.35,165,1360,45,718,210,2078,10.8,5.9,9.2,"Less than 25% P.O.C.","$70000 - $98000"
"17043843601","Census Tract 8436.01, DuPage County, Illinois",3536,78345,2677,131,5,48,0,537,75.7,3.7,0.1,1.4,0,15.2,24.3,1229,891,338,72.5,27.5,108,783,65,273,173,1056,12.1,19.2,14.1,"Less than 25% P.O.C.","$70000 - $98000"
"17043843602","Census Tract 8436.02, DuPage County, Illinois",3085,75855,2647,106,0,120,0,212,85.8,3.4,0,3.9,0,6.9,14.2,1197,1059,138,88.47,11.53,113,946,0,138,113,1084,10.7,0,9.4,"Less than 25% P.O.C.","$70000 - $98000"
"17043843700","Census Tract 8437, DuPage County, Illinois",4212,91100,3610,146,0,63,0,312,85.7,3.5,0,1.5,0,7.4,14.3,1498,1365,133,91.12,8.88,160,1205,18,115,178,1320,11.7,13.5,11.9,"Less than 25% P.O.C.","$70000 - $98000"
"17043843800","Census Tract 8438, DuPage County, Illinois",3268,83333,2635,135,0,20,0,362,80.6,4.1,0,0.6,0,11.1,19.4,1496,992,504,66.31,33.69,75,917,0,504,75,1421,7.6,0,5,"Less than 25% P.O.C.","$70000 - $98000"
"17043843900","Census Tract 8439, DuPage County, Illinois",4232,128611,3962,0,0,122,0,120,93.6,0,0,2.9,0,2.8,6.4,1430,1257,173,87.9,12.1,211,1046,7,166,218,1212,16.8,4,15.2,"Less than 25% P.O.C.","$98000 or more"
"17043844001","Census Tract 8440.01, DuPage County, Illinois",3965,126579,3458,2,0,196,0,248,87.2,0.1,0,4.9,0,6.3,12.8,1370,1188,182,86.72,13.28,181,1007,0,182,181,1189,15.2,0,13.2,"Less than 25% P.O.C.","$98000 or more"
"17043844002","Census Tract 8440.02, DuPage County, Illinois",4529,177679,4279,19,0,115,11,71,94.5,0.4,0,2.5,0.2,1.6,5.5,1413,1367,46,96.74,3.26,246,1121,0,46,246,1167,18,0,17.4,"Less than 25% P.O.C.","$98000 or more"
"17043844100","Census Tract 8441, DuPage County, Illinois",4133,147440,3526,22,0,196,0,325,85.3,0.5,0,4.7,0,7.9,14.7,1359,1286,73,94.63,5.37,162,1124,12,61,174,1185,12.6,16.4,12.8,"Less than 25% P.O.C.","$98000 or more"
"17043844201","Census Tract 8442.01, DuPage County, Illinois",5540,88796,3618,363,0,472,0,571,65.3,6.6,0,8.5,0,10.3,34.7,1910,1534,376,80.31,19.69,197,1337,37,339,234,1676,12.8,9.8,12.3,"25% - 50% P.O.C.","$70000 - $98000"
"17043844202","Census Tract 8442.02, DuPage County, Illinois",2634,95938,2211,88,0,99,0,115,83.9,3.3,0,3.8,0,4.4,16.1,911,863,48,94.73,5.27,113,750,0,48,113,798,13.1,0,12.4,"Less than 25% P.O.C.","$70000 - $98000"
"17043844301","Census Tract 8443.01, DuPage County, Illinois",6482,76629,4241,512,0,1350,0,196,65.4,7.9,0,20.8,0,3,34.6,3329,2094,1235,62.9,37.1,87,2007,54,1181,141,3188,4.2,4.4,4.2,"25% - 50% P.O.C.","$70000 - $98000"
"17043844304","Census Tract 8443.04, DuPage County, Illinois",4008,82462,2102,143,6,1524,0,233,52.4,3.6,0.1,38,0,5.8,47.6,1698,810,888,47.7,52.3,81,729,38,850,119,1579,10,4.3,7,"25% - 50% P.O.C.","$70000 - $98000"
"17043844305","Census Tract 8443.05, DuPage County, Illinois",4034,64183,2692,233,0,735,0,180,66.7,5.8,0,18.2,0,4.5,33.3,1861,729,1132,39.17,60.83,106,623,0,1132,106,1755,14.5,0,5.7,"25% - 50% P.O.C.","$49000 - $70000"
"17043844306","Census Tract 8443.06, DuPage County, Illinois",4546,62464,1669,485,0,1234,0,939,36.7,10.7,0,27.1,0,20.7,63.3,1676,1310,366,78.16,21.84,159,1151,78,288,237,1439,12.1,21.3,14.1,"50% - 75% P.O.C.","$49000 - $70000"
"17043844307","Census Tract 8443.07, DuPage County, Illinois",3822,81563,1875,305,0,1041,0,537,49.1,8,0,27.2,0,14.1,50.9,1395,769,626,55.13,44.87,49,720,109,517,158,1237,6.4,17.4,11.3,"50% - 75% P.O.C.","$70000 - $98000"
"17043844401","Census Tract 8444.01, DuPage County, Illinois",3137,129821,2638,69,14,246,0,98,84.1,2.2,0.4,7.8,0,3.1,15.9,1249,1079,170,86.39,13.61,105,974,0,170,105,1144,9.7,0,8.4,"Less than 25% P.O.C.","$98000 or more"
"17043844402","Census Tract 8444.02, DuPage County, Illinois",4791,91473,2614,570,0,1125,0,222,54.6,11.9,0,23.5,0,4.6,45.4,1887,1245,642,65.98,34.02,80,1165,8,634,88,1799,6.4,1.2,4.7,"25% - 50% P.O.C.","$70000 - $98000"
"17043844501","Census Tract 8445.01, DuPage County, Illinois",3811,81455,2600,271,0,411,0,460,68.2,7.1,0,10.8,0,12.1,31.8,1498,1087,411,72.56,27.44,77,1010,11,400,88,1410,7.1,2.7,5.9,"25% - 50% P.O.C.","$70000 - $98000"
"17043844502","Census Tract 8445.02, DuPage County, Illinois",3344,81645,1997,78,0,1043,0,99,59.7,2.3,0,31.2,0,3,40.3,1593,938,655,58.88,41.12,89,849,54,601,143,1450,9.5,8.2,9,"25% - 50% P.O.C.","$70000 - $98000"
"17043844601","Census Tract 8446.01, DuPage County, Illinois",3767,93814,2876,144,0,413,0,300,76.3,3.8,0,11,0,8,23.7,1845,1527,318,82.76,17.24,104,1423,2,316,106,1739,6.8,0.6,5.7,"Less than 25% P.O.C.","$70000 - $98000"
"17043844602","Census Tract 8446.02, DuPage County, Illinois",4844,97587,3681,205,0,577,0,270,76,4.2,0,11.9,0,5.6,24,2007,1406,601,70.05,29.95,168,1238,0,601,168,1839,11.9,0,8.4,"Less than 25% P.O.C.","$70000 - $98000"
"17043844701","Census Tract 8447.01, DuPage County, Illinois",4258,84250,3827,11,0,150,0,187,89.9,0.3,0,3.5,0,4.4,10.1,1586,1372,214,86.51,13.49,113,1259,12,202,125,1461,8.2,5.6,7.9,"Less than 25% P.O.C.","$70000 - $98000"
"17043844702","Census Tract 8447.02, DuPage County, Illinois",5687,151250,4698,52,0,596,0,202,82.6,0.9,0,10.5,0,3.6,17.4,1900,1632,268,85.89,14.11,180,1452,24,244,204,1696,11,9,10.7,"Less than 25% P.O.C.","$98000 or more"
"17043844801","Census Tract 8448.01, DuPage County, Illinois",4191,126389,3785,8,0,226,0,106,90.3,0.2,0,5.4,0,2.5,9.7,1522,1344,178,88.3,11.7,109,1235,0,178,109,1413,8.1,0,7.2,"Less than 25% P.O.C.","$98000 or more"
"17043844802","Census Tract 8448.02, DuPage County, Illinois",3189,89773,3005,0,0,49,0,96,94.2,0,0,1.5,0,3,5.8,1324,1140,184,86.1,13.9,118,1022,10,174,128,1196,10.4,5.4,9.7,"Less than 25% P.O.C.","$70000 - $98000"
"17043844901","Census Tract 8449.01, DuPage County, Illinois",3616,105972,3212,29,0,137,1,222,88.8,0.8,0,3.8,0,6.1,11.2,1433,1051,382,73.34,26.66,141,910,33,349,174,1259,13.4,8.6,12.1,"Less than 25% P.O.C.","$98000 or more"
"17043844902","Census Tract 8449.02, DuPage County, Illinois",4092,112228,3575,136,0,195,0,113,87.4,3.3,0,4.8,0,2.8,12.6,1635,1146,489,70.09,29.91,175,971,0,489,175,1460,15.3,0,10.7,"Less than 25% P.O.C.","$98000 or more"
"17043845000","Census Tract 8450, DuPage County, Illinois",6329,81154,4491,365,0,197,0,1147,71,5.8,0,3.1,0,18.1,29,2294,1490,804,64.95,35.05,174,1316,140,664,314,1980,11.7,17.4,13.7,"25% - 50% P.O.C.","$70000 - $98000"
"17043845100","Census Tract 8451, DuPage County, Illinois",6469,166625,5391,1,13,492,0,418,83.3,0,0.2,7.6,0,6.5,16.7,2198,2049,149,93.22,6.78,206,1843,0,149,206,1992,10.1,0,9.4,"Less than 25% P.O.C.","$98000 or more"
"17043845200","Census Tract 8452, DuPage County, Illinois",5028,212250,4480,0,0,276,0,191,89.1,0,0,5.5,0,3.8,10.9,1588,1438,150,90.55,9.45,207,1231,37,113,244,1344,14.4,24.7,15.4,"Less than 25% P.O.C.","$98000 or more"
"17043845300","Census Tract 8453, DuPage County, Illinois",3368,250001,2955,27,0,202,15,84,87.7,0.8,0,6,0.4,2.5,12.3,1001,942,59,94.11,5.89,171,771,13,46,184,817,18.2,22,18.4,"Less than 25% P.O.C.","$98000 or more"
"17043845401","Census Tract 8454.01, DuPage County, Illinois",3715,169444,2694,129,0,758,0,114,72.5,3.5,0,20.4,0,3.1,27.5,1454,1256,198,86.38,13.62,93,1163,25,173,118,1336,7.4,12.6,8.1,"25% - 50% P.O.C.","$98000 or more"
"17043845402","Census Tract 8454.02, DuPage County, Illinois",3026,116875,2180,0,0,662,0,137,72,0,0,21.9,0,4.5,28,1135,900,235,79.3,20.7,86,814,9,226,95,1040,9.6,3.8,8.4,"25% - 50% P.O.C.","$98000 or more"
"17043845502","Census Tract 8455.02, DuPage County, Illinois",4918,70489,3552,146,0,603,0,541,72.2,3,0,12.3,0,11,27.8,2554,1410,1144,55.21,44.79,110,1300,35,1109,145,2409,7.8,3.1,5.7,"25% - 50% P.O.C.","$70000 - $98000"
"17043845505","Census Tract 8455.05, DuPage County, Illinois",4346,80223,2635,189,0,830,0,631,60.6,4.3,0,19.1,0,14.5,39.4,1569,991,578,63.16,36.84,149,842,40,538,189,1380,15,6.9,12,"25% - 50% P.O.C.","$70000 - $98000"
"17043845506","Census Tract 8455.06, DuPage County, Illinois",3624,47244,2064,119,0,488,0,875,57,3.3,0,13.5,0,24.1,43,1755,998,757,56.87,43.13,40,958,43,714,83,1672,4,5.7,4.7,"25% - 50% P.O.C.","Less than $49000"
"17043845507","Census Tract 8455.07, DuPage County, Illinois",3335,102308,2930,31,0,141,0,216,87.9,0.9,0,4.2,0,6.5,12.1,1332,1288,44,96.7,3.3,101,1187,0,44,101,1231,7.8,0,7.6,"Less than 25% P.O.C.","$98000 or more"
"17043845508","Census Tract 8455.08, DuPage County, Illinois",3721,66094,3025,13,0,514,0,101,81.3,0.3,0,13.8,0,2.7,18.7,1737,1560,177,89.81,10.19,34,1526,12,165,46,1691,2.2,6.8,2.6,"Less than 25% P.O.C.","$49000 - $70000"
"17043845509","Census Tract 8455.09, DuPage County, Illinois",3260,124063,1518,84,0,1428,0,168,46.6,2.6,0,43.8,0,5.2,53.4,1237,1075,162,86.9,13.1,75,1000,0,162,75,1162,7,0,6.1,"50% - 75% P.O.C.","$98000 or more"
"17043845510","Census Tract 8455.10, DuPage County, Illinois",3292,69732,2053,196,0,841,0,145,62.4,6,0,25.5,0,4.4,37.6,1514,582,932,38.44,61.56,65,517,17,915,82,1432,11.2,1.8,5.4,"25% - 50% P.O.C.","$49000 - $70000"
"17043845601","Census Tract 8456.01, DuPage County, Illinois",4133,69769,2949,211,0,195,0,659,71.4,5.1,0,4.7,0,15.9,28.6,1711,1091,620,63.76,36.24,117,974,0,620,117,1594,10.7,0,6.8,"25% - 50% P.O.C.","$49000 - $70000"
"17043845602","Census Tract 8456.02, DuPage County, Illinois",4994,88795,3988,360,0,323,0,285,79.9,7.2,0,6.5,0,5.7,20.1,2063,1270,793,61.56,38.44,160,1110,0,793,160,1903,12.6,0,7.8,"Less than 25% P.O.C.","$70000 - $98000"
"17043845701","Census Tract 8457.01, DuPage County, Illinois",4001,112958,3544,0,0,188,0,261,88.6,0,0,4.7,0,6.5,11.4,1475,1389,86,94.17,5.83,119,1270,0,86,119,1356,8.6,0,8.1,"Less than 25% P.O.C.","$98000 or more"
"17043845702","Census Tract 8457.02, DuPage County, Illinois",4617,131134,3969,42,0,161,0,393,86,0.9,0,3.5,0,8.5,14,1657,1581,76,95.41,4.59,128,1453,25,51,153,1504,8.1,32.9,9.2,"Less than 25% P.O.C.","$98000 or more"
"17043845703","Census Tract 8457.03, DuPage County, Illinois",4692,75291,2988,492,0,843,0,344,63.7,10.5,0,18,0,7.3,36.3,1997,1176,821,58.89,41.11,98,1078,17,804,115,1882,8.3,2.1,5.8,"25% - 50% P.O.C.","$70000 - $98000"
"17043845704","Census Tract 8457.04, DuPage County, Illinois",4872,68713,3467,730,0,244,0,310,71.2,15,0,5,0,6.4,28.8,2061,1454,607,70.55,29.45,65,1389,76,531,141,1920,4.5,12.5,6.8,"25% - 50% P.O.C.","$49000 - $70000"
"17043845802","Census Tract 8458.02, DuPage County, Illinois",3649,95815,3132,110,0,277,0,108,85.8,3,0,7.6,0,3,14.2,1597,1510,87,94.55,5.45,60,1450,6,81,66,1531,4,6.9,4.1,"Less than 25% P.O.C.","$70000 - $98000"
"17043845803","Census Tract 8458.03, DuPage County, Illinois",5576,58877,2129,1950,0,494,0,922,38.2,35,0,8.9,0,16.5,61.8,1957,1466,491,74.91,25.09,35,1431,11,480,46,1911,2.4,2.2,2.4,"50% - 75% P.O.C.","$49000 - $70000"
"17043845805","Census Tract 8458.05, DuPage County, Illinois",3679,92734,2966,0,0,474,0,172,80.6,0,0,12.9,0,4.7,19.4,1544,1181,363,76.49,23.51,72,1109,20,343,92,1452,6.1,5.5,6,"Less than 25% P.O.C.","$70000 - $98000"
"17043845807","Census Tract 8458.07, DuPage County, Illinois",6303,100250,4694,323,0,533,0,262,74.5,5.1,0,8.5,0,4.2,25.5,2572,2193,379,85.26,14.74,168,2025,0,379,168,2404,7.7,0,6.5,"25% - 50% P.O.C.","$98000 or more"
"17043845808","Census Tract 8458.08, DuPage County, Illinois",3618,137414,2442,72,0,741,0,246,67.5,2,0,20.5,0,6.8,32.5,1172,1172,0,100,0,164,1008,0,0,164,1008,14,NA,14,"25% - 50% P.O.C.","$98000 or more"
"17043845809","Census Tract 8458.09, DuPage County, Illinois",4361,104541,3168,159,22,705,0,211,72.6,3.6,0.5,16.2,0,4.8,27.4,1587,1436,151,90.49,9.51,55,1381,12,139,67,1520,3.8,7.9,4.2,"25% - 50% P.O.C.","$98000 or more"
"17043845810","Census Tract 8458.10, DuPage County, Illinois",3887,73620,2976,213,0,337,0,301,76.6,5.5,0,8.7,0,7.7,23.4,1791,1080,711,60.3,39.7,34,1046,60,651,94,1697,3.1,8.4,5.2,"Less than 25% P.O.C.","$70000 - $98000"
"17043845811","Census Tract 8458.11, DuPage County, Illinois",3922,85139,2869,260,7,325,0,372,73.2,6.6,0.2,8.3,0,9.5,26.8,1523,1023,500,67.17,32.83,47,976,44,456,91,1432,4.6,8.8,6,"25% - 50% P.O.C.","$70000 - $98000"
"17043845901","Census Tract 8459.01, DuPage County, Illinois",3240,146786,2393,0,0,563,0,168,73.9,0,0,17.4,0,5.2,26.1,1184,1116,68,94.26,5.74,77,1039,0,68,77,1107,6.9,0,6.5,"25% - 50% P.O.C.","$98000 or more"
"17043845902","Census Tract 8459.02, DuPage County, Illinois",3477,120625,2471,101,0,792,0,43,71.1,2.9,0,22.8,0,1.2,28.9,1354,1244,110,91.88,8.12,118,1126,0,110,118,1236,9.5,0,8.7,"25% - 50% P.O.C.","$98000 or more"
"17043846002","Census Tract 8460.02, DuPage County, Illinois",4655,67857,3751,237,0,188,0,291,80.6,5.1,0,4,0,6.3,19.4,2562,1875,687,73.19,26.81,111,1764,0,687,111,2451,5.9,0,4.3,"Less than 25% P.O.C.","$49000 - $70000"
"17043846003","Census Tract 8460.03, DuPage County, Illinois",4180,84776,3516,51,0,328,0,201,84.1,1.2,0,7.8,0,4.8,15.9,1875,1354,521,72.21,27.79,97,1257,12,509,109,1766,7.2,2.3,5.8,"Less than 25% P.O.C.","$70000 - $98000"
"17043846004","Census Tract 8460.04, DuPage County, Illinois",3287,75625,2835,49,0,193,0,196,86.2,1.5,0,5.9,0,6,13.8,1518,625,893,41.17,58.83,76,549,0,893,76,1442,12.2,0,5,"Less than 25% P.O.C.","$70000 - $98000"
"17043846102","Census Tract 8461.02, DuPage County, Illinois",4509,77109,2653,534,17,697,0,487,58.8,11.8,0.4,15.5,0,10.8,41.2,2002,751,1251,37.51,62.49,74,677,59,1192,133,1869,9.9,4.7,6.6,"25% - 50% P.O.C.","$70000 - $98000"
"17043846103","Census Tract 8461.03, DuPage County, Illinois",5587,127264,4424,176,0,511,0,331,79.2,3.2,0,9.1,0,5.9,20.8,1910,1320,590,69.11,30.89,128,1192,47,543,175,1735,9.7,8,9.2,"Less than 25% P.O.C.","$98000 or more"
"17043846104","Census Tract 8461.04, DuPage County, Illinois",4505,114329,2994,163,0,652,0,631,66.5,3.6,0,14.5,0,14,33.5,1518,1242,276,81.82,18.18,151,1091,29,247,180,1338,12.2,10.5,11.9,"25% - 50% P.O.C.","$98000 or more"
"17043846105","Census Tract 8461.05, DuPage County, Illinois",3564,135438,2897,110,0,233,0,254,81.3,3.1,0,6.5,0,7.1,18.7,1255,1051,204,83.75,16.25,104,947,29,175,133,1122,9.9,14.2,10.6,"Less than 25% P.O.C.","$98000 or more"
"17043846106","Census Tract 8461.06, DuPage County, Illinois",3831,109777,2461,187,0,858,0,240,64.2,4.9,0,22.4,0,6.3,35.8,1579,981,598,62.13,37.87,172,809,0,598,172,1407,17.5,0,10.9,"25% - 50% P.O.C.","$98000 or more"
"17043846201","Census Tract 8462.01, DuPage County, Illinois",6191,99808,4301,330,12,764,0,345,69.5,5.3,0.2,12.3,0,5.6,30.5,2214,1665,549,75.2,24.8,104,1561,9,540,113,2101,6.2,1.6,5.1,"25% - 50% P.O.C.","$98000 or more"
"17043846202","Census Tract 8462.02, DuPage County, Illinois",6647,104828,4241,182,0,1619,0,345,63.8,2.7,0,24.4,0,5.2,36.2,2415,1576,839,65.26,34.74,137,1439,0,839,137,2278,8.7,0,5.7,"25% - 50% P.O.C.","$98000 or more"
"17043846203","Census Tract 8462.03, DuPage County, Illinois",4323,131719,3241,76,0,746,0,200,75,1.8,0,17.3,0,4.6,25,1505,1439,66,95.61,4.39,120,1319,0,66,120,1385,8.3,0,8,"25% - 50% P.O.C.","$98000 or more"
"17043846205","Census Tract 8462.05, DuPage County, Illinois",3762,147829,2949,78,0,614,0,90,78.4,2.1,0,16.3,0,2.4,21.6,1255,1121,134,89.32,10.68,176,945,12,122,188,1067,15.7,9,15,"Less than 25% P.O.C.","$98000 or more"
"17043846206","Census Tract 8462.06, DuPage County, Illinois",4359,119000,3785,117,0,161,0,163,86.8,2.7,0,3.7,0,3.7,13.2,1570,1221,349,77.77,22.23,201,1020,10,339,211,1359,16.5,2.9,13.4,"Less than 25% P.O.C.","$98000 or more"
"17043846207","Census Tract 8462.07, DuPage County, Illinois",5626,130682,4564,216,0,437,0,275,81.1,3.8,0,7.8,0,4.9,18.9,1950,1891,59,96.97,3.03,241,1650,9,50,250,1700,12.7,15.3,12.8,"Less than 25% P.O.C.","$98000 or more"
"17043846208","Census Tract 8462.08, DuPage County, Illinois",3315,157500,2708,17,17,410,0,83,81.7,0.5,0.5,12.4,0,2.5,18.3,1154,1141,13,98.87,1.13,113,1028,0,13,113,1041,9.9,0,9.8,"Less than 25% P.O.C.","$98000 or more"
"17043846209","Census Tract 8462.09, DuPage County, Illinois",4134,151188,3576,15,0,348,0,152,86.5,0.4,0,8.4,0,3.7,13.5,1267,1130,137,89.19,10.81,135,995,7,130,142,1125,11.9,5.1,11.2,"Less than 25% P.O.C.","$98000 or more"
"17043846304","Census Tract 8463.04, DuPage County, Illinois",6404,144583,3879,220,18,1996,0,124,60.6,3.4,0.3,31.2,0,1.9,39.4,2178,1985,193,91.14,8.86,224,1761,14,179,238,1940,11.3,7.3,10.9,"25% - 50% P.O.C.","$98000 or more"
"17043846305","Census Tract 8463.05, DuPage County, Illinois",5625,87341,3807,279,25,554,0,869,67.7,5,0.4,9.8,0,15.4,32.3,2183,1802,381,82.55,17.45,154,1648,43,338,197,1986,8.5,11.3,9,"25% - 50% P.O.C.","$70000 - $98000"
"17043846307","Census Tract 8463.07, DuPage County, Illinois",4641,70110,2821,394,0,626,0,518,60.8,8.5,0,13.5,0,11.2,39.2,2037,1178,859,57.83,42.17,141,1037,3,856,144,1893,12,0.3,7.1,"25% - 50% P.O.C.","$70000 - $98000"
"17043846308","Census Tract 8463.08, DuPage County, Illinois",3663,68750,1678,558,0,429,0,893,45.8,15.2,0,11.7,0,24.4,54.2,1538,1011,527,65.73,34.27,45,966,6,521,51,1487,4.5,1.1,3.3,"50% - 75% P.O.C.","$49000 - $70000"
"17043846310","Census Tract 8463.10, DuPage County, Illinois",4712,64548,2225,897,0,264,0,1219,47.2,19,0,5.6,0,25.9,52.8,1782,725,1057,40.68,59.32,70,655,104,953,174,1608,9.7,9.8,9.8,"50% - 75% P.O.C.","$49000 - $70000"
"17043846311","Census Tract 8463.11, DuPage County, Illinois",5553,100032,3920,200,0,319,0,1034,70.6,3.6,0,5.7,0,18.6,29.4,2071,1578,493,76.2,23.8,133,1445,64,429,197,1874,8.4,13,9.5,"25% - 50% P.O.C.","$98000 or more"
"17043846312","Census Tract 8463.12, DuPage County, Illinois",4458,66818,3185,256,29,330,0,629,71.4,5.7,0.7,7.4,0,14.1,28.6,2642,1482,1160,56.09,43.91,57,1425,14,1146,71,2571,3.8,1.2,2.7,"25% - 50% P.O.C.","$49000 - $70000"
"17043846313","Census Tract 8463.13, DuPage County, Illinois",4859,114569,3732,240,0,744,0,107,76.8,4.9,0,15.3,0,2.2,23.2,2226,1351,875,60.69,39.31,56,1295,37,838,93,2133,4.1,4.2,4.2,"Less than 25% P.O.C.","$98000 or more"
"17043846314","Census Tract 8463.14, DuPage County, Illinois",3332,112475,2735,84,0,308,0,185,82.1,2.5,0,9.2,0,5.6,17.9,1423,877,546,61.63,38.37,54,823,0,546,54,1369,6.2,0,3.8,"Less than 25% P.O.C.","$98000 or more"
"17043846315","Census Tract 8463.15, DuPage County, Illinois",4068,113553,3487,107,0,224,0,243,85.7,2.6,0,5.5,0,6,14.3,1520,1392,128,91.58,8.42,96,1296,24,104,120,1400,6.9,18.8,7.9,"Less than 25% P.O.C.","$98000 or more"
"17043846404","Census Tract 8464.04, DuPage County, Illinois",6279,74118,4545,560,0,278,0,831,72.4,8.9,0,4.4,0,13.2,27.6,2780,1464,1316,52.66,47.34,87,1377,109,1207,196,2584,5.9,8.3,7.1,"25% - 50% P.O.C.","$70000 - $98000"
"17043846405","Census Tract 8464.05, DuPage County, Illinois",3760,108357,2676,102,0,706,0,97,71.2,2.7,0,18.8,0,2.6,28.8,1486,1198,288,80.62,19.38,101,1097,0,288,101,1385,8.4,0,6.8,"25% - 50% P.O.C.","$98000 or more"
"17043846408","Census Tract 8464.08, DuPage County, Illinois",4059,158808,1842,287,0,1576,0,262,45.4,7.1,0,38.8,0,6.5,54.6,1301,1147,154,88.16,11.84,115,1032,9,145,124,1177,10,5.8,9.5,"50% - 75% P.O.C.","$98000 or more"
"17043846409","Census Tract 8464.09, DuPage County, Illinois",4726,130536,2733,250,0,941,0,671,57.8,5.3,0,19.9,0,14.2,42.2,1589,1417,172,89.18,10.82,208,1209,11,161,219,1370,14.7,6.4,13.8,"25% - 50% P.O.C.","$98000 or more"
"17043846410","Census Tract 8464.10, DuPage County, Illinois",5324,86834,2292,841,0,1571,0,547,43.1,15.8,0,29.5,0,10.3,56.9,2129,633,1496,29.73,70.27,86,547,53,1443,139,1990,13.6,3.5,6.5,"50% - 75% P.O.C.","$70000 - $98000"
"17043846411","Census Tract 8464.11, DuPage County, Illinois",4656,85608,2103,501,0,1338,0,667,45.2,10.8,0,28.7,0,14.3,54.8,1881,742,1139,39.45,60.55,69,673,88,1051,157,1724,9.3,7.7,8.3,"50% - 75% P.O.C.","$70000 - $98000"
"17043846412","Census Tract 8464.12, DuPage County, Illinois",4525,97775,3174,391,7,619,0,256,70.1,8.6,0.2,13.7,0,5.7,29.9,1737,975,762,56.13,43.87,49,926,63,699,112,1625,5,8.3,6.4,"25% - 50% P.O.C.","$70000 - $98000"
"17043846413","Census Tract 8464.13, DuPage County, Illinois",3500,94598,2500,161,0,518,0,185,71.4,4.6,0,14.8,0,5.3,28.6,1477,717,760,48.54,51.46,33,684,26,734,59,1418,4.6,3.4,4,"25% - 50% P.O.C.","$70000 - $98000"
"17043846504","Census Tract 8465.04, DuPage County, Illinois",6371,106850,4442,246,0,347,0,1191,69.7,3.9,0,5.4,0,18.7,30.3,2283,1320,963,57.82,42.18,95,1225,109,854,204,2079,7.2,11.3,8.9,"25% - 50% P.O.C.","$98000 or more"
"17043846507","Census Tract 8465.07, DuPage County, Illinois",2578,87838,1094,428,0,780,0,230,42.4,16.6,0,30.3,0,8.9,57.6,1120,551,569,49.2,50.8,36,515,0,569,36,1084,6.5,0,3.2,"50% - 75% P.O.C.","$70000 - $98000"
"17043846509","Census Tract 8465.09, DuPage County, Illinois",5600,84024,1893,1003,0,2006,0,624,33.8,17.9,0,35.8,0,11.1,66.2,2202,1295,907,58.81,41.19,54,1241,79,828,133,2069,4.2,8.7,6,"50% - 75% P.O.C.","$70000 - $98000"
"17043846510","Census Tract 8465.10, DuPage County, Illinois",3163,79209,1701,229,0,474,0,658,53.8,7.2,0,15,0,20.8,46.2,1215,550,665,45.27,54.73,87,463,27,638,114,1101,15.8,4.1,9.4,"25% - 50% P.O.C.","$70000 - $98000"
"17043846511","Census Tract 8465.11, DuPage County, Illinois",6503,86096,3162,524,0,546,0,2242,48.6,8.1,0,8.4,0,34.5,51.4,1900,1547,353,81.42,18.58,291,1256,21,332,312,1588,18.8,5.9,16.4,"50% - 75% P.O.C.","$70000 - $98000"
"17043846513","Census Tract 8465.13, DuPage County, Illinois",2568,137222,1479,79,0,785,0,161,57.6,3.1,0,30.6,0,6.3,42.4,900,845,55,93.89,6.11,77,768,20,35,97,803,9.1,36.4,10.8,"25% - 50% P.O.C.","$98000 or more"
"17043846514","Census Tract 8465.14, DuPage County, Illinois",4120,134116,1960,447,0,1443,0,138,47.6,10.8,0,35,0,3.3,52.4,1237,956,281,77.28,22.72,120,836,68,213,188,1049,12.6,24.2,15.2,"50% - 75% P.O.C.","$98000 or more"
"17043846515","Census Tract 8465.15, DuPage County, Illinois",5080,70190,2636,532,0,396,0,1355,51.9,10.5,0,7.8,0,26.7,48.1,1761,1040,721,59.06,40.94,107,933,36,685,143,1618,10.3,5,8.1,"25% - 50% P.O.C.","$70000 - $98000"
"17043846517","Census Tract 8465.17, DuPage County, Illinois",6019,104135,3503,347,0,1213,0,725,58.2,5.8,0,20.2,0,12,41.8,2031,1487,544,73.22,26.78,127,1360,67,477,194,1837,8.5,12.3,9.6,"25% - 50% P.O.C.","$98000 or more"
"17043846518","Census Tract 8465.18, DuPage County, Illinois",3442,160263,2561,158,0,372,0,109,74.4,4.6,0,10.8,0,3.2,25.6,1166,1122,44,96.23,3.77,141,981,0,44,141,1025,12.6,0,12.1,"25% - 50% P.O.C.","$98000 or more"
"17043846519","Census Tract 8465.19, DuPage County, Illinois",2963,99879,1709,202,0,596,0,311,57.7,6.8,0,20.1,0,10.5,42.3,1147,612,535,53.36,46.64,29,583,15,520,44,1103,4.7,2.8,3.8,"25% - 50% P.O.C.","$98000 or more"
"17043846521","Census Tract 8465.21, DuPage County, Illinois",5391,144583,4317,308,0,505,0,212,80.1,5.7,0,9.4,0,3.9,19.9,2010,1688,322,83.98,16.02,196,1492,49,273,245,1765,11.6,15.2,12.2,"Less than 25% P.O.C.","$98000 or more"
"17043846522","Census Tract 8465.22, DuPage County, Illinois",4097,112250,1787,218,18,1496,0,465,43.6,5.3,0.4,36.5,0,11.3,56.4,1588,1032,556,64.99,35.01,97,935,17,539,114,1474,9.4,3.1,7.2,"50% - 75% P.O.C.","$98000 or more"
"17043846523","Census Tract 8465.23, DuPage County, Illinois",2726,155655,2566,9,0,51,0,18,94.1,0.3,0,1.9,0,0.7,5.9,927,839,88,90.51,9.49,84,755,4,84,88,839,10,4.5,9.5,"Less than 25% P.O.C.","$98000 or more"
"17043846524","Census Tract 8465.24, DuPage County, Illinois",4802,117723,3106,293,0,962,0,337,64.7,6.1,0,20,0,7,35.3,1723,1379,344,80.03,19.97,69,1310,0,344,69,1654,5,0,4,"25% - 50% P.O.C.","$98000 or more"
"17043846603","Census Tract 8466.03, DuPage County, Illinois",4159,54127,754,60,0,298,0,3029,18.1,1.4,0,7.2,0,72.8,81.9,1336,792,544,59.28,40.72,170,622,75,469,245,1091,21.5,13.8,18.3,"75% or more P.O.C.","$49000 - $70000"
"17043846604","Census Tract 8466.04, DuPage County, Illinois",3758,70579,1733,113,0,381,0,1488,46.1,3,0,10.1,0,39.6,53.9,1333,1048,285,78.62,21.38,138,910,44,241,182,1151,13.2,15.4,13.7,"50% - 75% P.O.C.","$70000 - $98000"
"17043846701","Census Tract 8467.01, DuPage County, Illinois",4597,70417,1758,89,0,148,0,2499,38.2,1.9,0,3.2,0,54.4,61.8,1541,1067,474,69.24,30.76,207,860,8,466,215,1326,19.4,1.7,14,"50% - 75% P.O.C.","$70000 - $98000"
"17043846702","Census Tract 8467.02, DuPage County, Illinois",3990,70817,2008,140,0,307,0,1423,50.3,3.5,0,7.7,0,35.7,49.7,1260,955,305,75.79,24.21,166,789,76,229,242,1018,17.4,24.9,19.2,"25% - 50% P.O.C.","$70000 - $98000"
"17089850101","Census Tract 8501.01, Kane County, Illinois",6306,67743,2824,540,0,472,0,2405,44.8,8.6,0,7.5,0,38.1,55.2,2229,1603,626,71.92,28.08,262,1341,97,529,359,1870,16.3,15.5,16.1,"50% - 75% P.O.C.","$49000 - $70000"
"17089850103","Census Tract 8501.03, Kane County, Illinois",5863,120625,4407,34,0,832,0,461,75.2,0.6,0,14.2,0,7.9,24.8,2041,1930,111,94.56,5.44,296,1634,0,111,296,1745,15.3,0,14.5,"Less than 25% P.O.C.","$98000 or more"
"17089850105","Census Tract 8501.05, Kane County, Illinois",7032,99593,4166,293,0,1647,0,894,59.2,4.2,0,23.4,0,12.7,40.8,2357,1963,394,83.28,16.72,256,1707,41,353,297,2060,13,10.4,12.6,"25% - 50% P.O.C.","$98000 or more"
"17089850106","Census Tract 8501.06, Kane County, Illinois",8296,106700,6007,99,11,577,0,1502,72.4,1.2,0.1,7,0,18.1,27.6,2548,2307,241,90.54,9.46,470,1837,44,197,514,2034,20.4,18.3,20.2,"25% - 50% P.O.C.","$98000 or more"
"17089850201","Census Tract 8502.01, Kane County, Illinois",4424,64728,887,169,0,188,0,3151,20,3.8,0,4.2,0,71.2,80,1017,828,189,81.42,18.58,353,475,51,138,404,613,42.6,27,39.7,"75% or more P.O.C.","$49000 - $70000"
"17089850202","Census Tract 8502.02, Kane County, Illinois",6657,57606,1098,586,0,22,0,4868,16.5,8.8,0,0.3,0,73.1,83.5,1577,894,683,56.69,43.31,220,674,361,322,581,996,24.6,52.9,36.8,"75% or more P.O.C.","$49000 - $70000"
"17089850301","Census Tract 8503.01, Kane County, Illinois",8372,51059,1530,1454,13,109,0,5232,18.3,17.4,0.2,1.3,0,62.5,81.7,1962,1062,900,54.13,45.87,432,630,422,478,854,1108,40.7,46.9,43.5,"75% or more P.O.C.","$49000 - $70000"
"17089850302","Census Tract 8503.02, Kane County, Illinois",4597,55298,1991,253,0,129,19,2077,43.3,5.5,0,2.8,0.4,45.2,56.7,1594,826,768,51.82,48.18,103,723,105,663,208,1386,12.5,13.7,13,"50% - 75% P.O.C.","$49000 - $70000"
"17089850400","Census Tract 8504, Kane County, Illinois",2532,64299,1789,52,0,99,0,592,70.7,2.1,0,3.9,0,23.4,29.3,1091,842,249,77.18,22.82,85,757,11,238,96,995,10.1,4.4,8.8,"25% - 50% P.O.C.","$49000 - $70000"
"17089850500","Census Tract 8505, Kane County, Illinois",3993,73111,3209,168,0,179,0,437,80.4,4.2,0,4.5,0,10.9,19.6,1770,1144,626,64.63,35.37,119,1025,0,626,119,1651,10.4,0,6.7,"Less than 25% P.O.C.","$70000 - $98000"
"17089850600","Census Tract 8506, Kane County, Illinois",7407,103148,5731,165,9,698,0,674,77.4,2.2,0.1,9.4,0,9.1,22.6,2712,2143,569,79.02,20.98,250,1893,26,543,276,2436,11.7,4.6,10.2,"Less than 25% P.O.C.","$98000 or more"
"17089850701","Census Tract 8507.01, Kane County, Illinois",23965,102411,17272,552,0,1920,0,3635,72.1,2.3,0,8,0,15.2,27.9,7751,6983,768,90.09,9.91,991,5992,42,726,1033,6718,14.2,5.5,13.3,"25% - 50% P.O.C.","$98000 or more"
"17089850702","Census Tract 8507.02, Kane County, Illinois",13948,62351,13322,2,0,171,0,453,95.5,0,0,1.2,0,3.2,4.5,6751,6006,745,88.96,11.04,408,5598,0,745,408,6343,6.8,0,6,"Less than 25% P.O.C.","$49000 - $70000"
"17089850703","Census Tract 8507.03, Kane County, Illinois",2224,86250,2058,6,0,29,0,127,92.5,0.3,0,1.3,0,5.7,7.5,839,670,169,79.86,20.14,58,612,10,159,68,771,8.7,5.9,8.1,"Less than 25% P.O.C.","$70000 - $98000"
"17089850800","Census Tract 8508, Kane County, Illinois",6800,63730,2337,130,0,0,0,4320,34.4,1.9,0,0,0,63.5,65.6,1982,1490,492,75.18,24.82,311,1179,98,394,409,1573,20.9,19.9,20.6,"50% - 75% P.O.C.","$49000 - $70000"
"17089851000","Census Tract 8510, Kane County, Illinois",6757,51354,3387,463,3,515,0,2066,50.1,6.9,0,7.6,0,30.6,49.9,2482,1460,1022,58.82,41.18,218,1242,38,984,256,2226,14.9,3.7,10.3,"25% - 50% P.O.C.","$49000 - $70000"
"17089851101","Census Tract 8511.01, Kane County, Illinois",4417,56372,1771,482,0,27,0,1865,40.1,10.9,0,0.6,0,42.2,59.9,1528,917,611,60.01,39.99,163,754,48,563,211,1317,17.8,7.9,13.8,"50% - 75% P.O.C.","$49000 - $70000"
"17089851102","Census Tract 8511.02, Kane County, Illinois",3946,66875,1643,209,0,108,0,1955,41.6,5.3,0,2.7,0,49.5,58.4,1272,874,398,68.71,31.29,134,740,57,341,191,1081,15.3,14.3,15,"50% - 75% P.O.C.","$49000 - $70000"
"17089851301","Census Tract 8513.01, Kane County, Illinois",3766,41010,726,120,0,199,0,2657,19.3,3.2,0,5.3,0,70.6,80.7,1171,579,592,49.44,50.56,146,433,106,486,252,919,25.2,17.9,21.5,"75% or more P.O.C.","Less than $49000"
"17089851302","Census Tract 8513.02, Kane County, Illinois",3432,52368,516,332,5,34,0,2496,15,9.7,0.1,1,0,72.7,85,872,442,430,50.69,49.31,129,313,123,307,252,620,29.2,28.6,28.9,"75% or more P.O.C.","$49000 - $70000"
"17089851400","Census Tract 8514, Kane County, Illinois",6585,54722,1075,216,0,70,0,5114,16.3,3.3,0,1.1,0,77.7,83.7,1804,948,856,52.55,47.45,243,705,190,666,433,1371,25.6,22.2,24,"75% or more P.O.C.","$49000 - $70000"
"17089851500","Census Tract 8515, Kane County, Illinois",1163,55500,279,34,0,29,0,821,24,2.9,0,2.5,0,70.6,76,384,126,258,32.81,67.19,34,92,16,242,50,334,27,6.2,13,"75% or more P.O.C.","$49000 - $70000"
"17089851600","Census Tract 8516, Kane County, Illinois",6760,59286,1984,174,0,7,0,4496,29.3,2.6,0,0.1,0,66.5,70.7,2390,1410,980,59,41,204,1206,102,878,306,2084,14.5,10.4,12.8,"50% - 75% P.O.C.","$49000 - $70000"
"17089851801","Census Tract 8518.01, Kane County, Illinois",7439,83319,5245,185,0,424,0,1390,70.5,2.5,0,5.7,0,18.7,29.5,2447,2017,430,82.43,17.57,273,1744,89,341,362,2085,13.5,20.7,14.8,"25% - 50% P.O.C.","$70000 - $98000"
"17089851904","Census Tract 8519.04, Kane County, Illinois",7852,77741,4283,426,3,521,0,2564,54.5,5.4,0,6.6,0,32.7,45.5,2679,1795,884,67,33,127,1668,59,825,186,2493,7.1,6.7,6.9,"25% - 50% P.O.C.","$70000 - $98000"
"17089851905","Census Tract 8519.05, Kane County, Illinois",14174,108771,10349,68,0,1672,0,1862,73,0.5,0,11.8,0,13.1,27,5171,4842,329,93.64,6.36,545,4297,160,169,705,4466,11.3,48.6,13.6,"25% - 50% P.O.C.","$98000 or more"
"17089851907","Census Tract 8519.07, Kane County, Illinois",7798,99440,4479,330,0,699,0,2116,57.4,4.2,0,9,0,27.1,42.6,2549,2039,510,79.99,20.01,345,1694,76,434,421,2128,16.9,14.9,16.5,"25% - 50% P.O.C.","$98000 or more"
"17089851908","Census Tract 8519.08, Kane County, Illinois",5394,72139,2614,412,0,405,0,1893,48.5,7.6,0,7.5,0,35.1,51.5,1975,1682,293,85.16,14.84,178,1504,66,227,244,1731,10.6,22.5,12.4,"50% - 75% P.O.C.","$70000 - $98000"
"17089851909","Census Tract 8519.09, Kane County, Illinois",4432,75353,2635,137,0,155,0,1370,59.5,3.1,0,3.5,0,30.9,40.5,1623,1192,431,73.44,26.56,146,1046,61,370,207,1416,12.2,14.2,12.8,"25% - 50% P.O.C.","$70000 - $98000"
"17089851910","Census Tract 8519.10, Kane County, Illinois",3854,79728,2134,182,30,100,0,1218,55.4,4.7,0.8,2.6,0,31.6,44.6,1521,1114,407,73.24,26.76,95,1019,56,351,151,1370,8.5,13.8,9.9,"25% - 50% P.O.C.","$70000 - $98000"
"17089852001","Census Tract 8520.01, Kane County, Illinois",4891,85833,3946,142,13,157,0,619,80.7,2.9,0.3,3.2,0,12.7,19.3,1822,1517,305,83.26,16.74,106,1411,76,229,182,1640,7,24.9,10,"Less than 25% P.O.C.","$70000 - $98000"
"17089852002","Census Tract 8520.02, Kane County, Illinois",7084,91624,5920,73,68,175,0,808,83.6,1,1,2.5,0,11.4,16.4,2657,1959,698,73.73,26.27,165,1794,91,607,256,2401,8.4,13,9.6,"Less than 25% P.O.C.","$70000 - $98000"
"17089852003","Census Tract 8520.03, Kane County, Illinois",7722,134420,6958,101,0,357,0,227,90.1,1.3,0,4.6,0,2.9,9.9,3039,2551,488,83.94,16.06,279,2272,0,488,279,2760,10.9,0,9.2,"Less than 25% P.O.C.","$98000 or more"
"17089852101","Census Tract 8521.01, Kane County, Illinois",7146,180808,6013,271,0,414,9,365,84.1,3.8,0,5.8,0.1,5.1,15.9,2122,2102,20,99.06,0.94,420,1682,0,20,420,1702,20,0,19.8,"Less than 25% P.O.C.","$98000 or more"
"17089852102","Census Tract 8521.02, Kane County, Illinois",9160,133608,7839,91,0,401,0,637,85.6,1,0,4.4,0,7,14.4,3065,2917,148,95.17,4.83,290,2627,0,148,290,2775,9.9,0,9.5,"Less than 25% P.O.C.","$98000 or more"
"17089852201","Census Tract 8522.01, Kane County, Illinois",4573,86719,3963,54,0,168,0,202,86.7,1.2,0,3.7,0,4.4,13.3,1919,1370,549,71.39,28.61,97,1273,36,513,133,1786,7.1,6.6,6.9,"Less than 25% P.O.C.","$70000 - $98000"
"17089852202","Census Tract 8522.02, Kane County, Illinois",9212,87604,6352,400,20,292,7,1920,69,4.3,0.2,3.2,0.1,20.8,31,2972,1885,1087,63.43,36.57,270,1615,196,891,466,2506,14.3,18,15.7,"25% - 50% P.O.C.","$70000 - $98000"
"17089852300","Census Tract 8523, Kane County, Illinois",2001,62344,1777,24,0,3,0,190,88.8,1.2,0,0.1,0,9.5,11.2,1043,316,727,30.3,69.7,10,306,12,715,22,1021,3.2,1.7,2.1,"Less than 25% P.O.C.","$49000 - $70000"
"17089852401","Census Tract 8524.01, Kane County, Illinois",8677,132194,7846,76,0,346,0,354,90.4,0.9,0,4,0,4.1,9.6,2839,2712,127,95.53,4.47,412,2300,14,113,426,2413,15.2,11,15,"Less than 25% P.O.C.","$98000 or more"
"17089852402","Census Tract 8524.02, Kane County, Illinois",8609,135139,7643,128,0,190,0,438,88.8,1.5,0,2.2,0,5.1,11.2,2738,2586,152,94.45,5.55,350,2236,67,85,417,2321,13.5,44.1,15.2,"Less than 25% P.O.C.","$98000 or more"
"17089852403","Census Tract 8524.03, Kane County, Illinois",5284,96952,4941,63,4,15,0,168,93.5,1.2,0.1,0.3,0,3.2,6.5,2003,1627,376,81.23,18.77,171,1456,38,338,209,1794,10.5,10.1,10.4,"Less than 25% P.O.C.","$70000 - $98000"
"17089852500","Census Tract 8525, Kane County, Illinois",6551,95483,5549,37,0,230,0,621,84.7,0.6,0,3.5,0,9.5,15.3,2376,1896,480,79.8,20.2,137,1759,67,413,204,2172,7.2,14,8.6,"Less than 25% P.O.C.","$70000 - $98000"
"17089852601","Census Tract 8526.01, Kane County, Illinois",7835,103149,7195,83,0,130,0,383,91.8,1.1,0,1.7,0,4.9,8.2,2973,2185,788,73.49,26.51,166,2019,14,774,180,2793,7.6,1.8,6.1,"Less than 25% P.O.C.","$98000 or more"
"17089852606","Census Tract 8526.06, Kane County, Illinois",4769,122778,4393,13,0,76,0,228,92.1,0.3,0,1.6,0,4.8,7.9,1722,1423,299,82.64,17.36,177,1246,18,281,195,1527,12.4,6,11.3,"Less than 25% P.O.C.","$98000 or more"
"17089852700","Census Tract 8527, Kane County, Illinois",6774,71948,5754,158,0,79,0,652,84.9,2.3,0,1.2,0,9.6,15.1,2931,1884,1047,64.28,35.72,124,1760,44,1003,168,2763,6.6,4.2,5.7,"Less than 25% P.O.C.","$70000 - $98000"
"17089852803","Census Tract 8528.03, Kane County, Illinois",4952,87635,3849,392,0,49,0,597,77.7,7.9,0,1,0,12.1,22.3,1818,1299,519,71.45,28.55,154,1145,70,449,224,1594,11.9,13.5,12.3,"Less than 25% P.O.C.","$70000 - $98000"
"17089852805","Census Tract 8528.05, Kane County, Illinois",6025,106513,4655,98,0,48,8,719,77.3,1.6,0,0.8,0.1,11.9,22.7,2147,1905,242,88.73,11.27,210,1695,0,242,210,1937,11,0,9.8,"Less than 25% P.O.C.","$98000 or more"
"17089852806","Census Tract 8528.06, Kane County, Illinois",6893,129773,6034,72,0,262,0,454,87.5,1,0,3.8,0,6.6,12.5,2198,1947,251,88.58,11.42,382,1565,14,237,396,1802,19.6,5.6,18,"Less than 25% P.O.C.","$98000 or more"
"17089852807","Census Tract 8528.07, Kane County, Illinois",3683,123095,3129,135,15,141,0,234,85,3.7,0.4,3.8,0,6.4,15,1342,1169,173,87.11,12.89,116,1053,0,173,116,1226,9.9,0,8.6,"Less than 25% P.O.C.","$98000 or more"
"17089852808","Census Tract 8528.08, Kane County, Illinois",7542,87473,6418,66,0,240,0,721,85.1,0.9,0,3.2,0,9.6,14.9,2757,2155,602,78.16,21.84,175,1980,54,548,229,2528,8.1,9,8.3,"Less than 25% P.O.C.","$70000 - $98000"
"17089852903","Census Tract 8529.03, Kane County, Illinois",6373,59684,2937,862,33,292,0,2249,46.1,13.5,0.5,4.6,0,35.3,53.9,2717,1427,1290,52.52,47.48,19,1408,144,1146,163,2554,1.3,11.2,6,"50% - 75% P.O.C.","$49000 - $70000"
"17089852904","Census Tract 8529.04, Kane County, Illinois",2859,58646,252,421,0,12,0,2174,8.8,14.7,0,0.4,0,76,91.2,716,496,220,69.27,30.73,167,329,67,153,234,482,33.7,30.5,32.7,"75% or more P.O.C.","$49000 - $70000"
"17089852905","Census Tract 8529.05, Kane County, Illinois",4695,48526,947,702,7,151,6,2580,20.2,15,0.1,3.2,0.1,55,79.8,1424,919,505,64.54,35.46,192,727,98,407,290,1134,20.9,19.4,20.4,"75% or more P.O.C.","Less than $49000"
"17089852906","Census Tract 8529.06, Kane County, Illinois",5768,59000,2580,409,14,303,0,2404,44.7,7.1,0.2,5.3,0,41.7,55.3,2112,1369,743,64.82,35.18,188,1181,9,734,197,1915,13.7,1.2,9.3,"50% - 75% P.O.C.","$49000 - $70000"
"17089852907","Census Tract 8529.07, Kane County, Illinois",7122,60716,1177,464,0,73,0,5372,16.5,6.5,0,1,0,75.4,83.5,2179,1490,689,68.38,31.62,307,1183,156,533,463,1716,20.6,22.6,21.2,"75% or more P.O.C.","$49000 - $70000"
"17089853001","Census Tract 8530.01, Kane County, Illinois",3058,70813,1567,357,0,101,0,963,51.2,11.7,0,3.3,0,31.5,48.8,1181,1014,167,85.86,14.14,58,956,62,105,120,1061,5.7,37.1,10.2,"25% - 50% P.O.C.","$70000 - $98000"
"17089853004","Census Tract 8530.04, Kane County, Illinois",3380,58444,2334,204,0,22,0,773,69.1,6,0,0.7,0,22.9,30.9,1407,771,636,54.8,45.2,77,694,51,585,128,1279,10,8,9.1,"25% - 50% P.O.C.","$49000 - $70000"
"17089853005","Census Tract 8530.05, Kane County, Illinois",5943,47320,2190,1541,0,40,0,1997,36.9,25.9,0,0.7,0,33.6,63.1,2347,1027,1320,43.76,56.24,70,957,172,1148,242,2105,6.8,13,10.3,"50% - 75% P.O.C.","Less than $49000"
"17089853006","Census Tract 8530.06, Kane County, Illinois",3445,72813,1365,561,0,214,0,1290,39.6,16.3,0,6.2,0,37.4,60.4,1193,735,458,61.61,38.39,80,655,39,419,119,1074,10.9,8.5,10,"50% - 75% P.O.C.","$70000 - $98000"
"17089853007","Census Tract 8530.07, Kane County, Illinois",5964,60455,1564,848,0,269,116,2992,26.2,14.2,0,4.5,1.9,50.2,73.8,1834,903,931,49.24,50.76,191,712,76,855,267,1567,21.2,8.2,14.6,"50% - 75% P.O.C.","$49000 - $70000"
"17089853008","Census Tract 8530.08, Kane County, Illinois",4467,58594,1652,518,0,121,0,2025,37,11.6,0,2.7,0,45.3,63,1410,931,479,66.03,33.97,193,738,89,390,282,1128,20.7,18.6,20,"50% - 75% P.O.C.","$49000 - $70000"
"17089853100","Census Tract 8531, Kane County, Illinois",3272,57177,915,265,15,121,0,1886,28,8.1,0.5,3.7,0,57.6,72,982,753,229,76.68,23.32,125,628,65,164,190,792,16.6,28.4,19.3,"50% - 75% P.O.C.","$49000 - $70000"
"17089853200","Census Tract 8532, Kane County, Illinois",6591,47917,1393,1035,37,374,0,3684,21.1,15.7,0.6,5.7,0,55.9,78.9,2014,794,1220,39.42,60.58,166,628,275,945,441,1573,20.9,22.5,21.9,"75% or more P.O.C.","Less than $49000"
"17089853300","Census Tract 8533, Kane County, Illinois",5080,58494,1050,20,0,0,0,4010,20.7,0.4,0,0,0,78.9,79.3,1339,882,457,65.87,34.13,318,564,88,369,406,933,36.1,19.3,30.3,"75% or more P.O.C.","$49000 - $70000"
"17089853400","Census Tract 8534, Kane County, Illinois",9252,50417,198,407,0,0,0,8647,2.1,4.4,0,0,0,93.5,97.9,2260,1097,1163,48.54,51.46,355,742,344,819,699,1561,32.4,29.6,30.9,"75% or more P.O.C.","$49000 - $70000"
"17089853500","Census Tract 8535, Kane County, Illinois",6572,59074,328,758,0,33,0,5453,5,11.5,0,0.5,0,83,95,1668,1143,525,68.53,31.47,355,788,200,325,555,1113,31.1,38.1,33.3,"75% or more P.O.C.","$49000 - $70000"
"17089853600","Census Tract 8536, Kane County, Illinois",7796,38442,809,1453,0,114,0,5401,10.4,18.6,0,1.5,0,69.3,89.6,2369,1190,1179,50.23,49.77,112,1078,318,861,430,1939,9.4,27,18.2,"75% or more P.O.C.","Less than $49000"
"17089853900","Census Tract 8539, Kane County, Illinois",6131,75278,4291,320,22,96,0,1199,70,5.2,0.4,1.6,0,19.6,30,2108,1526,582,72.39,27.61,141,1385,91,491,232,1876,9.2,15.6,11,"25% - 50% P.O.C.","$70000 - $98000"
"17089854001","Census Tract 8540.01, Kane County, Illinois",4723,83688,3489,286,13,0,0,822,73.9,6.1,0.3,0,0,17.4,26.1,1709,1433,276,83.85,16.15,173,1260,32,244,205,1504,12.1,11.6,12,"25% - 50% P.O.C.","$70000 - $98000"
"17089854002","Census Tract 8540.02, Kane County, Illinois",5475,60971,1968,667,65,0,0,2598,35.9,12.2,1.2,0,0,47.5,64.1,1963,1246,717,63.47,36.53,106,1140,78,639,184,1779,8.5,10.9,9.4,"50% - 75% P.O.C.","$49000 - $70000"
"17089854100","Census Tract 8541, Kane County, Illinois",5360,44792,599,71,0,0,0,4625,11.2,1.3,0,0,0,86.3,88.8,1355,868,487,64.06,35.94,316,552,156,331,472,883,36.4,32,34.8,"75% or more P.O.C.","Less than $49000"
"17089854200","Census Tract 8542, Kane County, Illinois",5881,43192,966,555,0,18,0,4288,16.4,9.4,0,0.3,0,72.9,83.6,1640,921,719,56.16,43.84,219,702,282,437,501,1139,23.8,39.2,30.5,"75% or more P.O.C.","Less than $49000"
"17089854301","Census Tract 8543.01, Kane County, Illinois",7156,48842,728,191,0,0,6,6180,10.2,2.7,0,0,0.1,86.4,89.8,1978,1187,791,60.01,39.99,346,841,180,611,526,1452,29.1,22.8,26.6,"75% or more P.O.C.","Less than $49000"
"17089854302","Census Tract 8543.02, Kane County, Illinois",5092,54493,1233,259,0,20,0,3471,24.2,5.1,0,0.4,0,68.2,75.8,1538,992,546,64.5,35.5,248,744,68,478,316,1222,25,12.5,20.5,"75% or more P.O.C.","$49000 - $70000"
"17089854400","Census Tract 8544, Kane County, Illinois",14251,53776,4836,887,84,1165,0,7079,33.9,6.2,0.6,8.2,0,49.7,66.1,4680,2519,2161,53.82,46.18,279,2240,499,1662,778,3902,11.1,23.1,16.6,"50% - 75% P.O.C.","$49000 - $70000"
"17089854501","Census Tract 8545.01, Kane County, Illinois",15502,134664,13195,280,0,488,0,1228,85.1,1.8,0,3.1,0,7.9,14.9,5155,4647,508,90.15,9.85,707,3940,0,508,707,4448,15.2,0,13.7,"Less than 25% P.O.C.","$98000 or more"
"17089854503","Census Tract 8545.03, Kane County, Illinois",12243,115381,8541,610,0,414,19,2456,69.8,5,0,3.4,0.2,20.1,30.2,3880,3425,455,88.27,11.73,607,2818,39,416,646,3234,17.7,8.6,16.6,"25% - 50% P.O.C.","$98000 or more"
"17089854504","Census Tract 8545.04, Kane County, Illinois",8508,118652,6702,546,0,625,0,594,78.8,6.4,0,7.3,0,7,21.2,3002,2896,106,96.47,3.53,361,2535,0,106,361,2641,12.5,0,12,"Less than 25% P.O.C.","$98000 or more"
"17089854600","Census Tract 8546, Kane County, Illinois",4199,51203,1130,538,0,91,0,2392,26.9,12.8,0,2.2,0,57,73.1,1331,381,950,28.63,71.37,83,298,197,753,280,1051,21.8,20.7,21,"50% - 75% P.O.C.","$49000 - $70000"
"17089854700","Census Tract 8547, Kane County, Illinois",2261,49922,729,200,0,7,0,1276,32.2,8.8,0,0.3,0,56.4,67.8,873,348,525,39.86,60.14,47,301,30,495,77,796,13.5,5.7,8.8,"50% - 75% P.O.C.","$49000 - $70000"
"17089854800","Census Tract 8548, Kane County, Illinois",7824,135271,7081,44,0,131,0,333,90.5,0.6,0,1.7,0,4.3,9.5,2840,2747,93,96.73,3.27,238,2509,13,80,251,2589,8.7,14,8.8,"Less than 25% P.O.C.","$98000 or more"
"17089854900","Census Tract 8549, Kane County, Illinois",5565,65557,2497,1080,0,215,0,1675,44.9,19.4,0,3.9,0,30.1,55.1,1861,1080,781,58.03,41.97,87,993,111,670,198,1663,8.1,14.2,10.6,"50% - 75% P.O.C.","$49000 - $70000"
"17097860101","Census Tract 8601.01, Lake County, Illinois",8340,77692,3822,1835,0,876,0,1354,45.8,22,0,10.5,0,16.2,54.2,2794,1887,907,67.54,32.46,350,1537,112,795,462,2332,18.5,12.3,16.5,"50% - 75% P.O.C.","$70000 - $98000"
"17097860103","Census Tract 8601.03, Lake County, Illinois",3591,100125,3052,3,0,36,0,494,85,0.1,0,1,0,13.8,15,1352,1125,227,83.21,16.79,126,999,9,218,135,1217,11.2,4,10,"Less than 25% P.O.C.","$98000 or more"
"17097860104","Census Tract 8601.04, Lake County, Illinois",3269,67448,2740,132,12,21,0,302,83.8,4,0.4,0.6,0,9.2,16.2,1305,929,376,71.19,28.81,84,845,14,362,98,1207,9,3.7,7.5,"Less than 25% P.O.C.","$49000 - $70000"
"17097860200","Census Tract 8602, Lake County, Illinois",3573,54028,1425,691,0,93,0,1357,39.9,19.3,0,2.6,0,38,60.1,1216,822,394,67.6,32.4,89,733,56,338,145,1071,10.8,14.2,11.9,"50% - 75% P.O.C.","$49000 - $70000"
"17097860301","Census Tract 8603.01, Lake County, Illinois",3906,46618,991,1572,36,12,0,1014,25.4,40.2,0.9,0.3,0,26,74.6,1082,637,445,58.87,41.13,190,447,38,407,228,854,29.8,8.5,21.1,"50% - 75% P.O.C.","Less than $49000"
"17097860302","Census Tract 8603.02, Lake County, Illinois",2711,33886,509,1226,0,22,0,880,18.8,45.2,0,0.8,0,32.5,81.2,931,369,562,39.63,60.37,51,318,70,492,121,810,13.8,12.5,13,"75% or more P.O.C.","Less than $49000"
"17097860400","Census Tract 8604, Lake County, Illinois",5739,63387,2623,849,0,28,0,2090,45.7,14.8,0,0.5,0,36.4,54.3,2034,1224,810,60.18,39.82,274,950,14,796,288,1746,22.4,1.7,14.2,"50% - 75% P.O.C.","$49000 - $70000"
"17097860500","Census Tract 8605, Lake County, Illinois",4596,37006,1165,1422,0,29,0,1590,25.3,30.9,0,0.6,0,34.6,74.7,1614,826,788,51.18,48.82,170,656,110,678,280,1334,20.6,14,17.3,"50% - 75% P.O.C.","Less than $49000"
"17097860600","Census Tract 8606, Lake County, Illinois",7067,60508,3185,890,147,48,0,2666,45.1,12.6,2.1,0.7,0,37.7,54.9,2516,1816,700,72.18,27.82,168,1648,118,582,286,2230,9.3,16.9,11.4,"50% - 75% P.O.C.","$49000 - $70000"
"17097860805","Census Tract 8608.05, Lake County, Illinois",1885,64833,1648,0,0,18,0,174,87.4,0,0,1,0,9.2,12.6,724,568,156,78.45,21.55,49,519,39,117,88,636,8.6,25,12.2,"Less than 25% P.O.C.","$49000 - $70000"
"17097860806","Census Tract 8608.06, Lake County, Illinois",5006,78776,4248,28,0,38,0,521,84.9,0.6,0,0.8,0,10.4,15.1,1918,1293,625,67.41,32.59,182,1111,0,625,182,1736,14.1,0,9.5,"Less than 25% P.O.C.","$70000 - $98000"
"17097860807","Census Tract 8608.07, Lake County, Illinois",3356,52656,3186,0,0,0,0,154,94.9,0,0,0,0,4.6,5.1,1693,1140,553,67.34,32.66,32,1108,38,515,70,1623,2.8,6.9,4.1,"Less than 25% P.O.C.","$49000 - $70000"
"17097860808","Census Tract 8608.08, Lake County, Illinois",2654,70625,2420,0,0,22,0,148,91.2,0,0,0.8,0,5.6,8.8,1117,929,188,83.17,16.83,38,891,17,171,55,1062,4.1,9,4.9,"Less than 25% P.O.C.","$70000 - $98000"
"17097860809","Census Tract 8608.09, Lake County, Illinois",3128,88304,2948,0,0,35,0,88,94.2,0,0,1.1,0,2.8,5.8,1199,1055,144,87.99,12.01,106,949,30,114,136,1063,10,20.8,11.3,"Less than 25% P.O.C.","$70000 - $98000"
"17097860810","Census Tract 8608.10, Lake County, Illinois",6953,97028,5619,413,0,91,0,585,80.8,5.9,0,1.3,0,8.4,19.2,2439,1853,586,75.97,24.03,195,1658,0,586,195,2244,10.5,0,8,"Less than 25% P.O.C.","$70000 - $98000"
"17097860811","Census Tract 8608.11, Lake County, Illinois",4217,103542,3584,67,5,135,0,269,85,1.6,0.1,3.2,0,6.4,15,1496,1276,220,85.29,14.71,194,1082,0,220,194,1302,15.2,0,13,"Less than 25% P.O.C.","$98000 or more"
"17097860903","Census Tract 8609.03, Lake County, Illinois",6125,57315,5334,63,0,163,0,444,87.1,1,0,2.7,0,7.2,12.9,2553,1771,782,69.37,30.63,181,1590,31,751,212,2341,10.2,4,8.3,"Less than 25% P.O.C.","$49000 - $70000"
"17097860904","Census Tract 8609.04, Lake County, Illinois",5029,69234,4336,30,0,111,0,488,86.2,0.6,0,2.2,0,9.7,13.8,2241,1376,865,61.4,38.6,65,1311,12,853,77,2164,4.7,1.4,3.4,"Less than 25% P.O.C.","$49000 - $70000"
"17097860905","Census Tract 8609.05, Lake County, Illinois",5861,76129,4649,0,0,61,0,1062,79.3,0,0,1,0,18.1,20.7,2092,1746,346,83.46,16.54,223,1523,60,286,283,1809,12.8,17.3,13.5,"Less than 25% P.O.C.","$70000 - $98000"
"17097860906","Census Tract 8609.06, Lake County, Illinois",9593,93918,6316,816,46,340,0,1973,65.8,8.5,0.5,3.5,0,20.6,34.2,3254,2762,492,84.88,15.12,290,2472,33,459,323,2931,10.5,6.7,9.9,"25% - 50% P.O.C.","$70000 - $98000"
"17097861007","Census Tract 8610.07, Lake County, Illinois",4255,114455,3602,102,0,202,0,224,84.7,2.4,0,4.7,0,5.3,15.3,1367,1356,11,99.2,0.8,139,1217,1,10,140,1227,10.3,9.1,10.2,"Less than 25% P.O.C.","$98000 or more"
"17097861008","Census Tract 8610.08, Lake County, Illinois",5408,96356,4389,59,0,125,0,742,81.2,1.1,0,2.3,0,13.7,18.8,1822,1434,388,78.7,21.3,228,1206,41,347,269,1553,15.9,10.6,14.8,"Less than 25% P.O.C.","$70000 - $98000"
"17097861009","Census Tract 8610.09, Lake County, Illinois",4997,119299,4097,89,0,288,0,443,82,1.8,0,5.8,0,8.9,18,1819,1526,293,83.89,16.11,114,1412,7,286,121,1698,7.5,2.4,6.7,"Less than 25% P.O.C.","$98000 or more"
"17097861010","Census Tract 8610.10, Lake County, Illinois",5939,90909,4434,191,0,362,0,887,74.7,3.2,0,6.1,0,14.9,25.3,1996,1821,175,91.23,8.77,267,1554,0,175,267,1729,14.7,0,13.4,"25% - 50% P.O.C.","$70000 - $98000"
"17097861011","Census Tract 8610.11, Lake County, Illinois",7559,106083,5157,382,0,413,0,1492,68.2,5.1,0,5.5,0,19.7,31.8,2423,2160,263,89.15,10.85,320,1840,4,259,324,2099,14.8,1.5,13.4,"25% - 50% P.O.C.","$98000 or more"
"17097861012","Census Tract 8610.12, Lake County, Illinois",4966,74167,4503,28,3,124,0,289,90.7,0.6,0.1,2.5,0,5.8,9.3,2076,1300,776,62.62,37.38,176,1124,28,748,204,1872,13.5,3.6,9.8,"Less than 25% P.O.C.","$70000 - $98000"
"17097861013","Census Tract 8610.13, Lake County, Illinois",3064,92880,2271,308,0,113,0,271,74.1,10.1,0,3.7,0,8.8,25.9,1236,836,400,67.64,32.36,104,732,0,400,104,1132,12.4,0,8.4,"25% - 50% P.O.C.","$70000 - $98000"
"17097861014","Census Tract 8610.14, Lake County, Illinois",3869,94000,2983,134,0,180,0,347,77.1,3.5,0,4.7,0,9,22.9,1274,1135,139,89.09,10.91,166,969,17,122,183,1091,14.6,12.2,14.4,"Less than 25% P.O.C.","$70000 - $98000"
"17097861105","Census Tract 8611.05, Lake County, Illinois",4265,76340,3249,161,0,191,0,483,76.2,3.8,0,4.5,0,11.3,23.8,1687,839,848,49.73,50.27,43,796,90,758,133,1554,5.1,10.6,7.9,"Less than 25% P.O.C.","$70000 - $98000"
"17097861106","Census Tract 8611.06, Lake County, Illinois",8257,109850,5818,239,13,655,0,1174,70.5,2.9,0.2,7.9,0,14.2,29.5,2936,2234,702,76.09,23.91,222,2012,35,667,257,2679,9.9,5,8.8,"25% - 50% P.O.C.","$98000 or more"
"17097861107","Census Tract 8611.07, Lake County, Illinois",3832,119471,2994,124,0,295,0,416,78.1,3.2,0,7.7,0,10.9,21.9,1288,1085,203,84.24,15.76,141,944,27,176,168,1120,13,13.3,13,"Less than 25% P.O.C.","$98000 or more"
"17097861108","Census Tract 8611.08, Lake County, Illinois",6048,105605,4971,47,27,119,56,610,82.2,0.8,0.4,2,0.9,10.1,17.8,2209,1752,457,79.31,20.69,177,1575,10,447,187,2022,10.1,2.2,8.5,"Less than 25% P.O.C.","$98000 or more"
"17097861201","Census Tract 8612.01, Lake County, Illinois",6809,68008,2398,395,0,50,0,3945,35.2,5.8,0,0.7,0,57.9,64.8,1929,1450,479,75.17,24.83,434,1016,159,320,593,1336,29.9,33.2,30.7,"50% - 75% P.O.C.","$49000 - $70000"
"17097861202","Census Tract 8612.02, Lake County, Illinois",3990,76023,1770,47,0,161,0,1955,44.4,1.2,0,4,0,49,55.6,1323,1155,168,87.3,12.7,164,991,64,104,228,1095,14.2,38.1,17.2,"50% - 75% P.O.C.","$70000 - $98000"
"17097861301","Census Tract 8613.01, Lake County, Illinois",5286,58247,2539,225,20,89,0,2206,48,4.3,0.4,1.7,0,41.7,52,1921,1205,716,62.73,37.27,139,1066,183,533,322,1599,11.5,25.6,16.8,"50% - 75% P.O.C.","$49000 - $70000"
"17097861303","Census Tract 8613.03, Lake County, Illinois",4763,56270,1142,284,33,0,0,3259,24,6,0.7,0,0,68.4,76,1325,868,457,65.51,34.49,181,687,210,247,391,934,20.9,46,29.5,"75% or more P.O.C.","$49000 - $70000"
"17097861304","Census Tract 8613.04, Lake County, Illinois",3468,70136,905,19,0,13,0,2515,26.1,0.5,0,0.4,0,72.5,73.9,912,667,245,73.14,26.86,202,465,132,113,334,578,30.3,53.9,36.6,"50% - 75% P.O.C.","$70000 - $98000"
"17097861402","Census Tract 8614.02, Lake County, Illinois",8931,73225,4795,624,0,885,0,2327,53.7,7,0,9.9,0,26.1,46.3,3187,2381,806,74.71,25.29,228,2153,75,731,303,2884,9.6,9.3,9.5,"25% - 50% P.O.C.","$70000 - $98000"
"17097861403","Census Tract 8614.03, Lake County, Illinois",2434,52188,692,75,3,28,0,1587,28.4,3.1,0.1,1.2,0,65.2,71.6,752,531,221,70.61,29.39,84,447,66,155,150,602,15.8,29.9,19.9,"50% - 75% P.O.C.","$49000 - $70000"
"17097861404","Census Tract 8614.04, Lake County, Illinois",6199,66186,2402,557,0,75,0,2999,38.7,9,0,1.2,0,48.4,61.3,1950,1457,493,74.72,25.28,229,1228,105,388,334,1616,15.7,21.3,17.1,"50% - 75% P.O.C.","$49000 - $70000"
"17097861504","Census Tract 8615.04, Lake County, Illinois",7976,75409,1342,552,0,1776,0,4142,16.8,6.9,0,22.3,0,51.9,83.2,2606,1134,1472,43.51,56.49,365,769,148,1324,513,2093,32.2,10.1,19.7,"75% or more P.O.C.","$70000 - $98000"
"17097861505","Census Tract 8615.05, Lake County, Illinois",3418,106607,2208,216,0,413,0,430,64.6,6.3,0,12.1,0,12.6,35.4,1189,1076,113,90.5,9.5,101,975,41,72,142,1047,9.4,36.3,11.9,"25% - 50% P.O.C.","$98000 or more"
"17097861506","Census Tract 8615.06, Lake County, Illinois",5855,68603,2511,1107,0,448,0,1522,42.9,18.9,0,7.7,0,26,57.1,2277,1106,1171,48.57,51.43,173,933,81,1090,254,2023,15.6,6.9,11.2,"50% - 75% P.O.C.","$49000 - $70000"
"17097861507","Census Tract 8615.07, Lake County, Illinois",3054,79333,1682,173,0,185,0,886,55.1,5.7,0,6.1,0,29,44.9,996,691,305,69.38,30.62,106,585,39,266,145,851,15.3,12.8,14.6,"25% - 50% P.O.C.","$70000 - $98000"
"17097861508","Census Tract 8615.08, Lake County, Illinois",3697,64595,2328,521,0,220,0,599,63,14.1,0,6,0,16.2,37,1544,819,725,53.04,46.96,82,737,30,695,112,1432,10,4.1,7.3,"25% - 50% P.O.C.","$49000 - $70000"
"17097861509","Census Tract 8615.09, Lake County, Illinois",3451,77823,1819,547,0,336,0,596,52.7,15.9,0,9.7,0,17.3,47.3,1372,701,671,51.09,48.91,41,660,32,639,73,1299,5.8,4.8,5.3,"25% - 50% P.O.C.","$70000 - $98000"
"17097861510","Census Tract 8615.10, Lake County, Illinois",4797,64044,2652,394,0,363,0,1261,55.3,8.2,0,7.6,0,26.3,44.7,1792,1095,697,61.1,38.9,160,935,23,674,183,1609,14.6,3.3,10.2,"25% - 50% P.O.C.","$49000 - $70000"
"17097861603","Census Tract 8616.03, Lake County, Illinois",5771,97220,4691,236,81,431,0,260,81.3,4.1,1.4,7.5,0,4.5,18.7,2449,1863,586,76.07,23.93,105,1758,0,586,105,2344,5.6,0,4.3,"Less than 25% P.O.C.","$70000 - $98000"
"17097861604","Census Tract 8616.04, Lake County, Illinois",5310,119023,3342,291,0,779,0,693,62.9,5.5,0,14.7,0,13.1,37.1,1867,1555,312,83.29,16.71,124,1431,20,292,144,1723,8,6.4,7.7,"25% - 50% P.O.C.","$98000 or more"
"17097861607","Census Tract 8616.07, Lake County, Illinois",4465,68140,3380,122,0,230,0,650,75.7,2.7,0,5.2,0,14.6,24.3,1775,1134,641,63.89,36.11,95,1039,81,560,176,1599,8.4,12.6,9.9,"Less than 25% P.O.C.","$49000 - $70000"
"17097861608","Census Tract 8616.08, Lake County, Illinois",3678,91859,2746,215,0,94,0,546,74.7,5.8,0,2.6,0,14.8,25.3,1326,1131,195,85.29,14.71,83,1048,34,161,117,1209,7.3,17.4,8.8,"25% - 50% P.O.C.","$70000 - $98000"
"17097861609","Census Tract 8616.09, Lake County, Illinois",4559,124057,2354,277,0,1468,0,346,51.6,6.1,0,32.2,0,7.6,48.4,1578,1179,399,74.71,25.29,138,1041,34,365,172,1406,11.7,8.5,10.9,"25% - 50% P.O.C.","$98000 or more"
"17097861610","Census Tract 8616.10, Lake County, Illinois",3510,130125,2553,288,0,297,0,196,72.7,8.2,0,8.5,0,5.6,27.3,1253,1036,217,82.68,17.32,78,958,11,206,89,1164,7.5,5.1,7.1,"25% - 50% P.O.C.","$98000 or more"
"17097861611","Census Tract 8616.11, Lake County, Illinois",4409,162250,3167,49,0,436,0,483,71.8,1.1,0,9.9,0,11,28.2,1378,1341,37,97.31,2.69,165,1176,22,15,187,1191,12.3,59.5,13.6,"25% - 50% P.O.C.","$98000 or more"
"17097861701","Census Tract 8617.01, Lake County, Illinois",1533,70938,727,102,0,27,0,596,47.4,6.7,0,1.8,0,38.9,52.6,556,494,62,88.85,11.15,28,466,23,39,51,505,5.7,37.1,9.2,"50% - 75% P.O.C.","$70000 - $98000"
"17097861702","Census Tract 8617.02, Lake County, Illinois",4411,73966,1226,541,0,62,0,2421,27.8,12.3,0,1.4,0,54.9,72.2,1470,1208,262,82.18,17.82,212,996,0,262,212,1258,17.5,0,14.4,"50% - 75% P.O.C.","$70000 - $98000"
"17097861803","Census Tract 8618.03, Lake County, Illinois",7054,60290,1963,975,0,586,0,3415,27.8,13.8,0,8.3,0,48.4,72.2,2490,1346,1144,54.06,45.94,294,1052,74,1070,368,2122,21.8,6.5,14.8,"50% - 75% P.O.C.","$49000 - $70000"
"17097861804","Census Tract 8618.04, Lake County, Illinois",3641,43846,463,441,0,106,0,2532,12.7,12.1,0,2.9,0,69.5,87.3,1162,581,581,50,50,89,492,141,440,230,932,15.3,24.3,19.8,"75% or more P.O.C.","Less than $49000"
"17097861901","Census Tract 8619.01, Lake County, Illinois",3277,57472,1161,301,0,56,0,1601,35.4,9.2,0,1.7,0,48.9,64.6,1187,994,193,83.74,16.26,113,881,11,182,124,1063,11.4,5.7,10.4,"50% - 75% P.O.C.","$49000 - $70000"
"17097861902","Census Tract 8619.02, Lake County, Illinois",6522,46458,1584,1290,0,231,0,3157,24.3,19.8,0,3.5,0,48.4,75.7,2620,970,1650,37.02,62.98,181,789,103,1547,284,2336,18.7,6.2,10.8,"75% or more P.O.C.","Less than $49000"
"17097862000","Census Tract 8620, Lake County, Illinois",5538,49563,512,620,0,72,0,4288,9.2,11.2,0,1.3,0,77.4,90.8,1723,909,814,52.76,47.24,186,723,166,648,352,1371,20.5,20.4,20.4,"75% or more P.O.C.","$49000 - $70000"
"17097862100","Census Tract 8621, Lake County, Illinois",5628,41278,792,1229,0,11,0,3447,14.1,21.8,0,0.2,0,61.2,85.9,1729,730,999,42.22,57.78,176,554,227,772,403,1326,24.1,22.7,23.3,"75% or more P.O.C.","Less than $49000"
"17097862200","Census Tract 8622, Lake County, Illinois",4255,47964,1126,1371,0,57,0,1250,26.5,32.2,0,1.3,0,29.4,73.5,1349,418,931,30.99,69.01,0,418,156,775,156,1193,0,16.8,11.6,"50% - 75% P.O.C.","Less than $49000"
"17097862300","Census Tract 8623, Lake County, Illinois",2701,17402,250,1000,59,52,0,1290,9.3,37,2.2,1.9,0,47.8,90.7,1050,218,832,20.76,79.24,29,189,69,763,98,952,13.3,8.3,9.3,"75% or more P.O.C.","Less than $49000"
"17097862401","Census Tract 8624.01, Lake County, Illinois",3221,31620,526,506,20,73,0,2086,16.3,15.7,0.6,2.3,0,64.8,83.7,1303,357,946,27.4,72.6,33,324,177,769,210,1093,9.2,18.7,16.1,"75% or more P.O.C.","Less than $49000"
"17097862402","Census Tract 8624.02, Lake County, Illinois",2828,42898,58,317,22,0,0,2392,2.1,11.2,0.8,0,0,84.6,97.9,913,314,599,34.39,65.61,81,233,90,509,171,742,25.8,15,18.7,"75% or more P.O.C.","Less than $49000"
"17097862501","Census Tract 8625.01, Lake County, Illinois",3679,45657,186,380,0,0,0,3113,5.1,10.3,0,0,0,84.6,94.9,1103,621,482,56.3,43.7,162,459,142,340,304,799,26.1,29.5,27.6,"75% or more P.O.C.","Less than $49000"
"17097862502","Census Tract 8625.02, Lake County, Illinois",2680,60577,426,688,0,14,0,1475,15.9,25.7,0,0.5,0,55,84.1,578,405,173,70.07,29.93,132,273,59,114,191,387,32.6,34.1,33,"75% or more P.O.C.","$49000 - $70000"
"17097862603","Census Tract 8626.03, Lake County, Illinois",7649,46420,794,1293,0,554,0,4892,10.4,16.9,0,7.2,0,64,89.6,2602,1074,1528,41.28,58.72,218,856,171,1357,389,2213,20.3,11.2,15,"75% or more P.O.C.","Less than $49000"
"17097862604","Census Tract 8626.04, Lake County, Illinois",5172,48900,565,293,0,122,4,4146,10.9,5.7,0,2.4,0.1,80.2,89.1,1412,828,584,58.64,41.36,203,625,146,438,349,1063,24.5,25,24.7,"75% or more P.O.C.","Less than $49000"
"17097862605","Census Tract 8626.05, Lake County, Illinois",3938,25444,926,1599,0,120,0,1258,23.5,40.6,0,3,0,31.9,76.5,1686,479,1207,28.41,71.59,85,394,83,1124,168,1518,17.7,6.9,10,"75% or more P.O.C.","Less than $49000"
"17097862700","Census Tract 8627, Lake County, Illinois",3680,32444,172,602,9,0,0,2885,4.7,16.4,0.2,0,0,78.4,95.3,1047,460,587,43.94,56.06,135,325,189,398,324,723,29.3,32.2,30.9,"75% or more P.O.C.","Less than $49000"
"17097862800","Census Tract 8628, Lake County, Illinois",1585,28400,38,819,0,18,0,460,2.4,51.7,0,1.1,0,29,97.6,598,124,474,20.74,79.26,36,88,30,444,66,532,29,6.3,11,"75% or more P.O.C.","Less than $49000"
"17097862901","Census Tract 8629.01, Lake County, Illinois",4178,36162,143,977,0,0,15,3023,3.4,23.4,0,0,0.4,72.4,96.6,1213,375,838,30.92,69.08,142,233,189,649,331,882,37.9,22.6,27.3,"75% or more P.O.C.","Less than $49000"
"17097862902","Census Tract 8629.02, Lake County, Illinois",2422,39167,182,1082,0,2,0,1018,7.5,44.7,0,0.1,0,42,92.5,826,283,543,34.26,65.74,54,229,78,465,132,694,19.1,14.4,16,"75% or more P.O.C.","Less than $49000"
"17097863003","Census Tract 8630.03, Lake County, Illinois",9102,55682,4909,1485,0,413,0,1831,53.9,16.3,0,4.5,0,20.1,46.1,36,0,36,0,100,0,0,22,14,22,14,NA,61.1,61.1,"25% - 50% P.O.C.","$49000 - $70000"
"17097863004","Census Tract 8630.04, Lake County, Illinois",4680,37257,2405,815,0,705,49,526,51.4,17.4,0,15.1,1,11.2,48.6,1746,14,1732,0.8,99.2,0,14,113,1619,113,1633,0,6.5,6.5,"25% - 50% P.O.C.","Less than $49000"
"17097863005","Census Tract 8630.05, Lake County, Illinois",477,NA,233,59,0,29,0,156,48.8,12.4,0,6.1,0,32.7,51.2,0,0,0,NA,NA,0,0,0,0,0,0,NA,NA,NA,"50% - 75% P.O.C.","N/A"
"17097863006","Census Tract 8630.06, Lake County, Illinois",0,NA,0,0,0,0,0,0,NA,NA,NA,NA,NA,NA,NA,0,0,0,NA,NA,0,0,0,0,0,0,NA,NA,NA,"N/A","N/A"
"17097863100","Census Tract 8631, Lake County, Illinois",2541,33727,209,1330,0,14,0,927,8.2,52.3,0,0.6,0,36.5,91.8,975,476,499,48.82,51.18,75,401,48,451,123,852,15.8,9.6,12.6,"75% or more P.O.C.","Less than $49000"
"17097863201","Census Tract 8632.01, Lake County, Illinois",3593,59946,245,1279,8,29,0,1912,6.8,35.6,0.2,0.8,0,53.2,93.2,1039,712,327,68.53,31.47,124,588,41,286,165,874,17.4,12.5,15.9,"75% or more P.O.C.","$49000 - $70000"
"17097863202","Census Tract 8632.02, Lake County, Illinois",5312,126786,4244,17,0,391,0,576,79.9,0.3,0,7.4,0,10.8,20.1,1848,1537,311,83.17,16.83,188,1349,68,243,256,1592,12.2,21.9,13.9,"Less than 25% P.O.C.","$98000 or more"
"17097863300","Census Tract 8633, Lake County, Illinois",2322,206042,2222,0,3,43,0,40,95.7,0,0.1,1.9,0,1.7,4.3,841,731,110,86.92,13.08,94,637,0,110,94,747,12.9,0,11.2,"Less than 25% P.O.C.","$98000 or more"
"17097863400","Census Tract 8634, Lake County, Illinois",4207,151591,3535,129,0,185,0,250,84,3.1,0,4.4,0,5.9,16,1306,928,378,71.06,28.94,64,864,26,352,90,1216,6.9,6.9,6.9,"Less than 25% P.O.C.","$98000 or more"
"17097863500","Census Tract 8635, Lake County, Illinois",4393,131836,3823,3,0,443,0,124,87,0.1,0,10.1,0,2.8,13,2005,1635,370,81.55,18.45,147,1488,0,370,147,1858,9,0,7.3,"Less than 25% P.O.C.","$98000 or more"
"17097863601","Census Tract 8636.01, Lake County, Illinois",3573,213036,3038,77,0,364,0,28,85,2.2,0,10.2,0,0.8,15,1159,1063,96,91.72,8.28,139,924,0,96,139,1020,13.1,0,12,"Less than 25% P.O.C.","$98000 or more"
"17097863603","Census Tract 8636.03, Lake County, Illinois",3234,193333,2757,68,7,295,0,63,85.3,2.1,0.2,9.1,0,1.9,14.7,1114,1024,90,91.92,8.08,109,915,0,90,109,1005,10.6,0,9.8,"Less than 25% P.O.C.","$98000 or more"
"17097863604","Census Tract 8636.04, Lake County, Illinois",2891,152500,2590,42,0,49,0,203,89.6,1.5,0,1.7,0,7,10.4,1006,814,192,80.91,19.09,106,708,20,172,126,880,13,10.4,12.5,"Less than 25% P.O.C.","$98000 or more"
"17097863701","Census Tract 8637.01, Lake County, Illinois",4906,99688,4113,35,0,421,0,289,83.8,0.7,0,8.6,0,5.9,16.2,1895,1396,499,73.67,26.33,120,1276,12,487,132,1763,8.6,2.4,7,"Less than 25% P.O.C.","$98000 or more"
"17097863702","Census Tract 8637.02, Lake County, Illinois",3805,90492,2738,83,13,680,0,231,72,2.2,0.3,17.9,0,6.1,28,1667,1076,591,64.55,35.45,94,982,12,579,106,1561,8.7,2,6.4,"25% - 50% P.O.C.","$70000 - $98000"
"17097863801","Census Tract 8638.01, Lake County, Illinois",4586,134659,4107,9,0,202,0,205,89.6,0.2,0,4.4,0,4.5,10.4,1791,1388,403,77.5,22.5,170,1218,0,403,170,1621,12.2,0,9.5,"Less than 25% P.O.C.","$98000 or more"
"17097863902","Census Tract 8639.02, Lake County, Illinois",5822,78893,3562,152,11,1539,0,274,61.2,2.6,0.2,26.4,0,4.7,38.8,2663,1340,1323,50.32,49.68,0,1340,0,1323,0,2663,0,0,0,"25% - 50% P.O.C.","$70000 - $98000"
"17097863903","Census Tract 8639.03, Lake County, Illinois",4160,113929,3506,22,24,206,0,257,84.3,0.5,0.6,5,0,6.2,15.7,1586,1250,336,78.81,21.19,157,1093,8,328,165,1421,12.6,2.4,10.4,"Less than 25% P.O.C.","$98000 or more"
"17097863904","Census Tract 8639.04, Lake County, Illinois",6456,182656,4134,64,5,1607,8,509,64,1,0.1,24.9,0.1,7.9,36,1955,1842,113,94.22,5.78,274,1568,28,85,302,1653,14.9,24.8,15.4,"25% - 50% P.O.C.","$98000 or more"
"17097864001","Census Tract 8640.01, Lake County, Illinois",6277,79735,2914,141,0,840,0,2269,46.4,2.2,0,13.4,0,36.1,53.6,2074,1335,739,64.37,35.63,138,1197,193,546,331,1743,10.3,26.1,16,"50% - 75% P.O.C.","$70000 - $98000"
"17097864002","Census Tract 8640.02, Lake County, Illinois",6379,66250,1668,37,25,217,0,4330,26.1,0.6,0.4,3.4,0,67.9,73.9,1797,1064,733,59.21,40.79,252,812,210,523,462,1335,23.7,28.6,25.7,"50% - 75% P.O.C.","$49000 - $70000"
"17097864101","Census Tract 8641.01, Lake County, Illinois",11126,92188,8367,331,0,1469,0,773,75.2,3,0,13.2,0,6.9,24.8,4353,4165,188,95.68,4.32,463,3702,25,163,488,3865,11.1,13.3,11.2,"Less than 25% P.O.C.","$70000 - $98000"
"17097864105","Census Tract 8641.05, Lake County, Illinois",6325,114497,4316,80,10,946,0,737,68.2,1.3,0.2,15,0,11.7,31.8,2421,2226,195,91.95,8.05,150,2076,19,176,169,2252,6.7,9.7,7,"25% - 50% P.O.C.","$98000 or more"
"17097864106","Census Tract 8641.06, Lake County, Illinois",4284,108355,2782,149,0,116,0,1219,64.9,3.5,0,2.7,0,28.5,35.1,1450,1310,140,90.34,9.66,143,1167,7,133,150,1300,10.9,5,10.3,"25% - 50% P.O.C.","$98000 or more"
"17097864107","Census Tract 8641.07, Lake County, Illinois",5151,104659,3262,146,0,420,0,1250,63.3,2.8,0,8.2,0,24.3,36.7,1707,1458,249,85.41,14.59,164,1294,30,219,194,1513,11.2,12,11.4,"25% - 50% P.O.C.","$98000 or more"
"17097864108","Census Tract 8641.08, Lake County, Illinois",5569,88347,3260,52,0,247,0,1926,58.5,0.9,0,4.4,0,34.6,41.5,1945,1660,285,85.35,14.65,183,1477,6,279,189,1756,11,2.1,9.7,"25% - 50% P.O.C.","$70000 - $98000"
"17097864203","Census Tract 8642.03, Lake County, Illinois",4430,96130,3883,17,0,40,0,490,87.7,0.4,0,0.9,0,11.1,12.3,1569,1335,234,85.09,14.91,138,1197,0,234,138,1431,10.3,0,8.8,"Less than 25% P.O.C.","$70000 - $98000"
"17097864204","Census Tract 8642.04, Lake County, Illinois",4475,76712,3342,56,0,58,0,1001,74.7,1.3,0,1.3,0,22.4,25.3,1665,1193,472,71.65,28.35,118,1075,43,429,161,1504,9.9,9.1,9.7,"25% - 50% P.O.C.","$70000 - $98000"
"17097864205","Census Tract 8642.05, Lake County, Illinois",11204,91742,8721,47,0,570,0,1590,77.8,0.4,0,5.1,0,14.2,22.2,4057,3379,678,83.29,16.71,513,2866,17,661,530,3527,15.2,2.5,13.1,"Less than 25% P.O.C.","$70000 - $98000"
"17097864206","Census Tract 8642.06, Lake County, Illinois",3640,51111,2569,26,0,61,0,984,70.6,0.7,0,1.7,0,27,29.4,1492,1048,444,70.24,29.76,62,986,83,361,145,1347,5.9,18.7,9.7,"25% - 50% P.O.C.","$49000 - $70000"
"17097864303","Census Tract 8643.03, Lake County, Illinois",4226,147969,3696,110,0,144,0,158,87.5,2.6,0,3.4,0,3.7,12.5,1483,1418,65,95.62,4.38,99,1319,13,52,112,1371,7,20,7.6,"Less than 25% P.O.C.","$98000 or more"
"17097864305","Census Tract 8643.05, Lake County, Illinois",4014,108697,3599,19,0,145,0,209,89.7,0.5,0,3.6,0,5.2,10.3,1861,1742,119,93.61,6.39,82,1660,0,119,82,1779,4.7,0,4.4,"Less than 25% P.O.C.","$98000 or more"
"17097864306","Census Tract 8643.06, Lake County, Illinois",2214,180714,2056,31,3,44,0,37,92.9,1.4,0.1,2,0,1.7,7.1,792,763,29,96.34,3.66,73,690,7,22,80,712,9.6,24.1,10.1,"Less than 25% P.O.C.","$98000 or more"
"17097864307","Census Tract 8643.07, Lake County, Illinois",1567,112143,1487,0,4,37,0,29,94.9,0,0.3,2.4,0,1.9,5.1,654,536,118,81.96,18.04,35,501,0,118,35,619,6.5,0,5.4,"Less than 25% P.O.C.","$98000 or more"
"17097864308","Census Tract 8643.08, Lake County, Illinois",4602,106538,3830,53,0,268,0,348,83.2,1.2,0,5.8,0,7.6,16.8,1824,1368,456,75,25,140,1228,26,430,166,1658,10.2,5.7,9.1,"Less than 25% P.O.C.","$98000 or more"
"17097864402","Census Tract 8644.02, Lake County, Illinois",7487,163194,5724,110,4,1260,17,191,76.5,1.5,0.1,16.8,0.2,2.6,23.5,2544,2519,25,99.02,0.98,330,2189,0,25,330,2214,13.1,0,13,"Less than 25% P.O.C.","$98000 or more"
"17097864403","Census Tract 8644.03, Lake County, Illinois",5415,186371,4123,87,0,823,0,293,76.1,1.6,0,15.2,0,5.4,23.9,1738,1662,76,95.63,4.37,200,1462,6,70,206,1532,12,7.9,11.9,"Less than 25% P.O.C.","$98000 or more"
"17097864407","Census Tract 8644.07, Lake County, Illinois",5623,165875,4861,20,0,431,6,131,86.4,0.4,0,7.7,0.1,2.3,13.6,1881,1828,53,97.18,2.82,176,1652,17,36,193,1688,9.6,32.1,10.3,"Less than 25% P.O.C.","$98000 or more"
"17097864408","Census Tract 8644.08, Lake County, Illinois",5967,111206,4499,125,0,343,0,965,75.4,2.1,0,5.7,0,16.2,24.6,2195,1667,528,75.95,24.05,129,1538,81,447,210,1985,7.7,15.3,9.6,"Less than 25% P.O.C.","$98000 or more"
"17097864409","Census Tract 8644.09, Lake County, Illinois",4894,98244,3671,46,0,270,0,771,75,0.9,0,5.5,0,15.8,25,1699,1216,483,71.57,28.43,170,1046,45,438,215,1484,14,9.3,12.7,"25% - 50% P.O.C.","$98000 or more"
"17097864410","Census Tract 8644.10, Lake County, Illinois",5545,155259,4521,0,0,714,0,236,81.5,0,0,12.9,0,4.3,18.5,1710,1605,105,93.86,6.14,249,1356,10,95,259,1451,15.5,9.5,15.1,"Less than 25% P.O.C.","$98000 or more"
"17097864411","Census Tract 8644.11, Lake County, Illinois",5182,159861,4674,34,0,365,0,79,90.2,0.7,0,7,0,1.5,9.8,1665,1613,52,96.88,3.12,171,1442,8,44,179,1486,10.6,15.4,10.8,"Less than 25% P.O.C.","$98000 or more"
"17097864412","Census Tract 8644.12, Lake County, Illinois",4272,139188,3764,10,0,377,0,65,88.1,0.2,0,8.8,0,1.5,11.9,1407,1380,27,98.08,1.92,190,1190,20,7,210,1197,13.8,74.1,14.9,"Less than 25% P.O.C.","$98000 or more"
"17097864505","Census Tract 8645.05, Lake County, Illinois",7317,98299,4657,163,0,2190,0,165,63.6,2.2,0,29.9,0,2.3,36.4,2637,1361,1276,51.61,48.39,194,1167,22,1254,216,2421,14.3,1.7,8.2,"25% - 50% P.O.C.","$98000 or more"
"17097864510","Census Tract 8645.10, Lake County, Illinois",4863,77528,1642,80,115,1480,41,1397,33.8,1.6,2.4,30.4,0.8,28.7,66.2,1809,865,944,47.82,52.18,109,756,78,866,187,1622,12.6,8.3,10.3,"50% - 75% P.O.C.","$70000 - $98000"
"17097864511","Census Tract 8645.11, Lake County, Illinois",6365,100443,3426,359,26,1131,0,1287,53.8,5.6,0.4,17.8,0,20.2,46.2,2115,1489,626,70.4,29.6,261,1228,114,512,375,1740,17.5,18.2,17.7,"25% - 50% P.O.C.","$98000 or more"
"17097864512","Census Tract 8645.12, Lake County, Illinois",4332,199420,2703,25,0,971,0,515,62.4,0.6,0,22.4,0,11.9,37.6,1379,1170,209,84.84,15.16,172,998,36,173,208,1171,14.7,17.2,15.1,"25% - 50% P.O.C.","$98000 or more"
"17097864513","Census Tract 8645.13, Lake County, Illinois",5741,133818,4071,98,0,1188,0,282,70.9,1.7,0,20.7,0,4.9,29.1,2079,1474,605,70.9,29.1,183,1291,0,605,183,1896,12.4,0,8.8,"25% - 50% P.O.C.","$98000 or more"
"17097864514","Census Tract 8645.14, Lake County, Illinois",2486,149821,1526,17,0,743,0,109,61.4,0.7,0,29.9,0,4.4,38.6,969,742,227,76.57,23.43,29,713,12,215,41,928,3.9,5.3,4.2,"25% - 50% P.O.C.","$98000 or more"
"17097864515","Census Tract 8645.15, Lake County, Illinois",2736,150391,2022,28,0,544,0,94,73.9,1,0,19.9,0,3.4,26.1,885,836,49,94.46,5.54,84,752,7,42,91,794,10,14.3,10.3,"25% - 50% P.O.C.","$98000 or more"
"17097864516","Census Tract 8645.16, Lake County, Illinois",4447,129342,3315,99,0,841,0,143,74.5,2.2,0,18.9,0,3.2,25.5,1620,1490,130,91.98,8.02,87,1403,0,130,87,1533,5.8,0,5.4,"25% - 50% P.O.C.","$98000 or more"
"17097864517","Census Tract 8645.17, Lake County, Illinois",2797,158182,1764,0,0,1023,0,10,63.1,0,0,36.6,0,0.4,36.9,1044,925,119,88.6,11.4,59,866,11,108,70,974,6.4,9.2,6.7,"25% - 50% P.O.C.","$98000 or more"
"17097864518","Census Tract 8645.18, Lake County, Illinois",5004,135052,3718,0,15,1125,0,83,74.3,0,0.3,22.5,0,1.7,25.7,1833,1638,195,89.36,10.64,66,1572,26,169,92,1741,4,13.3,5,"25% - 50% P.O.C.","$98000 or more"
"17097864519","Census Tract 8645.19, Lake County, Illinois",4729,118421,3185,48,0,1146,0,197,67.4,1,0,24.2,0,4.2,32.6,1794,1508,286,84.06,15.94,82,1426,19,267,101,1693,5.4,6.6,5.6,"25% - 50% P.O.C.","$98000 or more"
"17097864520","Census Tract 8645.20, Lake County, Illinois",5170,143393,3205,117,22,1614,0,176,62,2.3,0.4,31.2,0,3.4,38,1724,1393,331,80.8,19.2,117,1276,27,304,144,1580,8.4,8.2,8.4,"25% - 50% P.O.C.","$98000 or more"
"17097864521","Census Tract 8645.21, Lake County, Illinois",2711,76855,1738,56,0,808,0,62,64.1,2.1,0,29.8,0,2.3,35.9,1431,942,489,65.83,34.17,30,912,6,483,36,1395,3.2,1.2,2.5,"25% - 50% P.O.C.","$70000 - $98000"
"17097864522","Census Tract 8645.22, Lake County, Illinois",4642,183056,3868,0,4,486,0,151,83.3,0,0.1,10.5,0,3.3,16.7,1570,1526,44,97.2,2.8,159,1367,0,44,159,1411,10.4,0,10.1,"Less than 25% P.O.C.","$98000 or more"
"17097864601","Census Tract 8646.01, Lake County, Illinois",3873,201000,3223,61,0,356,0,147,83.2,1.6,0,9.2,0,3.8,16.8,1320,1219,101,92.35,7.65,160,1059,43,58,203,1117,13.1,42.6,15.4,"Less than 25% P.O.C.","$98000 or more"
"17097864602","Census Tract 8646.02, Lake County, Illinois",3918,195417,3535,29,0,236,0,63,90.2,0.7,0,6,0,1.6,9.8,1367,1334,33,97.59,2.41,88,1246,0,33,88,1279,6.6,0,6.4,"Less than 25% P.O.C.","$98000 or more"
"17097864700","Census Tract 8647, Lake County, Illinois",2696,204904,2464,12,0,136,0,84,91.4,0.4,0,5,0,3.1,8.6,1021,970,51,95,5,93,877,0,51,93,928,9.6,0,9.1,"Less than 25% P.O.C.","$98000 or more"
"17097864801","Census Tract 8648.01, Lake County, Illinois",5628,146602,4790,169,6,321,0,261,85.1,3,0.1,5.7,0,4.6,14.9,1587,1381,206,87.02,12.98,191,1190,13,193,204,1383,13.8,6.3,12.9,"Less than 25% P.O.C.","$98000 or more"
"17097864802","Census Tract 8648.02, Lake County, Illinois",2826,162375,2394,56,0,234,0,131,84.7,2,0,8.3,0,4.6,15.3,1001,830,171,82.92,17.08,78,752,3,168,81,920,9.4,1.8,8.1,"Less than 25% P.O.C.","$98000 or more"
"17097864901","Census Tract 8649.01, Lake County, Illinois",4413,194167,4012,48,0,169,0,157,90.9,1.1,0,3.8,0,3.6,9.1,1568,1369,199,87.31,12.69,90,1279,22,177,112,1456,6.6,11.1,7.1,"Less than 25% P.O.C.","$98000 or more"
"17097864903","Census Tract 8649.03, Lake County, Illinois",4869,153148,4145,21,0,425,0,197,85.1,0.4,0,8.7,0,4,14.9,1746,1509,237,86.43,13.57,192,1317,25,212,217,1529,12.7,10.5,12.4,"Less than 25% P.O.C.","$98000 or more"
"17097864904","Census Tract 8649.04, Lake County, Illinois",2554,100509,2387,0,0,82,0,85,93.5,0,0,3.2,0,3.3,6.5,1143,927,216,81.1,18.9,68,859,18,198,86,1057,7.3,8.3,7.5,"Less than 25% P.O.C.","$98000 or more"
"17097865000","Census Tract 8650, Lake County, Illinois",1221,203750,1047,0,5,37,0,132,85.7,0,0.4,3,0,10.8,14.3,397,351,46,88.41,11.59,22,329,20,26,42,355,6.3,43.5,10.6,"Less than 25% P.O.C.","$98000 or more"
"17097865200","Census Tract 8652, Lake County, Illinois",5662,67411,2548,184,0,155,0,2681,45,3.2,0,2.7,0,47.4,55,1998,727,1271,36.39,63.61,62,665,229,1042,291,1707,8.5,18,14.6,"50% - 75% P.O.C.","$49000 - $70000"
"17097865300","Census Tract 8653, Lake County, Illinois",3446,142917,3019,23,0,82,0,234,87.6,0.7,0,2.4,0,6.8,12.4,1206,1152,54,95.52,4.48,103,1049,0,54,103,1103,8.9,0,8.5,"Less than 25% P.O.C.","$98000 or more"
"17097865400","Census Tract 8654, Lake County, Illinois",4344,85128,3172,117,0,200,0,785,73,2.7,0,4.6,0,18.1,27,1947,1177,770,60.45,39.55,48,1129,72,698,120,1827,4.1,9.4,6.2,"25% - 50% P.O.C.","$70000 - $98000"
"17097865501","Census Tract 8655.01, Lake County, Illinois",2202,105938,1765,4,0,39,0,347,80.2,0.2,0,1.8,0,15.8,19.8,809,542,267,67,33,40,502,65,202,105,704,7.4,24.3,13,"Less than 25% P.O.C.","$98000 or more"
"17097865502","Census Tract 8655.02, Lake County, Illinois",2257,158403,2126,19,0,32,0,70,94.2,0.8,0,1.4,0,3.1,5.8,961,741,220,77.11,22.89,23,718,0,220,23,938,3.1,0,2.4,"Less than 25% P.O.C.","$98000 or more"
"17097865600","Census Tract 8656, Lake County, Illinois",3665,248974,3406,0,0,28,0,56,92.9,0,0,0.8,0,1.5,7.1,1336,1220,116,91.32,8.68,101,1119,11,105,112,1224,8.3,9.5,8.4,"Less than 25% P.O.C.","$98000 or more"
"17097865700","Census Tract 8657, Lake County, Illinois",6016,171696,5193,25,0,172,0,350,86.3,0.4,0,2.9,0,5.8,13.7,2245,2026,219,90.24,9.76,184,1842,50,169,234,2011,9.1,22.8,10.4,"Less than 25% P.O.C.","$98000 or more"
"17097865801","Census Tract 8658.01, Lake County, Illinois",3106,124901,2722,9,0,44,0,317,87.6,0.3,0,1.4,0,10.2,12.4,1291,1047,244,81.1,18.9,77,970,0,244,77,1214,7.4,0,6,"Less than 25% P.O.C.","$98000 or more"
"17097865802","Census Tract 8658.02, Lake County, Illinois",2833,202917,2488,33,18,112,0,131,87.8,1.2,0.6,4,0,4.6,12.2,994,954,40,95.98,4.02,92,862,11,29,103,891,9.6,27.5,10.4,"Less than 25% P.O.C.","$98000 or more"
"17097866000","Census Tract 8660, Lake County, Illinois",6749,86690,4732,270,0,578,0,1046,70.1,4,0,8.6,0,15.5,29.9,2463,2291,172,93.02,6.98,349,1942,12,160,361,2102,15.2,7,14.7,"25% - 50% P.O.C.","$70000 - $98000"
"17097866100","Census Tract 8661, Lake County, Illinois",3526,51375,529,635,20,101,0,2037,15,18,0.6,2.9,0,57.8,85,1060,427,633,40.28,59.72,115,312,114,519,229,831,26.9,18,21.6,"75% or more P.O.C.","$49000 - $70000"
"17097866200","Census Tract 8662, Lake County, Illinois",5921,166703,4359,181,23,819,0,498,73.6,3.1,0.4,13.8,0,8.4,26.4,2137,1765,372,82.59,17.41,122,1643,12,360,134,2003,6.9,3.2,6.3,"25% - 50% P.O.C.","$98000 or more"
"17097990000","Census Tract 9900, Lake County, Illinois",0,NA,0,0,0,0,0,0,NA,NA,NA,NA,NA,NA,NA,0,0,0,NA,NA,0,0,0,0,0,0,NA,NA,NA,"N/A","N/A"
"17111870101","Census Tract 8701.01, McHenry County, Illinois",7387,81047,6528,56,28,63,0,592,88.4,0.8,0.4,0.9,0,8,11.6,2835,2010,825,70.9,29.1,255,1755,36,789,291,2544,12.7,4.4,10.3,"Less than 25% P.O.C.","$70000 - $98000"
"17111870102","Census Tract 8701.02, McHenry County, Illinois",6507,100234,5911,0,0,45,0,407,90.8,0,0,0.7,0,6.3,9.2,2133,2030,103,95.17,4.83,317,1713,0,103,317,1816,15.6,0,14.9,"Less than 25% P.O.C.","$98000 or more"
"17111870200","Census Tract 8702, McHenry County, Illinois",6066,75380,4410,14,0,0,0,1605,72.7,0.2,0,0,0,26.5,27.3,2132,1677,455,78.66,21.34,261,1416,102,353,363,1769,15.6,22.4,17,"25% - 50% P.O.C.","$70000 - $98000"
"17111870301","Census Tract 8703.01, McHenry County, Illinois",4345,51503,2436,0,17,0,11,1841,56.1,0,0.4,0,0.3,42.4,43.9,1577,934,643,59.23,40.77,155,779,75,568,230,1347,16.6,11.7,14.6,"25% - 50% P.O.C.","$49000 - $70000"
"17111870302","Census Tract 8703.02, McHenry County, Illinois",4502,50568,2504,11,0,14,0,1962,55.6,0.2,0,0.3,0,43.6,44.4,1468,823,645,56.06,43.94,159,664,228,417,387,1081,19.3,35.3,26.4,"25% - 50% P.O.C.","$49000 - $70000"
"17111870401","Census Tract 8704.01, McHenry County, Illinois",8212,81966,6949,49,0,172,0,900,84.6,0.6,0,2.1,0,11,15.4,3067,2655,412,86.57,13.43,283,2372,88,324,371,2696,10.7,21.4,12.1,"Less than 25% P.O.C.","$70000 - $98000"
"17111870402","Census Tract 8704.02, McHenry County, Illinois",5649,61283,3447,153,0,91,0,1838,61,2.7,0,1.6,0,32.5,39,1875,1178,697,62.83,37.17,181,997,139,558,320,1555,15.4,19.9,17.1,"25% - 50% P.O.C.","$49000 - $70000"
"17111870500","Census Tract 8705, McHenry County, Illinois",9191,72536,8334,24,0,62,0,632,90.7,0.3,0,0.7,0,6.9,9.3,3601,2879,722,79.95,20.05,300,2579,35,687,335,3266,10.4,4.8,9.3,"Less than 25% P.O.C.","$70000 - $98000"
"17111870603","Census Tract 8706.03, McHenry County, Illinois",5154,63716,3531,62,35,23,0,1273,68.5,1.2,0.7,0.4,0,24.7,31.5,1822,1233,589,67.67,32.33,149,1084,181,408,330,1492,12.1,30.7,18.1,"25% - 50% P.O.C.","$49000 - $70000"
"17111870604","Census Tract 8706.04, McHenry County, Illinois",6022,82656,4773,18,0,350,0,711,79.3,0.3,0,5.8,0,11.8,20.7,2362,1806,556,76.46,23.54,126,1680,25,531,151,2211,7,4.5,6.4,"Less than 25% P.O.C.","$70000 - $98000"
"17111870605","Census Tract 8706.05, McHenry County, Illinois",6222,67500,5473,0,18,60,0,616,88,0,0.3,1,0,9.9,12,2392,1902,490,79.52,20.48,219,1683,51,439,270,2122,11.5,10.4,11.3,"Less than 25% P.O.C.","$49000 - $70000"
"17111870606","Census Tract 8706.06, McHenry County, Illinois",4080,56071,3122,49,0,157,0,752,76.5,1.2,0,3.8,0,18.4,23.5,1766,920,846,52.1,47.9,57,863,100,746,157,1609,6.2,11.8,8.9,"Less than 25% P.O.C.","$49000 - $70000"
"17111870702","Census Tract 8707.02, McHenry County, Illinois",7438,83634,6422,141,0,53,0,807,86.3,1.9,0,0.7,0,10.8,13.7,2857,2229,628,78.02,21.98,90,2139,118,510,208,2649,4,18.8,7.3,"Less than 25% P.O.C.","$70000 - $98000"
"17111870703","Census Tract 8707.03, McHenry County, Illinois",5182,115000,4820,28,0,105,0,83,93,0.5,0,2,0,1.6,7,1712,1600,112,93.46,6.54,183,1417,17,95,200,1512,11.4,15.2,11.7,"Less than 25% P.O.C.","$98000 or more"
"17111870704","Census Tract 8707.04, McHenry County, Illinois",3574,71765,3359,0,29,0,0,174,94,0,0.8,0,0,4.9,6,1436,1198,238,83.43,16.57,100,1098,10,228,110,1326,8.3,4.2,7.7,"Less than 25% P.O.C.","$70000 - $98000"
"17111870803","Census Tract 8708.03, McHenry County, Illinois",7935,98580,7334,42,0,81,0,451,92.4,0.5,0,1,0,5.7,7.6,2948,2440,508,82.77,17.23,188,2252,66,442,254,2694,7.7,13,8.6,"Less than 25% P.O.C.","$98000 or more"
"17111870807","Census Tract 8708.07, McHenry County, Illinois",5466,98476,4218,131,0,67,0,956,77.2,2.4,0,1.2,0,17.5,22.8,1854,1306,548,70.44,29.56,137,1169,83,465,220,1634,10.5,15.1,11.9,"Less than 25% P.O.C.","$98000 or more"
"17111870808","Census Tract 8708.08, McHenry County, Illinois",3715,97772,3016,134,0,113,0,365,81.2,3.6,0,3,0,9.8,18.8,1309,1038,271,79.3,20.7,170,868,8,263,178,1131,16.4,3,13.6,"Less than 25% P.O.C.","$70000 - $98000"
"17111870809","Census Tract 8708.09, McHenry County, Illinois",6590,99412,5624,155,0,99,0,505,85.3,2.4,0,1.5,0,7.7,14.7,2428,1802,626,74.22,25.78,208,1594,28,598,236,2192,11.5,4.5,9.7,"Less than 25% P.O.C.","$98000 or more"
"17111870810","Census Tract 8708.10, McHenry County, Illinois",4521,96328,3967,23,0,49,0,445,87.7,0.5,0,1.1,0,9.8,12.3,1697,1522,175,89.69,10.31,174,1348,11,164,185,1512,11.4,6.3,10.9,"Less than 25% P.O.C.","$70000 - $98000"
"17111870811","Census Tract 8708.11, McHenry County, Illinois",4577,80298,3874,0,0,27,0,602,84.6,0,0,0.6,0,13.2,15.4,1729,1413,316,81.72,18.28,97,1316,43,273,140,1589,6.9,13.6,8.1,"Less than 25% P.O.C.","$70000 - $98000"
"17111870812","Census Tract 8708.12, McHenry County, Illinois",4850,78882,3880,0,0,193,0,775,80,0,0,4,0,16,20,1880,1553,327,82.61,17.39,151,1402,24,303,175,1705,9.7,7.3,9.3,"Less than 25% P.O.C.","$70000 - $98000"
"17111870902","Census Tract 8709.02, McHenry County, Illinois",8091,85096,6720,108,0,70,0,1178,83.1,1.3,0,0.9,0,14.6,16.9,2874,2063,811,71.78,28.22,232,1831,70,741,302,2572,11.2,8.6,10.5,"Less than 25% P.O.C.","$70000 - $98000"
"17111870903","Census Tract 8709.03, McHenry County, Illinois",3736,55974,2627,160,0,0,0,887,70.3,4.3,0,0,0,23.7,29.7,1407,766,641,54.44,45.56,50,716,68,573,118,1289,6.5,10.6,8.4,"25% - 50% P.O.C.","$49000 - $70000"
"17111870904","Census Tract 8709.04, McHenry County, Illinois",4718,66172,4023,93,9,0,0,519,85.3,2,0.2,0,0,11,14.7,1845,1170,675,63.41,36.59,89,1081,57,618,146,1699,7.6,8.4,7.9,"Less than 25% P.O.C.","$49000 - $70000"
"17111870905","Census Tract 8709.05, McHenry County, Illinois",4581,55313,3006,54,0,302,0,1086,65.6,1.2,0,6.6,0,23.7,34.4,1926,993,933,51.56,48.44,76,917,73,860,149,1777,7.7,7.8,7.7,"25% - 50% P.O.C.","$49000 - $70000"
"17111871003","Census Tract 8710.03, McHenry County, Illinois",4923,72132,4019,104,0,0,0,776,81.6,2.1,0,0,0,15.8,18.4,1813,1350,463,74.46,25.54,130,1220,51,412,181,1632,9.6,11,10,"Less than 25% P.O.C.","$70000 - $98000"
"17111871004","Census Tract 8710.04, McHenry County, Illinois",5499,75625,4614,75,0,0,0,751,83.9,1.4,0,0,0,13.7,16.1,1992,1530,462,76.81,23.19,216,1314,0,462,216,1776,14.1,0,10.8,"Less than 25% P.O.C.","$70000 - $98000"
"17111871104","Census Tract 8711.04, McHenry County, Illinois",16134,101685,12159,615,0,1251,0,1967,75.4,3.8,0,7.8,0,12.2,24.6,5384,4431,953,82.3,17.7,505,3926,72,881,577,4807,11.4,7.6,10.7,"Less than 25% P.O.C.","$98000 or more"
"17111871105","Census Tract 8711.05, McHenry County, Illinois",5363,92460,4542,61,0,88,0,627,84.7,1.1,0,1.6,0,11.7,15.3,1848,1650,198,89.29,10.71,123,1527,31,167,154,1694,7.5,15.7,8.3,"Less than 25% P.O.C.","$70000 - $98000"
"17111871106","Census Tract 8711.06, McHenry County, Illinois",9127,123796,7761,85,0,354,0,799,85,0.9,0,3.9,0,8.8,15,2926,2706,220,92.48,7.52,368,2338,17,203,385,2541,13.6,7.7,13.2,"Less than 25% P.O.C.","$98000 or more"
"17111871107","Census Tract 8711.07, McHenry County, Illinois",5328,131275,4483,54,0,343,0,355,84.1,1,0,6.4,0,6.7,15.9,1724,1574,150,91.3,8.7,194,1380,0,150,194,1530,12.3,0,11.3,"Less than 25% P.O.C.","$98000 or more"
"17111871108","Census Tract 8711.08, McHenry County, Illinois",5510,117582,4601,139,0,399,0,327,83.5,2.5,0,7.2,0,5.9,16.5,1701,1506,195,88.54,11.46,286,1220,44,151,330,1371,19,22.6,19.4,"Less than 25% P.O.C.","$98000 or more"
"17111871109","Census Tract 8711.09, McHenry County, Illinois",5357,124833,4008,62,0,416,0,835,74.8,1.2,0,7.8,0,15.6,25.2,1500,1341,159,89.4,10.6,263,1078,51,108,314,1186,19.6,32.1,20.9,"25% - 50% P.O.C.","$98000 or more"
"17111871201","Census Tract 8712.01, McHenry County, Illinois",6562,86325,5720,43,16,13,0,757,87.2,0.7,0.2,0.2,0,11.5,12.8,2561,2184,377,85.28,14.72,165,2019,0,377,165,2396,7.6,0,6.4,"Less than 25% P.O.C.","$70000 - $98000"
"17111871202","Census Tract 8712.02, McHenry County, Illinois",5905,63505,3676,0,43,275,0,1690,62.3,0,0.7,4.7,0,28.6,37.7,2133,1512,621,70.89,29.11,234,1278,173,448,407,1726,15.5,27.9,19.1,"25% - 50% P.O.C.","$49000 - $70000"
"17111871205","Census Tract 8712.05, McHenry County, Illinois",4414,73605,3422,193,0,76,0,558,77.5,4.4,0,1.7,0,12.6,22.5,1712,1414,298,82.59,17.41,166,1248,32,266,198,1514,11.7,10.7,11.6,"Less than 25% P.O.C.","$70000 - $98000"
"17111871206","Census Tract 8712.06, McHenry County, Illinois",6768,111216,5176,75,0,751,0,677,76.5,1.1,0,11.1,0,10,23.5,2448,2146,302,87.66,12.34,275,1871,0,302,275,2173,12.8,0,11.2,"Less than 25% P.O.C.","$98000 or more"
"17111871207","Census Tract 8712.07, McHenry County, Illinois",4786,73929,3624,47,24,394,0,636,75.7,1,0.5,8.2,0,13.3,24.3,1766,1311,455,74.24,25.76,141,1170,64,391,205,1561,10.8,14.1,11.6,"Less than 25% P.O.C.","$70000 - $98000"
"17111871208","Census Tract 8712.08, McHenry County, Illinois",3879,106458,3304,0,0,122,0,404,85.2,0,0,3.1,0,10.4,14.8,1364,1263,101,92.6,7.4,109,1154,29,72,138,1226,8.6,28.7,10.1,"Less than 25% P.O.C.","$98000 or more"
"17111871209","Census Tract 8712.09, McHenry County, Illinois",3522,68821,2607,238,0,76,0,439,74,6.8,0,2.2,0,12.5,26,1598,622,976,38.92,61.08,40,582,4,972,44,1554,6.4,0.4,2.8,"25% - 50% P.O.C.","$49000 - $70000"
"17111871301","Census Tract 8713.01, McHenry County, Illinois",4768,90603,4183,0,0,61,0,441,87.7,0,0,1.3,0,9.2,12.3,1866,1348,518,72.24,27.76,124,1224,0,518,124,1742,9.2,0,6.6,"Less than 25% P.O.C.","$70000 - $98000"
"17111871304","Census Tract 8713.04, McHenry County, Illinois",3055,79926,2556,64,0,13,0,352,83.7,2.1,0,0.4,0,11.5,16.3,1197,1027,170,85.8,14.2,53,974,26,144,79,1118,5.2,15.3,6.6,"Less than 25% P.O.C.","$70000 - $98000"
"17111871305","Census Tract 8713.05, McHenry County, Illinois",6395,111791,5502,31,0,12,0,760,86,0.5,0,0.2,0,11.9,14,2090,1816,274,86.89,13.11,196,1620,87,187,283,1807,10.8,31.8,13.5,"Less than 25% P.O.C.","$98000 or more"
"17111871306","Census Tract 8713.06, McHenry County, Illinois",8157,87415,6474,111,0,213,0,1154,79.4,1.4,0,2.6,0,14.1,20.6,2930,2647,283,90.34,9.66,266,2381,49,234,315,2615,10,17.3,10.8,"Less than 25% P.O.C.","$70000 - $98000"
"17111871307","Census Tract 8713.07, McHenry County, Illinois",4758,95104,3892,0,0,96,0,686,81.8,0,0,2,0,14.4,18.2,1666,1453,213,87.21,12.79,103,1350,11,202,114,1552,7.1,5.2,6.8,"Less than 25% P.O.C.","$70000 - $98000"
"17111871310","Census Tract 8713.10, McHenry County, Illinois",4492,105081,3964,33,0,62,0,258,88.2,0.7,0,1.4,0,5.7,11.8,1686,1537,149,91.16,8.84,123,1414,45,104,168,1518,8,30.2,10,"Less than 25% P.O.C.","$98000 or more"
"17111871311","Census Tract 8713.11, McHenry County, Illinois",4336,83611,2842,179,0,549,0,579,65.5,4.1,0,12.7,0,13.4,34.5,1628,1280,348,78.62,21.38,142,1138,24,324,166,1462,11.1,6.9,10.2,"25% - 50% P.O.C.","$70000 - $98000"
"17111871402","Census Tract 8714.02, McHenry County, Illinois",5753,111827,5273,0,0,117,0,363,91.7,0,0,2,0,6.3,8.3,2318,1947,371,83.99,16.01,153,1794,0,371,153,2165,7.9,0,6.6,"Less than 25% P.O.C.","$98000 or more"
"17111871404","Census Tract 8714.04, McHenry County, Illinois",4628,81691,3877,79,0,78,0,501,83.8,1.7,0,1.7,0,10.8,16.2,1827,1489,338,81.5,18.5,83,1406,0,338,83,1744,5.6,0,4.5,"Less than 25% P.O.C.","$70000 - $98000"
"17111871500","Census Tract 8715, McHenry County, Illinois",14732,94429,12735,217,0,569,0,888,86.4,1.5,0,3.9,0,6,13.6,5912,5441,471,92.03,7.97,431,5010,141,330,572,5340,7.9,29.9,9.7,"Less than 25% P.O.C.","$70000 - $98000"
"17111871600","Census Tract 8716, McHenry County, Illinois",5252,94363,4180,221,0,30,0,724,79.6,4.2,0,0.6,0,13.8,20.4,1931,1613,318,83.53,16.47,186,1427,10,308,196,1735,11.5,3.1,10.2,"Less than 25% P.O.C.","$70000 - $98000"
"17197880105","Census Tract 8801.05, Will County, Illinois",7565,82248,3021,1111,37,579,0,1953,39.9,14.7,0.5,7.7,0,25.8,60.1,2322,1962,360,84.5,15.5,288,1674,65,295,353,1969,14.7,18.1,15.2,"50% - 75% P.O.C.","$70000 - $98000"
"17197880106","Census Tract 8801.06, Will County, Illinois",4478,70685,1596,689,0,416,0,1572,35.6,15.4,0,9.3,0,35.1,64.4,1325,1039,286,78.42,21.58,237,802,63,223,300,1025,22.8,22,22.6,"50% - 75% P.O.C.","$70000 - $98000"
"17197880107","Census Tract 8801.07, Will County, Illinois",5434,64969,2043,1042,8,337,2,1804,37.6,19.2,0.1,6.2,0,33.2,62.4,1652,1234,418,74.7,25.3,191,1043,43,375,234,1418,15.5,10.3,14.2,"50% - 75% P.O.C.","$49000 - $70000"
"17197880109","Census Tract 8801.09, Will County, Illinois",4946,92267,3201,1120,4,122,0,456,64.7,22.6,0.1,2.5,0,9.2,35.3,1796,1581,215,88.03,11.97,142,1439,51,164,193,1603,9,23.7,10.7,"25% - 50% P.O.C.","$70000 - $98000"
"17197880111","Census Tract 8801.11, Will County, Illinois",3704,84167,1443,665,0,147,0,1314,39,18,0,4,0,35.5,61,1096,862,234,78.65,21.35,83,779,108,126,191,905,9.6,46.2,17.4,"50% - 75% P.O.C.","$70000 - $98000"
"17197880112","Census Tract 8801.12, Will County, Illinois",2198,96071,1003,381,0,167,0,621,45.6,17.3,0,7.6,0,28.3,54.4,638,594,44,93.1,6.9,105,489,9,35,114,524,17.7,20.5,17.9,"50% - 75% P.O.C.","$70000 - $98000"
"17197880113","Census Tract 8801.13, Will County, Illinois",4048,51298,676,1061,6,334,0,1921,16.7,26.2,0.1,8.3,0,47.5,83.3,1096,578,518,52.74,47.26,121,457,227,291,348,748,20.9,43.8,31.8,"75% or more P.O.C.","$49000 - $70000"
"17197880114","Census Tract 8801.14, Will County, Illinois",2933,37684,684,711,0,335,0,1145,23.3,24.2,0,11.4,0,39,76.7,1013,272,741,26.85,73.15,49,223,78,663,127,886,18,10.5,12.5,"75% or more P.O.C.","Less than $49000"
"17197880115","Census Tract 8801.15, Will County, Illinois",3255,67632,1066,821,0,215,0,1069,32.7,25.2,0,6.6,0,32.8,67.3,1090,900,190,82.57,17.43,116,784,54,136,170,920,12.9,28.4,15.6,"50% - 75% P.O.C.","$49000 - $70000"
"17197880116","Census Tract 8801.16, Will County, Illinois",3197,86659,1292,595,0,242,0,987,40.4,18.6,0,7.6,0,30.9,59.6,999,908,91,90.89,9.11,150,758,44,47,194,805,16.5,48.4,19.4,"50% - 75% P.O.C.","$70000 - $98000"
"17197880117","Census Tract 8801.17, Will County, Illinois",3244,53321,1303,854,0,132,0,864,40.2,26.3,0,4.1,0,26.6,59.8,1446,622,824,43.02,56.98,27,595,39,785,66,1380,4.3,4.7,4.6,"50% - 75% P.O.C.","$49000 - $70000"
"17197880118","Census Tract 8801.18, Will County, Illinois",4844,174130,3728,123,0,700,0,124,77,2.5,0,14.5,0,2.6,23,1444,1366,78,94.6,5.4,181,1185,48,30,229,1215,13.3,61.5,15.9,"Less than 25% P.O.C.","$98000 or more"
"17197880119","Census Tract 8801.19, Will County, Illinois",4071,141960,2861,86,34,819,0,157,70.3,2.1,0.8,20.1,0,3.9,29.7,1435,1380,55,96.17,3.83,165,1215,11,44,176,1259,12,20,12.3,"25% - 50% P.O.C.","$98000 or more"
"17197880120","Census Tract 8801.20, Will County, Illinois",10562,125402,4621,1606,0,2349,8,1632,43.8,15.2,0,22.2,0.1,15.5,56.2,3090,2811,279,90.97,9.03,567,2244,20,259,587,2503,20.2,7.2,19,"50% - 75% P.O.C.","$98000 or more"
"17197880121","Census Tract 8801.21, Will County, Illinois",9977,119810,4431,1644,24,1095,0,2433,44.4,16.5,0.2,11,0,24.4,55.6,2765,2672,93,96.64,3.36,588,2084,0,93,588,2177,22,0,21.3,"50% - 75% P.O.C.","$98000 or more"
"17197880202","Census Tract 8802.02, Will County, Illinois",4711,73900,2504,414,0,248,0,1526,53.2,8.8,0,5.3,0,32.4,46.8,1508,1358,150,90.05,9.95,291,1067,27,123,318,1190,21.4,18,21.1,"25% - 50% P.O.C.","$70000 - $98000"
"17197880203","Census Tract 8802.03, Will County, Illinois",4175,71273,2412,39,0,0,0,1639,57.8,0.9,0,0,0,39.3,42.2,1299,1100,199,84.68,15.32,254,846,43,156,297,1002,23.1,21.6,22.9,"25% - 50% P.O.C.","$70000 - $98000"
"17197880204","Census Tract 8802.04, Will County, Illinois",5486,71860,2843,388,0,563,6,1587,51.8,7.1,0,10.3,0.1,28.9,48.2,2154,1731,423,80.36,19.64,247,1484,0,423,247,1907,14.3,0,11.5,"25% - 50% P.O.C.","$70000 - $98000"
"17197880303","Census Tract 8803.03, Will County, Illinois",4093,132634,3177,122,5,460,0,172,77.6,3,0.1,11.2,0,4.2,22.4,1255,1153,102,91.87,8.13,141,1012,0,102,141,1114,12.2,0,11.2,"Less than 25% P.O.C.","$98000 or more"
"17197880304","Census Tract 8803.04, Will County, Illinois",4888,170353,3834,60,11,546,9,190,78.4,1.2,0.2,11.2,0.2,3.9,21.6,1515,1475,40,97.36,2.64,171,1304,11,29,182,1333,11.6,27.5,12,"Less than 25% P.O.C.","$98000 or more"
"17197880305","Census Tract 8803.05, Will County, Illinois",4972,179659,3712,170,16,815,0,187,74.7,3.4,0.3,16.4,0,3.8,25.3,1509,1499,10,99.34,0.66,157,1342,0,10,157,1352,10.5,0,10.4,"25% - 50% P.O.C.","$98000 or more"
"17197880306","Census Tract 8803.06, Will County, Illinois",6817,160597,2802,652,10,2389,0,611,41.1,9.6,0.1,35,0,9,58.9,1930,1708,222,88.5,11.5,263,1445,0,222,263,1667,15.4,0,13.6,"50% - 75% P.O.C.","$98000 or more"
"17197880307","Census Tract 8803.07, Will County, Illinois",6051,91151,3064,421,59,2160,0,288,50.6,7,1,35.7,0,4.8,49.4,2106,1349,757,64.06,35.94,122,1227,28,729,150,1956,9,3.7,7.1,"25% - 50% P.O.C.","$70000 - $98000"
"17197880308","Census Tract 8803.08, Will County, Illinois",9140,150764,5314,1130,0,1556,0,801,58.1,12.4,0,17,0,8.8,41.9,2777,2512,265,90.46,9.54,368,2144,54,211,422,2355,14.6,20.4,15.2,"25% - 50% P.O.C.","$98000 or more"
"17197880309","Census Tract 8803.09, Will County, Illinois",4939,152778,3276,142,0,1165,0,163,66.3,2.9,0,23.6,0,3.3,33.7,1416,1335,81,94.28,5.72,182,1153,21,60,203,1213,13.6,25.9,14.3,"25% - 50% P.O.C.","$98000 or more"
"17197880310","Census Tract 8803.10, Will County, Illinois",13248,126646,8839,750,0,2040,28,1200,66.7,5.7,0,15.4,0.2,9.1,33.3,3834,3485,349,90.9,9.1,587,2898,91,258,678,3156,16.8,26.1,17.7,"25% - 50% P.O.C.","$98000 or more"
"17197880312","Census Tract 8803.12, Will County, Illinois",11320,157406,6478,453,0,3676,0,398,57.2,4,0,32.5,0,3.5,42.8,3730,3366,364,90.24,9.76,463,2903,10,354,473,3257,13.8,2.7,12.7,"25% - 50% P.O.C.","$98000 or more"
"17197880313","Census Tract 8803.13, Will County, Illinois",11725,117720,5684,1218,0,2243,87,2038,48.5,10.4,0,19.1,0.7,17.4,51.5,3496,2963,533,84.75,15.25,513,2450,118,415,631,2865,17.3,22.1,18,"50% - 75% P.O.C.","$98000 or more"
"17197880314","Census Tract 8803.14, Will County, Illinois",7402,164970,5507,433,0,675,0,677,74.4,5.8,0,9.1,0,9.1,25.6,2097,2053,44,97.9,2.1,364,1689,12,32,376,1721,17.7,27.3,17.9,"25% - 50% P.O.C.","$98000 or more"
"17197880404","Census Tract 8804.04, Will County, Illinois",11974,117841,8350,808,0,770,0,1603,69.7,6.7,0,6.4,0,13.4,30.3,3657,2857,800,78.12,21.88,505,2352,86,714,591,3066,17.7,10.8,16.2,"25% - 50% P.O.C.","$98000 or more"
"17197880408","Census Tract 8804.08, Will County, Illinois",5456,91741,2354,1047,0,448,0,1555,43.1,19.2,0,8.2,0,28.5,56.9,1597,1376,221,86.16,13.84,306,1070,67,154,373,1224,22.2,30.3,23.4,"50% - 75% P.O.C.","$70000 - $98000"
"17197880410","Census Tract 8804.10, Will County, Illinois",8550,101250,3744,1022,0,637,0,2812,43.8,12,0,7.5,0,32.9,56.2,2137,2002,135,93.68,6.32,535,1467,25,110,560,1577,26.7,18.5,26.2,"50% - 75% P.O.C.","$98000 or more"
"17197880411","Census Tract 8804.11, Will County, Illinois",3342,126818,2812,157,0,66,0,272,84.1,4.7,0,2,0,8.1,15.9,1090,958,132,87.89,12.11,153,805,18,114,171,919,16,13.6,15.7,"Less than 25% P.O.C.","$98000 or more"
"17197880412","Census Tract 8804.12, Will County, Illinois",4028,88325,2920,421,33,0,0,645,72.5,10.5,0.8,0,0,16,27.5,1403,1201,202,85.6,14.4,108,1093,9,193,117,1286,9,4.5,8.3,"25% - 50% P.O.C.","$70000 - $98000"
"17197880414","Census Tract 8804.14, Will County, Illinois",4308,80559,3207,153,0,194,0,643,74.4,3.6,0,4.5,0,14.9,25.6,1457,1318,139,90.46,9.54,149,1169,17,122,166,1291,11.3,12.2,11.4,"25% - 50% P.O.C.","$70000 - $98000"
"17197880415","Census Tract 8804.15, Will County, Illinois",7620,83571,4135,561,2,312,0,2213,54.3,7.4,0,4.1,0,29,45.7,2494,2106,388,84.44,15.56,330,1776,28,360,358,2136,15.7,7.2,14.4,"25% - 50% P.O.C.","$70000 - $98000"
"17197880416","Census Tract 8804.16, Will County, Illinois",3293,93667,2595,33,0,91,0,557,78.8,1,0,2.8,0,16.9,21.2,1032,916,116,88.76,11.24,123,793,24,92,147,885,13.4,20.7,14.2,"Less than 25% P.O.C.","$70000 - $98000"
"17197880417","Census Tract 8804.17, Will County, Illinois",2741,82425,2103,175,0,50,0,409,76.7,6.4,0,1.8,0,14.9,23.3,992,818,174,82.46,17.54,130,688,0,174,130,862,15.9,0,13.1,"Less than 25% P.O.C.","$70000 - $98000"
"17197880418","Census Tract 8804.18, Will County, Illinois",5194,130457,3616,329,0,233,0,924,69.6,6.3,0,4.5,0,17.8,30.4,1419,1295,124,91.26,8.74,271,1024,25,99,296,1123,20.9,20.2,20.9,"25% - 50% P.O.C.","$98000 or more"
"17197880419","Census Tract 8804.19, Will County, Illinois",8724,118341,5639,705,0,294,0,1951,64.6,8.1,0,3.4,0,22.4,35.4,2463,2274,189,92.33,7.67,410,1864,73,116,483,1980,18,38.6,19.6,"25% - 50% P.O.C.","$98000 or more"
"17197880420","Census Tract 8804.20, Will County, Illinois",10485,90650,6151,1540,0,129,0,2507,58.7,14.7,0,1.2,0,23.9,41.3,2794,2609,185,93.38,6.62,619,1990,46,139,665,2129,23.7,24.9,23.8,"25% - 50% P.O.C.","$70000 - $98000"
"17197880421","Census Tract 8804.21, Will County, Illinois",6300,113533,4413,452,0,276,0,983,70,7.2,0,4.4,0,15.6,30,1837,1754,83,95.48,4.52,362,1392,10,73,372,1465,20.6,12,20.3,"25% - 50% P.O.C.","$98000 or more"
"17197880502","Census Tract 8805.02, Will County, Illinois",5317,91971,4900,0,0,72,0,306,92.2,0,0,1.4,0,5.8,7.8,1807,1465,342,81.07,18.93,186,1279,43,299,229,1578,12.7,12.6,12.7,"Less than 25% P.O.C.","$70000 - $98000"
"17197880503","Census Tract 8805.03, Will County, Illinois",4527,55128,3178,496,0,69,0,628,70.2,11,0,1.5,0,13.9,29.8,2181,1896,285,86.93,13.07,88,1808,71,214,159,2022,4.6,24.9,7.3,"25% - 50% P.O.C.","$49000 - $70000"
"17197880505","Census Tract 8805.05, Will County, Illinois",7222,80142,3058,333,0,288,0,3431,42.3,4.6,0,4,0,47.5,57.7,2060,1787,273,86.75,13.25,347,1440,87,186,434,1626,19.4,31.9,21.1,"50% - 75% P.O.C.","$70000 - $98000"
"17197880507","Census Tract 8805.07, Will County, Illinois",7479,83309,2321,1261,0,727,0,2722,31,16.9,0,9.7,0,36.4,69,2103,1555,548,73.94,26.06,420,1135,10,538,430,1673,27,1.8,20.4,"50% - 75% P.O.C.","$70000 - $98000"
"17197880601","Census Tract 8806.01, Will County, Illinois",3021,102292,2604,24,0,127,0,215,86.2,0.8,0,4.2,0,7.1,13.8,1188,1043,145,87.79,12.21,64,979,8,137,72,1116,6.1,5.5,6.1,"Less than 25% P.O.C.","$98000 or more"
"17197880602","Census Tract 8806.02, Will County, Illinois",3372,57159,2758,154,0,0,0,453,81.8,4.6,0,0,0,13.4,18.2,1320,810,510,61.36,38.64,84,726,46,464,130,1190,10.4,9,9.8,"Less than 25% P.O.C.","$49000 - $70000"
"17197880701","Census Tract 8807.01, Will County, Illinois",4225,63021,3713,137,0,61,0,282,87.9,3.2,0,1.4,0,6.7,12.1,1826,1381,445,75.63,24.37,89,1292,13,432,102,1724,6.4,2.9,5.6,"Less than 25% P.O.C.","$49000 - $70000"
"17197880702","Census Tract 8807.02, Will County, Illinois",3014,48472,945,1142,0,22,0,808,31.4,37.9,0,0.7,0,26.8,68.6,894,518,376,57.94,42.06,79,439,115,261,194,700,15.3,30.6,21.7,"50% - 75% P.O.C.","Less than $49000"
"17197880901","Census Tract 8809.01, Will County, Illinois",5744,63875,4177,209,0,603,0,706,72.7,3.6,0,10.5,0,12.3,27.3,2454,2309,145,94.09,5.91,240,2069,0,145,240,2214,10.4,0,9.8,"25% - 50% P.O.C.","$49000 - $70000"
"17197880903","Census Tract 8809.03, Will County, Illinois",2705,45553,1461,745,0,5,0,360,54,27.5,0,0.2,0,13.3,46,1294,410,884,31.68,68.32,21,389,16,868,37,1257,5.1,1.8,2.9,"25% - 50% P.O.C.","Less than $49000"
"17197880905","Census Tract 8809.05, Will County, Illinois",2707,57202,1612,26,0,1,0,1052,59.5,1,0,0,0,38.9,40.5,985,762,223,77.36,22.64,82,680,51,172,133,852,10.8,22.9,13.5,"25% - 50% P.O.C.","$49000 - $70000"
"17197881001","Census Tract 8810.01, Will County, Illinois",5401,94185,4809,70,0,21,0,471,89,1.3,0,0.4,0,8.7,11,1824,1657,167,90.84,9.16,217,1440,0,167,217,1607,13.1,0,11.9,"Less than 25% P.O.C.","$70000 - $98000"
"17197881002","Census Tract 8810.02, Will County, Illinois",5242,104236,4804,25,0,12,0,394,91.6,0.5,0,0.2,0,7.5,8.4,1769,1543,226,87.22,12.78,162,1381,0,226,162,1607,10.5,0,9.2,"Less than 25% P.O.C.","$98000 or more"
"17197881005","Census Tract 8810.05, Will County, Illinois",3513,105781,3289,0,0,68,0,110,93.6,0,0,1.9,0,3.1,6.4,1238,1176,62,94.99,5.01,144,1032,12,50,156,1082,12.2,19.4,12.6,"Less than 25% P.O.C.","$98000 or more"
"17197881006","Census Tract 8810.06, Will County, Illinois",2365,94500,1999,0,0,132,0,199,84.5,0,0,5.6,0,8.4,15.5,854,796,58,93.21,6.79,107,689,0,58,107,747,13.4,0,12.5,"Less than 25% P.O.C.","$70000 - $98000"
"17197881007","Census Tract 8810.07, Will County, Illinois",5842,116364,4923,119,0,93,0,642,84.3,2,0,1.6,0,11,15.7,1786,1722,64,96.42,3.58,233,1489,0,64,233,1553,13.5,0,13,"Less than 25% P.O.C.","$98000 or more"
"17197881009","Census Tract 8810.09, Will County, Illinois",6608,101442,6028,43,0,38,0,457,91.2,0.7,0,0.6,0,6.9,8.8,2252,2079,173,92.32,7.68,428,1651,0,173,428,1824,20.6,0,19,"Less than 25% P.O.C.","$98000 or more"
"17197881010","Census Tract 8810.10, Will County, Illinois",3912,115151,3122,107,0,112,0,377,79.8,2.7,0,2.9,0,9.6,20.2,1241,1116,125,89.93,10.07,161,955,39,86,200,1041,14.4,31.2,16.1,"Less than 25% P.O.C.","$98000 or more"
"17197881011","Census Tract 8810.11, Will County, Illinois",3533,99767,3004,9,13,228,0,199,85,0.3,0.4,6.5,0,5.6,15,1153,1053,100,91.33,8.67,147,906,37,63,184,969,14,37,16,"Less than 25% P.O.C.","$98000 or more"
"17197881012","Census Tract 8810.12, Will County, Illinois",3082,115385,2779,6,0,23,0,237,90.2,0.2,0,0.7,0,7.7,9.8,954,933,21,97.8,2.2,125,808,7,14,132,822,13.4,33.3,13.8,"Less than 25% P.O.C.","$98000 or more"
"17197881105","Census Tract 8811.05, Will County, Illinois",6916,125071,6083,0,0,19,0,782,88,0,0,0.3,0,11.3,12,2335,2286,49,97.9,2.1,371,1915,0,49,371,1964,16.2,0,15.9,"Less than 25% P.O.C.","$98000 or more"
"17197881107","Census Tract 8811.07, Will County, Illinois",2816,84087,2550,2,0,25,0,202,90.6,0.1,0,0.9,0,7.2,9.4,1093,884,209,80.88,19.12,106,778,20,189,126,967,12,9.6,11.5,"Less than 25% P.O.C.","$70000 - $98000"
"17197881108","Census Tract 8811.08, Will County, Illinois",6723,98695,5478,105,0,174,0,600,81.5,1.6,0,2.6,0,8.9,18.5,2179,2085,94,95.69,4.31,237,1848,0,94,237,1942,11.4,0,10.9,"Less than 25% P.O.C.","$98000 or more"
"17197881109","Census Tract 8811.09, Will County, Illinois",4598,114375,4074,114,0,21,0,337,88.6,2.5,0,0.5,0,7.3,11.4,1489,1162,327,78.04,21.96,236,926,9,318,245,1244,20.3,2.8,16.5,"Less than 25% P.O.C.","$98000 or more"
"17197881111","Census Tract 8811.11, Will County, Illinois",2770,83305,2533,0,0,56,0,144,91.4,0,0,2,0,5.2,8.6,1152,1007,145,87.41,12.59,85,922,6,139,91,1061,8.4,4.1,7.9,"Less than 25% P.O.C.","$70000 - $98000"
"17197881112","Census Tract 8811.12, Will County, Illinois",5678,106850,5383,4,0,7,0,270,94.8,0.1,0,0.1,0,4.8,5.2,1753,1617,136,92.24,7.76,252,1365,18,118,270,1483,15.6,13.2,15.4,"Less than 25% P.O.C.","$98000 or more"
"17197881113","Census Tract 8811.13, Will County, Illinois",4704,113043,4295,46,0,0,0,252,91.3,1,0,0,0,5.4,8.7,1472,1409,63,95.72,4.28,266,1143,0,63,266,1206,18.9,0,18.1,"Less than 25% P.O.C.","$98000 or more"
"17197881115","Census Tract 8811.15, Will County, Illinois",4151,106957,3931,36,0,0,0,118,94.7,0.9,0,0,0,2.8,5.3,1474,1288,186,87.38,12.62,168,1120,0,186,168,1306,13,0,11.4,"Less than 25% P.O.C.","$98000 or more"
"17197881116","Census Tract 8811.16, Will County, Illinois",3981,135250,3837,0,0,34,0,77,96.4,0,0,0.9,0,1.9,3.6,1298,1271,27,97.92,2.08,187,1084,0,27,187,1111,14.7,0,14.4,"Less than 25% P.O.C.","$98000 or more"
"17197881200","Census Tract 8812, Will County, Illinois",4811,43563,567,2280,6,12,0,1768,11.8,47.4,0.1,0.2,0,36.7,88.2,1371,581,790,42.38,57.62,116,465,124,666,240,1131,20,15.7,17.5,"75% or more P.O.C.","Less than $49000"
"17197881301","Census Tract 8813.01, Will County, Illinois",2812,45606,120,139,0,33,0,2503,4.3,4.9,0,1.2,0,89,95.7,790,434,356,54.94,45.06,116,318,80,276,196,594,26.7,22.5,24.8,"75% or more P.O.C.","Less than $49000"
"17197881302","Census Tract 8813.02, Will County, Illinois",1755,47371,29,136,0,0,0,1590,1.7,7.7,0,0,0,90.6,98.3,471,250,221,53.08,46.92,75,175,47,174,122,349,30,21.3,25.9,"75% or more P.O.C.","Less than $49000"
"17197881401","Census Tract 8814.01, Will County, Illinois",3722,42801,1324,70,0,0,0,2231,35.6,1.9,0,0,0,59.9,64.4,1145,699,446,61.05,38.95,125,574,177,269,302,843,17.9,39.7,26.4,"50% - 75% P.O.C.","Less than $49000"
"17197881402","Census Tract 8814.02, Will County, Illinois",3210,52317,1511,534,0,4,0,1049,47.1,16.6,0,0.1,0,32.7,52.9,1312,977,335,74.47,25.53,47,930,44,291,91,1221,4.8,13.1,6.9,"50% - 75% P.O.C.","$49000 - $70000"
"17197881500","Census Tract 8815, Will County, Illinois",2972,68750,1931,117,0,0,0,886,65,3.9,0,0,0,29.8,35,1134,981,153,86.51,13.49,101,880,18,135,119,1015,10.3,11.8,10.5,"25% - 50% P.O.C.","$49000 - $70000"
"17197881601","Census Tract 8816.01, Will County, Illinois",2053,68194,1417,193,0,16,0,394,69,9.4,0,0.8,0,19.2,31,883,527,356,59.68,40.32,51,476,14,342,65,818,9.7,3.9,7.4,"25% - 50% P.O.C.","$49000 - $70000"
"17197881603","Census Tract 8816.03, Will County, Illinois",3543,46503,1364,1301,0,42,0,650,38.5,36.7,0,1.2,0,18.3,61.5,1327,442,885,33.31,66.69,112,330,52,833,164,1163,25.3,5.9,12.4,"50% - 75% P.O.C.","Less than $49000"
"17197881604","Census Tract 8816.04, Will County, Illinois",2567,52653,940,982,0,40,0,470,36.6,38.3,0,1.6,0,18.3,63.4,1151,504,647,43.79,56.21,39,465,5,642,44,1107,7.7,0.8,3.8,"50% - 75% P.O.C.","$49000 - $70000"
"17197881700","Census Tract 8817, Will County, Illinois",3438,69940,2470,141,0,22,0,759,71.8,4.1,0,0.6,0,22.1,28.2,1367,1126,241,82.37,17.63,126,1000,9,232,135,1232,11.2,3.7,9.9,"25% - 50% P.O.C.","$49000 - $70000"
"17197881800","Census Tract 8818, Will County, Illinois",4202,50302,1787,728,0,0,0,1579,42.5,17.3,0,0,0,37.6,57.5,1343,666,677,49.59,50.41,95,571,137,540,232,1111,14.3,20.2,17.3,"50% - 75% P.O.C.","$49000 - $70000"
"17197881900","Census Tract 8819, Will County, Illinois",3662,23194,512,1677,0,0,0,1365,14,45.8,0,0,0,37.3,86,1514,275,1239,18.16,81.84,31,244,128,1111,159,1355,11.3,10.3,10.5,"75% or more P.O.C.","Less than $49000"
"17197882000","Census Tract 8820, Will County, Illinois",3262,31356,483,984,9,7,0,1665,14.8,30.2,0.3,0.2,0,51,85.2,886,246,640,27.77,72.23,114,132,46,594,160,726,46.3,7.2,18.1,"75% or more P.O.C.","Less than $49000"
"17197882100","Census Tract 8821, Will County, Illinois",2664,49659,58,363,4,0,0,2239,2.2,13.6,0.2,0,0,84,97.8,703,301,402,42.82,57.18,89,212,66,336,155,548,29.6,16.4,22,"75% or more P.O.C.","$49000 - $70000"
"17197882200","Census Tract 8822, Will County, Illinois",4066,44712,827,340,0,9,0,2824,20.3,8.4,0,0.2,0,69.5,79.7,1281,724,557,56.52,43.48,107,617,131,426,238,1043,14.8,23.5,18.6,"75% or more P.O.C.","Less than $49000"
"17197882300","Census Tract 8823, Will County, Illinois",3912,47159,1762,322,7,20,0,1573,45,8.2,0.2,0.5,0,40.2,55,1499,972,527,64.84,35.16,165,807,22,505,187,1312,17,4.2,12.5,"50% - 75% P.O.C.","Less than $49000"
"17197882400","Census Tract 8824, Will County, Illinois",3372,46842,239,1150,0,0,0,1919,7.1,34.1,0,0,0,56.9,92.9,930,548,382,58.92,41.08,159,389,73,309,232,698,29,19.1,24.9,"75% or more P.O.C.","Less than $49000"
"17197882500","Census Tract 8825, Will County, Illinois",2160,40855,55,1543,0,0,0,548,2.5,71.4,0,0,0,25.4,97.5,747,240,507,32.13,67.87,54,186,15,492,69,678,22.5,3,9.2,"75% or more P.O.C.","Less than $49000"
"17197882601","Census Tract 8826.01, Will County, Illinois",3328,60969,1367,637,0,69,0,1166,41.1,19.1,0,2.1,0,35,58.9,1145,755,390,65.94,34.06,35,720,53,337,88,1057,4.6,13.6,7.7,"50% - 75% P.O.C.","$49000 - $70000"
"17197882602","Census Tract 8826.02, Will County, Illinois",2825,54559,735,610,0,0,0,1462,26,21.6,0,0,0,51.8,74,878,454,424,51.71,48.29,99,355,87,337,186,692,21.8,20.5,21.2,"50% - 75% P.O.C.","$49000 - $70000"
"17197882701","Census Tract 8827.01, Will County, Illinois",2735,81389,1671,178,0,3,0,865,61.1,6.5,0,0.1,0,31.6,38.9,858,691,167,80.54,19.46,152,539,23,144,175,683,22,13.8,20.4,"25% - 50% P.O.C.","$70000 - $98000"
"17197882702","Census Tract 8827.02, Will County, Illinois",3143,60773,1424,674,0,23,0,971,45.3,21.4,0,0.7,0,30.9,54.7,1070,522,548,48.79,51.21,123,399,27,521,150,920,23.6,4.9,14,"50% - 75% P.O.C.","$49000 - $70000"
"17197882801","Census Tract 8828.01, Will County, Illinois",2803,46250,1283,466,0,145,0,866,45.8,16.6,0,5.2,0,30.9,54.2,1207,786,421,65.12,34.88,49,737,14,407,63,1144,6.2,3.3,5.2,"50% - 75% P.O.C.","Less than $49000"
"17197882802","Census Tract 8828.02, Will County, Illinois",3299,36835,1209,1020,10,75,0,830,36.6,30.9,0.3,2.3,0,25.2,63.4,1144,475,669,41.52,58.48,116,359,15,654,131,1013,24.4,2.2,11.5,"50% - 75% P.O.C.","Less than $49000"
"17197882900","Census Tract 8829, Will County, Illinois",2373,48571,1208,178,0,7,0,947,50.9,7.5,0,0.3,0,39.9,49.1,850,415,435,48.82,51.18,76,339,51,384,127,723,18.3,11.7,14.9,"25% - 50% P.O.C.","Less than $49000"
"17197883000","Census Tract 8830, Will County, Illinois",3709,48571,1224,1294,45,18,0,1005,33,34.9,1.2,0.5,0,27.1,67,1166,627,539,53.77,46.23,122,505,55,484,177,989,19.5,10.2,15.2,"50% - 75% P.O.C.","Less than $49000"
"17197883100","Census Tract 8831, Will County, Illinois",4261,50833,1161,1832,0,9,0,1130,27.2,43,0,0.2,0,26.5,72.8,1432,900,532,62.85,37.15,118,782,90,442,208,1224,13.1,16.9,14.5,"50% - 75% P.O.C.","$49000 - $70000"
"17197883206","Census Tract 8832.06, Will County, Illinois",3887,61650,2527,442,0,71,0,789,65,11.4,0,1.8,0,20.3,35,1621,1132,489,69.83,30.17,77,1055,0,489,77,1544,6.8,0,4.8,"25% - 50% P.O.C.","$49000 - $70000"
"17197883208","Census Tract 8832.08, Will County, Illinois",2879,55076,1914,363,0,37,0,479,66.5,12.6,0,1.3,0,16.6,33.5,1330,1003,327,75.41,24.59,38,965,56,271,94,1236,3.8,17.1,7.1,"25% - 50% P.O.C.","$49000 - $70000"
"17197883209","Census Tract 8832.09, Will County, Illinois",3025,82725,2305,311,0,0,0,307,76.2,10.3,0,0,0,10.1,23.8,1067,794,273,74.41,25.59,76,718,32,241,108,959,9.6,11.7,10.1,"Less than 25% P.O.C.","$70000 - $98000"
"17197883210","Census Tract 8832.10, Will County, Illinois",2768,74263,2104,287,0,48,0,329,76,10.4,0,1.7,0,11.9,24,1331,958,373,71.98,28.02,38,920,0,373,38,1293,4,0,2.9,"Less than 25% P.O.C.","$70000 - $98000"
"17197883211","Census Tract 8832.11, Will County, Illinois",6042,80508,3423,905,7,199,0,1373,56.7,15,0.1,3.3,0,22.7,43.3,1911,1733,178,90.69,9.31,95,1638,117,61,212,1699,5.5,65.7,11.1,"25% - 50% P.O.C.","$70000 - $98000"
"17197883212","Census Tract 8832.12, Will County, Illinois",5588,117440,4373,338,0,115,0,641,78.3,6,0,2.1,0,11.5,21.7,1839,1777,62,96.63,3.37,306,1471,0,62,306,1533,17.2,0,16.6,"Less than 25% P.O.C.","$98000 or more"
"17197883213","Census Tract 8832.13, Will County, Illinois",5814,105089,5098,126,0,70,0,481,87.7,2.2,0,1.2,0,8.3,12.3,2268,2006,262,88.45,11.55,133,1873,0,262,133,2135,6.6,0,5.9,"Less than 25% P.O.C.","$98000 or more"
"17197883214","Census Tract 8832.14, Will County, Illinois",2557,71875,1762,239,0,169,0,342,68.9,9.3,0,6.6,0,13.4,31.1,970,903,67,93.09,6.91,58,845,0,67,58,912,6.4,0,6,"25% - 50% P.O.C.","$70000 - $98000"
"17197883215","Census Tract 8832.15, Will County, Illinois",11966,97394,6813,1503,0,319,0,3263,56.9,12.6,0,2.7,0,27.3,43.1,3430,2778,652,80.99,19.01,663,2115,103,549,766,2664,23.9,15.8,22.3,"25% - 50% P.O.C.","$70000 - $98000"
"17197883216","Census Tract 8832.16, Will County, Illinois",2934,106094,2266,126,0,8,0,377,77.2,4.3,0,0.3,0,12.8,22.8,1032,986,46,95.54,4.46,111,875,0,46,111,921,11.3,0,10.8,"Less than 25% P.O.C.","$98000 or more"
"17197883303","Census Tract 8833.03, Will County, Illinois",3970,112500,3769,21,0,36,0,115,94.9,0.5,0,0.9,0,2.9,5.1,1274,1218,56,95.6,4.4,84,1134,0,56,84,1190,6.9,0,6.6,"Less than 25% P.O.C.","$98000 or more"
"17197883304","Census Tract 8833.04, Will County, Illinois",1753,78269,1488,0,0,0,0,265,84.9,0,0,0,0,15.1,15.1,688,646,42,93.9,6.1,38,608,6,36,44,644,5.9,14.3,6.4,"Less than 25% P.O.C.","$70000 - $98000"
"17197883305","Census Tract 8833.05, Will County, Illinois",3080,97455,2605,0,19,0,0,409,84.6,0,0.6,0,0,13.3,15.4,1045,914,131,87.46,12.54,58,856,40,91,98,947,6.3,30.5,9.4,"Less than 25% P.O.C.","$70000 - $98000"
"17197883306","Census Tract 8833.06, Will County, Illinois",3527,97059,3096,14,6,31,0,370,87.8,0.4,0.2,0.9,0,10.5,12.2,1168,1024,144,87.67,12.33,117,907,42,102,159,1009,11.4,29.2,13.6,"Less than 25% P.O.C.","$70000 - $98000"
"17197883307","Census Tract 8833.07, Will County, Illinois",4040,84851,3504,140,0,18,0,346,86.7,3.5,0,0.4,0,8.6,13.3,1535,1439,96,93.75,6.25,84,1355,2,94,86,1449,5.8,2.1,5.6,"Less than 25% P.O.C.","$70000 - $98000"
"17197883401","Census Tract 8834.01, Will County, Illinois",4242,53714,3929,21,0,12,0,269,92.6,0.5,0,0.3,0,6.3,7.4,1596,979,617,61.34,38.66,56,923,15,602,71,1525,5.7,2.4,4.4,"Less than 25% P.O.C.","$49000 - $70000"
"17197883402","Census Tract 8834.02, Will County, Illinois",1895,64185,1585,14,8,0,0,247,83.6,0.7,0.4,0,0,13,16.4,793,574,219,72.38,27.62,24,550,11,208,35,758,4.2,5,4.4,"Less than 25% P.O.C.","$49000 - $70000"
"17197883504","Census Tract 8835.04, Will County, Illinois",5612,97132,4766,481,0,14,0,281,84.9,8.6,0,0.2,0,5,15.1,2252,2090,162,92.81,7.19,159,1931,15,147,174,2078,7.6,9.3,7.7,"Less than 25% P.O.C.","$70000 - $98000"
"17197883505","Census Tract 8835.05, Will County, Illinois",8623,126612,6405,954,0,464,0,605,74.3,11.1,0,5.4,0,7,25.7,2525,2433,92,96.36,3.64,434,1999,20,72,454,2071,17.8,21.7,18,"25% - 50% P.O.C.","$98000 or more"
"17197883507","Census Tract 8835.07, Will County, Illinois",3981,110500,3493,183,3,0,0,302,87.7,4.6,0.1,0,0,7.6,12.3,1318,1269,49,96.28,3.72,187,1082,6,43,193,1125,14.7,12.2,14.6,"Less than 25% P.O.C.","$98000 or more"
"17197883509","Census Tract 8835.09, Will County, Illinois",4426,81864,4256,0,0,0,0,134,96.2,0,0,0,0,3,3.8,1559,1260,299,80.82,19.18,151,1109,10,289,161,1398,12,3.3,10.3,"Less than 25% P.O.C.","$70000 - $98000"
"17197883510","Census Tract 8835.10, Will County, Illinois",5502,113782,5242,22,0,23,0,168,95.3,0.4,0,0.4,0,3.1,4.7,1619,1485,134,91.72,8.28,325,1160,6,128,331,1288,21.9,4.5,20.4,"Less than 25% P.O.C.","$98000 or more"
"17197883511","Census Tract 8835.11, Will County, Illinois",4531,92632,3882,213,0,59,0,377,85.7,4.7,0,1.3,0,8.3,14.3,1650,1434,216,86.91,13.09,149,1285,16,200,165,1485,10.4,7.4,10,"Less than 25% P.O.C.","$70000 - $98000"
"17197883513","Census Tract 8835.13, Will County, Illinois",5795,114922,4816,53,11,379,0,422,83.1,0.9,0.2,6.5,0,7.3,16.9,1687,1616,71,95.79,4.21,268,1348,0,71,268,1419,16.6,0,15.9,"Less than 25% P.O.C.","$98000 or more"
"17197883514","Census Tract 8835.14, Will County, Illinois",6813,122794,5681,157,0,442,0,384,83.4,2.3,0,6.5,0,5.6,16.6,2088,2027,61,97.08,2.92,387,1640,0,61,387,1701,19.1,0,18.5,"Less than 25% P.O.C.","$98000 or more"
"17197883515","Census Tract 8835.15, Will County, Illinois",4071,131302,3609,73,0,100,0,220,88.7,1.8,0,2.5,0,5.4,11.3,1411,1296,115,91.85,8.15,176,1120,8,107,184,1227,13.6,7,13,"Less than 25% P.O.C.","$98000 or more"
"17197883516","Census Tract 8835.16, Will County, Illinois",7666,130066,7103,13,0,190,0,254,92.7,0.2,0,2.5,0,3.3,7.3,2441,2287,154,93.69,6.31,444,1843,0,154,444,1997,19.4,0,18.2,"Less than 25% P.O.C.","$98000 or more"
"17197883517","Census Tract 8835.17, Will County, Illinois",3467,94330,3066,2,0,75,0,285,88.4,0.1,0,2.2,0,8.2,11.6,1361,1081,280,79.43,20.57,75,1006,11,269,86,1275,6.9,3.9,6.3,"Less than 25% P.O.C.","$70000 - $98000"
"17197883519","Census Tract 8835.19, Will County, Illinois",5560,100200,5254,137,0,0,0,112,94.5,2.5,0,0,0,2,5.5,2038,1756,282,86.16,13.84,284,1472,0,282,284,1754,16.2,0,13.9,"Less than 25% P.O.C.","$98000 or more"
"17197883521","Census Tract 8835.21, Will County, Illinois",3799,115694,3453,41,0,41,0,182,90.9,1.1,0,1.1,0,4.8,9.1,1298,1136,162,87.52,12.48,136,1000,10,152,146,1152,12,6.2,11.2,"Less than 25% P.O.C.","$98000 or more"
"17197883522","Census Tract 8835.22, Will County, Illinois",3384,106012,3114,30,0,91,0,66,92,0.9,0,2.7,0,2,8,1240,1175,65,94.76,5.24,48,1127,37,28,85,1155,4.1,56.9,6.9,"Less than 25% P.O.C.","$98000 or more"
"17197883602","Census Tract 8836.02, Will County, Illinois",5519,71416,3870,1277,0,105,0,262,70.1,23.1,0,1.9,0,4.7,29.9,2575,2354,221,91.42,8.58,0,2354,35,186,35,2540,0,15.8,1.4,"25% - 50% P.O.C.","$70000 - $98000"
"17197883603","Census Tract 8836.03, Will County, Illinois",3098,59940,1246,1619,0,18,0,86,40.2,52.3,0,0.6,0,2.8,59.8,1373,933,440,67.95,32.05,43,890,0,440,43,1330,4.6,0,3.1,"50% - 75% P.O.C.","$49000 - $70000"
"17197883605","Census Tract 8836.05, Will County, Illinois",2893,40769,184,2579,0,15,0,82,6.4,89.1,0,0.5,0,2.8,93.6,1076,362,714,33.64,66.36,46,316,47,667,93,983,12.7,6.6,8.6,"75% or more P.O.C.","Less than $49000"
"17197883606","Census Tract 8836.06, Will County, Illinois",4021,73904,608,2593,0,194,0,477,15.1,64.5,0,4.8,0,11.9,84.9,1218,1131,87,92.86,7.14,174,957,19,68,193,1025,15.4,21.8,15.8,"75% or more P.O.C.","$70000 - $98000"
"17197883700","Census Tract 8837, Will County, Illinois",3157,53542,2437,251,0,0,0,395,77.2,8,0,0,0,12.5,22.8,1388,984,404,70.89,29.11,99,885,20,384,119,1269,10.1,5,8.6,"Less than 25% P.O.C.","$49000 - $70000"
"17197883803","Census Tract 8838.03, Will County, Illinois",2840,45320,436,1787,0,30,0,386,15.4,62.9,0,1.1,0,13.6,84.6,1367,274,1093,20.04,79.96,32,242,0,1093,32,1335,11.7,0,2.3,"75% or more P.O.C.","Less than $49000"
"17197883804","Census Tract 8838.04, Will County, Illinois",2671,74013,1840,582,0,8,9,131,68.9,21.8,0,0.3,0.3,4.9,31.1,1029,878,151,85.33,14.67,81,797,0,151,81,948,9.2,0,7.9,"25% - 50% P.O.C.","$70000 - $98000"
"17197883806","Census Tract 8838.06, Will County, Illinois",3279,82347,1763,1253,0,76,0,176,53.8,38.2,0,2.3,0,5.4,46.2,1216,1156,60,95.07,4.93,111,1045,8,52,119,1097,9.6,13.3,9.8,"25% - 50% P.O.C.","$70000 - $98000"
"17197883808","Census Tract 8838.08, Will County, Illinois",1857,66622,1538,146,4,23,0,117,82.8,7.9,0.2,1.2,0,6.3,17.2,812,670,142,82.51,17.49,69,601,0,142,69,743,10.3,0,8.5,"Less than 25% P.O.C.","$49000 - $70000"
"17197883809","Census Tract 8838.09, Will County, Illinois",3024,50425,2295,433,0,0,0,221,75.9,14.3,0,0,0,7.3,24.1,1238,1091,147,88.13,11.87,133,958,40,107,173,1065,12.2,27.2,14,"Less than 25% P.O.C.","$49000 - $70000"
"17197883810","Census Tract 8838.10, Will County, Illinois",3530,76935,1382,1552,0,11,0,504,39.2,44,0,0.3,0,14.3,60.8,1264,1091,173,86.31,13.69,155,936,0,173,155,1109,14.2,0,12.3,"50% - 75% P.O.C.","$70000 - $98000"
"17197883811","Census Tract 8838.11, Will County, Illinois",3043,75203,1983,641,0,29,0,329,65.2,21.1,0,1,0,10.8,34.8,1096,902,194,82.3,17.7,87,815,32,162,119,977,9.6,16.5,10.9,"25% - 50% P.O.C.","$70000 - $98000"
"17197883902","Census Tract 8839.02, Will County, Illinois",6337,87301,5911,10,4,0,0,385,93.3,0.2,0.1,0,0,6.1,6.7,2272,1931,341,84.99,15.01,154,1777,14,327,168,2104,8,4.1,7.4,"Less than 25% P.O.C.","$70000 - $98000"
"17197883903","Census Tract 8839.03, Will County, Illinois",1866,93906,1696,9,0,0,0,104,90.9,0.5,0,0,0,5.6,9.1,664,571,93,85.99,14.01,86,485,0,93,86,578,15.1,0,13,"Less than 25% P.O.C.","$70000 - $98000"
"17197883904","Census Tract 8839.04, Will County, Illinois",4392,75357,3868,25,0,6,0,375,88.1,0.6,0,0.1,0,8.5,11.9,1644,1251,393,76.09,23.91,174,1077,41,352,215,1429,13.9,10.4,13.1,"Less than 25% P.O.C.","$70000 - $98000"
"17197884003","Census Tract 8840.03, Will County, Illinois",4378,64345,3890,19,0,8,0,285,88.9,0.4,0,0.2,0,6.5,11.1,1690,1263,427,74.73,25.27,101,1162,16,411,117,1573,8,3.7,6.9,"Less than 25% P.O.C.","$49000 - $70000"
"17197884004","Census Tract 8840.04, Will County, Illinois",2668,60463,2521,0,0,6,0,130,94.5,0,0,0.2,0,4.9,5.5,1076,848,228,78.81,21.19,70,778,15,213,85,991,8.3,6.6,7.9,"Less than 25% P.O.C.","$49000 - $70000"
"17197884005","Census Tract 8840.05, Will County, Illinois",1324,65000,1251,9,29,0,0,22,94.5,0.7,2.2,0,0,1.7,5.5,578,559,19,96.71,3.29,13,546,1,18,14,564,2.3,5.3,2.4,"Less than 25% P.O.C.","$49000 - $70000"
"17197884006","Census Tract 8840.06, Will County, Illinois",2244,68088,2054,29,0,22,0,54,91.5,1.3,0,1,0,2.4,8.5,894,736,158,82.33,17.67,44,692,33,125,77,817,6,20.9,8.6,"Less than 25% P.O.C.","$49000 - $70000"
"17197884101","Census Tract 8841.01, Will County, Illinois",4553,57204,2904,390,0,103,0,1098,63.8,8.6,0,2.3,0,24.1,36.2,1482,1090,392,73.55,26.45,85,1005,27,365,112,1370,7.8,6.9,7.6,"25% - 50% P.O.C.","$49000 - $70000"
"17197884103","Census Tract 8841.03, Will County, Illinois",2724,90352,1222,511,0,114,0,826,44.9,18.8,0,4.2,0,30.3,55.1,903,733,170,81.17,18.83,145,588,0,170,145,758,19.8,0,16.1,"50% - 75% P.O.C.","$70000 - $98000"
"17197980000","Census Tract 9800, Will County, Illinois",0,NA,0,0,0,0,0,0,NA,NA,NA,NA,NA,NA,NA,0,0,0,NA,NA,0,0,0,0,0,0,NA,NA,NA,"N/A","N/A"
"17197980100","Census Tract 9801, Will County, Illinois",3435,168750,585,2256,12,38,0,438,17,65.7,0.3,1.1,0,12.8,83,21,21,0,100,0,0,21,0,0,0,21,0,NA,0,"75% or more P.O.C.","$98000 or more"
