"GEOID","NAME","total_pop","median_hh_income","white","black","ai_an","asian","hi_pi","hisp_lat","pct_white","pct_black","pct_ai_an","pct_asian","pct_hi_pi","pct_hisp_lat","pct_poc","total_hh","total_hh_owner","total_hh_renter","pct_owners","pct_renters","total_owner_more_than_4","total_owner_less_than_4","total_renter_more_than_4","total_renter_less_than_4","total_hh_more_than_4","total_hh_less_than_4","pct_owner_more_than_4","pct_renter_more_than_4","pct_total_hh_more_than_4","poc_bin","income_bin"
"10001040100","Census Tract 401, Kent County, Delaware",7078,75194,5933,548,48,99,2,250,83.8,7.7,0.7,1.4,0,3.5,16.2,2657,2272,385,85.51,14.49,240,2032,32,353,272,2385,10.6,8.3,10.2,"Less than 25% P.O.C.","$72000 - $96000"
"10001040201","Census Tract 402.01, Kent County, Delaware",4736,54800,3111,1035,27,51,0,329,65.7,21.9,0.6,1.1,0,6.9,34.3,1814,1173,641,64.66,35.34,96,1077,29,612,125,1689,8.2,4.5,6.9,"25% - 50% P.O.C.","$51000 - $72000"
"10001040202","Census Tract 402.02, Kent County, Delaware",16940,74146,10615,4618,6,123,0,966,62.7,27.3,0,0.7,0,5.7,37.3,5944,5120,824,86.14,13.86,930,4190,0,824,930,5014,18.2,0,15.6,"25% - 50% P.O.C.","$72000 - $96000"
"10001040203","Census Tract 402.03, Kent County, Delaware",5443,66797,2986,1996,0,0,0,336,54.9,36.7,0,0,0,6.2,45.1,2010,1543,467,76.77,23.23,186,1357,19,448,205,1805,12.1,4.1,10.2,"25% - 50% P.O.C.","$51000 - $72000"
"10001040501","Census Tract 405.01, Kent County, Delaware",4501,47288,1918,1975,0,97,0,246,42.6,43.9,0,2.2,0,5.5,57.4,1883,1288,595,68.4,31.6,69,1219,85,510,154,1729,5.4,14.3,8.2,"50% - 75% P.O.C.","Less than $51000"
"10001040502","Census Tract 405.02, Kent County, Delaware",2402,52961,1225,783,0,46,0,222,51,32.6,0,1.9,0,9.2,49,945,708,237,74.92,25.08,42,666,28,209,70,875,5.9,11.8,7.4,"25% - 50% P.O.C.","$51000 - $72000"
"10001040700","Census Tract 407, Kent County, Delaware",4908,58815,2204,1677,168,216,0,527,44.9,34.2,3.4,4.4,0,10.7,55.1,1869,1127,742,60.3,39.7,62,1065,160,582,222,1647,5.5,21.6,11.9,"50% - 75% P.O.C.","$51000 - $72000"
"10001040900","Census Tract 409, Kent County, Delaware",2646,29566,1577,837,0,10,0,159,59.6,31.6,0,0.4,0,6,40.4,1117,343,774,30.71,69.29,0,343,0,774,0,1117,0,0,0,"25% - 50% P.O.C.","Less than $51000"
"10001041000","Census Tract 410, Kent County, Delaware",6559,45632,2476,2804,15,79,0,815,37.7,42.8,0.2,1.2,0,12.4,62.3,2861,1397,1464,48.83,51.17,191,1206,44,1420,235,2626,13.7,3,8.2,"50% - 75% P.O.C.","Less than $51000"
"10001041100","Census Tract 411, Kent County, Delaware",3920,43935,2699,391,35,12,5,693,68.9,10,0.9,0.3,0.1,17.7,31.1,1250,3,1247,0.24,99.76,0,3,225,1022,225,1025,0,18,18,"25% - 50% P.O.C.","Less than $51000"
"10001041200","Census Tract 412, Kent County, Delaware",4649,59850,2123,1595,0,414,19,207,45.7,34.3,0,8.9,0.4,4.5,54.3,1657,1103,554,66.57,33.43,119,984,68,486,187,1470,10.8,12.3,11.3,"50% - 75% P.O.C.","$51000 - $72000"
"10001041300","Census Tract 413, Kent County, Delaware",2221,38288,969,950,29,45,0,119,43.6,42.8,1.3,2,0,5.4,56.4,973,327,646,33.61,66.39,29,298,62,584,91,882,8.9,9.6,9.4,"50% - 75% P.O.C.","Less than $51000"
"10001041400","Census Tract 414, Kent County, Delaware",3639,45741,1169,1960,2,34,0,252,32.1,53.9,0.1,0.9,0,6.9,67.9,1484,642,842,43.26,56.74,58,584,156,686,214,1270,9,18.5,14.4,"50% - 75% P.O.C.","Less than $51000"
"10001041500","Census Tract 415, Kent County, Delaware",4525,45698,2355,1563,0,125,0,283,52,34.5,0,2.8,0,6.3,48,1630,845,785,51.84,48.16,99,746,77,708,176,1454,11.7,9.8,10.8,"25% - 50% P.O.C.","Less than $51000"
"10001041600","Census Tract 416, Kent County, Delaware",2117,51625,1401,347,5,62,0,231,66.2,16.4,0.2,2.9,0,10.9,33.8,877,681,196,77.65,22.35,55,626,38,158,93,784,8.1,19.4,10.6,"25% - 50% P.O.C.","$51000 - $72000"
"10001041701","Census Tract 417.01, Kent County, Delaware",6142,63908,3954,1338,0,228,0,444,64.4,21.8,0,3.7,0,7.2,35.6,2402,1869,533,77.81,22.19,148,1721,60,473,208,2194,7.9,11.3,8.7,"25% - 50% P.O.C.","$51000 - $72000"
"10001041702","Census Tract 417.02, Kent County, Delaware",4612,95556,2814,1274,0,151,0,105,61,27.6,0,3.3,0,2.3,39,1560,1282,278,82.18,17.82,115,1167,74,204,189,1371,9,26.6,12.1,"25% - 50% P.O.C.","$72000 - $96000"
"10001041801","Census Tract 418.01, Kent County, Delaware",10008,61990,6363,2290,200,280,0,643,63.6,22.9,2,2.8,0,6.4,36.4,3956,3166,790,80.03,19.97,196,2970,58,732,254,3702,6.2,7.3,6.4,"25% - 50% P.O.C.","$51000 - $72000"
"10001041802","Census Tract 418.02, Kent County, Delaware",6020,85010,3262,1647,0,196,0,633,54.2,27.4,0,3.3,0,10.5,45.8,2039,1309,730,64.2,35.8,171,1138,103,627,274,1765,13.1,14.1,13.4,"25% - 50% P.O.C.","$72000 - $96000"
"10001041900","Census Tract 419, Kent County, Delaware",5336,63660,4581,309,59,18,0,92,85.9,5.8,1.1,0.3,0,1.7,14.1,1908,1671,237,87.58,12.42,227,1444,2,235,229,1679,13.6,0.8,12,"Less than 25% P.O.C.","$51000 - $72000"
"10001042000","Census Tract 420, Kent County, Delaware",3193,67000,2738,133,81,33,0,126,85.8,4.2,2.5,1,0,3.9,14.2,1070,958,112,89.53,10.47,125,833,33,79,158,912,13,29.5,14.8,"Less than 25% P.O.C.","$51000 - $72000"
"10001042100","Census Tract 421, Kent County, Delaware",3881,69293,2869,537,0,7,0,313,73.9,13.8,0,0.2,0,8.1,26.1,1622,1406,216,86.68,13.32,103,1303,0,216,103,1519,7.3,0,6.4,"25% - 50% P.O.C.","$51000 - $72000"
"10001042201","Census Tract 422.01, Kent County, Delaware",12282,69223,7028,2665,80,715,0,1199,57.2,21.7,0.7,5.8,0,9.8,42.8,4358,3027,1331,69.46,30.54,323,2704,151,1180,474,3884,10.7,11.3,10.9,"25% - 50% P.O.C.","$51000 - $72000"
"10001042202","Census Tract 422.02, Kent County, Delaware",9175,74643,6446,1455,87,79,0,825,70.3,15.9,0.9,0.9,0,9,29.7,3258,2743,515,84.19,15.81,216,2527,158,357,374,2884,7.9,30.7,11.5,"25% - 50% P.O.C.","$72000 - $96000"
"10001042500","Census Tract 425, Kent County, Delaware",3963,41212,1478,1762,0,20,0,671,37.3,44.5,0,0.5,0,16.9,62.7,1635,533,1102,32.6,67.4,48,485,43,1059,91,1544,9,3.9,5.6,"50% - 75% P.O.C.","Less than $51000"
"10001042800","Census Tract 428, Kent County, Delaware",7104,55758,5677,907,25,64,0,310,79.9,12.8,0.4,0.9,0,4.4,20.1,2882,2179,703,75.61,24.39,94,2085,105,598,199,2683,4.3,14.9,6.9,"Less than 25% P.O.C.","$51000 - $72000"
"10001042900","Census Tract 429, Kent County, Delaware",4898,62250,4072,510,10,19,0,182,83.1,10.4,0.2,0.4,0,3.7,16.9,1884,1545,339,82.01,17.99,119,1426,47,292,166,1718,7.7,13.9,8.8,"Less than 25% P.O.C.","$51000 - $72000"
"10001043000","Census Tract 430, Kent County, Delaware",5262,53625,3250,1431,14,133,0,285,61.8,27.2,0.3,2.5,0,5.4,38.2,2012,1179,833,58.6,41.4,87,1092,124,709,211,1801,7.4,14.9,10.5,"25% - 50% P.O.C.","$51000 - $72000"
"10001043100","Census Tract 431, Kent County, Delaware",2628,61351,2518,35,0,14,0,61,95.8,1.3,0,0.5,0,2.3,4.2,901,708,193,78.58,21.42,81,627,24,169,105,796,11.4,12.4,11.7,"Less than 25% P.O.C.","$51000 - $72000"
"10001043202","Census Tract 432.02, Kent County, Delaware",4548,47370,3678,461,10,46,0,144,80.9,10.1,0.2,1,0,3.2,19.1,1821,1200,621,65.9,34.1,61,1139,114,507,175,1646,5.1,18.4,9.6,"Less than 25% P.O.C.","Less than $51000"
"10001043300","Census Tract 433, Kent County, Delaware",6357,49542,1977,3622,15,94,5,294,31.1,57,0.2,1.5,0.1,4.6,68.9,1572,659,913,41.92,58.08,75,584,39,874,114,1458,11.4,4.3,7.3,"50% - 75% P.O.C.","Less than $51000"
"10001043400","Census Tract 434, Kent County, Delaware",5006,59135,3368,896,0,5,57,523,67.3,17.9,0,0.1,1.1,10.4,32.7,1945,1430,515,73.52,26.48,75,1355,29,486,104,1841,5.2,5.6,5.3,"25% - 50% P.O.C.","$51000 - $72000"
"10001990000","Census Tract 9900, Kent County, Delaware",0,NA,0,0,0,0,0,0,NA,NA,NA,NA,NA,NA,NA,0,0,0,NA,NA,0,0,0,0,0,0,NA,NA,NA,"N/A","N/A"
"10003000200","Census Tract 2, New Castle County, Delaware",5351,57011,1542,3102,0,54,0,583,28.8,58,0,1,0,10.9,71.2,2255,1463,792,64.88,35.12,125,1338,10,782,135,2120,8.5,1.3,6,"50% - 75% P.O.C.","$51000 - $72000"
"10003000300","Census Tract 3, New Castle County, Delaware",3000,40345,371,2356,17,0,0,245,12.4,78.5,0.6,0,0,8.2,87.6,1144,632,512,55.24,44.76,52,580,52,460,104,1040,8.2,10.2,9.1,"75% or more P.O.C.","Less than $51000"
"10003000400","Census Tract 4, New Castle County, Delaware",2945,34162,1266,1421,23,0,0,129,43,48.3,0.8,0,0,4.4,57,1601,640,961,39.98,60.02,54,586,9,952,63,1538,8.4,0.9,3.9,"50% - 75% P.O.C.","Less than $51000"
"10003000500","Census Tract 5, New Castle County, Delaware",3909,57832,249,3510,14,0,0,13,6.4,89.8,0.4,0,0,0.3,93.6,1318,747,571,56.68,43.32,68,679,46,525,114,1204,9.1,8.1,8.6,"75% or more P.O.C.","$51000 - $72000"
"10003000601","Census Tract 6.01, New Castle County, Delaware",3311,45350,93,3081,0,0,0,76,2.8,93.1,0,0,0,2.3,97.2,996,491,505,49.3,50.7,45,446,97,408,142,854,9.2,19.2,14.3,"75% or more P.O.C.","Less than $51000"
"10003000602","Census Tract 6.02, New Castle County, Delaware",2786,21590,177,2496,9,57,0,47,6.4,89.6,0.3,2,0,1.7,93.6,1229,402,827,32.71,67.29,0,402,25,802,25,1204,0,3,2,"75% or more P.O.C.","Less than $51000"
"10003000900","Census Tract 9, New Castle County, Delaware",2344,24615,53,2030,0,15,0,175,2.3,86.6,0,0.6,0,7.5,97.7,810,234,576,28.89,71.11,19,215,42,534,61,749,8.1,7.3,7.5,"75% or more P.O.C.","Less than $51000"
"10003001100","Census Tract 11, New Castle County, Delaware",3380,60548,2531,672,0,75,0,72,74.9,19.9,0,2.2,0,2.1,25.1,2210,761,1449,34.43,65.57,0,761,12,1437,12,2198,0,0.8,0.5,"25% - 50% P.O.C.","$51000 - $72000"
"10003001200","Census Tract 12, New Castle County, Delaware",1793,95714,1637,73,0,6,0,65,91.3,4.1,0,0.3,0,3.6,8.7,796,422,374,53.02,46.98,15,407,0,374,15,781,3.6,0,1.9,"Less than 25% P.O.C.","$72000 - $96000"
"10003001300","Census Tract 13, New Castle County, Delaware",3524,106701,3170,97,0,94,0,50,90,2.8,0,2.7,0,1.4,10,1661,1380,281,83.08,16.92,39,1341,0,281,39,1622,2.8,0,2.3,"Less than 25% P.O.C.","$96000 or more"
"10003001400","Census Tract 14, New Castle County, Delaware",2232,56250,1188,648,0,65,0,302,53.2,29,0,2.9,0,13.5,46.8,976,454,522,46.52,53.48,37,417,0,522,37,939,8.1,0,3.8,"25% - 50% P.O.C.","$51000 - $72000"
"10003001500","Census Tract 15, New Castle County, Delaware",2252,50942,1112,897,22,23,0,121,49.4,39.8,1,1,0,5.4,50.6,1008,381,627,37.8,62.2,0,381,0,627,0,1008,0,0,0,"50% - 75% P.O.C.","Less than $51000"
"10003001600","Census Tract 16, New Castle County, Delaware",2211,32599,512,1478,0,0,0,214,23.2,66.8,0,0,0,9.7,76.8,875,237,638,27.09,72.91,25,212,8,630,33,842,10.5,1.3,3.8,"75% or more P.O.C.","Less than $51000"
"10003001902","Census Tract 19.02, New Castle County, Delaware",2148,48636,434,1475,0,138,0,63,20.2,68.7,0,6.4,0,2.9,79.8,870,316,554,36.32,63.68,23,293,6,548,29,841,7.3,1.1,3.3,"75% or more P.O.C.","Less than $51000"
"10003002100","Census Tract 21, New Castle County, Delaware",1872,18009,143,1460,0,17,0,200,7.6,78,0,0.9,0,10.7,92.4,773,109,664,14.1,85.9,8,101,72,592,80,693,7.3,10.8,10.3,"75% or more P.O.C.","Less than $51000"
"10003002200","Census Tract 22, New Castle County, Delaware",2518,33902,152,980,46,34,0,1273,6,38.9,1.8,1.4,0,50.6,94,767,320,447,41.72,58.28,21,299,119,328,140,627,6.6,26.6,18.3,"75% or more P.O.C.","Less than $51000"
"10003002300","Census Tract 23, New Castle County, Delaware",2331,31892,170,1243,0,15,0,849,7.3,53.3,0,0.6,0,36.4,92.7,1001,322,679,32.17,67.83,8,314,49,630,57,944,2.5,7.2,5.7,"75% or more P.O.C.","Less than $51000"
"10003002400","Census Tract 24, New Castle County, Delaware",4346,40208,1855,2009,0,0,0,450,42.7,46.2,0,0,0,10.4,57.3,1875,794,1081,42.35,57.65,18,776,117,964,135,1740,2.3,10.8,7.2,"50% - 75% P.O.C.","Less than $51000"
"10003002500","Census Tract 25, New Castle County, Delaware",3170,43194,1276,1200,0,53,0,549,40.3,37.9,0,1.7,0,17.3,59.7,1265,760,505,60.08,39.92,13,747,171,334,184,1081,1.7,33.9,14.5,"50% - 75% P.O.C.","Less than $51000"
"10003002600","Census Tract 26, New Castle County, Delaware",3651,33269,567,1948,0,77,0,951,15.5,53.4,0,2.1,0,26,84.5,1296,388,908,29.94,70.06,33,355,58,850,91,1205,8.5,6.4,7,"75% or more P.O.C.","Less than $51000"
"10003002700","Census Tract 27, New Castle County, Delaware",2559,60259,651,1385,0,91,0,367,25.4,54.1,0,3.6,0,14.3,74.6,958,559,399,58.35,41.65,14,545,74,325,88,870,2.5,18.5,9.2,"50% - 75% P.O.C.","$51000 - $72000"
"10003002800","Census Tract 28, New Castle County, Delaware",1647,41016,775,736,0,22,8,97,47.1,44.7,0,1.3,0.5,5.9,52.9,943,190,753,20.15,79.85,0,190,0,753,0,943,0,0,0,"50% - 75% P.O.C.","Less than $51000"
"10003002900","Census Tract 29, New Castle County, Delaware",3827,16778,201,3576,3,0,0,18,5.3,93.4,0.1,0,0,0.5,94.7,1555,283,1272,18.2,81.8,32,251,70,1202,102,1453,11.3,5.5,6.6,"75% or more P.O.C.","Less than $51000"
"10003003002","Census Tract 30.02, New Castle County, Delaware",3537,25326,483,2701,14,4,4,293,13.7,76.4,0.4,0.1,0.1,8.3,86.3,624,203,421,32.53,67.47,7,196,68,353,75,549,3.4,16.2,12,"75% or more P.O.C.","Less than $51000"
"10003010101","Census Tract 101.01, New Castle County, Delaware",4082,48683,1413,1651,9,629,0,227,34.6,40.4,0.2,15.4,0,5.6,65.4,1819,435,1384,23.91,76.09,67,368,28,1356,95,1724,15.4,2,5.2,"50% - 75% P.O.C.","Less than $51000"
"10003010104","Census Tract 101.04, New Castle County, Delaware",3620,43418,2019,1131,0,1,0,439,55.8,31.2,0,0,0,12.1,44.2,1562,468,1094,29.96,70.04,19,449,69,1025,88,1474,4.1,6.3,5.6,"25% - 50% P.O.C.","Less than $51000"
"10003010200","Census Tract 102, New Castle County, Delaware",2241,86361,1516,463,0,54,0,171,67.6,20.7,0,2.4,0,7.6,32.4,733,666,67,90.86,9.14,86,580,22,45,108,625,12.9,32.8,14.7,"25% - 50% P.O.C.","$72000 - $96000"
"10003010300","Census Tract 103, New Castle County, Delaware",3625,66875,2097,949,10,420,0,149,57.8,26.2,0.3,11.6,0,4.1,42.2,1347,1014,333,75.28,24.72,62,952,29,304,91,1256,6.1,8.7,6.8,"25% - 50% P.O.C.","$51000 - $72000"
"10003010400","Census Tract 104, New Castle County, Delaware",4537,85213,3315,542,58,480,0,60,73.1,11.9,1.3,10.6,0,1.3,26.9,1753,1158,595,66.06,33.94,99,1059,23,572,122,1631,8.5,3.9,7,"25% - 50% P.O.C.","$72000 - $96000"
"10003010502","Census Tract 105.02, New Castle County, Delaware",6331,68750,4577,946,0,43,1,457,72.3,14.9,0,0.7,0,7.2,27.7,2537,1572,965,61.96,38.04,87,1485,80,885,167,2370,5.5,8.3,6.6,"25% - 50% P.O.C.","$51000 - $72000"
"10003010702","Census Tract 107.02, New Castle County, Delaware",6190,55271,1736,3410,19,735,0,133,28,55.1,0.3,11.9,0,2.1,72,2508,1309,1199,52.19,47.81,131,1178,80,1119,211,2297,10,6.7,8.4,"50% - 75% P.O.C.","$51000 - $72000"
"10003010800","Census Tract 108, New Castle County, Delaware",4614,113796,3444,551,38,361,0,65,74.6,11.9,0.8,7.8,0,1.4,25.4,1840,1340,500,72.83,27.17,61,1279,16,484,77,1763,4.6,3.2,4.2,"25% - 50% P.O.C.","$96000 or more"
"10003010900","Census Tract 109, New Castle County, Delaware",2536,113953,2273,85,0,71,0,68,89.6,3.4,0,2.8,0,2.7,10.4,1044,976,68,93.49,6.51,23,953,9,59,32,1012,2.4,13.2,3.1,"Less than 25% P.O.C.","$96000 or more"
"10003011000","Census Tract 110, New Castle County, Delaware",3206,89375,2486,245,0,177,0,134,77.5,7.6,0,5.5,0,4.2,22.5,1225,1123,102,91.67,8.33,86,1037,0,102,86,1139,7.7,0,7,"Less than 25% P.O.C.","$72000 - $96000"
"10003011100","Census Tract 111, New Castle County, Delaware",2854,113846,2495,183,0,87,2,38,87.4,6.4,0,3,0.1,1.3,12.6,1100,870,230,79.09,20.91,55,815,29,201,84,1016,6.3,12.6,7.6,"Less than 25% P.O.C.","$96000 or more"
"10003011201","Census Tract 112.01, New Castle County, Delaware",2947,108478,2223,85,21,554,0,36,75.4,2.9,0.7,18.8,0,1.2,24.6,846,575,271,67.97,32.03,139,436,17,254,156,690,24.2,6.3,18.4,"Less than 25% P.O.C.","$96000 or more"
"10003011202","Census Tract 112.02, New Castle County, Delaware",4128,103558,3234,159,0,486,0,118,78.3,3.9,0,11.8,0,2.9,21.7,1577,1532,45,97.15,2.85,132,1400,0,45,132,1445,8.6,0,8.4,"Less than 25% P.O.C.","$96000 or more"
"10003011203","Census Tract 112.03, New Castle County, Delaware",4637,70777,3017,1162,0,422,0,18,65.1,25.1,0,9.1,0,0.4,34.9,1941,1236,705,63.68,36.32,28,1208,61,644,89,1852,2.3,8.7,4.6,"25% - 50% P.O.C.","$51000 - $72000"
"10003011204","Census Tract 112.04, New Castle County, Delaware",3500,88594,2868,359,0,157,0,100,81.9,10.3,0,4.5,0,2.9,18.1,1386,1215,171,87.66,12.34,86,1129,17,154,103,1283,7.1,9.9,7.4,"Less than 25% P.O.C.","$72000 - $96000"
"10003011205","Census Tract 112.05, New Castle County, Delaware",1865,90833,1566,115,4,175,0,1,84,6.2,0.2,9.4,0,0.1,16,690,655,35,94.93,5.07,37,618,0,35,37,653,5.6,0,5.4,"Less than 25% P.O.C.","$72000 - $96000"
"10003011206","Census Tract 112.06, New Castle County, Delaware",4294,109792,3850,222,0,149,0,73,89.7,5.2,0,3.5,0,1.7,10.3,1460,1317,143,90.21,9.79,152,1165,6,137,158,1302,11.5,4.2,10.8,"Less than 25% P.O.C.","$96000 or more"
"10003011300","Census Tract 113, New Castle County, Delaware",2199,103207,2024,55,7,61,0,41,92,2.5,0.3,2.8,0,1.9,8,944,790,154,83.69,16.31,35,755,0,154,35,909,4.4,0,3.7,"Less than 25% P.O.C.","$96000 or more"
"10003011400","Census Tract 114, New Castle County, Delaware",3348,110652,2818,97,7,279,0,53,84.2,2.9,0.2,8.3,0,1.6,15.8,1318,1079,239,81.87,18.13,52,1027,7,232,59,1259,4.8,2.9,4.5,"Less than 25% P.O.C.","$96000 or more"
"10003011500","Census Tract 115, New Castle County, Delaware",2924,85655,2400,94,8,253,0,58,82.1,3.2,0.3,8.7,0,2,17.9,1181,1057,124,89.5,10.5,75,982,13,111,88,1093,7.1,10.5,7.5,"Less than 25% P.O.C.","$72000 - $96000"
"10003011600","Census Tract 116, New Castle County, Delaware",3432,95082,2776,158,72,87,0,239,80.9,4.6,2.1,2.5,0,7,19.1,1311,1071,240,81.69,18.31,59,1012,0,240,59,1252,5.5,0,4.5,"Less than 25% P.O.C.","$72000 - $96000"
"10003011700","Census Tract 117, New Castle County, Delaware",4148,139868,3880,16,0,36,0,190,93.5,0.4,0,0.9,0,4.6,6.5,1668,1557,111,93.35,6.65,88,1469,0,111,88,1580,5.7,0,5.3,"Less than 25% P.O.C.","$96000 or more"
"10003011800","Census Tract 118, New Castle County, Delaware",4167,111648,3589,32,0,480,0,29,86.1,0.8,0,11.5,0,0.7,13.9,2030,1263,767,62.22,37.78,66,1197,7,760,73,1957,5.2,0.9,3.6,"Less than 25% P.O.C.","$96000 or more"
"10003011900","Census Tract 119, New Castle County, Delaware",3292,174688,2678,101,0,214,0,262,81.3,3.1,0,6.5,0,8,18.7,1181,1023,158,86.62,13.38,105,918,0,158,105,1076,10.3,0,8.9,"Less than 25% P.O.C.","$96000 or more"
"10003012000","Census Tract 120, New Castle County, Delaware",4460,61286,2926,569,0,126,0,774,65.6,12.8,0,2.8,0,17.4,34.4,1670,1371,299,82.1,17.9,62,1309,56,243,118,1552,4.5,18.7,7.1,"25% - 50% P.O.C.","$51000 - $72000"
"10003012100","Census Tract 121, New Castle County, Delaware",3064,66667,2195,288,0,118,0,404,71.6,9.4,0,3.9,0,13.2,28.4,1140,783,357,68.68,31.32,51,732,13,344,64,1076,6.5,3.6,5.6,"25% - 50% P.O.C.","$51000 - $72000"
"10003012200","Census Tract 122, New Castle County, Delaware",4538,59524,2297,822,89,96,0,1100,50.6,18.1,2,2.1,0,24.2,49.4,1712,1099,613,64.19,35.81,120,979,37,576,157,1555,10.9,6,9.2,"25% - 50% P.O.C.","$51000 - $72000"
"10003012300","Census Tract 123, New Castle County, Delaware",2784,60475,1806,219,0,59,0,700,64.9,7.9,0,2.1,0,25.1,35.1,1135,645,490,56.83,43.17,78,567,0,490,78,1057,12.1,0,6.9,"25% - 50% P.O.C.","$51000 - $72000"
"10003012400","Census Tract 124, New Castle County, Delaware",4310,51534,2401,568,39,39,0,1183,55.7,13.2,0.9,0.9,0,27.4,44.3,1707,1332,375,78.03,21.97,109,1223,79,296,188,1519,8.2,21.1,11,"25% - 50% P.O.C.","$51000 - $72000"
"10003012500","Census Tract 125, New Castle County, Delaware",4963,67226,2569,334,0,31,9,1905,51.8,6.7,0,0.6,0.2,38.4,48.2,1897,1317,580,69.43,30.57,134,1183,0,580,134,1763,10.2,0,7.1,"25% - 50% P.O.C.","$51000 - $72000"
"10003012600","Census Tract 126, New Castle County, Delaware",2977,69521,2106,190,0,39,0,621,70.7,6.4,0,1.3,0,20.9,29.3,1052,865,187,82.22,17.78,68,797,47,140,115,937,7.9,25.1,10.9,"25% - 50% P.O.C.","$51000 - $72000"
"10003012700","Census Tract 127, New Castle County, Delaware",4008,49152,2931,465,0,0,0,589,73.1,11.6,0,0,0,14.7,26.9,1710,1179,531,68.95,31.05,50,1129,11,520,61,1649,4.2,2.1,3.6,"25% - 50% P.O.C.","Less than $51000"
"10003012900","Census Tract 129, New Castle County, Delaware",4787,43487,1996,1076,45,11,0,1583,41.7,22.5,0.9,0.2,0,33.1,58.3,1769,945,824,53.42,46.58,136,809,119,705,255,1514,14.4,14.4,14.4,"50% - 75% P.O.C.","Less than $51000"
"10003013000","Census Tract 130, New Castle County, Delaware",1881,75057,1467,78,0,85,0,208,78,4.1,0,4.5,0,11.1,22,699,603,96,86.27,13.73,32,571,8,88,40,659,5.3,8.3,5.7,"Less than 25% P.O.C.","$72000 - $96000"
"10003013100","Census Tract 131, New Castle County, Delaware",2311,72368,1610,38,8,32,0,577,69.7,1.6,0.3,1.4,0,25,30.3,818,648,170,79.22,20.78,57,591,6,164,63,755,8.8,3.5,7.7,"25% - 50% P.O.C.","$72000 - $96000"
"10003013200","Census Tract 132, New Castle County, Delaware",3116,70352,1697,504,0,93,0,757,54.5,16.2,0,3,0,24.3,45.5,1000,778,222,77.8,22.2,46,732,8,214,54,946,5.9,3.6,5.4,"25% - 50% P.O.C.","$51000 - $72000"
"10003013300","Census Tract 133, New Castle County, Delaware",1860,73042,1579,38,0,12,0,231,84.9,2,0,0.6,0,12.4,15.1,729,633,96,86.83,13.17,10,623,27,69,37,692,1.6,28.1,5.1,"Less than 25% P.O.C.","$72000 - $96000"
"10003013400","Census Tract 134, New Castle County, Delaware",2245,78542,1879,81,0,201,0,11,83.7,3.6,0,9,0,0.5,16.3,978,789,189,80.67,19.33,52,737,26,163,78,900,6.6,13.8,8,"Less than 25% P.O.C.","$72000 - $96000"
"10003013501","Census Tract 135.01, New Castle County, Delaware",6952,114449,5996,326,0,423,0,80,86.2,4.7,0,6.1,0,1.2,13.8,2597,2218,379,85.41,14.59,107,2111,13,366,120,2477,4.8,3.4,4.6,"Less than 25% P.O.C.","$96000 or more"
"10003013503","Census Tract 135.03, New Castle County, Delaware",7151,128547,5838,239,0,682,0,156,81.6,3.3,0,9.5,0,2.2,18.4,2606,2320,286,89.03,10.97,166,2154,15,271,181,2425,7.2,5.2,6.9,"Less than 25% P.O.C.","$96000 or more"
"10003013505","Census Tract 135.05, New Castle County, Delaware",3130,136250,2525,150,42,341,0,0,80.7,4.8,1.3,10.9,0,0,19.3,1195,1063,132,88.95,11.05,69,994,0,132,69,1126,6.5,0,5.8,"Less than 25% P.O.C.","$96000 or more"
"10003013506","Census Tract 135.06, New Castle County, Delaware",4373,139722,3645,117,0,392,0,52,83.4,2.7,0,9,0,1.2,16.6,1550,1510,40,97.42,2.58,77,1433,9,31,86,1464,5.1,22.5,5.5,"Less than 25% P.O.C.","$96000 or more"
"10003013604","Census Tract 136.04, New Castle County, Delaware",4372,85100,3626,280,0,109,0,302,82.9,6.4,0,2.5,0,6.9,17.1,1598,1377,221,86.17,13.83,86,1291,40,181,126,1472,6.2,18.1,7.9,"Less than 25% P.O.C.","$72000 - $96000"
"10003013607","Census Tract 136.07, New Castle County, Delaware",5806,78234,4304,300,56,880,0,155,74.1,5.2,1,15.2,0,2.7,25.9,2770,1617,1153,58.38,41.62,31,1586,0,1153,31,2739,1.9,0,1.1,"25% - 50% P.O.C.","$72000 - $96000"
"10003013608","Census Tract 136.08, New Castle County, Delaware",2083,73472,1336,304,0,204,0,171,64.1,14.6,0,9.8,0,8.2,35.9,721,453,268,62.83,37.17,58,395,35,233,93,628,12.8,13.1,12.9,"25% - 50% P.O.C.","$72000 - $96000"
"10003013610","Census Tract 136.10, New Castle County, Delaware",5700,91865,4565,94,11,358,0,529,80.1,1.6,0.2,6.3,0,9.3,19.9,2150,1606,544,74.7,25.3,209,1397,0,544,209,1941,13,0,9.7,"Less than 25% P.O.C.","$72000 - $96000"
"10003013611","Census Tract 136.11, New Castle County, Delaware",5750,79013,3540,1415,0,105,19,360,61.6,24.6,0,1.8,0.3,6.3,38.4,2370,1447,923,61.05,38.95,69,1378,14,909,83,2287,4.8,1.5,3.5,"25% - 50% P.O.C.","$72000 - $96000"
"10003013612","Census Tract 136.12, New Castle County, Delaware",5865,130404,4106,283,24,1203,0,113,70,4.8,0.4,20.5,0,1.9,30,2183,1943,240,89.01,10.99,32,1911,0,240,32,2151,1.6,0,1.5,"25% - 50% P.O.C.","$96000 or more"
"10003013613","Census Tract 136.13, New Castle County, Delaware",5384,93882,4615,219,0,385,0,133,85.7,4.1,0,7.2,0,2.5,14.3,2095,1476,619,70.45,29.55,111,1365,0,619,111,1984,7.5,0,5.3,"Less than 25% P.O.C.","$72000 - $96000"
"10003013614","Census Tract 136.14, New Castle County, Delaware",2971,61779,1599,237,0,128,0,982,53.8,8,0,4.3,0,33.1,46.2,1192,624,568,52.35,47.65,22,602,73,495,95,1097,3.5,12.9,8,"25% - 50% P.O.C.","$51000 - $72000"
"10003013615","Census Tract 136.15, New Castle County, Delaware",3593,55357,2741,43,0,82,0,631,76.3,1.2,0,2.3,0,17.6,23.7,1660,1387,273,83.55,16.45,34,1353,19,254,53,1607,2.5,7,3.2,"Less than 25% P.O.C.","$51000 - $72000"
"10003013700","Census Tract 137, New Castle County, Delaware",4079,63047,2267,587,15,115,0,1040,55.6,14.4,0.4,2.8,0,25.5,44.4,1526,674,852,44.17,55.83,47,627,42,810,89,1437,7,4.9,5.8,"25% - 50% P.O.C.","$51000 - $72000"
"10003013800","Census Tract 138, New Castle County, Delaware",5783,83646,3371,807,3,998,4,559,58.3,14,0.1,17.3,0.1,9.7,41.7,2034,1047,987,51.47,48.53,97,950,14,973,111,1923,9.3,1.4,5.5,"25% - 50% P.O.C.","$72000 - $96000"
"10003013901","Census Tract 139.01, New Castle County, Delaware",3364,72377,1501,1071,0,101,0,689,44.6,31.8,0,3,0,20.5,55.4,1058,749,309,70.79,29.21,141,608,52,257,193,865,18.8,16.8,18.2,"50% - 75% P.O.C.","$72000 - $96000"
"10003013903","Census Tract 139.03, New Castle County, Delaware",5122,105223,3242,940,15,479,0,302,63.3,18.4,0.3,9.4,0,5.9,36.7,1548,1411,137,91.15,8.85,231,1180,14,123,245,1303,16.4,10.2,15.8,"25% - 50% P.O.C.","$96000 or more"
"10003013904","Census Tract 139.04, New Castle County, Delaware",8306,85000,3454,2316,42,1324,15,903,41.6,27.9,0.5,15.9,0.2,10.9,58.4,3208,1671,1537,52.09,47.91,105,1566,86,1451,191,3017,6.3,5.6,6,"50% - 75% P.O.C.","$72000 - $96000"
"10003014000","Census Tract 140, New Castle County, Delaware",5004,46836,2397,1335,52,476,0,682,47.9,26.7,1,9.5,0,13.6,52.1,2079,911,1168,43.82,56.18,55,856,10,1158,65,2014,6,0.9,3.1,"50% - 75% P.O.C.","Less than $51000"
"10003014100","Census Tract 141, New Castle County, Delaware",4107,51128,2413,977,37,7,0,510,58.8,23.8,0.9,0.2,0,12.4,41.2,1599,1079,520,67.48,32.52,69,1010,52,468,121,1478,6.4,10,7.6,"25% - 50% P.O.C.","$51000 - $72000"
"10003014200","Census Tract 142, New Castle County, Delaware",1825,95078,1451,179,0,105,0,54,79.5,9.8,0,5.8,0,3,20.5,640,582,58,90.94,9.06,32,550,9,49,41,599,5.5,15.5,6.4,"Less than 25% P.O.C.","$72000 - $96000"
"10003014300","Census Tract 143, New Castle County, Delaware",7165,106094,5615,668,9,438,6,231,78.4,9.3,0.1,6.1,0.1,3.2,21.6,1713,1286,427,75.07,24.93,64,1222,9,418,73,1640,5,2.1,4.3,"Less than 25% P.O.C.","$96000 or more"
"10003014402","Census Tract 144.02, New Castle County, Delaware",3243,57031,2674,82,0,253,0,132,82.5,2.5,0,7.8,0,4.1,17.5,1380,739,641,53.55,46.45,43,696,52,589,95,1285,5.8,8.1,6.9,"Less than 25% P.O.C.","$51000 - $72000"
"10003014403","Census Tract 144.03, New Castle County, Delaware",5377,64211,3034,663,0,659,0,833,56.4,12.3,0,12.3,0,15.5,43.6,1782,839,943,47.08,52.92,33,806,126,817,159,1623,3.9,13.4,8.9,"25% - 50% P.O.C.","$51000 - $72000"
"10003014404","Census Tract 144.04, New Castle County, Delaware",4370,80962,3064,413,28,578,0,278,70.1,9.5,0.6,13.2,0,6.4,29.9,1866,1288,578,69.02,30.98,60,1228,0,578,60,1806,4.7,0,3.2,"25% - 50% P.O.C.","$72000 - $96000"
"10003014501","Census Tract 145.01, New Castle County, Delaware",2414,17979,1602,339,0,114,10,208,66.4,14,0,4.7,0.4,8.6,33.6,977,39,938,3.99,96.01,5,34,39,899,44,933,12.8,4.2,4.5,"25% - 50% P.O.C.","Less than $51000"
"10003014502","Census Tract 145.02, New Castle County, Delaware",6555,14907,5271,230,0,465,0,398,80.4,3.5,0,7.1,0,6.1,19.6,1018,162,856,15.91,84.09,15,147,23,833,38,980,9.3,2.7,3.7,"Less than 25% P.O.C.","Less than $51000"
"10003014702","Census Tract 147.02, New Castle County, Delaware",1766,77083,1169,156,0,72,0,274,66.2,8.8,0,4.1,0,15.5,33.8,638,588,50,92.16,7.84,44,544,0,50,44,594,7.5,0,6.9,"25% - 50% P.O.C.","$72000 - $96000"
"10003014703","Census Tract 147.03, New Castle County, Delaware",4775,57224,2856,589,29,398,0,762,59.8,12.3,0.6,8.3,0,16,40.2,1973,1157,816,58.64,41.36,120,1037,84,732,204,1769,10.4,10.3,10.3,"25% - 50% P.O.C.","$51000 - $72000"
"10003014705","Census Tract 147.05, New Castle County, Delaware",5524,68574,3497,856,0,184,0,833,63.3,15.5,0,3.3,0,15.1,36.7,1899,1297,602,68.3,31.7,143,1154,46,556,189,1710,11,7.6,10,"25% - 50% P.O.C.","$51000 - $72000"
"10003014706","Census Tract 147.06, New Castle County, Delaware",2856,61483,1063,996,0,221,0,437,37.2,34.9,0,7.7,0,15.3,62.8,969,481,488,49.64,50.36,88,393,2,486,90,879,18.3,0.4,9.3,"50% - 75% P.O.C.","$51000 - $72000"
"10003014803","Census Tract 148.03, New Castle County, Delaware",4113,54722,2913,308,43,294,0,355,70.8,7.5,1,7.1,0,8.6,29.2,1854,1383,471,74.6,25.4,92,1291,0,471,92,1762,6.7,0,5,"25% - 50% P.O.C.","$51000 - $72000"
"10003014805","Census Tract 148.05, New Castle County, Delaware",10479,118722,6504,1837,0,1594,0,379,62.1,17.5,0,15.2,0,3.6,37.9,3414,3076,338,90.1,9.9,172,2904,39,299,211,3203,5.6,11.5,6.2,"25% - 50% P.O.C.","$96000 or more"
"10003014807","Census Tract 148.07, New Castle County, Delaware",9106,87843,4906,1951,20,1014,0,798,53.9,21.4,0.2,11.1,0,8.8,46.1,3241,2408,833,74.3,25.7,191,2217,110,723,301,2940,7.9,13.2,9.3,"25% - 50% P.O.C.","$72000 - $96000"
"10003014808","Census Tract 148.08, New Castle County, Delaware",6387,73452,2605,2108,24,516,0,845,40.8,33,0.4,8.1,0,13.2,59.2,2426,1634,792,67.35,32.65,116,1518,86,706,202,2224,7.1,10.9,8.3,"50% - 75% P.O.C.","$72000 - $96000"
"10003014809","Census Tract 148.09, New Castle County, Delaware",7700,86457,4305,2200,0,319,0,660,55.9,28.6,0,4.1,0,8.6,44.1,2991,2244,747,75.03,24.97,97,2147,18,729,115,2876,4.3,2.4,3.8,"25% - 50% P.O.C.","$72000 - $96000"
"10003014810","Census Tract 148.10, New Castle County, Delaware",7435,93452,4724,1716,0,225,0,476,63.5,23.1,0,3,0,6.4,36.5,2494,1710,784,68.56,31.44,124,1586,72,712,196,2298,7.3,9.2,7.9,"25% - 50% P.O.C.","$72000 - $96000"
"10003014903","Census Tract 149.03, New Castle County, Delaware",8211,70511,2308,2863,0,74,0,2803,28.1,34.9,0,0.9,0,34.1,71.9,2373,1354,1019,57.06,42.94,90,1264,355,664,445,1928,6.6,34.8,18.8,"50% - 75% P.O.C.","$51000 - $72000"
"10003014904","Census Tract 149.04, New Castle County, Delaware",4803,63803,2269,1417,0,523,0,529,47.2,29.5,0,10.9,0,11,52.8,2095,1140,955,54.42,45.58,105,1035,0,955,105,1990,9.2,0,5,"50% - 75% P.O.C.","$51000 - $72000"
"10003014906","Census Tract 149.06, New Castle County, Delaware",5097,64760,1369,2462,0,404,0,598,26.9,48.3,0,7.9,0,11.7,73.1,1822,970,852,53.24,46.76,48,922,48,804,96,1726,4.9,5.6,5.3,"50% - 75% P.O.C.","$51000 - $72000"
"10003014907","Census Tract 149.07, New Castle County, Delaware",4915,61023,1661,2399,0,170,0,537,33.8,48.8,0,3.5,0,10.9,66.2,1838,1357,481,73.83,26.17,126,1231,65,416,191,1647,9.3,13.5,10.4,"50% - 75% P.O.C.","$51000 - $72000"
"10003014908","Census Tract 149.08, New Castle County, Delaware",1947,40805,598,1163,31,0,0,136,30.7,59.7,1.6,0,0,7,69.3,934,342,592,36.62,63.38,4,338,15,577,19,915,1.2,2.5,2,"50% - 75% P.O.C.","Less than $51000"
"10003014909","Census Tract 149.09, New Castle County, Delaware",5878,59980,1562,3246,0,97,0,839,26.6,55.2,0,1.7,0,14.3,73.4,2321,1066,1255,45.93,54.07,141,925,71,1184,212,2109,13.2,5.7,9.1,"50% - 75% P.O.C.","$51000 - $72000"
"10003015000","Census Tract 150, New Castle County, Delaware",5848,64734,2835,1317,0,288,0,1025,48.5,22.5,0,4.9,0,17.5,51.5,2069,1481,588,71.58,28.42,212,1269,30,558,242,1827,14.3,5.1,11.7,"50% - 75% P.O.C.","$51000 - $72000"
"10003015100","Census Tract 151, New Castle County, Delaware",3474,60341,2339,895,21,22,0,159,67.3,25.8,0.6,0.6,0,4.6,32.7,1344,1041,303,77.46,22.54,76,965,37,266,113,1231,7.3,12.2,8.4,"25% - 50% P.O.C.","$51000 - $72000"
"10003015200","Census Tract 152, New Castle County, Delaware",5779,55811,2457,1352,17,104,32,1572,42.5,23.4,0.3,1.8,0.6,27.2,57.5,1874,1299,575,69.32,30.68,133,1166,78,497,211,1663,10.2,13.6,11.3,"50% - 75% P.O.C.","$51000 - $72000"
"10003015400","Census Tract 154, New Castle County, Delaware",2974,53929,74,2331,0,0,0,569,2.5,78.4,0,0,0,19.1,97.5,998,748,250,74.95,25.05,103,645,8,242,111,887,13.8,3.2,11.1,"75% or more P.O.C.","$51000 - $72000"
"10003015502","Census Tract 155.02, New Castle County, Delaware",2880,45697,588,1847,0,0,0,305,20.4,64.1,0,0,0,10.6,79.6,1010,588,422,58.22,41.78,28,560,86,336,114,896,4.8,20.4,11.3,"75% or more P.O.C.","Less than $51000"
"10003015600","Census Tract 156, New Castle County, Delaware",2638,52522,592,1265,0,145,0,570,22.4,48,0,5.5,0,21.6,77.6,801,635,166,79.28,20.72,69,566,51,115,120,681,10.9,30.7,15,"75% or more P.O.C.","$51000 - $72000"
"10003015802","Census Tract 158.02, New Castle County, Delaware",2268,49208,919,427,0,23,0,821,40.5,18.8,0,1,0,36.2,59.5,729,560,169,76.82,23.18,42,518,48,121,90,639,7.5,28.4,12.3,"50% - 75% P.O.C.","Less than $51000"
"10003015900","Census Tract 159, New Castle County, Delaware",3615,53725,1955,1118,12,49,0,389,54.1,30.9,0.3,1.4,0,10.8,45.9,1182,966,216,81.73,18.27,139,827,41,175,180,1002,14.4,19,15.2,"25% - 50% P.O.C.","$51000 - $72000"
"10003016000","Census Tract 160, New Castle County, Delaware",2617,46541,914,1335,0,9,0,237,34.9,51,0,0.3,0,9.1,65.1,985,655,330,66.5,33.5,67,588,23,307,90,895,10.2,7,9.1,"50% - 75% P.O.C.","Less than $51000"
"10003016100","Census Tract 161, New Castle County, Delaware",2176,69615,1461,544,0,20,0,114,67.1,25,0,0.9,0,5.2,32.9,950,706,244,74.32,25.68,13,693,7,237,20,930,1.8,2.9,2.1,"25% - 50% P.O.C.","$51000 - $72000"
"10003016200","Census Tract 162, New Castle County, Delaware",2657,65417,1856,509,0,57,0,171,69.9,19.2,0,2.1,0,6.4,30.1,1262,663,599,52.54,47.46,71,592,0,599,71,1191,10.7,0,5.6,"25% - 50% P.O.C.","$51000 - $72000"
"10003016301","Census Tract 163.01, New Castle County, Delaware",5557,73694,2603,1512,0,586,0,737,46.8,27.2,0,10.5,0,13.3,53.2,2268,1499,769,66.09,33.91,126,1373,66,703,192,2076,8.4,8.6,8.5,"50% - 75% P.O.C.","$72000 - $96000"
"10003016302","Census Tract 163.02, New Castle County, Delaware",7349,78571,2821,2982,0,410,16,885,38.4,40.6,0,5.6,0.2,12,61.6,2308,2130,178,92.29,7.71,313,1817,0,178,313,1995,14.7,0,13.6,"50% - 75% P.O.C.","$72000 - $96000"
"10003016305","Census Tract 163.05, New Castle County, Delaware",7896,77636,2486,3953,19,495,0,850,31.5,50.1,0.2,6.3,0,10.8,68.5,2755,1669,1086,60.58,39.42,243,1426,33,1053,276,2479,14.6,3,10,"50% - 75% P.O.C.","$72000 - $96000"
"10003016401","Census Tract 164.01, New Castle County, Delaware",6271,102930,3500,2024,32,237,0,401,55.8,32.3,0.5,3.8,0,6.4,44.2,2096,2084,12,99.43,0.57,133,1951,0,12,133,1963,6.4,0,6.3,"25% - 50% P.O.C.","$96000 or more"
"10003016404","Census Tract 164.04, New Castle County, Delaware",2977,74663,1978,659,14,50,0,173,66.4,22.1,0.5,1.7,0,5.8,33.6,1077,858,219,79.67,20.33,77,781,19,200,96,981,9,8.7,8.9,"25% - 50% P.O.C.","$72000 - $96000"
"10003016601","Census Tract 166.01, New Castle County, Delaware",12837,86701,8870,2472,0,253,0,942,69.1,19.3,0,2,0,7.3,30.9,4686,3564,1122,76.06,23.94,259,3305,45,1077,304,4382,7.3,4,6.5,"25% - 50% P.O.C.","$72000 - $96000"
"10003016602","Census Tract 166.02, New Castle County, Delaware",10739,122476,7503,1867,0,775,0,415,69.9,17.4,0,7.2,0,3.9,30.1,3566,3412,154,95.68,4.32,243,3169,0,154,243,3323,7.1,0,6.8,"25% - 50% P.O.C.","$96000 or more"
"10003016604","Census Tract 166.04, New Castle County, Delaware",12083,95565,7436,3019,0,292,0,1077,61.5,25,0,2.4,0,8.9,38.5,3918,3323,595,84.81,15.19,500,2823,98,497,598,3320,15,16.5,15.3,"25% - 50% P.O.C.","$72000 - $96000"
"10003016608","Census Tract 166.08, New Castle County, Delaware",5577,105139,4216,930,18,162,0,127,75.6,16.7,0.3,2.9,0,2.3,24.4,1882,1873,9,99.52,0.48,200,1673,0,9,200,1682,10.7,0,10.6,"Less than 25% P.O.C.","$96000 or more"
"10003016801","Census Tract 168.01, New Castle County, Delaware",6654,92826,4100,1549,0,449,41,309,61.6,23.3,0,6.7,0.6,4.6,38.4,2216,2008,208,90.61,9.39,285,1723,3,205,288,1928,14.2,1.4,13,"25% - 50% P.O.C.","$72000 - $96000"
"10003016804","Census Tract 168.04, New Castle County, Delaware",7581,107278,5166,1489,0,266,0,524,68.1,19.6,0,3.5,0,6.9,31.9,2301,2238,63,97.26,2.74,335,1903,15,48,350,1951,15,23.8,15.2,"25% - 50% P.O.C.","$96000 or more"
"10003016901","Census Tract 169.01, New Castle County, Delaware",2264,79514,2211,34,0,1,0,5,97.7,1.5,0,0,0,0.2,2.3,809,757,52,93.57,6.43,83,674,2,50,85,724,11,3.8,10.5,"Less than 25% P.O.C.","$72000 - $96000"
"10003016904","Census Tract 169.04, New Castle County, Delaware",3953,97574,2121,1585,5,3,0,177,53.7,40.1,0.1,0.1,0,4.5,46.3,523,489,34,93.5,6.5,31,458,9,25,40,483,6.3,26.5,7.6,"25% - 50% P.O.C.","$96000 or more"
"10003980100","Census Tract 9801, New Castle County, Delaware",0,NA,0,0,0,0,0,0,NA,NA,NA,NA,NA,NA,NA,0,0,0,NA,NA,0,0,0,0,0,0,NA,NA,NA,"N/A","N/A"
"10003990100","Census Tract 9901, New Castle County, Delaware",0,NA,0,0,0,0,0,0,NA,NA,NA,NA,NA,NA,NA,0,0,0,NA,NA,0,0,0,0,0,0,NA,NA,NA,"N/A","N/A"
"34001000100","Census Tract 1, Atlantic County, New Jersey",2195,35293,511,353,0,650,0,600,23.3,16.1,0,29.6,0,27.3,76.7,795,300,495,37.74,62.26,39,261,63,432,102,693,13,12.7,12.8,"75% or more P.O.C.","Less than $51000"
"34001000200","Census Tract 2, Atlantic County, New Jersey",3353,44327,1064,180,0,833,0,1181,31.7,5.4,0,24.8,0,35.2,68.3,1324,716,608,54.08,45.92,96,620,93,515,189,1135,13.4,15.3,14.3,"50% - 75% P.O.C.","Less than $51000"
"34001000300","Census Tract 3, Atlantic County, New Jersey",3765,38179,531,174,28,1178,0,1590,14.1,4.6,0.7,31.3,0,42.2,85.9,1173,262,911,22.34,77.66,13,249,188,723,201,972,5,20.6,17.1,"75% or more P.O.C.","Less than $51000"
"34001000400","Census Tract 4, Atlantic County, New Jersey",3374,29453,1024,114,0,930,0,1211,30.3,3.4,0,27.6,0,35.9,69.7,1420,477,943,33.59,66.41,7,470,131,812,138,1282,1.5,13.9,9.7,"50% - 75% P.O.C.","Less than $51000"
"34001000500","Census Tract 5, Atlantic County, New Jersey",3141,42163,277,37,5,1150,0,1564,8.8,1.2,0.2,36.6,0,49.8,91.2,848,379,469,44.69,55.31,134,245,150,319,284,564,35.4,32,33.5,"75% or more P.O.C.","Less than $51000"
"34001001100","Census Tract 11, Atlantic County, New Jersey",2091,14100,45,1791,0,15,0,229,2.2,85.7,0,0.7,0,11,97.8,956,93,863,9.73,90.27,8,85,124,739,132,824,8.6,14.4,13.8,"75% or more P.O.C.","Less than $51000"
"34001001200","Census Tract 12, Atlantic County, New Jersey",2841,28553,96,1974,14,49,0,570,3.4,69.5,0.5,1.7,0,20.1,96.6,1178,557,621,47.28,52.72,59,498,39,582,98,1080,10.6,6.3,8.3,"75% or more P.O.C.","Less than $51000"
"34001001300","Census Tract 13, Atlantic County, New Jersey",1510,33158,145,1087,0,1,0,236,9.6,72,0,0.1,0,15.6,90.4,706,310,396,43.91,56.09,0,310,7,389,7,699,0,1.8,1,"75% or more P.O.C.","Less than $51000"
"34001001400","Census Tract 14, Atlantic County, New Jersey",3777,20887,341,2284,43,45,0,1063,9,60.5,1.1,1.2,0,28.1,91,1504,320,1184,21.28,78.72,0,320,134,1050,134,1370,0,11.3,8.9,"75% or more P.O.C.","Less than $51000"
"34001001500","Census Tract 15, Atlantic County, New Jersey",1680,17143,111,1243,12,81,0,192,6.6,74,0.7,4.8,0,11.4,93.4,794,21,773,2.64,97.36,0,21,30,743,30,764,0,3.9,3.8,"75% or more P.O.C.","Less than $51000"
"34001001900","Census Tract 19, Atlantic County, New Jersey",1406,29058,188,506,0,75,0,595,13.4,36,0,5.3,0,42.3,86.6,767,70,697,9.13,90.87,31,39,12,685,43,724,44.3,1.7,5.6,"75% or more P.O.C.","Less than $51000"
"34001002300","Census Tract 23, Atlantic County, New Jersey",2323,31563,250,144,4,462,0,1405,10.8,6.2,0.2,19.9,0,60.5,89.2,755,188,567,24.9,75.1,35,153,101,466,136,619,18.6,17.8,18,"75% or more P.O.C.","Less than $51000"
"34001002400","Census Tract 24, Atlantic County, New Jersey",2508,21076,592,1164,9,390,0,258,23.6,46.4,0.4,15.6,0,10.3,76.4,1243,132,1111,10.62,89.38,0,132,75,1036,75,1168,0,6.8,6,"75% or more P.O.C.","Less than $51000"
"34001002500","Census Tract 25, Atlantic County, New Jersey",4035,27860,739,1747,10,402,0,1112,18.3,43.3,0.2,10,0,27.6,81.7,2041,398,1643,19.5,80.5,28,370,82,1561,110,1931,7,5,5.4,"75% or more P.O.C.","Less than $51000"
"34001010101","Census Tract 101.01, Atlantic County, New Jersey",3261,72578,3103,1,0,63,0,84,95.2,0,0,1.9,0,2.6,4.8,1415,1180,235,83.39,16.61,36,1144,2,233,38,1377,3.1,0.9,2.7,"Less than 25% P.O.C.","$72000 - $96000"
"34001010102","Census Tract 101.02, Atlantic County, New Jersey",1651,86618,1565,7,0,16,0,42,94.8,0.4,0,1,0,2.5,5.2,794,574,220,72.29,27.71,16,558,0,220,16,778,2.8,0,2,"Less than 25% P.O.C.","$72000 - $96000"
"34001010104","Census Tract 101.04, Atlantic County, New Jersey",1338,70804,1140,17,6,79,0,79,85.2,1.3,0.4,5.9,0,5.9,14.8,679,355,324,52.28,47.72,2,353,9,315,11,668,0.6,2.8,1.6,"Less than 25% P.O.C.","$51000 - $72000"
"34001010105","Census Tract 101.05, Atlantic County, New Jersey",2582,64638,1913,0,0,315,0,331,74.1,0,0,12.2,0,12.8,25.9,1164,894,270,76.8,23.2,25,869,27,243,52,1112,2.8,10,4.5,"25% - 50% P.O.C.","$51000 - $72000"
"34001010200","Census Tract 102, Atlantic County, New Jersey",5778,78342,4862,206,0,0,36,629,84.1,3.6,0,0,0.6,10.9,15.9,2235,1918,317,85.82,14.18,175,1743,43,274,218,2017,9.1,13.6,9.8,"Less than 25% P.O.C.","$72000 - $96000"
"34001010300","Census Tract 103, Atlantic County, New Jersey",2584,43314,1089,641,0,459,0,390,42.1,24.8,0,17.8,0,15.1,57.9,942,632,310,67.09,32.91,45,587,54,256,99,843,7.1,17.4,10.5,"50% - 75% P.O.C.","Less than $51000"
"34001010401","Census Tract 104.01, Atlantic County, New Jersey",6177,90150,5194,447,28,171,0,319,84.1,7.2,0.5,2.8,0,5.2,15.9,2303,1757,546,76.29,23.71,183,1574,12,534,195,2108,10.4,2.2,8.5,"Less than 25% P.O.C.","$72000 - $96000"
"34001010403","Census Tract 104.03, Atlantic County, New Jersey",7248,82269,3199,1139,0,1435,10,1166,44.1,15.7,0,19.8,0.1,16.1,55.9,2197,1808,389,82.29,17.71,289,1519,49,340,338,1859,16,12.6,15.4,"50% - 75% P.O.C.","$72000 - $96000"
"34001010501","Census Tract 105.01, Atlantic County, New Jersey",6794,66042,5794,389,0,73,0,334,85.3,5.7,0,1.1,0,4.9,14.7,3141,2662,479,84.75,15.25,86,2576,45,434,131,3010,3.2,9.4,4.2,"Less than 25% P.O.C.","$51000 - $72000"
"34001010503","Census Tract 105.03, Atlantic County, New Jersey",6734,53446,2783,1729,31,622,0,1012,41.3,25.7,0.5,9.2,0,15,58.7,2894,1491,1403,51.52,48.48,103,1388,25,1378,128,2766,6.9,1.8,4.4,"50% - 75% P.O.C.","$51000 - $72000"
"34001010505","Census Tract 105.05, Atlantic County, New Jersey",2852,95036,2230,31,0,179,0,332,78.2,1.1,0,6.3,0,11.6,21.8,1003,970,33,96.71,3.29,100,870,0,33,100,903,10.3,0,10,"Less than 25% P.O.C.","$72000 - $96000"
"34001010506","Census Tract 105.06, Atlantic County, New Jersey",4968,80331,3551,192,0,449,0,502,71.5,3.9,0,9,0,10.1,28.5,1703,1488,215,87.38,12.62,145,1343,26,189,171,1532,9.7,12.1,10,"25% - 50% P.O.C.","$72000 - $96000"
"34001010600","Census Tract 106, Atlantic County, New Jersey",4100,42279,1684,996,27,277,0,1105,41.1,24.3,0.7,6.8,0,27,58.9,1454,734,720,50.48,49.52,67,667,128,592,195,1259,9.1,17.8,13.4,"50% - 75% P.O.C.","Less than $51000"
"34001010700","Census Tract 107, Atlantic County, New Jersey",5925,82663,5430,241,0,0,0,218,91.6,4.1,0,0,0,3.7,8.4,2282,1978,304,86.68,13.32,118,1860,36,268,154,2128,6,11.8,6.7,"Less than 25% P.O.C.","$72000 - $96000"
"34001010800","Census Tract 108, Atlantic County, New Jersey",3151,71464,2348,143,0,30,7,619,74.5,4.5,0,1,0.2,19.6,25.5,1067,698,369,65.42,34.58,83,615,65,304,148,919,11.9,17.6,13.9,"25% - 50% P.O.C.","$51000 - $72000"
"34001010900","Census Tract 109, Atlantic County, New Jersey",5596,74211,4180,183,0,122,0,1098,74.7,3.3,0,2.2,0,19.6,25.3,2149,1552,597,72.22,27.78,143,1409,33,564,176,1973,9.2,5.5,8.2,"25% - 50% P.O.C.","$72000 - $96000"
"34001011000","Census Tract 110, Atlantic County, New Jersey",2447,88295,1921,52,4,0,0,455,78.5,2.1,0.2,0,0,18.6,21.5,833,674,159,80.91,19.09,90,584,7,152,97,736,13.4,4.4,11.6,"Less than 25% P.O.C.","$72000 - $96000"
"34001011100","Census Tract 111, Atlantic County, New Jersey",2945,68665,1881,17,0,11,0,1004,63.9,0.6,0,0.4,0,34.1,36.1,943,698,245,74.02,25.98,62,636,108,137,170,773,8.9,44.1,18,"25% - 50% P.O.C.","$51000 - $72000"
"34001011201","Census Tract 112.01, Atlantic County, New Jersey",1697,76429,1462,47,0,19,0,94,86.2,2.8,0,1.1,0,5.5,13.8,588,543,45,92.35,7.65,60,483,9,36,69,519,11,20,11.7,"Less than 25% P.O.C.","$72000 - $96000"
"34001011202","Census Tract 112.02, Atlantic County, New Jersey",7295,62994,5288,726,197,47,9,969,72.5,10,2.7,0.6,0.1,13.3,27.5,2558,2122,436,82.96,17.04,266,1856,51,385,317,2241,12.5,11.7,12.4,"25% - 50% P.O.C.","$51000 - $72000"
"34001011300","Census Tract 113, Atlantic County, New Jersey",4356,53275,2646,356,0,125,8,1123,60.7,8.2,0,2.9,0.2,25.8,39.3,1750,970,780,55.43,44.57,109,861,124,656,233,1517,11.2,15.9,13.3,"25% - 50% P.O.C.","$51000 - $72000"
"34001011401","Census Tract 114.01, Atlantic County, New Jersey",4360,79612,3425,212,0,49,0,602,78.6,4.9,0,1.1,0,13.8,21.4,1751,1442,309,82.35,17.65,95,1347,17,292,112,1639,6.6,5.5,6.4,"Less than 25% P.O.C.","$72000 - $96000"
"34001011403","Census Tract 114.03, Atlantic County, New Jersey",5860,67443,2645,1378,11,971,0,722,45.1,23.5,0.2,16.6,0,12.3,54.9,2289,1105,1184,48.27,51.73,104,1001,33,1151,137,2152,9.4,2.8,6,"50% - 75% P.O.C.","$51000 - $72000"
"34001011404","Census Tract 114.04, Atlantic County, New Jersey",9317,71953,4803,1590,13,875,0,1534,51.6,17.1,0.1,9.4,0,16.5,48.4,3501,2677,824,76.46,23.54,224,2453,44,780,268,3233,8.4,5.3,7.7,"25% - 50% P.O.C.","$51000 - $72000"
"34001011500","Census Tract 115, Atlantic County, New Jersey",6436,75134,3723,803,19,457,0,1167,57.8,12.5,0.3,7.1,0,18.1,42.2,2235,1769,466,79.15,20.85,181,1588,158,308,339,1896,10.2,33.9,15.2,"25% - 50% P.O.C.","$72000 - $96000"
"34001011600","Census Tract 116, Atlantic County, New Jersey",5020,69226,4464,272,0,15,0,116,88.9,5.4,0,0.3,0,2.3,11.1,1983,1798,185,90.67,9.33,115,1683,73,112,188,1795,6.4,39.5,9.5,"Less than 25% P.O.C.","$51000 - $72000"
"34001011701","Census Tract 117.01, Atlantic County, New Jersey",9003,55524,3516,927,0,2280,0,2056,39.1,10.3,0,25.3,0,22.8,60.9,2767,2297,470,83.01,16.99,477,1820,78,392,555,2212,20.8,16.6,20.1,"50% - 75% P.O.C.","$51000 - $72000"
"34001011702","Census Tract 117.02, Atlantic County, New Jersey",3175,44808,1120,439,25,133,4,1405,35.3,13.8,0.8,4.2,0.1,44.3,64.7,1190,851,339,71.51,28.49,80,771,29,310,109,1081,9.4,8.6,9.2,"50% - 75% P.O.C.","Less than $51000"
"34001011802","Census Tract 118.02, Atlantic County, New Jersey",15860,107201,10295,871,0,1612,0,1982,64.9,5.5,0,10.2,0,12.5,35.1,4920,4578,342,93.05,6.95,810,3768,78,264,888,4032,17.7,22.8,18,"25% - 50% P.O.C.","$96000 or more"
"34001011803","Census Tract 118.03, Atlantic County, New Jersey",4567,68846,2835,213,12,325,0,1139,62.1,4.7,0.3,7.1,0,24.9,37.9,1894,1431,463,75.55,24.45,89,1342,0,463,89,1805,6.2,0,4.7,"25% - 50% P.O.C.","$51000 - $72000"
"34001011804","Census Tract 118.04, Atlantic County, New Jersey",7000,81732,5543,179,0,203,0,714,79.2,2.6,0,2.9,0,10.2,20.8,2395,2265,130,94.57,5.43,329,1936,49,81,378,2017,14.5,37.7,15.8,"Less than 25% P.O.C.","$72000 - $96000"
"34001011805","Census Tract 118.05, Atlantic County, New Jersey",2062,90714,1816,47,0,11,0,188,88.1,2.3,0,0.5,0,9.1,11.9,748,706,42,94.39,5.61,80,626,17,25,97,651,11.3,40.5,13,"Less than 25% P.O.C.","$72000 - $96000"
"34001011900","Census Tract 119, Atlantic County, New Jersey",8819,42377,687,3820,55,90,18,3952,7.8,43.3,0.6,1,0.2,44.8,92.2,2838,928,1910,32.7,67.3,175,753,256,1654,431,2407,18.9,13.4,15.2,"75% or more P.O.C.","Less than $51000"
"34001012000","Census Tract 120, Atlantic County, New Jersey",4514,36520,802,1118,19,376,5,2082,17.8,24.8,0.4,8.3,0.1,46.1,82.2,1581,852,729,53.89,46.11,183,669,100,629,283,1298,21.5,13.7,17.9,"75% or more P.O.C.","Less than $51000"
"34001012100","Census Tract 121, Atlantic County, New Jersey",2679,39514,401,749,0,35,0,1494,15,28,0,1.3,0,55.8,85,754,387,367,51.33,48.67,80,307,72,295,152,602,20.7,19.6,20.2,"75% or more P.O.C.","Less than $51000"
"34001012200","Census Tract 122, Atlantic County, New Jersey",5151,41672,410,1993,8,169,0,2387,8,38.7,0.2,3.3,0,46.3,92,1834,1048,786,57.14,42.86,208,840,36,750,244,1590,19.8,4.6,13.3,"75% or more P.O.C.","Less than $51000"
"34001012302","Census Tract 123.02, Atlantic County, New Jersey",3419,94722,2229,67,0,250,0,851,65.2,2,0,7.3,0,24.9,34.8,1066,930,136,87.24,12.76,133,797,20,116,153,913,14.3,14.7,14.4,"25% - 50% P.O.C.","$72000 - $96000"
"34001012401","Census Tract 124.01, Atlantic County, New Jersey",2784,76563,2449,104,0,62,0,140,88,3.7,0,2.2,0,5,12,994,944,50,94.97,5.03,95,849,0,50,95,899,10.1,0,9.6,"Less than 25% P.O.C.","$72000 - $96000"
"34001012402","Census Tract 124.02, Atlantic County, New Jersey",1950,87596,1656,29,5,119,0,92,84.9,1.5,0.3,6.1,0,4.7,15.1,803,750,53,93.4,6.6,58,692,7,46,65,738,7.7,13.2,8.1,"Less than 25% P.O.C.","$72000 - $96000"
"34001012501","Census Tract 125.01, Atlantic County, New Jersey",2433,98571,2110,34,0,79,3,170,86.7,1.4,0,3.2,0.1,7,13.3,890,684,206,76.85,23.15,44,640,54,152,98,792,6.4,26.2,11,"Less than 25% P.O.C.","$96000 or more"
"34001012502","Census Tract 125.02, Atlantic County, New Jersey",1451,101875,1185,19,2,128,0,86,81.7,1.3,0.1,8.8,0,5.9,18.3,556,471,85,84.71,15.29,27,444,6,79,33,523,5.7,7.1,5.9,"Less than 25% P.O.C.","$96000 or more"
"34001012602","Census Tract 126.02, Atlantic County, New Jersey",1323,128000,1024,15,0,57,0,222,77.4,1.1,0,4.3,0,16.8,22.6,470,441,29,93.83,6.17,34,407,1,28,35,435,7.7,3.4,7.4,"Less than 25% P.O.C.","$96000 or more"
"34001012701","Census Tract 127.01, Atlantic County, New Jersey",3112,63301,2092,392,0,337,0,215,67.2,12.6,0,10.8,0,6.9,32.8,1327,739,588,55.69,44.31,22,717,0,588,22,1305,3,0,1.7,"25% - 50% P.O.C.","$51000 - $72000"
"34001012702","Census Tract 127.02, Atlantic County, New Jersey",1622,53300,1244,179,0,20,0,142,76.7,11,0,1.2,0,8.8,23.3,694,411,283,59.22,40.78,24,387,4,279,28,666,5.8,1.4,4,"Less than 25% P.O.C.","$51000 - $72000"
"34001012801","Census Tract 128.01, Atlantic County, New Jersey",4126,56605,2779,583,12,107,0,645,67.4,14.1,0.3,2.6,0,15.6,32.6,1631,798,833,48.93,51.07,71,727,76,757,147,1484,8.9,9.1,9,"25% - 50% P.O.C.","$51000 - $72000"
"34001012802","Census Tract 128.02, Atlantic County, New Jersey",1461,79338,1157,21,0,117,0,166,79.2,1.4,0,8,0,11.4,20.8,719,589,130,81.92,18.08,39,550,17,113,56,663,6.6,13.1,7.8,"Less than 25% P.O.C.","$72000 - $96000"
"34001013000","Census Tract 130, Atlantic County, New Jersey",3369,86848,3212,7,17,28,0,17,95.3,0.2,0.5,0.8,0,0.5,4.7,1512,1327,185,87.76,12.24,57,1270,0,185,57,1455,4.3,0,3.8,"Less than 25% P.O.C.","$72000 - $96000"
"34001013101","Census Tract 131.01, Atlantic County, New Jersey",1095,112917,1075,2,0,0,3,15,98.2,0.2,0,0,0.3,1.4,1.8,509,496,13,97.45,2.55,35,461,0,13,35,474,7.1,0,6.9,"Less than 25% P.O.C.","$96000 or more"
"34001013102","Census Tract 131.02, Atlantic County, New Jersey",1533,55333,1320,113,0,32,0,44,86.1,7.4,0,2.1,0,2.9,13.9,912,556,356,60.96,39.04,0,556,0,356,0,912,0,0,0,"Less than 25% P.O.C.","$51000 - $72000"
"34001013201","Census Tract 132.01, Atlantic County, New Jersey",2864,56176,1253,73,0,626,0,852,43.8,2.5,0,21.9,0,29.7,56.2,1140,743,397,65.18,34.82,63,680,28,369,91,1049,8.5,7.1,8,"50% - 75% P.O.C.","$51000 - $72000"
"34001013202","Census Tract 132.02, Atlantic County, New Jersey",2310,80850,2051,41,0,50,0,114,88.8,1.8,0,2.2,0,4.9,11.2,903,694,209,76.85,23.15,86,608,10,199,96,807,12.4,4.8,10.6,"Less than 25% P.O.C.","$72000 - $96000"
"34001013301","Census Tract 133.01, Atlantic County, New Jersey",2335,46303,1575,166,0,223,0,371,67.5,7.1,0,9.6,0,15.9,32.5,1124,545,579,48.49,51.51,9,536,47,532,56,1068,1.7,8.1,5,"25% - 50% P.O.C.","Less than $51000"
"34001013302","Census Tract 133.02, Atlantic County, New Jersey",2586,70651,1887,226,15,92,0,366,73,8.7,0.6,3.6,0,14.2,27,1199,874,325,72.89,27.11,52,822,20,305,72,1127,5.9,6.2,6,"25% - 50% P.O.C.","$51000 - $72000"
"34001013500","Census Tract 135, Atlantic County, New Jersey",2589,115804,2292,31,2,168,0,89,88.5,1.2,0.1,6.5,0,3.4,11.5,1111,966,145,86.95,13.05,84,882,0,145,84,1027,8.7,0,7.6,"Less than 25% P.O.C.","$96000 or more"
"34001983400","Census Tract 9834, Atlantic County, New Jersey",2442,81250,1818,218,0,49,0,302,74.4,8.9,0,2,0,12.4,25.6,12,12,0,100,0,0,12,0,0,0,12,0,NA,0,"25% - 50% P.O.C.","$72000 - $96000"
"34001990000","Census Tract 9900, Atlantic County, New Jersey",0,NA,0,0,0,0,0,0,NA,NA,NA,NA,NA,NA,NA,0,0,0,NA,NA,0,0,0,0,0,0,NA,NA,NA,"N/A","N/A"
"34005700102","Census Tract 7001.02, Burlington County, New Jersey",2438,92563,2093,137,0,89,0,85,85.8,5.6,0,3.7,0,3.5,14.2,905,714,191,78.9,21.1,82,632,38,153,120,785,11.5,19.9,13.3,"Less than 25% P.O.C.","$72000 - $96000"
"34005700103","Census Tract 7001.03, Burlington County, New Jersey",2905,68811,1971,551,0,48,0,268,67.8,19,0,1.7,0,9.2,32.2,1283,896,387,69.84,30.16,57,839,36,351,93,1190,6.4,9.3,7.2,"25% - 50% P.O.C.","$51000 - $72000"
"34005700104","Census Tract 7001.04, Burlington County, New Jersey",1846,58750,870,661,0,62,0,191,47.1,35.8,0,3.4,0,10.3,52.9,637,353,284,55.42,44.58,76,277,43,241,119,518,21.5,15.1,18.7,"50% - 75% P.O.C.","$51000 - $72000"
"34005700200","Census Tract 7002, Burlington County, New Jersey",2705,106058,2442,80,2,13,0,97,90.3,3,0.1,0.5,0,3.6,9.7,1020,825,195,80.88,19.12,83,742,12,183,95,925,10.1,6.2,9.3,"Less than 25% P.O.C.","$96000 or more"
"34005700303","Census Tract 7003.03, Burlington County, New Jersey",3550,102978,2734,598,0,18,0,170,77,16.8,0,0.5,0,4.8,23,1389,970,419,69.83,30.17,105,865,0,419,105,1284,10.8,0,7.6,"Less than 25% P.O.C.","$96000 or more"
"34005700304","Census Tract 7003.04, Burlington County, New Jersey",2533,90156,2173,63,0,0,9,231,85.8,2.5,0,0,0.4,9.1,14.2,873,823,50,94.27,5.73,74,749,7,43,81,792,9,14,9.3,"Less than 25% P.O.C.","$72000 - $96000"
"34005700305","Census Tract 7003.05, Burlington County, New Jersey",5143,113200,4566,82,0,74,0,273,88.8,1.6,0,1.4,0,5.3,11.2,1828,1708,120,93.44,6.56,191,1517,19,101,210,1618,11.2,15.8,11.5,"Less than 25% P.O.C.","$96000 or more"
"34005700306","Census Tract 7003.06, Burlington County, New Jersey",2430,117708,2322,20,0,15,0,58,95.6,0.8,0,0.6,0,2.4,4.4,845,821,24,97.16,2.84,79,742,7,17,86,759,9.6,29.2,10.2,"Less than 25% P.O.C.","$96000 or more"
"34005700307","Census Tract 7003.07, Burlington County, New Jersey",2760,135721,2476,64,0,58,0,94,89.7,2.3,0,2.1,0,3.4,10.3,943,921,22,97.67,2.33,131,790,0,22,131,812,14.2,0,13.9,"Less than 25% P.O.C.","$96000 or more"
"34005700401","Census Tract 7004.01, Burlington County, New Jersey",1923,76458,1688,0,0,113,0,95,87.8,0,0,5.9,0,4.9,12.2,752,627,125,83.38,16.62,77,550,16,109,93,659,12.3,12.8,12.4,"Less than 25% P.O.C.","$72000 - $96000"
"34005700402","Census Tract 7004.02, Burlington County, New Jersey",3323,83913,2885,30,0,111,0,238,86.8,0.9,0,3.3,0,7.2,13.2,1248,1151,97,92.23,7.77,118,1033,0,97,118,1130,10.3,0,9.5,"Less than 25% P.O.C.","$72000 - $96000"
"34005700403","Census Tract 7004.03, Burlington County, New Jersey",4432,67727,3929,132,0,133,0,203,88.7,3,0,3,0,4.6,11.3,1626,1164,462,71.59,28.41,178,986,18,444,196,1430,15.3,3.9,12.1,"Less than 25% P.O.C.","$51000 - $72000"
"34005700405","Census Tract 7004.05, Burlington County, New Jersey",1821,69519,1442,15,0,109,0,229,79.2,0.8,0,6,0,12.6,20.8,649,513,136,79.04,20.96,48,465,29,107,77,572,9.4,21.3,11.9,"Less than 25% P.O.C.","$51000 - $72000"
"34005700407","Census Tract 7004.07, Burlington County, New Jersey",4914,47644,2484,1353,0,641,0,383,50.5,27.5,0,13,0,7.8,49.5,2778,303,2475,10.91,89.09,0,303,127,2348,127,2651,0,5.1,4.6,"25% - 50% P.O.C.","Less than $51000"
"34005700408","Census Tract 7004.08, Burlington County, New Jersey",2229,61797,986,366,0,421,0,278,44.2,16.4,0,18.9,0,12.5,55.8,1232,129,1103,10.47,89.53,0,129,27,1076,27,1205,0,2.4,2.2,"50% - 75% P.O.C.","$51000 - $72000"
"34005700501","Census Tract 7005.01, Burlington County, New Jersey",5400,108780,4441,451,0,41,0,321,82.2,8.4,0,0.8,0,5.9,17.8,2070,1500,570,72.46,27.54,199,1301,0,570,199,1871,13.3,0,9.6,"Less than 25% P.O.C.","$96000 or more"
"34005700502","Census Tract 7005.02, Burlington County, New Jersey",1975,125000,1729,63,6,99,0,78,87.5,3.2,0.3,5,0,3.9,12.5,718,637,81,88.72,11.28,81,556,0,81,81,637,12.7,0,11.3,"Less than 25% P.O.C.","$96000 or more"
"34005700503","Census Tract 7005.03, Burlington County, New Jersey",3603,165833,2867,430,0,83,0,138,79.6,11.9,0,2.3,0,3.8,20.4,1316,1116,200,84.8,15.2,183,933,0,200,183,1133,16.4,0,13.9,"Less than 25% P.O.C.","$96000 or more"
"34005700504","Census Tract 7005.04, Burlington County, New Jersey",3076,129722,2645,150,0,96,0,99,86,4.9,0,3.1,0,3.2,14,1092,835,257,76.47,23.53,84,751,44,213,128,964,10.1,17.1,11.7,"Less than 25% P.O.C.","$96000 or more"
"34005700505","Census Tract 7005.05, Burlington County, New Jersey",6395,245662,4894,183,0,1133,0,68,76.5,2.9,0,17.7,0,1.1,23.5,1949,1740,209,89.28,10.72,224,1516,58,151,282,1667,12.9,27.8,14.5,"Less than 25% P.O.C.","$96000 or more"
"34005700602","Census Tract 7006.02, Burlington County, New Jersey",5661,101473,4453,670,0,317,0,133,78.7,11.8,0,5.6,0,2.3,21.3,2119,1892,227,89.29,10.71,162,1730,37,190,199,1920,8.6,16.3,9.4,"Less than 25% P.O.C.","$96000 or more"
"34005700603","Census Tract 7006.03, Burlington County, New Jersey",6154,73664,5131,491,0,61,0,204,83.4,8,0,1,0,3.3,16.6,2267,1285,982,56.68,43.32,257,1028,62,920,319,1948,20,6.3,14.1,"Less than 25% P.O.C.","$72000 - $96000"
"34005700605","Census Tract 7006.05, Burlington County, New Jersey",4733,97036,3882,416,0,241,43,113,82,8.8,0,5.1,0.9,2.4,18,1605,1250,355,77.88,22.12,203,1047,31,324,234,1371,16.2,8.7,14.6,"Less than 25% P.O.C.","$96000 or more"
"34005700701","Census Tract 7007.01, Burlington County, New Jersey",3213,67735,2509,322,0,29,0,353,78.1,10,0,0.9,0,11,21.9,1292,876,416,67.8,32.2,66,810,66,350,132,1160,7.5,15.9,10.2,"Less than 25% P.O.C.","$51000 - $72000"
"34005700702","Census Tract 7007.02, Burlington County, New Jersey",2452,59570,1650,196,0,119,0,454,67.3,8,0,4.9,0,18.5,32.7,879,582,297,66.21,33.79,62,520,66,231,128,751,10.7,22.2,14.6,"25% - 50% P.O.C.","$51000 - $72000"
"34005700703","Census Tract 7007.03, Burlington County, New Jersey",2192,49773,1450,214,0,8,0,475,66.1,9.8,0,0.4,0,21.7,33.9,876,506,370,57.76,42.24,9,497,35,335,44,832,1.8,9.5,5,"25% - 50% P.O.C.","Less than $51000"
"34005700800","Census Tract 7008, Burlington County, New Jersey",4469,82043,3322,657,0,64,0,271,74.3,14.7,0,1.4,0,6.1,25.7,1991,1493,498,74.99,25.01,20,1473,10,488,30,1961,1.3,2,1.5,"25% - 50% P.O.C.","$72000 - $96000"
"34005700900","Census Tract 7009, Burlington County, New Jersey",2267,50868,1385,362,0,12,0,341,61.1,16,0,0.5,0,15,38.9,913,652,261,71.41,28.59,50,602,23,238,73,840,7.7,8.8,8,"25% - 50% P.O.C.","Less than $51000"
"34005701001","Census Tract 7010.01, Burlington County, New Jersey",5318,57917,2603,1307,0,72,0,1117,48.9,24.6,0,1.4,0,21,51.1,2212,1042,1170,47.11,52.89,18,1024,225,945,243,1969,1.7,19.2,11,"50% - 75% P.O.C.","$51000 - $72000"
"34005701002","Census Tract 7010.02, Burlington County, New Jersey",3374,87500,1673,964,0,30,0,596,49.6,28.6,0,0.9,0,17.7,50.4,1202,862,340,71.71,28.29,67,795,14,326,81,1121,7.8,4.1,6.7,"50% - 75% P.O.C.","$72000 - $96000"
"34005701102","Census Tract 7011.02, Burlington County, New Jersey",5336,103676,2223,1315,0,646,0,939,41.7,24.6,0,12.1,0,17.6,58.3,1840,1574,266,85.54,14.46,329,1245,8,258,337,1503,20.9,3,18.3,"50% - 75% P.O.C.","$96000 or more"
"34005701103","Census Tract 7011.03, Burlington County, New Jersey",6254,90478,2974,2067,17,468,0,523,47.6,33.1,0.3,7.5,0,8.4,52.4,2059,1800,259,87.42,12.58,387,1413,0,259,387,1672,21.5,0,18.8,"50% - 75% P.O.C.","$72000 - $96000"
"34005701104","Census Tract 7011.04, Burlington County, New Jersey",4819,79828,2079,1694,0,413,0,302,43.1,35.2,0,8.6,0,6.3,56.9,1820,1176,644,64.62,35.38,122,1054,28,616,150,1670,10.4,4.3,8.2,"50% - 75% P.O.C.","$72000 - $96000"
"34005701105","Census Tract 7011.05, Burlington County, New Jersey",6177,91356,2586,2035,0,711,0,588,41.9,32.9,0,11.5,0,9.5,58.1,2169,1604,565,73.95,26.05,223,1381,97,468,320,1849,13.9,17.2,14.8,"50% - 75% P.O.C.","$72000 - $96000"
"34005701201","Census Tract 7012.01, Burlington County, New Jersey",2929,73850,1726,686,0,63,0,178,58.9,23.4,0,2.2,0,6.1,41.1,1213,1110,103,91.51,8.49,67,1043,5,98,72,1141,6,4.9,5.9,"25% - 50% P.O.C.","$72000 - $96000"
"34005701203","Census Tract 7012.03, Burlington County, New Jersey",2103,70662,1231,519,0,132,0,146,58.5,24.7,0,6.3,0,6.9,41.5,737,445,292,60.38,39.62,58,387,25,267,83,654,13,8.6,11.3,"25% - 50% P.O.C.","$51000 - $72000"
"34005701204","Census Tract 7012.04, Burlington County, New Jersey",2564,26500,717,1285,0,97,0,413,28,50.1,0,3.8,0,16.1,72,1032,312,720,30.23,69.77,37,275,122,598,159,873,11.9,16.9,15.4,"50% - 75% P.O.C.","Less than $51000"
"34005701205","Census Tract 7012.05, Burlington County, New Jersey",2219,58663,1586,206,0,37,0,352,71.5,9.3,0,1.7,0,15.9,28.5,978,624,354,63.8,36.2,34,590,34,320,68,910,5.4,9.6,7,"25% - 50% P.O.C.","$51000 - $72000"
"34005701301","Census Tract 7013.01, Burlington County, New Jersey",4455,55960,3143,436,0,150,0,278,70.5,9.8,0,3.4,0,6.2,29.5,1899,1153,746,60.72,39.28,111,1042,94,652,205,1694,9.6,12.6,10.8,"25% - 50% P.O.C.","$51000 - $72000"
"34005701302","Census Tract 7013.02, Burlington County, New Jersey",2901,87500,2365,221,0,27,0,267,81.5,7.6,0,0.9,0,9.2,18.5,1094,869,225,79.43,20.57,59,810,25,200,84,1010,6.8,11.1,7.7,"Less than 25% P.O.C.","$72000 - $96000"
"34005701303","Census Tract 7013.03, Burlington County, New Jersey",5196,102976,3487,480,0,594,0,472,67.1,9.2,0,11.4,0,9.1,32.9,1948,1851,97,95.02,4.98,190,1661,46,51,236,1712,10.3,47.4,12.1,"25% - 50% P.O.C.","$96000 or more"
"34005701401","Census Tract 7014.01, Burlington County, New Jersey",6454,127039,4495,723,0,754,0,396,69.6,11.2,0,11.7,0,6.1,30.4,2346,2217,129,94.5,5.5,218,1999,0,129,218,2128,9.8,0,9.3,"25% - 50% P.O.C.","$96000 or more"
"34005701402","Census Tract 7014.02, Burlington County, New Jersey",2079,55903,1872,95,0,54,0,42,90,4.6,0,2.6,0,2,10,1231,1178,53,95.69,4.31,37,1141,0,53,37,1194,3.1,0,3,"Less than 25% P.O.C.","$51000 - $72000"
"34005701502","Census Tract 7015.02, Burlington County, New Jersey",4092,72736,3291,145,0,324,0,267,80.4,3.5,0,7.9,0,6.5,19.6,1721,1222,499,71.01,28.99,142,1080,48,451,190,1531,11.6,9.6,11,"Less than 25% P.O.C.","$72000 - $96000"
"34005701700","Census Tract 7017, Burlington County, New Jersey",3823,80896,2900,479,0,170,0,178,75.9,12.5,0,4.4,0,4.7,24.1,1707,905,802,53.02,46.98,100,805,21,781,121,1586,11,2.6,7.1,"Less than 25% P.O.C.","$72000 - $96000"
"34005702101","Census Tract 7021.01, Burlington County, New Jersey",4260,72163,2514,401,8,113,0,994,59,9.4,0.2,2.7,0,23.3,41,1283,0,1283,0,100,0,0,282,1001,282,1001,NA,22,22,"25% - 50% P.O.C.","$72000 - $96000"
"34005702203","Census Tract 7022.03, Burlington County, New Jersey",3543,57663,1423,1202,0,92,0,356,40.2,33.9,0,2.6,0,10,59.8,1513,864,649,57.11,42.89,136,728,14,635,150,1363,15.7,2.2,9.9,"50% - 75% P.O.C.","$51000 - $72000"
"34005702204","Census Tract 7022.04, Burlington County, New Jersey",2370,67072,1274,608,0,41,0,369,53.8,25.7,0,1.7,0,15.6,46.2,727,460,267,63.27,36.73,87,373,10,257,97,630,18.9,3.7,13.3,"25% - 50% P.O.C.","$51000 - $72000"
"34005702206","Census Tract 7022.06, Burlington County, New Jersey",1869,64875,1487,123,0,7,0,182,79.6,6.6,0,0.4,0,9.7,20.4,685,529,156,77.23,22.77,65,464,20,136,85,600,12.3,12.8,12.4,"Less than 25% P.O.C.","$51000 - $72000"
"34005702207","Census Tract 7022.07, Burlington County, New Jersey",3102,37788,1814,677,0,68,0,336,58.5,21.8,0,2.2,0,10.8,41.5,1327,974,353,73.4,26.6,35,939,24,329,59,1268,3.6,6.8,4.4,"25% - 50% P.O.C.","Less than $51000"
"34005702208","Census Tract 7022.08, Burlington County, New Jersey",6478,80984,4375,694,0,260,0,894,67.5,10.7,0,4,0,13.8,32.5,2294,2043,251,89.06,10.94,245,1798,37,214,282,2012,12,14.7,12.3,"25% - 50% P.O.C.","$72000 - $96000"
"34005702209","Census Tract 7022.09, Burlington County, New Jersey",3183,80435,1922,535,0,103,0,251,60.4,16.8,0,3.2,0,7.9,39.6,1106,906,200,81.92,18.08,125,781,67,133,192,914,13.8,33.5,17.4,"25% - 50% P.O.C.","$72000 - $96000"
"34005702210","Census Tract 7022.10, Burlington County, New Jersey",4744,63788,2146,1401,23,191,0,564,45.2,29.5,0.5,4,0,11.9,54.8,1667,1145,522,68.69,31.31,180,965,81,441,261,1406,15.7,15.5,15.7,"50% - 75% P.O.C.","$51000 - $72000"
"34005702300","Census Tract 7023, Burlington County, New Jersey",1499,66354,887,157,3,51,0,300,59.2,10.5,0.2,3.4,0,20,40.8,605,387,218,63.97,36.03,12,375,18,200,30,575,3.1,8.3,5,"25% - 50% P.O.C.","$51000 - $72000"
"34005702400","Census Tract 7024, Burlington County, New Jersey",3275,116458,2856,167,0,23,0,169,87.2,5.1,0,0.7,0,5.2,12.8,1110,984,126,88.65,11.35,82,902,34,92,116,994,8.3,27,10.5,"Less than 25% P.O.C.","$96000 or more"
"34005702500","Census Tract 7025, Burlington County, New Jersey",5989,96429,3495,1208,11,417,0,618,58.4,20.2,0.2,7,0,10.3,41.6,2138,1420,718,66.42,33.58,194,1226,42,676,236,1902,13.7,5.8,11,"25% - 50% P.O.C.","$96000 or more"
"34005702601","Census Tract 7026.01, Burlington County, New Jersey",4343,85636,2826,777,0,61,0,519,65.1,17.9,0,1.4,0,12,34.9,1746,1356,390,77.66,22.34,114,1242,10,380,124,1622,8.4,2.6,7.1,"25% - 50% P.O.C.","$72000 - $96000"
"34005702603","Census Tract 7026.03, Burlington County, New Jersey",2439,38919,1316,503,0,88,0,424,54,20.6,0,3.6,0,17.4,46,818,327,491,39.98,60.02,31,296,51,440,82,736,9.5,10.4,10,"25% - 50% P.O.C.","Less than $51000"
"34005702700","Census Tract 7027, Burlington County, New Jersey",8672,109527,4629,2023,0,557,0,954,53.4,23.3,0,6.4,0,11,46.6,3169,2989,180,94.32,5.68,234,2755,0,180,234,2935,7.8,0,7.4,"25% - 50% P.O.C.","$96000 or more"
"34005702801","Census Tract 7028.01, Burlington County, New Jersey",2130,84943,207,1615,0,0,0,271,9.7,75.8,0,0,0,12.7,90.3,719,615,104,85.54,14.46,79,536,15,89,94,625,12.8,14.4,13.1,"75% or more P.O.C.","$72000 - $96000"
"34005702802","Census Tract 7028.02, Burlington County, New Jersey",3437,75511,315,2462,0,87,0,440,9.2,71.6,0,2.5,0,12.8,90.8,1077,1048,29,97.31,2.69,155,893,0,29,155,922,14.8,0,14.4,"75% or more P.O.C.","$72000 - $96000"
"34005702803","Census Tract 7028.03, Burlington County, New Jersey",3860,80417,595,2691,0,65,0,403,15.4,69.7,0,1.7,0,10.4,84.6,1304,1172,132,89.88,10.12,141,1031,55,77,196,1108,12,41.7,15,"75% or more P.O.C.","$72000 - $96000"
"34005702804","Census Tract 7028.04, Burlington County, New Jersey",2552,70000,337,1977,0,42,9,141,13.2,77.5,0,1.6,0.4,5.5,86.8,956,838,118,87.66,12.34,63,775,33,85,96,860,7.5,28,10,"75% or more P.O.C.","$51000 - $72000"
"34005702805","Census Tract 7028.05, Burlington County, New Jersey",4124,78625,687,2830,9,0,0,455,16.7,68.6,0.2,0,0,11,83.3,1225,967,258,78.94,21.06,85,882,119,139,204,1021,8.8,46.1,16.7,"75% or more P.O.C.","$72000 - $96000"
"34005702806","Census Tract 7028.06, Burlington County, New Jersey",3056,75324,579,1951,0,49,0,256,18.9,63.8,0,1.6,0,8.4,81.1,1065,811,254,76.15,23.85,104,707,100,154,204,861,12.8,39.4,19.2,"75% or more P.O.C.","$72000 - $96000"
"34005702807","Census Tract 7028.07, Burlington County, New Jersey",3175,68431,429,2038,0,100,0,363,13.5,64.2,0,3.1,0,11.4,86.5,1162,668,494,57.49,42.51,39,629,54,440,93,1069,5.8,10.9,8,"75% or more P.O.C.","$51000 - $72000"
"34005702808","Census Tract 7028.08, Burlington County, New Jersey",3353,73194,453,1869,0,174,0,461,13.5,55.7,0,5.2,0,13.7,86.5,1055,848,207,80.38,19.62,98,750,78,129,176,879,11.6,37.7,16.7,"75% or more P.O.C.","$72000 - $96000"
"34005702809","Census Tract 7028.09, Burlington County, New Jersey",2114,69153,391,1246,0,39,0,377,18.5,58.9,0,1.8,0,17.8,81.5,837,329,508,39.31,60.69,13,316,100,408,113,724,4,19.7,13.5,"75% or more P.O.C.","$51000 - $72000"
"34005702810","Census Tract 7028.10, Burlington County, New Jersey",1362,91023,169,795,0,0,0,330,12.4,58.4,0,0,0,24.2,87.6,451,414,37,91.8,8.2,85,329,4,33,89,362,20.5,10.8,19.7,"75% or more P.O.C.","$72000 - $96000"
"34005702811","Census Tract 7028.11, Burlington County, New Jersey",2499,83750,329,1946,0,6,0,139,13.2,77.9,0,0.2,0,5.6,86.8,850,774,76,91.06,8.94,116,658,20,56,136,714,15,26.3,16,"75% or more P.O.C.","$72000 - $96000"
"34005702905","Census Tract 7029.05, Burlington County, New Jersey",4237,110430,3323,400,0,241,0,207,78.4,9.4,0,5.7,0,4.9,21.6,1769,1052,717,59.47,40.53,89,963,18,699,107,1662,8.5,2.5,6,"Less than 25% P.O.C.","$96000 or more"
"34005702906","Census Tract 7029.06, Burlington County, New Jersey",1995,115179,1517,92,0,137,0,200,76,4.6,0,6.9,0,10,24,604,578,26,95.7,4.3,114,464,9,17,123,481,19.7,34.6,20.4,"Less than 25% P.O.C.","$96000 or more"
"34005702907","Census Tract 7029.07, Burlington County, New Jersey",2502,99444,2299,0,0,48,0,110,91.9,0,0,1.9,0,4.4,8.1,1082,1047,35,96.77,3.23,41,1006,17,18,58,1024,3.9,48.6,5.4,"Less than 25% P.O.C.","$96000 or more"
"34005702908","Census Tract 7029.08, Burlington County, New Jersey",4245,74821,3427,185,0,365,0,164,80.7,4.4,0,8.6,0,3.9,19.3,1966,1741,225,88.56,11.44,150,1591,0,225,150,1816,8.6,0,7.6,"Less than 25% P.O.C.","$72000 - $96000"
"34005702909","Census Tract 7029.09, Burlington County, New Jersey",6632,103641,4458,882,0,812,0,280,67.2,13.3,0,12.2,0,4.2,32.8,2469,1922,547,77.85,22.15,156,1766,90,457,246,2223,8.1,16.5,10,"25% - 50% P.O.C.","$96000 or more"
"34005702910","Census Tract 7029.10, Burlington County, New Jersey",5201,131964,4009,434,10,475,0,161,77.1,8.3,0.2,9.1,0,3.1,22.9,2024,1755,269,86.71,13.29,115,1640,36,233,151,1873,6.6,13.4,7.5,"Less than 25% P.O.C.","$96000 or more"
"34005702913","Census Tract 7029.13, Burlington County, New Jersey",4612,67292,2509,811,1,639,0,355,54.4,17.6,0,13.9,0,7.7,45.6,2462,1307,1155,53.09,46.91,37,1270,0,1155,37,2425,2.8,0,1.5,"25% - 50% P.O.C.","$51000 - $72000"
"34005702914","Census Tract 7029.14, Burlington County, New Jersey",4174,111047,2838,371,58,558,0,132,68,8.9,1.4,13.4,0,3.2,32,1470,1271,199,86.46,13.54,113,1158,25,174,138,1332,8.9,12.6,9.4,"25% - 50% P.O.C.","$96000 or more"
"34005702915","Census Tract 7029.15, Burlington County, New Jersey",4175,82297,2364,1128,0,302,0,242,56.6,27,0,7.2,0,5.8,43.4,1795,1112,683,61.95,38.05,43,1069,38,645,81,1714,3.9,5.6,4.5,"25% - 50% P.O.C.","$72000 - $96000"
"34005702917","Census Tract 7029.17, Burlington County, New Jersey",1814,109479,1393,84,0,156,0,120,76.8,4.6,0,8.6,0,6.6,23.2,790,676,114,85.57,14.43,27,649,4,110,31,759,4,3.5,3.9,"Less than 25% P.O.C.","$96000 or more"
"34005702918","Census Tract 7029.18, Burlington County, New Jersey",1835,84511,1102,189,15,289,0,220,60.1,10.3,0.8,15.7,0,12,39.9,871,680,191,78.07,21.93,29,651,0,191,29,842,4.3,0,3.3,"25% - 50% P.O.C.","$72000 - $96000"
"34005703000","Census Tract 7030, Burlington County, New Jersey",6010,108363,5131,238,0,202,0,239,85.4,4,0,3.4,0,4,14.6,2305,2130,175,92.41,7.59,174,1956,0,175,174,2131,8.2,0,7.5,"Less than 25% P.O.C.","$96000 or more"
"34005703102","Census Tract 7031.02, Burlington County, New Jersey",2550,188875,2082,158,0,191,0,22,81.6,6.2,0,7.5,0,0.9,18.4,931,801,130,86.04,13.96,73,728,0,130,73,858,9.1,0,7.8,"Less than 25% P.O.C.","$96000 or more"
"34005703103","Census Tract 7031.03, Burlington County, New Jersey",4664,64594,2318,1245,0,329,0,606,49.7,26.7,0,7.1,0,13,50.3,1925,934,991,48.52,51.48,41,893,62,929,103,1822,4.4,6.3,5.4,"50% - 75% P.O.C.","$51000 - $72000"
"34005703104","Census Tract 7031.04, Burlington County, New Jersey",5018,91136,3467,858,0,315,0,193,69.1,17.1,0,6.3,0,3.8,30.9,1770,1603,167,90.56,9.44,103,1500,10,157,113,1657,6.4,6,6.4,"25% - 50% P.O.C.","$72000 - $96000"
"34005703201","Census Tract 7032.01, Burlington County, New Jersey",3663,67891,3178,92,0,9,0,237,86.8,2.5,0,0.2,0,6.5,13.2,1397,1305,92,93.41,6.59,208,1097,0,92,208,1189,15.9,0,14.9,"Less than 25% P.O.C.","$51000 - $72000"
"34005703202","Census Tract 7032.02, Burlington County, New Jersey",2702,106875,2444,35,0,45,0,178,90.5,1.3,0,1.7,0,6.6,9.5,923,813,110,88.08,11.92,124,689,42,68,166,757,15.3,38.2,18,"Less than 25% P.O.C.","$96000 or more"
"34005703203","Census Tract 7032.03, Burlington County, New Jersey",3789,52734,3505,125,0,0,0,86,92.5,3.3,0,0,0,2.3,7.5,2259,2139,120,94.69,5.31,22,2117,0,120,22,2237,1,0,1,"Less than 25% P.O.C.","$51000 - $72000"
"34005703600","Census Tract 7036, Burlington County, New Jersey",6851,103101,6596,37,0,78,0,38,96.3,0.5,0,1.1,0,0.6,3.7,2465,2340,125,94.93,5.07,226,2114,0,125,226,2239,9.7,0,9.2,"Less than 25% P.O.C.","$96000 or more"
"34005703700","Census Tract 7037, Burlington County, New Jersey",6396,118554,5769,110,0,28,106,177,90.2,1.7,0,0.4,1.7,2.8,9.8,2135,1981,154,92.79,7.21,208,1773,46,108,254,1881,10.5,29.9,11.9,"Less than 25% P.O.C.","$96000 or more"
"34005703801","Census Tract 7038.01, Burlington County, New Jersey",6943,134873,6380,43,0,179,0,177,91.9,0.6,0,2.6,0,2.5,8.1,2574,2182,392,84.77,15.23,147,2035,18,374,165,2409,6.7,4.6,6.4,"Less than 25% P.O.C.","$96000 or more"
"34005703802","Census Tract 7038.02, Burlington County, New Jersey",4702,90213,4034,66,0,174,0,269,85.8,1.4,0,3.7,0,5.7,14.2,1998,1320,678,66.07,33.93,88,1232,32,646,120,1878,6.7,4.7,6,"Less than 25% P.O.C.","$72000 - $96000"
"34005703803","Census Tract 7038.03, Burlington County, New Jersey",5027,118015,4575,25,0,247,0,131,91,0.5,0,4.9,0,2.6,9,1714,1604,110,93.58,6.42,153,1451,4,106,157,1557,9.5,3.6,9.2,"Less than 25% P.O.C.","$96000 or more"
"34005703804","Census Tract 7038.04, Burlington County, New Jersey",6640,146058,6264,102,9,82,0,91,94.3,1.5,0.1,1.2,0,1.4,5.7,2249,2198,51,97.73,2.27,277,1921,0,51,277,1972,12.6,0,12.3,"Less than 25% P.O.C.","$96000 or more"
"34005703900","Census Tract 7039, Burlington County, New Jersey",3984,110792,3818,9,0,0,0,137,95.8,0.2,0,0,0,3.4,4.2,1465,1392,73,95.02,4.98,136,1256,0,73,136,1329,9.8,0,9.3,"Less than 25% P.O.C.","$96000 or more"
"34005704004","Census Tract 7040.04, Burlington County, New Jersey",3555,78319,2705,215,0,194,0,387,76.1,6,0,5.5,0,10.9,23.9,1595,827,768,51.85,48.15,78,749,0,768,78,1517,9.4,0,4.9,"Less than 25% P.O.C.","$72000 - $96000"
"34005704005","Census Tract 7040.05, Burlington County, New Jersey",3785,87316,3223,114,0,265,0,124,85.2,3,0,7,0,3.3,14.8,1523,1054,469,69.21,30.79,86,968,11,458,97,1426,8.2,2.3,6.4,"Less than 25% P.O.C.","$72000 - $96000"
"34005704006","Census Tract 7040.06, Burlington County, New Jersey",2232,94931,1548,141,0,248,0,137,69.4,6.3,0,11.1,0,6.1,30.6,895,724,171,80.89,19.11,75,649,22,149,97,798,10.4,12.9,10.8,"25% - 50% P.O.C.","$72000 - $96000"
"34005704007","Census Tract 7040.07, Burlington County, New Jersey",3500,63563,3188,47,0,100,0,138,91.1,1.3,0,2.9,0,3.9,8.9,1424,911,513,63.97,36.03,68,843,18,495,86,1338,7.5,3.5,6,"Less than 25% P.O.C.","$51000 - $72000"
"34005704008","Census Tract 7040.08, Burlington County, New Jersey",5048,111094,4354,302,0,124,0,165,86.3,6,0,2.5,0,3.3,13.7,1961,1449,512,73.89,26.11,145,1304,0,512,145,1816,10,0,7.4,"Less than 25% P.O.C.","$96000 or more"
"34005704009","Census Tract 7040.09, Burlington County, New Jersey",4709,93894,3416,823,0,234,0,195,72.5,17.5,0,5,0,4.1,27.5,1908,1120,788,58.7,41.3,194,926,9,779,203,1705,17.3,1.1,10.6,"25% - 50% P.O.C.","$72000 - $96000"
"34005704011","Census Tract 7040.11, Burlington County, New Jersey",3083,124315,2657,76,0,208,0,121,86.2,2.5,0,6.7,0,3.9,13.8,1061,1048,13,98.77,1.23,101,947,0,13,101,960,9.6,0,9.5,"Less than 25% P.O.C.","$96000 or more"
"34005704012","Census Tract 7040.12, Burlington County, New Jersey",5913,96859,5082,77,0,108,0,447,85.9,1.3,0,1.8,0,7.6,14.1,2407,2101,306,87.29,12.71,126,1975,0,306,126,2281,6,0,5.2,"Less than 25% P.O.C.","$96000 or more"
"34005704013","Census Tract 7040.13, Burlington County, New Jersey",5148,120658,4067,161,0,418,0,337,79,3.1,0,8.1,0,6.5,21,1712,1671,41,97.61,2.39,202,1469,0,41,202,1510,12.1,0,11.8,"Less than 25% P.O.C.","$96000 or more"
"34005704014","Census Tract 7040.14, Burlington County, New Jersey",8162,123615,6416,547,0,808,0,260,78.6,6.7,0,9.9,0,3.2,21.4,3138,2476,662,78.9,21.1,258,2218,0,662,258,2880,10.4,0,8.2,"Less than 25% P.O.C.","$96000 or more"
"34005704200","Census Tract 7042, Burlington County, New Jersey",8627,103151,5703,1023,0,796,0,825,66.1,11.9,0,9.2,0,9.6,33.9,3132,2527,605,80.68,19.32,276,2251,12,593,288,2844,10.9,2,9.2,"25% - 50% P.O.C.","$96000 or more"
"34005704302","Census Tract 7043.02, Burlington County, New Jersey",5683,146719,3840,226,0,1111,0,407,67.6,4,0,19.5,0,7.2,32.4,1726,1584,142,91.77,8.23,177,1407,0,142,177,1549,11.2,0,10.3,"25% - 50% P.O.C.","$96000 or more"
"34005704500","Census Tract 7045, Burlington County, New Jersey",3931,56963,2809,247,19,64,0,530,71.5,6.3,0.5,1.6,0,13.5,28.5,1594,1078,516,67.63,32.37,68,1010,22,494,90,1504,6.3,4.3,5.6,"25% - 50% P.O.C.","$51000 - $72000"
"34005704600","Census Tract 7046, Burlington County, New Jersey",2781,70278,1093,830,0,0,0,687,39.3,29.8,0,0,0,24.7,60.7,990,523,467,52.83,47.17,80,443,48,419,128,862,15.3,10.3,12.9,"50% - 75% P.O.C.","$51000 - $72000"
"34005704700","Census Tract 7047, Burlington County, New Jersey",3834,78264,3350,60,0,24,0,280,87.4,1.6,0,0.6,0,7.3,12.6,1351,1089,262,80.61,19.39,119,970,17,245,136,1215,10.9,6.5,10.1,"Less than 25% P.O.C.","$72000 - $96000"
"34005704801","Census Tract 7048.01, Burlington County, New Jersey",3248,69417,1762,451,0,34,0,667,54.2,13.9,0,1,0,20.5,45.8,1016,318,698,31.3,68.7,18,300,105,593,123,893,5.7,15,12.1,"25% - 50% P.O.C.","$51000 - $72000"
"34005704802","Census Tract 7048.02, Burlington County, New Jersey",5363,92147,1912,1857,0,116,0,1257,35.7,34.6,0,2.2,0,23.4,64.3,231,5,226,2.16,97.84,0,5,39,187,39,192,0,17.3,16.9,"50% - 75% P.O.C.","$72000 - $96000"
"34005981802","Census Tract 9818.02, Burlington County, New Jersey",1823,158750,299,1215,0,10,0,299,16.4,66.6,0,0.5,0,16.4,83.6,12,12,0,100,0,0,12,0,0,0,12,0,NA,0,"75% or more P.O.C.","$96000 or more"
"34005982111","Census Tract 9821.11, Burlington County, New Jersey",853,67813,484,60,0,20,0,259,56.7,7,0,2.3,0,30.4,43.3,111,0,111,0,100,0,0,33,78,33,78,NA,29.7,29.7,"25% - 50% P.O.C.","$51000 - $72000"
"34007600200","Census Tract 6002, Camden County, New Jersey",2085,25801,20,1278,0,0,0,711,1,61.3,0,0,0,34.1,99,733,370,363,50.48,49.52,75,295,15,348,90,643,20.3,4.1,12.3,"75% or more P.O.C.","Less than $51000"
"34007600400","Census Tract 6004, Camden County, New Jersey",3451,19576,108,1473,0,69,0,1796,3.1,42.7,0,2,0,52,96.9,1051,367,684,34.92,65.08,12,355,172,512,184,867,3.3,25.1,17.5,"75% or more P.O.C.","Less than $51000"
"34007600700","Census Tract 6007, Camden County, New Jersey",1482,26667,147,288,0,0,0,1047,9.9,19.4,0,0,0,70.6,90.1,472,141,331,29.87,70.13,11,130,50,281,61,411,7.8,15.1,12.9,"75% or more P.O.C.","Less than $51000"
"34007600800","Census Tract 6008, Camden County, New Jersey",5282,19923,156,1458,0,6,0,3662,3,27.6,0,0.1,0,69.3,97,1662,357,1305,21.48,78.52,60,297,191,1114,251,1411,16.8,14.6,15.1,"75% or more P.O.C.","Less than $51000"
"34007600900","Census Tract 6009, Camden County, New Jersey",4358,23765,393,703,0,150,0,3031,9,16.1,0,3.4,0,69.6,91,1304,279,1025,21.4,78.6,34,245,233,792,267,1037,12.2,22.7,20.5,"75% or more P.O.C.","Less than $51000"
"34007601000","Census Tract 6010, Camden County, New Jersey",6286,40200,211,585,0,16,0,5433,3.4,9.3,0,0.3,0,86.4,96.6,1793,1004,789,56,44,215,789,245,544,460,1333,21.4,31.1,25.7,"75% or more P.O.C.","Less than $51000"
"34007601101","Census Tract 6011.01, Camden County, New Jersey",3273,36297,108,603,0,108,0,2414,3.3,18.4,0,3.3,0,73.8,96.7,889,342,547,38.47,61.53,70,272,108,439,178,711,20.5,19.7,20,"75% or more P.O.C.","Less than $51000"
"34007601102","Census Tract 6011.02, Camden County, New Jersey",5181,35689,135,876,0,696,0,3322,2.6,16.9,0,13.4,0,64.1,97.4,1623,798,825,49.17,50.83,198,600,39,786,237,1386,24.8,4.7,14.6,"75% or more P.O.C.","Less than $51000"
"34007601200","Census Tract 6012, Camden County, New Jersey",6156,41440,287,2300,0,162,0,3347,4.7,37.4,0,2.6,0,54.4,95.3,1955,1252,703,64.04,35.96,125,1127,167,536,292,1663,10,23.8,14.9,"75% or more P.O.C.","Less than $51000"
"34007601300","Census Tract 6013, Camden County, New Jersey",4288,21370,209,1367,0,194,0,2518,4.9,31.9,0,4.5,0,58.7,95.1,1597,602,995,37.7,62.3,54,548,99,896,153,1444,9,9.9,9.6,"75% or more P.O.C.","Less than $51000"
"34007601400","Census Tract 6014, Camden County, New Jersey",4766,34752,261,3488,34,7,39,768,5.5,73.2,0.7,0.1,0.8,16.1,94.5,1549,728,821,47,53,64,664,185,636,249,1300,8.8,22.5,16.1,"75% or more P.O.C.","Less than $51000"
"34007601500","Census Tract 6015, Camden County, New Jersey",4921,19422,233,2932,0,0,0,1730,4.7,59.6,0,0,0,35.2,95.3,2009,641,1368,31.91,68.09,69,572,63,1305,132,1877,10.8,4.6,6.6,"75% or more P.O.C.","Less than $51000"
"34007601600","Census Tract 6016, Camden County, New Jersey",2644,24919,63,1558,64,20,0,832,2.4,58.9,2.4,0.8,0,31.5,97.6,908,248,660,27.31,72.69,17,231,97,563,114,794,6.9,14.7,12.6,"75% or more P.O.C.","Less than $51000"
"34007601700","Census Tract 6017, Camden County, New Jersey",2855,18969,61,1544,0,0,0,1057,2.1,54.1,0,0,0,37,97.9,1231,140,1091,11.37,88.63,0,140,18,1073,18,1213,0,1.6,1.5,"75% or more P.O.C.","Less than $51000"
"34007601800","Census Tract 6018, Camden County, New Jersey",1082,23520,62,442,0,54,0,524,5.7,40.9,0,5,0,48.4,94.3,448,228,220,50.89,49.11,42,186,15,205,57,391,18.4,6.8,12.7,"75% or more P.O.C.","Less than $51000"
"34007601900","Census Tract 6019, Camden County, New Jersey",2913,27214,14,1542,0,30,0,1327,0.5,52.9,0,1,0,45.6,99.5,1095,407,688,37.17,62.83,34,373,38,650,72,1023,8.4,5.5,6.6,"75% or more P.O.C.","Less than $51000"
"34007602000","Census Tract 6020, Camden County, New Jersey",6106,31750,698,3213,0,0,0,2195,11.4,52.6,0,0,0,35.9,88.6,2211,1016,1195,45.95,54.05,101,915,168,1027,269,1942,9.9,14.1,12.2,"75% or more P.O.C.","Less than $51000"
"34007602503","Census Tract 6025.03, Camden County, New Jersey",2421,64231,380,932,0,112,0,913,15.7,38.5,0,4.6,0,37.7,84.3,798,669,129,83.83,16.17,61,608,21,108,82,716,9.1,16.3,10.3,"75% or more P.O.C.","$51000 - $72000"
"34007602601","Census Tract 6026.01, Camden County, New Jersey",2654,70220,1029,447,0,452,0,685,38.8,16.8,0,17,0,25.8,61.2,919,803,116,87.38,12.62,101,702,35,81,136,783,12.6,30.2,14.8,"50% - 75% P.O.C.","$51000 - $72000"
"34007602602","Census Tract 6026.02, Camden County, New Jersey",2924,60039,538,678,0,344,0,1301,18.4,23.2,0,11.8,0,44.5,81.6,1056,712,344,67.42,32.58,88,624,22,322,110,946,12.4,6.4,10.4,"75% or more P.O.C.","$51000 - $72000"
"34007602901","Census Tract 6029.01, Camden County, New Jersey",4351,79578,2514,611,0,67,0,993,57.8,14,0,1.5,0,22.8,42.2,1761,1514,247,85.97,14.03,98,1416,13,234,111,1650,6.5,5.3,6.3,"25% - 50% P.O.C.","$72000 - $96000"
"34007602902","Census Tract 6029.02, Camden County, New Jersey",3402,57083,1540,790,0,65,0,949,45.3,23.2,0,1.9,0,27.9,54.7,1195,777,418,65.02,34.98,189,588,0,418,189,1006,24.3,0,15.8,"50% - 75% P.O.C.","$51000 - $72000"
"34007603001","Census Tract 6030.01, Camden County, New Jersey",3702,71607,2146,630,8,49,15,729,58,17,0.2,1.3,0.4,19.7,42,1346,1151,195,85.51,14.49,66,1085,23,172,89,1257,5.7,11.8,6.6,"25% - 50% P.O.C.","$51000 - $72000"
"34007603002","Census Tract 6030.02, Camden County, New Jersey",4880,70513,693,1020,0,642,0,2378,14.2,20.9,0,13.2,0,48.7,85.8,1562,1285,277,82.27,17.73,171,1114,31,246,202,1360,13.3,11.2,12.9,"75% or more P.O.C.","$51000 - $72000"
"34007603100","Census Tract 6031, Camden County, New Jersey",3719,81295,2385,461,0,205,0,661,64.1,12.4,0,5.5,0,17.8,35.9,1413,904,509,63.98,36.02,155,749,11,498,166,1247,17.1,2.2,11.7,"25% - 50% P.O.C.","$72000 - $96000"
"34007603200","Census Tract 6032, Camden County, New Jersey",6636,71411,4630,598,0,522,0,720,69.8,9,0,7.9,0,10.8,30.2,2573,1725,848,67.04,32.96,252,1473,36,812,288,2285,14.6,4.2,11.2,"25% - 50% P.O.C.","$51000 - $72000"
"34007603301","Census Tract 6033.01, Camden County, New Jersey",5752,78404,3458,289,0,1003,0,592,60.1,5,0,17.4,0,10.3,39.9,2272,1290,982,56.78,43.22,101,1189,0,982,101,2171,7.8,0,4.4,"25% - 50% P.O.C.","$72000 - $96000"
"34007603302","Census Tract 6033.02, Camden County, New Jersey",6337,103203,4229,472,0,971,0,527,66.7,7.4,0,15.3,0,8.3,33.3,2227,1831,396,82.22,17.78,251,1580,25,371,276,1951,13.7,6.3,12.4,"25% - 50% P.O.C.","$96000 or more"
"34007603303","Census Tract 6033.03, Camden County, New Jersey",2876,62355,2196,67,0,408,0,94,76.4,2.3,0,14.2,0,3.3,23.6,1391,597,794,42.92,57.08,49,548,33,761,82,1309,8.2,4.2,5.9,"Less than 25% P.O.C.","$51000 - $72000"
"34007603400","Census Tract 6034, Camden County, New Jersey",7313,78432,4694,889,0,1275,0,363,64.2,12.2,0,17.4,0,5,35.8,2809,1944,865,69.21,30.79,141,1803,155,710,296,2513,7.3,17.9,10.5,"25% - 50% P.O.C.","$72000 - $96000"
"34007603501","Census Tract 6035.01, Camden County, New Jersey",6440,145707,4627,77,0,1257,0,381,71.8,1.2,0,19.5,0,5.9,28.2,2361,1854,507,78.53,21.47,196,1658,0,507,196,2165,10.6,0,8.3,"25% - 50% P.O.C.","$96000 or more"
"34007603503","Census Tract 6035.03, Camden County, New Jersey",4577,150078,3714,129,0,564,0,65,81.1,2.8,0,12.3,0,1.4,18.9,1590,1582,8,99.5,0.5,174,1408,0,8,174,1416,11,0,10.9,"Less than 25% P.O.C.","$96000 or more"
"34007603504","Census Tract 6035.04, Camden County, New Jersey",2611,118816,1963,35,0,306,0,279,75.2,1.3,0,11.7,0,10.7,24.8,920,856,64,93.04,6.96,81,775,7,57,88,832,9.5,10.9,9.6,"Less than 25% P.O.C.","$96000 or more"
"34007603505","Census Tract 6035.05, Camden County, New Jersey",3625,114441,2288,448,0,555,0,206,63.1,12.4,0,15.3,0,5.7,36.9,1195,1131,64,94.64,5.36,107,1024,24,40,131,1064,9.5,37.5,11,"25% - 50% P.O.C.","$96000 or more"
"34007603506","Census Tract 6035.06, Camden County, New Jersey",6020,140026,4243,202,0,1063,0,281,70.5,3.4,0,17.7,0,4.7,29.5,2117,2051,66,96.88,3.12,160,1891,0,66,160,1957,7.8,0,7.6,"25% - 50% P.O.C.","$96000 or more"
"34007603507","Census Tract 6035.07, Camden County, New Jersey",6761,147670,4663,435,0,1051,0,337,69,6.4,0,15.5,0,5,31,2657,2106,551,79.26,20.74,135,1971,0,551,135,2522,6.4,0,5.1,"25% - 50% P.O.C.","$96000 or more"
"34007603601","Census Tract 6036.01, Camden County, New Jersey",3540,94205,2731,280,4,235,0,244,77.1,7.9,0.1,6.6,0,6.9,22.9,1405,1270,135,90.39,9.61,104,1166,0,135,104,1301,8.2,0,7.4,"Less than 25% P.O.C.","$72000 - $96000"
"34007603602","Census Tract 6036.02, Camden County, New Jersey",2454,167778,2130,12,0,97,0,169,86.8,0.5,0,4,0,6.9,13.2,852,828,24,97.18,2.82,93,735,0,24,93,759,11.2,0,10.9,"Less than 25% P.O.C.","$96000 or more"
"34007603603","Census Tract 6036.03, Camden County, New Jersey",2354,130750,2070,16,0,151,0,85,87.9,0.7,0,6.4,0,3.6,12.1,823,798,25,96.96,3.04,74,724,0,25,74,749,9.3,0,9,"Less than 25% P.O.C.","$96000 or more"
"34007603700","Census Tract 6037, Camden County, New Jersey",3669,85616,2498,496,0,178,0,435,68.1,13.5,0,4.9,0,11.9,31.9,1497,969,528,64.73,35.27,49,920,6,522,55,1442,5.1,1.1,3.7,"25% - 50% P.O.C.","$72000 - $96000"
"34007603800","Census Tract 6038, Camden County, New Jersey",4963,110417,4627,67,0,35,0,179,93.2,1.3,0,0.7,0,3.6,6.8,1829,1618,211,88.46,11.54,142,1476,0,211,142,1687,8.8,0,7.8,"Less than 25% P.O.C.","$96000 or more"
"34007603901","Census Tract 6039.01, Camden County, New Jersey",5310,89526,4850,55,0,0,0,256,91.3,1,0,0,0,4.8,8.7,2222,1544,678,69.49,30.51,137,1407,19,659,156,2066,8.9,2.8,7,"Less than 25% P.O.C.","$72000 - $96000"
"34007603902","Census Tract 6039.02, Camden County, New Jersey",2668,87222,2293,281,0,0,0,94,85.9,10.5,0,0,0,3.5,14.1,1282,631,651,49.22,50.78,34,597,0,651,34,1248,5.4,0,2.7,"Less than 25% P.O.C.","$72000 - $96000"
"34007604100","Census Tract 6041, Camden County, New Jersey",2920,48786,360,1031,0,266,0,1224,12.3,35.3,0,9.1,0,41.9,87.7,818,478,340,58.44,41.56,127,351,68,272,195,623,26.6,20,23.8,"75% or more P.O.C.","Less than $51000"
"34007604200","Census Tract 6042, Camden County, New Jersey",3438,85640,2653,325,0,48,0,324,77.2,9.5,0,1.4,0,9.4,22.8,1426,678,748,47.55,52.45,32,646,21,727,53,1373,4.7,2.8,3.7,"Less than 25% P.O.C.","$72000 - $96000"
"34007604300","Census Tract 6043, Camden County, New Jersey",3828,98000,3300,210,0,22,0,219,86.2,5.5,0,0.6,0,5.7,13.8,1672,1090,582,65.19,34.81,65,1025,0,582,65,1607,6,0,3.9,"Less than 25% P.O.C.","$96000 or more"
"34007604400","Census Tract 6044, Camden County, New Jersey",3222,120893,2678,32,0,171,0,263,83.1,1,0,5.3,0,8.2,16.9,1285,978,307,76.11,23.89,103,875,0,307,103,1182,10.5,0,8,"Less than 25% P.O.C.","$96000 or more"
"34007604600","Census Tract 6046, Camden County, New Jersey",2090,66625,1632,149,0,29,0,174,78.1,7.1,0,1.4,0,8.3,21.9,961,530,431,55.15,44.85,10,520,12,419,22,939,1.9,2.8,2.3,"Less than 25% P.O.C.","$51000 - $72000"
"34007604700","Census Tract 6047, Camden County, New Jersey",1874,88170,1771,0,0,52,0,51,94.5,0,0,2.8,0,2.7,5.5,713,619,94,86.82,13.18,34,585,4,90,38,675,5.5,4.3,5.3,"Less than 25% P.O.C.","$72000 - $96000"
"34007605100","Census Tract 6051, Camden County, New Jersey",2122,64179,2001,19,0,18,0,84,94.3,0.9,0,0.8,0,4,5.7,827,679,148,82.1,17.9,52,627,23,125,75,752,7.7,15.5,9.1,"Less than 25% P.O.C.","$51000 - $72000"
"34007605200","Census Tract 6052, Camden County, New Jersey",2779,67000,2024,88,21,214,0,432,72.8,3.2,0.8,7.7,0,15.5,27.2,932,754,178,80.9,19.1,134,620,60,118,194,738,17.8,33.7,20.8,"25% - 50% P.O.C.","$51000 - $72000"
"34007605300","Census Tract 6053, Camden County, New Jersey",2004,66797,1573,117,0,119,0,167,78.5,5.8,0,5.9,0,8.3,21.5,676,490,186,72.49,27.51,47,443,24,162,71,605,9.6,12.9,10.5,"Less than 25% P.O.C.","$51000 - $72000"
"34007605400","Census Tract 6054, Camden County, New Jersey",2642,63939,2529,34,0,0,0,63,95.7,1.3,0,0,0,2.4,4.3,1032,733,299,71.03,28.97,61,672,43,256,104,928,8.3,14.4,10.1,"Less than 25% P.O.C.","$51000 - $72000"
"34007605602","Census Tract 6056.02, Camden County, New Jersey",2963,97537,2654,154,0,0,0,116,89.6,5.2,0,0,0,3.9,10.4,1051,728,323,69.27,30.73,148,580,0,323,148,903,20.3,0,14.1,"Less than 25% P.O.C.","$96000 or more"
"34007605700","Census Tract 6057, Camden County, New Jersey",3255,85699,2902,248,0,0,0,47,89.2,7.6,0,0,0,1.4,10.8,1312,949,363,72.33,27.67,76,873,35,328,111,1201,8,9.6,8.5,"Less than 25% P.O.C.","$72000 - $96000"
"34007605800","Census Tract 6058, Camden County, New Jersey",2803,102800,2701,36,0,27,0,20,96.4,1.3,0,1,0,0.7,3.6,1094,989,105,90.4,9.6,76,913,0,105,76,1018,7.7,0,6.9,"Less than 25% P.O.C.","$96000 or more"
"34007605900","Census Tract 6059, Camden County, New Jersey",2774,116574,2505,3,0,55,0,135,90.3,0.1,0,2,0,4.9,9.7,996,846,150,84.94,15.06,95,751,6,144,101,895,11.2,4,10.1,"Less than 25% P.O.C.","$96000 or more"
"34007606000","Census Tract 6060, Camden County, New Jersey",1937,81763,1839,51,0,28,0,19,94.9,2.6,0,1.4,0,1,5.1,851,549,302,64.51,35.49,61,488,5,297,66,785,11.1,1.7,7.8,"Less than 25% P.O.C.","$72000 - $96000"
"34007606100","Census Tract 6061, Camden County, New Jersey",2308,168438,2169,0,0,15,0,124,94,0,0,0.6,0,5.4,6,772,654,118,84.72,15.28,100,554,0,118,100,672,15.3,0,13,"Less than 25% P.O.C.","$96000 or more"
"34007606200","Census Tract 6062, Camden County, New Jersey",3747,135076,3520,46,0,99,0,28,93.9,1.2,0,2.6,0,0.7,6.1,1434,1265,169,88.21,11.79,107,1158,0,169,107,1327,8.5,0,7.5,"Less than 25% P.O.C.","$96000 or more"
"34007606300","Census Tract 6063, Camden County, New Jersey",2330,115714,2105,63,0,60,0,30,90.3,2.7,0,2.6,0,1.3,9.7,916,648,268,70.74,29.26,63,585,16,252,79,837,9.7,6,8.6,"Less than 25% P.O.C.","$96000 or more"
"34007606400","Census Tract 6064, Camden County, New Jersey",2962,225000,2708,0,0,42,0,196,91.4,0,0,1.4,0,6.6,8.6,996,937,59,94.08,5.92,149,788,0,59,149,847,15.9,0,15,"Less than 25% P.O.C.","$96000 or more"
"34007606500","Census Tract 6065, Camden County, New Jersey",2885,65273,159,2320,0,14,0,256,5.5,80.4,0,0.5,0,8.9,94.5,1159,716,443,61.78,38.22,67,649,51,392,118,1041,9.4,11.5,10.2,"75% or more P.O.C.","$51000 - $72000"
"34007606600","Census Tract 6066, Camden County, New Jersey",2412,85692,2260,0,0,8,0,113,93.7,0,0,0.3,0,4.7,6.3,1010,659,351,65.25,34.75,90,569,0,351,90,920,13.7,0,8.9,"Less than 25% P.O.C.","$72000 - $96000"
"34007606700","Census Tract 6067, Camden County, New Jersey",4304,75833,3659,200,0,78,0,220,85,4.6,0,1.8,0,5.1,15,1864,1049,815,56.28,43.72,79,970,23,792,102,1762,7.5,2.8,5.5,"Less than 25% P.O.C.","$72000 - $96000"
"34007606800","Census Tract 6068, Camden County, New Jersey",3919,75132,2771,29,0,772,0,309,70.7,0.7,0,19.7,0,7.9,29.3,1400,1196,204,85.43,14.57,120,1076,0,204,120,1280,10,0,8.6,"25% - 50% P.O.C.","$72000 - $96000"
"34007607000","Census Tract 6070, Camden County, New Jersey",4494,51875,3534,126,0,270,0,483,78.6,2.8,0,6,0,10.7,21.4,1784,857,927,48.04,51.96,86,771,80,847,166,1618,10,8.6,9.3,"Less than 25% P.O.C.","$51000 - $72000"
"34007607100","Census Tract 6071, Camden County, New Jersey",3845,76146,3177,159,0,202,0,307,82.6,4.1,0,5.3,0,8,17.4,1380,1155,225,83.7,16.3,132,1023,33,192,165,1215,11.4,14.7,12,"Less than 25% P.O.C.","$72000 - $96000"
"34007607200","Census Tract 6072, Camden County, New Jersey",4482,61979,2953,613,0,164,0,709,65.9,13.7,0,3.7,0,15.8,34.1,1778,1011,767,56.86,43.14,120,891,26,741,146,1632,11.9,3.4,8.2,"25% - 50% P.O.C.","$51000 - $72000"
"34007607300","Census Tract 6073, Camden County, New Jersey",4272,60000,2831,721,0,184,0,484,66.3,16.9,0,4.3,0,11.3,33.7,1680,1088,592,64.76,35.24,62,1026,90,502,152,1528,5.7,15.2,9,"25% - 50% P.O.C.","$51000 - $72000"
"34007607401","Census Tract 6074.01, Camden County, New Jersey",2622,60357,1725,417,0,31,0,347,65.8,15.9,0,1.2,0,13.2,34.2,1182,801,381,67.77,32.23,20,781,10,371,30,1152,2.5,2.6,2.5,"25% - 50% P.O.C.","$51000 - $72000"
"34007607402","Census Tract 6074.02, Camden County, New Jersey",2826,74848,1363,932,0,91,0,324,48.2,33,0,3.2,0,11.5,51.8,1054,804,250,76.28,23.72,73,731,5,245,78,976,9.1,2,7.4,"50% - 75% P.O.C.","$72000 - $96000"
"34007607502","Census Tract 6075.02, Camden County, New Jersey",5491,113319,3996,412,147,661,0,233,72.8,7.5,2.7,12,0,4.2,27.2,2043,1790,253,87.62,12.38,99,1691,0,253,99,1944,5.5,0,4.8,"25% - 50% P.O.C.","$96000 or more"
"34007607503","Census Tract 6075.03, Camden County, New Jersey",6493,103806,4285,327,0,1392,0,178,66,5,0,21.4,0,2.7,34,2182,1709,473,78.32,21.68,292,1417,10,463,302,1880,17.1,2.1,13.8,"25% - 50% P.O.C.","$96000 or more"
"34007607504","Census Tract 6075.04, Camden County, New Jersey",3531,184750,2892,98,0,368,0,120,81.9,2.8,0,10.4,0,3.4,18.1,1152,1131,21,98.18,1.82,132,999,0,21,132,1020,11.7,0,11.5,"Less than 25% P.O.C.","$96000 or more"
"34007607505","Census Tract 6075.05, Camden County, New Jersey",4131,144414,3159,108,0,684,0,32,76.5,2.6,0,16.6,0,0.8,23.5,1381,1332,49,96.45,3.55,161,1171,0,49,161,1220,12.1,0,11.7,"Less than 25% P.O.C.","$96000 or more"
"34007607506","Census Tract 6075.06, Camden County, New Jersey",3618,90486,1026,947,0,1182,0,197,28.4,26.2,0,32.7,0,5.4,71.6,1342,625,717,46.57,53.43,54,571,55,662,109,1233,8.6,7.7,8.1,"50% - 75% P.O.C.","$72000 - $96000"
"34007607507","Census Tract 6075.07, Camden County, New Jersey",5948,58457,2650,932,0,1417,0,634,44.6,15.7,0,23.8,0,10.7,55.4,2914,763,2151,26.18,73.82,138,625,77,2074,215,2699,18.1,3.6,7.4,"50% - 75% P.O.C.","$51000 - $72000"
"34007607600","Census Tract 6076, Camden County, New Jersey",2169,85438,1906,31,0,47,0,151,87.9,1.4,0,2.2,0,7,12.1,763,730,33,95.67,4.33,88,642,16,17,104,659,12.1,48.5,13.6,"Less than 25% P.O.C.","$72000 - $96000"
"34007607701","Census Tract 6077.01, Camden County, New Jersey",5809,30351,1041,2367,0,0,0,2138,17.9,40.7,0,0,0,36.8,82.1,2410,566,1844,23.49,76.51,75,491,34,1810,109,2301,13.3,1.8,4.5,"75% or more P.O.C.","Less than $51000"
"34007607702","Census Tract 6077.02, Camden County, New Jersey",3942,53851,1959,1072,0,68,0,684,49.7,27.2,0,1.7,0,17.4,50.3,1594,746,848,46.8,53.2,81,665,9,839,90,1504,10.9,1.1,5.6,"50% - 75% P.O.C.","$51000 - $72000"
"34007607801","Census Tract 6078.01, Camden County, New Jersey",5221,44784,1675,2015,0,217,0,1031,32.1,38.6,0,4.2,0,19.7,67.9,2656,1053,1603,39.65,60.35,60,993,28,1575,88,2568,5.7,1.7,3.3,"50% - 75% P.O.C.","Less than $51000"
"34007607802","Census Tract 6078.02, Camden County, New Jersey",2348,66855,1402,517,31,19,0,307,59.7,22,1.3,0.8,0,13.1,40.3,930,669,261,71.94,28.06,27,642,39,222,66,864,4,14.9,7.1,"25% - 50% P.O.C.","$51000 - $72000"
"34007607900","Census Tract 6079, Camden County, New Jersey",1959,89375,1750,55,0,38,0,56,89.3,2.8,0,1.9,0,2.9,10.7,696,573,123,82.33,17.67,87,486,6,117,93,603,15.2,4.9,13.4,"Less than 25% P.O.C.","$72000 - $96000"
"34007608001","Census Tract 6080.01, Camden County, New Jersey",3455,61324,2137,635,0,286,0,297,61.9,18.4,0,8.3,0,8.6,38.1,1330,864,466,64.96,35.04,106,758,11,455,117,1213,12.3,2.4,8.8,"25% - 50% P.O.C.","$51000 - $72000"
"34007608202","Census Tract 6082.02, Camden County, New Jersey",3720,88167,2866,383,0,80,0,264,77,10.3,0,2.2,0,7.1,23,1336,1145,191,85.7,14.3,129,1016,15,176,144,1192,11.3,7.9,10.8,"Less than 25% P.O.C.","$72000 - $96000"
"34007608205","Census Tract 6082.05, Camden County, New Jersey",3723,101929,3502,125,0,23,0,61,94.1,3.4,0,0.6,0,1.6,5.9,1315,1279,36,97.26,2.74,103,1176,0,36,103,1212,8.1,0,7.8,"Less than 25% P.O.C.","$96000 or more"
"34007608206","Census Tract 6082.06, Camden County, New Jersey",3607,92214,2744,294,7,25,0,410,76.1,8.2,0.2,0.7,0,11.4,23.9,1258,1083,175,86.09,13.91,74,1009,73,102,147,1111,6.8,41.7,11.7,"Less than 25% P.O.C.","$72000 - $96000"
"34007608209","Census Tract 6082.09, Camden County, New Jersey",3262,69613,2245,704,0,159,0,92,68.8,21.6,0,4.9,0,2.8,31.2,1389,859,530,61.84,38.16,48,811,19,511,67,1322,5.6,3.6,4.8,"25% - 50% P.O.C.","$51000 - $72000"
"34007608210","Census Tract 6082.10, Camden County, New Jersey",3637,47617,1632,1064,0,162,0,598,44.9,29.3,0,4.5,0,16.4,55.1,1547,401,1146,25.92,74.08,41,360,82,1064,123,1424,10.2,7.2,8,"50% - 75% P.O.C.","Less than $51000"
"34007608211","Census Tract 6082.11, Camden County, New Jersey",5836,68214,2827,1575,0,399,20,812,48.4,27,0,6.8,0.3,13.9,51.6,2158,1484,674,68.77,31.23,132,1352,111,563,243,1915,8.9,16.5,11.3,"50% - 75% P.O.C.","$51000 - $72000"
"34007608302","Census Tract 6083.02, Camden County, New Jersey",4545,62536,3751,307,0,0,0,284,82.5,6.8,0,0,0,6.2,17.5,1979,978,1001,49.42,50.58,129,849,39,962,168,1811,13.2,3.9,8.5,"Less than 25% P.O.C.","$51000 - $72000"
"34007608303","Census Tract 6083.03, Camden County, New Jersey",2891,53581,2175,447,0,7,0,163,75.2,15.5,0,0.2,0,5.6,24.8,1018,593,425,58.25,41.75,54,539,69,356,123,895,9.1,16.2,12.1,"Less than 25% P.O.C.","$51000 - $72000"
"34007608304","Census Tract 6083.04, Camden County, New Jersey",6277,68846,4750,724,13,203,0,571,75.7,11.5,0.2,3.2,0,9.1,24.3,2660,1919,741,72.14,27.86,127,1792,75,666,202,2458,6.6,10.1,7.6,"Less than 25% P.O.C.","$51000 - $72000"
"34007608401","Census Tract 6084.01, Camden County, New Jersey",3999,95568,3186,361,0,123,0,240,79.7,9,0,3.1,0,6,20.3,1236,1191,45,96.36,3.64,219,972,25,20,244,992,18.4,55.6,19.7,"Less than 25% P.O.C.","$72000 - $96000"
"34007608402","Census Tract 6084.02, Camden County, New Jersey",3882,100167,2622,625,0,216,0,278,67.5,16.1,0,5.6,0,7.2,32.5,1292,1241,51,96.05,3.95,207,1034,0,51,207,1085,16.7,0,16,"25% - 50% P.O.C.","$96000 or more"
"34007608403","Census Tract 6084.03, Camden County, New Jersey",7490,125369,3977,2335,0,242,0,505,53.1,31.2,0,3.2,0,6.7,46.9,2242,1914,328,85.37,14.63,330,1584,79,249,409,1833,17.2,24.1,18.2,"25% - 50% P.O.C.","$96000 or more"
"34007608404","Census Tract 6084.04, Camden County, New Jersey",6673,95854,4106,1658,0,260,0,451,61.5,24.8,0,3.9,0,6.8,38.5,2340,1949,391,83.29,16.71,269,1680,93,298,362,1978,13.8,23.8,15.5,"25% - 50% P.O.C.","$72000 - $96000"
"34007608503","Census Tract 6085.03, Camden County, New Jersey",2945,51373,1224,1345,0,45,0,149,41.6,45.7,0,1.5,0,5.1,58.4,1244,579,665,46.54,53.46,73,506,0,665,73,1171,12.6,0,5.9,"50% - 75% P.O.C.","$51000 - $72000"
"34007608504","Census Tract 6085.04, Camden County, New Jersey",3244,39870,1505,1071,0,82,0,464,46.4,33,0,2.5,0,14.3,53.6,1596,639,957,40.04,59.96,30,609,30,927,60,1536,4.7,3.1,3.8,"50% - 75% P.O.C.","Less than $51000"
"34007608600","Census Tract 6086, Camden County, New Jersey",4918,53281,2253,1743,12,97,0,683,45.8,35.4,0.2,2,0,13.9,54.2,1831,970,861,52.98,47.02,99,871,33,828,132,1699,10.2,3.8,7.2,"50% - 75% P.O.C.","$51000 - $72000"
"34007608700","Census Tract 6087, Camden County, New Jersey",7539,97003,6525,270,0,143,0,328,86.5,3.6,0,1.9,0,4.4,13.5,2902,2537,365,87.42,12.58,271,2266,33,332,304,2598,10.7,9,10.5,"Less than 25% P.O.C.","$96000 or more"
"34007608800","Census Tract 6088, Camden County, New Jersey",5553,67654,3581,655,0,442,35,802,64.5,11.8,0,8,0.6,14.4,35.5,1957,1333,624,68.11,31.89,159,1174,125,499,284,1673,11.9,20,14.5,"25% - 50% P.O.C.","$51000 - $72000"
"34007608901","Census Tract 6089.01, Camden County, New Jersey",6038,105051,4840,422,0,102,0,546,80.2,7,0,1.7,0,9,19.8,1976,1790,186,90.59,9.41,374,1416,0,186,374,1602,20.9,0,18.9,"Less than 25% P.O.C.","$96000 or more"
"34007608903","Census Tract 6089.03, Camden County, New Jersey",3244,102619,3051,92,0,35,0,11,94.1,2.8,0,1.1,0,0.3,5.9,1064,1027,37,96.52,3.48,142,885,0,37,142,922,13.8,0,13.3,"Less than 25% P.O.C.","$96000 or more"
"34007608904","Census Tract 6089.04, Camden County, New Jersey",1420,112868,1358,1,0,0,0,60,95.6,0.1,0,0,0,4.2,4.4,497,478,19,96.18,3.82,58,420,0,19,58,439,12.1,0,11.7,"Less than 25% P.O.C.","$96000 or more"
"34007609000","Census Tract 6090, Camden County, New Jersey",1489,55556,733,463,18,0,0,234,49.2,31.1,1.2,0,0,15.7,50.8,544,420,124,77.21,22.79,39,381,1,123,40,504,9.3,0.8,7.4,"50% - 75% P.O.C.","$51000 - $72000"
"34007609103","Census Tract 6091.03, Camden County, New Jersey",5079,69262,3188,1233,8,106,0,313,62.8,24.3,0.2,2.1,0,6.2,37.2,1859,1426,433,76.71,23.29,139,1287,36,397,175,1684,9.7,8.3,9.4,"25% - 50% P.O.C.","$51000 - $72000"
"34007609201","Census Tract 6092.01, Camden County, New Jersey",4474,77125,2299,1532,0,0,0,557,51.4,34.2,0,0,0,12.4,48.6,1721,1290,431,74.96,25.04,86,1204,21,410,107,1614,6.7,4.9,6.2,"25% - 50% P.O.C.","$72000 - $96000"
"34007609202","Census Tract 6092.02, Camden County, New Jersey",5139,61754,902,2924,0,92,0,826,17.6,56.9,0,1.8,0,16.1,82.4,1674,1125,549,67.2,32.8,221,904,97,452,318,1356,19.6,17.7,19,"75% or more P.O.C.","$51000 - $72000"
"34007609203","Census Tract 6092.03, Camden County, New Jersey",9032,95181,3413,3405,0,599,0,1187,37.8,37.7,0,6.6,0,13.1,62.2,3161,2684,477,84.91,15.09,377,2307,17,460,394,2767,14,3.6,12.5,"50% - 75% P.O.C.","$72000 - $96000"
"34007609204","Census Tract 6092.04, Camden County, New Jersey",4375,48958,450,3094,0,85,0,679,10.3,70.7,0,1.9,0,15.5,89.7,1389,831,558,59.83,40.17,112,719,130,428,242,1147,13.5,23.3,17.4,"75% or more P.O.C.","Less than $51000"
"34007609205","Census Tract 6092.05, Camden County, New Jersey",5980,90368,3860,1244,26,3,0,679,64.5,20.8,0.4,0.1,0,11.4,35.5,2122,1782,340,83.98,16.02,248,1534,35,305,283,1839,13.9,10.3,13.3,"25% - 50% P.O.C.","$72000 - $96000"
"34007610300","Census Tract 6103, Camden County, New Jersey",1881,27092,492,841,0,92,0,406,26.2,44.7,0,4.9,0,21.6,73.8,871,133,738,15.27,84.73,0,133,0,738,0,871,0,0,0,"50% - 75% P.O.C.","Less than $51000"
"34007610400","Census Tract 6104, Camden County, New Jersey",4992,26028,611,2422,0,179,0,1628,12.2,48.5,0,3.6,0,32.6,87.8,1251,637,614,50.92,49.08,13,624,77,537,90,1161,2,12.5,7.2,"75% or more P.O.C.","Less than $51000"
"34007610500","Census Tract 6105, Camden County, New Jersey",7373,69484,1075,1446,0,792,0,4042,14.6,19.6,0,10.7,0,54.8,85.4,1965,1449,516,73.74,26.26,361,1088,192,324,553,1412,24.9,37.2,28.1,"75% or more P.O.C.","$51000 - $72000"
"34007610600","Census Tract 6106, Camden County, New Jersey",1226,55536,686,167,0,156,0,195,56,13.6,0,12.7,0,15.9,44,640,111,529,17.34,82.66,18,93,0,529,18,622,16.2,0,2.8,"25% - 50% P.O.C.","$51000 - $72000"
"34007610800","Census Tract 6108, Camden County, New Jersey",2727,55833,1172,959,0,104,0,472,43,35.2,0,3.8,0,17.3,57,1034,811,223,78.43,21.57,90,721,0,223,90,944,11.1,0,8.7,"50% - 75% P.O.C.","$51000 - $72000"
"34007610900","Census Tract 6109, Camden County, New Jersey",3297,68553,3023,112,0,14,0,132,91.7,3.4,0,0.4,0,4,8.3,1430,757,673,52.94,47.06,89,668,10,663,99,1331,11.8,1.5,6.9,"Less than 25% P.O.C.","$51000 - $72000"
"34007611000","Census Tract 6110, Camden County, New Jersey",6347,53911,4597,360,0,418,0,772,72.4,5.7,0,6.6,0,12.2,27.6,2188,1242,946,56.76,43.24,108,1134,262,684,370,1818,8.7,27.7,16.9,"25% - 50% P.O.C.","$51000 - $72000"
"34007611100","Census Tract 6111, Camden County, New Jersey",2985,61122,2248,68,0,254,0,388,75.3,2.3,0,8.5,0,13,24.7,1208,708,500,58.61,41.39,96,612,26,474,122,1086,13.6,5.2,10.1,"Less than 25% P.O.C.","$51000 - $72000"
"34007611200","Census Tract 6112, Camden County, New Jersey",4504,85975,3761,214,0,202,0,256,83.5,4.8,0,4.5,0,5.7,16.5,1635,1250,385,76.45,23.55,159,1091,21,364,180,1455,12.7,5.5,11,"Less than 25% P.O.C.","$72000 - $96000"
"34007611300","Census Tract 6113, Camden County, New Jersey",4163,61765,3308,247,0,188,0,365,79.5,5.9,0,4.5,0,8.8,20.5,1478,1151,327,77.88,22.12,114,1037,15,312,129,1349,9.9,4.6,8.7,"Less than 25% P.O.C.","$51000 - $72000"
"34007611400","Census Tract 6114, Camden County, New Jersey",4258,72447,3165,599,0,84,0,246,74.3,14.1,0,2,0,5.8,25.7,1592,1460,132,91.71,8.29,47,1413,34,98,81,1511,3.2,25.8,5.1,"25% - 50% P.O.C.","$72000 - $96000"
"34007611500","Census Tract 6115, Camden County, New Jersey",4750,81027,3890,318,0,133,0,326,81.9,6.7,0,2.8,0,6.9,18.1,1645,1428,217,86.81,13.19,82,1346,0,217,82,1563,5.7,0,5,"Less than 25% P.O.C.","$72000 - $96000"
"34007611600","Census Tract 6116, Camden County, New Jersey",4007,32190,2599,911,0,0,0,423,64.9,22.7,0,0,0,10.6,35.1,1994,480,1514,24.07,75.93,50,430,0,1514,50,1944,10.4,0,2.5,"25% - 50% P.O.C.","Less than $51000"
"34007611700","Census Tract 6117, Camden County, New Jersey",2955,87917,2748,71,0,18,0,118,93,2.4,0,0.6,0,4,7,1095,824,271,75.25,24.75,95,729,0,271,95,1000,11.5,0,8.7,"Less than 25% P.O.C.","$72000 - $96000"
"34009020101","Census Tract 201.01, Cape May County, New Jersey",3733,68869,2643,341,2,84,0,432,70.8,9.1,0.1,2.3,0,11.6,29.2,1757,1132,625,64.43,35.57,44,1088,43,582,87,1670,3.9,6.9,5,"25% - 50% P.O.C.","$51000 - $72000"
"34009020102","Census Tract 201.02, Cape May County, New Jersey",2048,74167,1958,2,0,0,0,88,95.6,0.1,0,0,0,4.3,4.4,1000,704,296,70.4,29.6,108,596,0,296,108,892,15.3,0,10.8,"Less than 25% P.O.C.","$72000 - $96000"
"34009020201","Census Tract 202.01, Cape May County, New Jersey",1506,109286,1278,0,0,69,0,137,84.9,0,0,4.6,0,9.1,15.1,592,505,87,85.3,14.7,52,453,44,43,96,496,10.3,50.6,16.2,"Less than 25% P.O.C.","$96000 or more"
"34009020203","Census Tract 202.03, Cape May County, New Jersey",2154,76250,2109,16,0,0,0,29,97.9,0.7,0,0,0,1.3,2.1,1020,660,360,64.71,35.29,38,622,9,351,47,973,5.8,2.5,4.6,"Less than 25% P.O.C.","$72000 - $96000"
"34009020205","Census Tract 202.05, Cape May County, New Jersey",849,101719,840,0,0,0,0,9,98.9,0,0,0,0,1.1,1.1,473,418,55,88.37,11.63,8,410,0,55,8,465,1.9,0,1.7,"Less than 25% P.O.C.","$96000 or more"
"34009020206","Census Tract 202.06, Cape May County, New Jersey",842,90536,842,0,0,0,0,0,100,0,0,0,0,0,0,411,327,84,79.56,20.44,21,306,1,83,22,389,6.4,1.2,5.4,"Less than 25% P.O.C.","$72000 - $96000"
"34009020301","Census Tract 203.01, Cape May County, New Jersey",4520,85156,4362,14,0,10,0,119,96.5,0.3,0,0.2,0,2.6,3.5,1882,1638,244,87.04,12.96,131,1507,30,214,161,1721,8,12.3,8.6,"Less than 25% P.O.C.","$72000 - $96000"
"34009020302","Census Tract 203.02, Cape May County, New Jersey",4519,102112,4370,2,0,50,0,30,96.7,0,0,1.1,0,0.7,3.3,1823,1722,101,94.46,5.54,87,1635,0,101,87,1736,5.1,0,4.8,"Less than 25% P.O.C.","$96000 or more"
"34009020400","Census Tract 204, Cape May County, New Jersey",2847,80486,2716,0,0,0,0,109,95.4,0,0,0,0,3.8,4.6,1137,925,212,81.35,18.65,113,812,36,176,149,988,12.2,17,13.1,"Less than 25% P.O.C.","$72000 - $96000"
"34009020500","Census Tract 205, Cape May County, New Jersey",2341,39615,1087,514,9,34,0,662,46.4,22,0.4,1.5,0,28.3,53.6,804,458,346,56.97,43.03,16,442,78,268,94,710,3.5,22.5,11.7,"50% - 75% P.O.C.","Less than $51000"
"34009020600","Census Tract 206, Cape May County, New Jersey",2184,64632,2080,0,0,0,0,104,95.2,0,0,0,0,4.8,4.8,833,682,151,81.87,18.13,59,623,77,74,136,697,8.7,51,16.3,"Less than 25% P.O.C.","$51000 - $72000"
"34009020700","Census Tract 207, Cape May County, New Jersey",4020,80833,3589,20,0,63,0,330,89.3,0.5,0,1.6,0,8.2,10.7,1472,1325,147,90.01,9.99,141,1184,88,59,229,1243,10.6,59.9,15.6,"Less than 25% P.O.C.","$72000 - $96000"
"34009020800","Census Tract 208, Cape May County, New Jersey",2147,73403,2105,0,0,15,0,27,98,0,0,0.7,0,1.3,2,1111,1008,103,90.73,9.27,11,997,19,84,30,1081,1.1,18.4,2.7,"Less than 25% P.O.C.","$72000 - $96000"
"34009020901","Census Tract 209.01, Cape May County, New Jersey",885,99375,875,1,0,3,0,6,98.9,0.1,0,0.3,0,0.7,1.1,476,429,47,90.13,9.87,11,418,0,47,11,465,2.6,0,2.3,"Less than 25% P.O.C.","$96000 or more"
"34009020902","Census Tract 209.02, Cape May County, New Jersey",1406,95556,1385,2,0,1,0,18,98.5,0.1,0,0.1,0,1.3,1.5,726,675,51,92.98,7.02,13,662,0,51,13,713,1.9,0,1.8,"Less than 25% P.O.C.","$72000 - $96000"
"34009021001","Census Tract 210.01, Cape May County, New Jersey",2143,90234,1788,208,0,6,0,73,83.4,9.7,0,0.3,0,3.4,16.6,747,624,123,83.53,16.47,86,538,23,100,109,638,13.8,18.7,14.6,"Less than 25% P.O.C.","$72000 - $96000"
"34009021002","Census Tract 210.02, Cape May County, New Jersey",3468,76705,3076,360,0,14,0,18,88.7,10.4,0,0.4,0,0.5,11.3,1330,1173,157,88.2,11.8,51,1122,0,157,51,1279,4.3,0,3.8,"Less than 25% P.O.C.","$72000 - $96000"
"34009021100","Census Tract 211, Cape May County, New Jersey",4617,62781,3820,272,0,28,0,325,82.7,5.9,0,0.6,0,7,17.3,2069,1493,576,72.16,27.84,57,1436,0,576,57,2012,3.8,0,2.8,"Less than 25% P.O.C.","$51000 - $72000"
"34009021300","Census Tract 213, Cape May County, New Jersey",3812,50422,3601,116,0,0,0,80,94.5,3,0,0,0,2.1,5.5,1974,1517,457,76.85,23.15,75,1442,0,457,75,1899,4.9,0,3.8,"Less than 25% P.O.C.","Less than $51000"
"34009021400","Census Tract 214, Cape May County, New Jersey",3518,40513,2568,231,0,59,0,525,73,6.6,0,1.7,0,14.9,27,1641,776,865,47.29,52.71,80,696,57,808,137,1504,10.3,6.6,8.3,"25% - 50% P.O.C.","Less than $51000"
"34009021500","Census Tract 215, Cape May County, New Jersey",1909,58152,1308,128,0,66,0,378,68.5,6.7,0,3.5,0,19.8,31.5,880,453,427,51.48,48.52,11,442,51,376,62,818,2.4,11.9,7,"25% - 50% P.O.C.","$51000 - $72000"
"34009021600","Census Tract 216, Cape May County, New Jersey",3096,60982,2785,0,0,0,0,259,90,0,0,0,0,8.4,10,1460,1059,401,72.53,27.47,83,976,0,401,83,1377,7.8,0,5.7,"Less than 25% P.O.C.","$51000 - $72000"
"34009021701","Census Tract 217.01, Cape May County, New Jersey",2715,73411,2534,18,0,0,0,94,93.3,0.7,0,0,0,3.5,6.7,1161,817,344,70.37,29.63,81,736,0,344,81,1080,9.9,0,7,"Less than 25% P.O.C.","$72000 - $96000"
"34009021702","Census Tract 217.02, Cape May County, New Jersey",2375,74840,2248,1,0,48,0,0,94.7,0,0,2,0,0,5.3,1113,947,166,85.09,14.91,21,926,0,166,21,1092,2.2,0,1.9,"Less than 25% P.O.C.","$72000 - $96000"
"34009021803","Census Tract 218.03, Cape May County, New Jersey",2924,51627,2718,31,0,10,0,165,93,1.1,0,0.3,0,5.6,7,1514,1250,264,82.56,17.44,47,1203,0,264,47,1467,3.8,0,3.1,"Less than 25% P.O.C.","$51000 - $72000"
"34009021804","Census Tract 218.04, Cape May County, New Jersey",5845,59155,4726,15,0,0,0,801,80.9,0.3,0,0,0,13.7,19.1,2314,1843,471,79.65,20.35,184,1659,59,412,243,2071,10,12.5,10.5,"Less than 25% P.O.C.","$51000 - $72000"
"34009021805","Census Tract 218.05, Cape May County, New Jersey",4458,80889,3916,60,0,142,0,340,87.8,1.3,0,3.2,0,7.6,12.2,1850,1655,195,89.46,10.54,168,1487,15,180,183,1667,10.2,7.7,9.9,"Less than 25% P.O.C.","$72000 - $96000"
"34009021806","Census Tract 218.06, Cape May County, New Jersey",2546,62926,2348,198,0,0,0,0,92.2,7.8,0,0,0,0,7.8,1157,895,262,77.36,22.64,28,867,49,213,77,1080,3.1,18.7,6.7,"Less than 25% P.O.C.","$51000 - $72000"
"34009021900","Census Tract 219, Cape May County, New Jersey",2059,92022,1857,62,0,22,0,20,90.2,3,0,1.1,0,1,9.8,909,799,110,87.9,12.1,19,780,17,93,36,873,2.4,15.5,4,"Less than 25% P.O.C.","$72000 - $96000"
"34009022000","Census Tract 220, Cape May County, New Jersey",3463,55700,2724,96,9,2,0,579,78.7,2.8,0.3,0.1,0,16.7,21.3,1354,780,574,57.61,42.39,8,772,46,528,54,1300,1,8,4,"Less than 25% P.O.C.","$51000 - $72000"
"34009022101","Census Tract 221.01, Cape May County, New Jersey",1670,59173,1375,85,0,0,0,207,82.3,5.1,0,0,0,12.4,17.7,665,567,98,85.26,14.74,10,557,0,98,10,655,1.8,0,1.5,"Less than 25% P.O.C.","$51000 - $72000"
"34009022102","Census Tract 221.02, Cape May County, New Jersey",6467,62422,3742,1331,0,134,0,1189,57.9,20.6,0,2.1,0,18.4,42.1,2516,1933,583,76.83,23.17,159,1774,171,412,330,2186,8.2,29.3,13.1,"25% - 50% P.O.C.","$51000 - $72000"
"34009990100","Census Tract 9901, Cape May County, New Jersey",0,NA,0,0,0,0,0,0,NA,NA,NA,NA,NA,NA,NA,0,0,0,NA,NA,0,0,0,0,0,0,NA,NA,NA,"N/A","N/A"
"34011010101","Census Tract 101.01, Cumberland County, New Jersey",2514,74150,2180,83,0,0,0,82,86.7,3.3,0,0,0,3.3,13.3,963,876,87,90.97,9.03,30,846,0,87,30,933,3.4,0,3.1,"Less than 25% P.O.C.","$72000 - $96000"
"34011010103","Census Tract 101.03, Cumberland County, New Jersey",4970,NA,1096,2695,12,39,0,1037,22.1,54.2,0.2,0.8,0,20.9,77.9,0,0,0,NA,NA,0,0,0,0,0,0,NA,NA,NA,"75% or more P.O.C.","N/A"
"34011010200","Census Tract 102, Cumberland County, New Jersey",4979,44856,4016,248,33,67,0,405,80.7,5,0.7,1.3,0,8.1,19.3,1932,1328,604,68.74,31.26,99,1229,90,514,189,1743,7.5,14.9,9.8,"Less than 25% P.O.C.","Less than $51000"
"34011010301","Census Tract 103.01, Cumberland County, New Jersey",3123,73750,2056,369,44,0,0,558,65.8,11.8,1.4,0,0,17.9,34.2,977,799,178,81.78,18.22,99,700,89,89,188,789,12.4,50,19.2,"25% - 50% P.O.C.","$72000 - $96000"
"34011010302","Census Tract 103.02, Cumberland County, New Jersey",1107,52321,975,18,67,3,0,29,88.1,1.6,6.1,0.3,0,2.6,11.9,452,370,82,81.86,18.14,20,350,3,79,23,429,5.4,3.7,5.1,"Less than 25% P.O.C.","$51000 - $72000"
"34011010401","Census Tract 104.01, Cumberland County, New Jersey",5047,55134,1544,2358,251,23,0,658,30.6,46.7,5,0.5,0,13,69.4,1741,1321,420,75.88,24.12,173,1148,46,374,219,1522,13.1,11,12.6,"50% - 75% P.O.C.","$51000 - $72000"
"34011010402","Census Tract 104.02, Cumberland County, New Jersey",1043,NA,199,583,45,5,0,191,19.1,55.9,4.3,0.5,0,18.3,80.9,0,0,0,NA,NA,0,0,0,0,0,0,NA,NA,NA,"75% or more P.O.C.","N/A"
"34011010500","Census Tract 105, Cumberland County, New Jersey",1611,71375,1405,60,18,33,0,43,87.2,3.7,1.1,2,0,2.7,12.8,638,517,121,81.03,18.97,47,470,6,115,53,585,9.1,5,8.3,"Less than 25% P.O.C.","$51000 - $72000"
"34011010600","Census Tract 106, Cumberland County, New Jersey",4785,78636,3787,319,75,115,4,367,79.1,6.7,1.6,2.4,0.1,7.7,20.9,1832,1477,355,80.62,19.38,110,1367,29,326,139,1693,7.4,8.2,7.6,"Less than 25% P.O.C.","$72000 - $96000"
"34011010700","Census Tract 107, Cumberland County, New Jersey",7379,56534,4550,881,48,183,0,1232,61.7,11.9,0.7,2.5,0,16.7,38.3,2805,2137,668,76.19,23.81,239,1898,44,624,283,2522,11.2,6.6,10.1,"25% - 50% P.O.C.","$51000 - $72000"
"34011010800","Census Tract 108, Cumberland County, New Jersey",3053,64324,2006,588,45,33,4,313,65.7,19.3,1.5,1.1,0.1,10.3,34.3,1060,852,208,80.38,19.62,91,761,49,159,140,920,10.7,23.6,13.2,"25% - 50% P.O.C.","$51000 - $72000"
"34011020100","Census Tract 201, Cumberland County, New Jersey",1065,22000,49,357,0,12,0,647,4.6,33.5,0,1.1,0,60.8,95.4,362,24,338,6.63,93.37,17,7,69,269,86,276,70.8,20.4,23.8,"75% or more P.O.C.","Less than $51000"
"34011020200","Census Tract 202, Cumberland County, New Jersey",3093,30972,282,710,0,58,0,2013,9.1,23,0,1.9,0,65.1,90.9,773,108,665,13.97,86.03,65,43,196,469,261,512,60.2,29.5,33.8,"75% or more P.O.C.","Less than $51000"
"34011020300","Census Tract 203, Cumberland County, New Jersey",6188,35797,581,848,18,9,0,4732,9.4,13.7,0.3,0.1,0,76.5,90.6,1566,349,1217,22.29,77.71,125,224,419,798,544,1022,35.8,34.4,34.7,"75% or more P.O.C.","Less than $51000"
"34011020400","Census Tract 204, Cumberland County, New Jersey",3238,48497,847,765,10,42,0,1509,26.2,23.6,0.3,1.3,0,46.6,73.8,1007,553,454,54.92,45.08,79,474,165,289,244,763,14.3,36.3,24.2,"50% - 75% P.O.C.","Less than $51000"
"34011020502","Census Tract 205.02, Cumberland County, New Jersey",1663,NA,494,695,12,11,0,385,29.7,41.8,0.7,0.7,0,23.2,70.3,0,0,0,NA,NA,0,0,0,0,0,0,NA,NA,NA,"50% - 75% P.O.C.","N/A"
"34011020503","Census Tract 205.03, Cumberland County, New Jersey",5390,20938,366,3239,46,14,0,1622,6.8,60.1,0.9,0.3,0,30.1,93.2,1098,390,708,35.52,64.48,73,317,110,598,183,915,18.7,15.5,16.7,"75% or more P.O.C.","Less than $51000"
"34011020600","Census Tract 206, Cumberland County, New Jersey",3903,50663,1186,1318,57,0,0,1220,30.4,33.8,1.5,0,0,31.3,69.6,1493,979,514,65.57,34.43,201,778,19,495,220,1273,20.5,3.7,14.7,"50% - 75% P.O.C.","Less than $51000"
"34011030100","Census Tract 301, Cumberland County, New Jersey",855,22941,388,172,0,0,0,254,45.4,20.1,0,0,0,29.7,54.6,448,40,408,8.93,91.07,0,40,26,382,26,422,0,6.4,5.8,"50% - 75% P.O.C.","Less than $51000"
"34011030200","Census Tract 302, Cumberland County, New Jersey",3869,49903,1703,394,93,0,0,1496,44,10.2,2.4,0,0,38.7,56,1651,1046,605,63.36,36.64,42,1004,50,555,92,1559,4,8.3,5.6,"50% - 75% P.O.C.","Less than $51000"
"34011030300","Census Tract 303, Cumberland County, New Jersey",3777,46772,1683,1292,0,36,0,518,44.6,34.2,0,1,0,13.7,55.4,1484,545,939,36.73,63.27,77,468,0,939,77,1407,14.1,0,5.2,"50% - 75% P.O.C.","Less than $51000"
"34011030400","Census Tract 304, Cumberland County, New Jersey",8713,59103,5646,1051,4,502,0,1489,64.8,12.1,0,5.8,0,17.1,35.2,3390,2070,1320,61.06,38.94,139,1931,368,952,507,2883,6.7,27.9,15,"25% - 50% P.O.C.","$51000 - $72000"
"34011030501","Census Tract 305.01, Cumberland County, New Jersey",6528,86142,5452,501,0,159,0,376,83.5,7.7,0,2.4,0,5.8,16.5,2388,2269,119,95.02,4.98,274,1995,37,82,311,2077,12.1,31.1,13,"Less than 25% P.O.C.","$72000 - $96000"
"34011030502","Census Tract 305.02, Cumberland County, New Jersey",3979,53397,2089,805,0,46,0,933,52.5,20.2,0,1.2,0,23.4,47.5,1588,1148,440,72.29,27.71,63,1085,27,413,90,1498,5.5,6.1,5.7,"25% - 50% P.O.C.","$51000 - $72000"
"34011040300","Census Tract 403, Cumberland County, New Jersey",3371,51285,1314,138,0,31,0,1848,39,4.1,0,0.9,0,54.8,61,1399,712,687,50.89,49.11,93,619,28,659,121,1278,13.1,4.1,8.6,"50% - 75% P.O.C.","$51000 - $72000"
"34011040400","Census Tract 404, Cumberland County, New Jersey",7030,66349,2891,294,26,9,0,3655,41.1,4.2,0.4,0.1,0,52,58.9,2022,1462,560,72.3,27.7,356,1106,56,504,412,1610,24.4,10,20.4,"50% - 75% P.O.C.","$51000 - $72000"
"34011040500","Census Tract 405, Cumberland County, New Jersey",5879,30111,940,882,0,55,0,3890,16,15,0,0.9,0,66.2,84,2177,1011,1166,46.44,53.56,255,756,101,1065,356,1821,25.2,8.7,16.4,"75% or more P.O.C.","Less than $51000"
"34011040600","Census Tract 406, Cumberland County, New Jersey",7357,48803,2686,1351,0,102,0,3013,36.5,18.4,0,1.4,0,41,63.5,2665,1489,1176,55.87,44.13,288,1201,23,1153,311,2354,19.3,2,11.7,"50% - 75% P.O.C.","Less than $51000"
"34011040700","Census Tract 407, Cumberland County, New Jersey",8511,57250,4918,1037,6,0,0,2248,57.8,12.2,0.1,0,0,26.4,42.2,2790,1928,862,69.1,30.9,139,1789,71,791,210,2580,7.2,8.2,7.5,"25% - 50% P.O.C.","$51000 - $72000"
"34011040800","Census Tract 408, Cumberland County, New Jersey",5101,104152,3436,428,0,287,0,875,67.4,8.4,0,5.6,0,17.2,32.6,1743,1530,213,87.78,12.22,222,1308,37,176,259,1484,14.5,17.4,14.9,"25% - 50% P.O.C.","$96000 or more"
"34011040901","Census Tract 409.01, Cumberland County, New Jersey",2760,63156,1030,472,0,0,0,855,37.3,17.1,0,0,0,31,62.7,995,869,126,87.34,12.66,126,743,43,83,169,826,14.5,34.1,17,"50% - 75% P.O.C.","$51000 - $72000"
"34011040902","Census Tract 409.02, Cumberland County, New Jersey",6094,53813,3358,694,0,0,0,1962,55.1,11.4,0,0,0,32.2,44.9,2442,1893,549,77.52,22.48,85,1808,167,382,252,2190,4.5,30.4,10.3,"25% - 50% P.O.C.","$51000 - $72000"
"34011041000","Census Tract 410, Cumberland County, New Jersey",8102,67426,4855,883,0,23,0,1993,59.9,10.9,0,0.3,0,24.6,40.1,2889,2447,442,84.7,15.3,277,2170,31,411,308,2581,11.3,7,10.7,"25% - 50% P.O.C.","$51000 - $72000"
"34011041100","Census Tract 411, Cumberland County, New Jersey",5829,31948,491,962,20,114,0,4195,8.4,16.5,0.3,2,0,72,91.6,1959,554,1405,28.28,71.72,150,404,152,1253,302,1657,27.1,10.8,15.4,"75% or more P.O.C.","Less than $51000"
"34011990000","Census Tract 9900, Cumberland County, New Jersey",0,NA,0,0,0,0,0,0,NA,NA,NA,NA,NA,NA,NA,0,0,0,NA,NA,0,0,0,0,0,0,NA,NA,NA,"N/A","N/A"
"34015500100","Census Tract 5001, Gloucester County, New Jersey",4169,51983,3340,361,0,172,0,200,80.1,8.7,0,4.1,0,4.8,19.9,1646,997,649,60.57,39.43,172,825,27,622,199,1447,17.3,4.2,12.1,"Less than 25% P.O.C.","$51000 - $72000"
"34015500201","Census Tract 5002.01, Gloucester County, New Jersey",2367,71481,2215,16,0,59,0,70,93.6,0.7,0,2.5,0,3,6.4,864,756,108,87.5,12.5,83,673,18,90,101,763,11,16.7,11.7,"Less than 25% P.O.C.","$51000 - $72000"
"34015500202","Census Tract 5002.02, Gloucester County, New Jersey",4582,66830,3768,425,0,103,0,195,82.2,9.3,0,2.2,0,4.3,17.8,1619,1248,371,77.08,22.92,167,1081,0,371,167,1452,13.4,0,10.3,"Less than 25% P.O.C.","$51000 - $72000"
"34015500203","Census Tract 5002.03, Gloucester County, New Jersey",4202,78277,3915,206,0,13,0,68,93.2,4.9,0,0.3,0,1.6,6.8,1857,1325,532,71.35,28.65,73,1252,17,515,90,1767,5.5,3.2,4.8,"Less than 25% P.O.C.","$72000 - $96000"
"34015500204","Census Tract 5002.04, Gloucester County, New Jersey",6347,88382,4396,607,0,357,0,707,69.3,9.6,0,5.6,0,11.1,30.7,2570,1419,1151,55.21,44.79,159,1260,19,1132,178,2392,11.2,1.7,6.9,"25% - 50% P.O.C.","$72000 - $96000"
"34015500205","Census Tract 5002.05, Gloucester County, New Jersey",3651,61250,3299,187,0,0,0,70,90.4,5.1,0,0,0,1.9,9.6,1495,1080,415,72.24,27.76,56,1024,33,382,89,1406,5.2,8,6,"Less than 25% P.O.C.","$51000 - $72000"
"34015500300","Census Tract 5003, Gloucester County, New Jersey",2959,65625,2639,81,0,12,0,141,89.2,2.7,0,0.4,0,4.8,10.8,1087,884,203,81.32,18.68,93,791,27,176,120,967,10.5,13.3,11,"Less than 25% P.O.C.","$51000 - $72000"
"34015500400","Census Tract 5004, Gloucester County, New Jersey",5904,45450,3610,1621,0,0,0,431,61.1,27.5,0,0,0,7.3,38.9,2475,1747,728,70.59,29.41,148,1599,0,728,148,2327,8.5,0,6,"25% - 50% P.O.C.","Less than $51000"
"34015500500","Census Tract 5005, Gloucester County, New Jersey",4831,73083,4424,177,0,91,0,84,91.6,3.7,0,1.9,0,1.7,8.4,1926,1547,379,80.32,19.68,150,1397,30,349,180,1746,9.7,7.9,9.3,"Less than 25% P.O.C.","$72000 - $96000"
"34015500600","Census Tract 5006, Gloucester County, New Jersey",10488,129353,8399,920,0,592,23,307,80.1,8.8,0,5.6,0.2,2.9,19.9,3387,3197,190,94.39,5.61,352,2845,26,164,378,3009,11,13.7,11.2,"Less than 25% P.O.C.","$96000 or more"
"34015500701","Census Tract 5007.01, Gloucester County, New Jersey",7824,85972,6900,430,67,109,0,282,88.2,5.5,0.9,1.4,0,3.6,11.8,3061,2754,307,89.97,10.03,135,2619,21,286,156,2905,4.9,6.8,5.1,"Less than 25% P.O.C.","$72000 - $96000"
"34015500702","Census Tract 5007.02, Gloucester County, New Jersey",5775,94554,5414,2,0,174,0,111,93.7,0,0,3,0,1.9,6.3,2038,1917,121,94.06,5.94,220,1697,15,106,235,1803,11.5,12.4,11.5,"Less than 25% P.O.C.","$72000 - $96000"
"34015500703","Census Tract 5007.03, Gloucester County, New Jersey",1342,104625,1202,55,0,45,0,30,89.6,4.1,0,3.4,0,2.2,10.4,481,422,59,87.73,12.27,20,402,0,59,20,461,4.7,0,4.2,"Less than 25% P.O.C.","$96000 or more"
"34015500800","Census Tract 5008, Gloucester County, New Jersey",2259,124821,2075,21,0,44,0,42,91.9,0.9,0,1.9,0,1.9,8.1,766,731,35,95.43,4.57,92,639,4,31,96,670,12.6,11.4,12.5,"Less than 25% P.O.C.","$96000 or more"
"34015500900","Census Tract 5009, Gloucester County, New Jersey",2986,96875,2691,19,0,42,0,200,90.1,0.6,0,1.4,0,6.7,9.9,1052,942,110,89.54,10.46,118,824,6,104,124,928,12.5,5.5,11.8,"Less than 25% P.O.C.","$96000 or more"
"34015501001","Census Tract 5010.01, Gloucester County, New Jersey",2135,72411,1385,379,0,29,0,242,64.9,17.8,0,1.4,0,11.3,35.1,766,531,235,69.32,30.68,64,467,3,232,67,699,12.1,1.3,8.7,"25% - 50% P.O.C.","$72000 - $96000"
"34015501002","Census Tract 5010.02, Gloucester County, New Jersey",4171,30878,1611,1308,21,0,0,916,38.6,31.4,0.5,0,0,22,61.4,1820,740,1080,40.66,59.34,41,699,78,1002,119,1701,5.5,7.2,6.5,"50% - 75% P.O.C.","Less than $51000"
"34015501003","Census Tract 5010.03, Gloucester County, New Jersey",3555,59113,2258,751,0,117,0,294,63.5,21.1,0,3.3,0,8.3,36.5,1430,1029,401,71.96,28.04,63,966,45,356,108,1322,6.1,11.2,7.6,"25% - 50% P.O.C.","$51000 - $72000"
"34015501101","Census Tract 5011.01, Gloucester County, New Jersey",3820,41920,2729,555,0,0,0,439,71.4,14.5,0,0,0,11.5,28.6,1797,1088,709,60.55,39.45,66,1022,0,709,66,1731,6.1,0,3.7,"25% - 50% P.O.C.","Less than $51000"
"34015501102","Census Tract 5011.02, Gloucester County, New Jersey",6504,94215,4527,993,0,612,0,261,69.6,15.3,0,9.4,0,4,30.4,2837,2014,823,70.99,29.01,133,1881,0,823,133,2704,6.6,0,4.7,"25% - 50% P.O.C.","$72000 - $96000"
"34015501103","Census Tract 5011.03, Gloucester County, New Jersey",5367,95192,4145,360,0,536,0,243,77.2,6.7,0,10,0,4.5,22.8,1790,1636,154,91.4,8.6,156,1480,15,139,171,1619,9.5,9.7,9.6,"Less than 25% P.O.C.","$72000 - $96000"
"34015501104","Census Tract 5011.04, Gloucester County, New Jersey",3344,83594,2597,184,0,228,0,234,77.7,5.5,0,6.8,0,7,22.3,1057,876,181,82.88,17.12,104,772,0,181,104,953,11.9,0,9.8,"Less than 25% P.O.C.","$72000 - $96000"
"34015501105","Census Tract 5011.05, Gloucester County, New Jersey",2943,52472,2164,381,0,124,0,196,73.5,12.9,0,4.2,0,6.7,26.5,1286,589,697,45.8,54.2,53,536,12,685,65,1221,9,1.7,5.1,"25% - 50% P.O.C.","$51000 - $72000"
"34015501106","Census Tract 5011.06, Gloucester County, New Jersey",3975,71083,2240,1005,0,366,0,220,56.4,25.3,0,9.2,0,5.5,43.6,1423,1205,218,84.68,15.32,95,1110,25,193,120,1303,7.9,11.5,8.4,"25% - 50% P.O.C.","$51000 - $72000"
"34015501107","Census Tract 5011.07, Gloucester County, New Jersey",4495,82284,3844,114,0,16,0,353,85.5,2.5,0,0.4,0,7.9,14.5,1547,1341,206,86.68,13.32,130,1211,0,206,130,1417,9.7,0,8.4,"Less than 25% P.O.C.","$72000 - $96000"
"34015501201","Census Tract 5012.01, Gloucester County, New Jersey",6047,124063,4924,274,0,430,0,353,81.4,4.5,0,7.1,0,5.8,18.6,1928,1874,54,97.2,2.8,222,1652,0,54,222,1706,11.8,0,11.5,"Less than 25% P.O.C.","$96000 or more"
"34015501202","Census Tract 5012.02, Gloucester County, New Jersey",4717,128279,4233,54,0,316,0,83,89.7,1.1,0,6.7,0,1.8,10.3,1566,1534,32,97.96,2.04,110,1424,18,14,128,1438,7.2,56.2,8.2,"Less than 25% P.O.C.","$96000 or more"
"34015501203","Census Tract 5012.03, Gloucester County, New Jersey",3044,88750,2771,12,0,17,0,244,91,0.4,0,0.6,0,8,9,1147,1039,108,90.58,9.42,124,915,17,91,141,1006,11.9,15.7,12.3,"Less than 25% P.O.C.","$72000 - $96000"
"34015501204","Census Tract 5012.04, Gloucester County, New Jersey",3641,92108,3247,167,0,102,0,79,89.2,4.6,0,2.8,0,2.2,10.8,1282,1244,38,97.04,2.96,47,1197,18,20,65,1217,3.8,47.4,5.1,"Less than 25% P.O.C.","$72000 - $96000"
"34015501205","Census Tract 5012.05, Gloucester County, New Jersey",2806,95759,2368,106,0,160,0,172,84.4,3.8,0,5.7,0,6.1,15.6,981,846,135,86.24,13.76,122,724,21,114,143,838,14.4,15.6,14.6,"Less than 25% P.O.C.","$72000 - $96000"
"34015501206","Census Tract 5012.06, Gloucester County, New Jersey",3877,74167,3198,342,0,81,0,196,82.5,8.8,0,2.1,0,5.1,17.5,1510,881,629,58.34,41.66,97,784,0,629,97,1413,11,0,6.4,"Less than 25% P.O.C.","$72000 - $96000"
"34015501208","Census Tract 5012.08, Gloucester County, New Jersey",3866,81424,3581,98,0,59,0,114,92.6,2.5,0,1.5,0,2.9,7.4,1637,1420,217,86.74,13.26,105,1315,0,217,105,1532,7.4,0,6.4,"Less than 25% P.O.C.","$72000 - $96000"
"34015501209","Census Tract 5012.09, Gloucester County, New Jersey",7484,79266,5418,671,0,686,0,141,72.4,9,0,9.2,0,1.9,27.6,2847,1782,1065,62.59,37.41,147,1635,14,1051,161,2686,8.2,1.3,5.7,"25% - 50% P.O.C.","$72000 - $96000"
"34015501210","Census Tract 5012.10, Gloucester County, New Jersey",3452,123750,3121,150,32,110,0,29,90.4,4.3,0.9,3.2,0,0.8,9.6,1159,1159,0,100,0,87,1072,0,0,87,1072,7.5,NA,7.5,"Less than 25% P.O.C.","$96000 or more"
"34015501212","Census Tract 5012.12, Gloucester County, New Jersey",4152,82563,2991,450,0,96,0,451,72,10.8,0,2.3,0,10.9,28,1416,1055,361,74.51,25.49,102,953,9,352,111,1305,9.7,2.5,7.8,"25% - 50% P.O.C.","$72000 - $96000"
"34015501213","Census Tract 5012.13, Gloucester County, New Jersey",4747,107308,3725,423,0,303,0,173,78.5,8.9,0,6.4,0,3.6,21.5,1736,1439,297,82.89,17.11,99,1340,0,297,99,1637,6.9,0,5.7,"Less than 25% P.O.C.","$96000 or more"
"34015501301","Census Tract 5013.01, Gloucester County, New Jersey",3570,88190,3144,57,27,0,0,113,88.1,1.6,0.8,0,0,3.2,11.9,1384,1058,326,76.45,23.55,110,948,0,326,110,1274,10.4,0,7.9,"Less than 25% P.O.C.","$72000 - $96000"
"34015501302","Census Tract 5013.02, Gloucester County, New Jersey",2641,58495,2350,159,0,0,0,87,89,6,0,0,0,3.3,11,1005,698,307,69.45,30.55,112,586,61,246,173,832,16,19.9,17.2,"Less than 25% P.O.C.","$51000 - $72000"
"34015501303","Census Tract 5013.03, Gloucester County, New Jersey",2594,68063,2350,91,0,64,0,89,90.6,3.5,0,2.5,0,3.4,9.4,977,679,298,69.5,30.5,57,622,6,292,63,914,8.4,2,6.4,"Less than 25% P.O.C.","$51000 - $72000"
"34015501402","Census Tract 5014.02, Gloucester County, New Jersey",3259,45369,1801,756,0,65,0,577,55.3,23.2,0,2,0,17.7,44.7,1007,379,628,37.64,62.36,64,315,120,508,184,823,16.9,19.1,18.3,"25% - 50% P.O.C.","Less than $51000"
"34015501403","Census Tract 5014.03, Gloucester County, New Jersey",4375,90945,2751,851,0,122,0,379,62.9,19.5,0,2.8,0,8.7,37.1,1721,1289,432,74.9,25.1,87,1202,24,408,111,1610,6.7,5.6,6.4,"25% - 50% P.O.C.","$72000 - $96000"
"34015501404","Census Tract 5014.04, Gloucester County, New Jersey",3347,27500,2296,395,7,278,0,255,68.6,11.8,0.2,8.3,0,7.6,31.4,448,187,261,41.74,58.26,20,167,9,252,29,419,10.7,3.4,6.5,"25% - 50% P.O.C.","Less than $51000"
"34015501405","Census Tract 5014.05, Gloucester County, New Jersey",4275,94942,2802,680,0,220,0,406,65.5,15.9,0,5.1,0,9.5,34.5,1424,1170,254,82.16,17.84,50,1120,53,201,103,1321,4.3,20.9,7.2,"25% - 50% P.O.C.","$72000 - $96000"
"34015501406","Census Tract 5014.06, Gloucester County, New Jersey",4570,65081,2925,698,0,109,0,618,64,15.3,0,2.4,0,13.5,36,1468,897,571,61.1,38.9,65,832,88,483,153,1315,7.2,15.4,10.4,"25% - 50% P.O.C.","$51000 - $72000"
"34015501500","Census Tract 5015, Gloucester County, New Jersey",8626,69883,6216,1349,24,143,0,678,72.1,15.6,0.3,1.7,0,7.9,27.9,3029,2369,660,78.21,21.79,283,2086,0,660,283,2746,11.9,0,9.3,"25% - 50% P.O.C.","$51000 - $72000"
"34015501603","Census Tract 5016.03, Gloucester County, New Jersey",5768,78040,4740,420,0,19,0,388,82.2,7.3,0,0.3,0,6.7,17.8,2633,2147,486,81.54,18.46,90,2057,2,484,92,2541,4.2,0.4,3.5,"Less than 25% P.O.C.","$72000 - $96000"
"34015501604","Census Tract 5016.04, Gloucester County, New Jersey",7333,88000,5541,877,0,327,0,348,75.6,12,0,4.5,0,4.7,24.4,2560,2148,412,83.91,16.09,281,1867,4,408,285,2275,13.1,1,11.1,"Less than 25% P.O.C.","$72000 - $96000"
"34015501605","Census Tract 5016.05, Gloucester County, New Jersey",4328,63972,3315,578,0,13,0,401,76.6,13.4,0,0.3,0,9.3,23.4,1633,1444,189,88.43,11.57,127,1317,20,169,147,1486,8.8,10.6,9,"Less than 25% P.O.C.","$51000 - $72000"
"34015501606","Census Tract 5016.06, Gloucester County, New Jersey",7623,99571,5562,1183,0,110,0,523,73,15.5,0,1.4,0,6.9,27,2538,2429,109,95.71,4.29,327,2102,14,95,341,2197,13.5,12.8,13.4,"25% - 50% P.O.C.","$96000 or more"
"34015501608","Census Tract 5016.08, Gloucester County, New Jersey",5736,78003,4240,741,0,0,0,659,73.9,12.9,0,0,0,11.5,26.1,2171,1853,318,85.35,14.65,174,1679,44,274,218,1953,9.4,13.8,10,"25% - 50% P.O.C.","$72000 - $96000"
"34015501609","Census Tract 5016.09, Gloucester County, New Jersey",6001,124470,3961,1288,0,273,0,294,66,21.5,0,4.5,0,4.9,34,1822,1489,333,81.72,18.28,168,1321,0,333,168,1654,11.3,0,9.2,"25% - 50% P.O.C.","$96000 or more"
"34015501701","Census Tract 5017.01, Gloucester County, New Jersey",5246,97500,4712,419,0,33,0,82,89.8,8,0,0.6,0,1.6,10.2,1838,1712,126,93.14,6.86,173,1539,0,126,173,1665,10.1,0,9.4,"Less than 25% P.O.C.","$96000 or more"
"34015501702","Census Tract 5017.02, Gloucester County, New Jersey",2543,95714,2242,121,0,7,0,139,88.2,4.8,0,0.3,0,5.5,11.8,850,766,84,90.12,9.88,104,662,0,84,104,746,13.6,0,12.2,"Less than 25% P.O.C.","$72000 - $96000"
"34015501703","Census Tract 5017.03, Gloucester County, New Jersey",4236,75125,3530,183,0,134,0,308,83.3,4.3,0,3.2,0,7.3,16.7,1590,1455,135,91.51,8.49,182,1273,9,126,191,1399,12.5,6.7,12,"Less than 25% P.O.C.","$72000 - $96000"
"34015501704","Census Tract 5017.04, Gloucester County, New Jersey",4415,66852,3534,342,0,39,0,421,80,7.7,0,0.9,0,9.5,20,1526,1318,208,86.37,13.63,96,1222,9,199,105,1421,7.3,4.3,6.9,"Less than 25% P.O.C.","$51000 - $72000"
"34015501800","Census Tract 5018, Gloucester County, New Jersey",1521,71875,1297,31,0,0,0,176,85.3,2,0,0,0,11.6,14.7,585,493,92,84.27,15.73,18,475,0,92,18,567,3.7,0,3.1,"Less than 25% P.O.C.","$51000 - $72000"
"34015501900","Census Tract 5019, Gloucester County, New Jersey",4135,86591,3350,503,0,25,0,182,81,12.2,0,0.6,0,4.4,19,1320,1209,111,91.59,8.41,137,1072,0,111,137,1183,11.3,0,10.4,"Less than 25% P.O.C.","$72000 - $96000"
"34015502001","Census Tract 5020.01, Gloucester County, New Jersey",6140,152738,5441,131,0,89,0,469,88.6,2.1,0,1.4,0,7.6,11.4,1928,1747,181,90.61,9.39,294,1453,10,171,304,1624,16.8,5.5,15.8,"Less than 25% P.O.C.","$96000 or more"
"34015502002","Census Tract 5020.02, Gloucester County, New Jersey",6855,142805,6573,128,0,26,0,120,95.9,1.9,0,0.4,0,1.8,4.1,2336,2165,171,92.68,7.32,339,1826,22,149,361,1975,15.7,12.9,15.5,"Less than 25% P.O.C.","$96000 or more"
"34015502100","Census Tract 5021, Gloucester County, New Jersey",3148,132880,2850,35,0,15,0,224,90.5,1.1,0,0.5,0,7.1,9.5,987,931,56,94.33,5.67,123,808,24,32,147,840,13.2,42.9,14.9,"Less than 25% P.O.C.","$96000 or more"
"34015502200","Census Tract 5022, Gloucester County, New Jersey",12549,141875,9478,1551,0,598,0,820,75.5,12.4,0,4.8,0,6.5,24.5,3934,3300,634,83.88,16.12,715,2585,28,606,743,3191,21.7,4.4,18.9,"Less than 25% P.O.C.","$96000 or more"
"34015502300","Census Tract 5023, Gloucester County, New Jersey",2579,81071,1520,272,0,45,0,629,58.9,10.5,0,1.7,0,24.4,41.1,852,576,276,67.61,32.39,57,519,52,224,109,743,9.9,18.8,12.8,"25% - 50% P.O.C.","$72000 - $96000"
"34015502400","Census Tract 5024, Gloucester County, New Jersey",5924,111324,4691,708,26,47,0,303,79.2,12,0.4,0.8,0,5.1,20.8,2056,1860,196,90.47,9.53,177,1683,0,196,177,1879,9.5,0,8.6,"Less than 25% P.O.C.","$96000 or more"
"34021000100","Census Tract 1, Mercer County, New Jersey",3191,33112,507,564,0,75,0,2020,15.9,17.7,0,2.4,0,63.3,84.1,1145,393,752,34.32,65.68,24,369,133,619,157,988,6.1,17.7,13.7,"75% or more P.O.C.","Less than $51000"
"34021000200","Census Tract 2, Mercer County, New Jersey",4065,45164,875,615,0,58,0,2517,21.5,15.1,0,1.4,0,61.9,78.5,1028,523,505,50.88,49.12,178,345,148,357,326,702,34,29.3,31.7,"75% or more P.O.C.","Less than $51000"
"34021000300","Census Tract 3, Mercer County, New Jersey",4326,40625,849,1416,0,6,0,2055,19.6,32.7,0,0.1,0,47.5,80.4,1257,623,634,49.56,50.44,26,597,148,486,174,1083,4.2,23.3,13.8,"75% or more P.O.C.","Less than $51000"
"34021000400","Census Tract 4, Mercer County, New Jersey",4876,36686,599,589,0,171,0,3451,12.3,12.1,0,3.5,0,70.8,87.7,1415,364,1051,25.72,74.28,71,293,246,805,317,1098,19.5,23.4,22.4,"75% or more P.O.C.","Less than $51000"
"34021000500","Census Tract 5, Mercer County, New Jersey",4641,41368,533,849,0,211,0,2951,11.5,18.3,0,4.5,0,63.6,88.5,1247,373,874,29.91,70.09,60,313,259,615,319,928,16.1,29.6,25.6,"75% or more P.O.C.","Less than $51000"
"34021000600","Census Tract 6, Mercer County, New Jersey",4959,58879,650,1377,0,23,0,2881,13.1,27.8,0,0.5,0,58.1,86.9,1356,936,420,69.03,30.97,207,729,147,273,354,1002,22.1,35,26.1,"75% or more P.O.C.","$51000 - $72000"
"34021000700","Census Tract 7, Mercer County, New Jersey",3743,49159,466,364,0,0,0,2861,12.4,9.7,0,0,0,76.4,87.6,995,236,759,23.72,76.28,96,140,232,527,328,667,40.7,30.6,33,"75% or more P.O.C.","Less than $51000"
"34021000800","Census Tract 8, Mercer County, New Jersey",2282,31821,163,372,0,19,0,1718,7.1,16.3,0,0.8,0,75.3,92.9,781,222,559,28.43,71.57,41,181,104,455,145,636,18.5,18.6,18.6,"75% or more P.O.C.","Less than $51000"
"34021000900","Census Tract 9, Mercer County, New Jersey",3512,25665,386,1884,0,91,0,1051,11,53.6,0,2.6,0,29.9,89,1560,344,1216,22.05,77.95,4,340,105,1111,109,1451,1.2,8.6,7,"75% or more P.O.C.","Less than $51000"
"34021001000","Census Tract 10, Mercer County, New Jersey",2659,17332,215,1399,0,6,0,883,8.1,52.6,0,0.2,0,33.2,91.9,1123,213,910,18.97,81.03,0,213,49,861,49,1074,0,5.4,4.4,"75% or more P.O.C.","Less than $51000"
"34021001101","Census Tract 11.01, Mercer County, New Jersey",2511,34674,108,2160,0,38,0,192,4.3,86,0,1.5,0,7.6,95.7,1036,265,771,25.58,74.42,73,192,19,752,92,944,27.5,2.5,8.9,"75% or more P.O.C.","Less than $51000"
"34021001102","Census Tract 11.02, Mercer County, New Jersey",3063,20517,129,2656,0,20,0,258,4.2,86.7,0,0.7,0,8.4,95.8,1415,249,1166,17.6,82.4,7,242,49,1117,56,1359,2.8,4.2,4,"75% or more P.O.C.","Less than $51000"
"34021001200","Census Tract 12, Mercer County, New Jersey",3722,57019,641,2631,0,94,0,269,17.2,70.7,0,2.5,0,7.2,82.8,1461,779,682,53.32,46.68,55,724,62,620,117,1344,7.1,9.1,8,"75% or more P.O.C.","$51000 - $72000"
"34021001300","Census Tract 13, Mercer County, New Jersey",4488,77321,1067,2951,0,40,0,360,23.8,65.8,0,0.9,0,8,76.2,1111,707,404,63.64,36.36,22,685,83,321,105,1006,3.1,20.5,9.5,"75% or more P.O.C.","$72000 - $96000"
"34021001401","Census Tract 14.01, Mercer County, New Jersey",3666,18641,99,3205,0,10,0,352,2.7,87.4,0,0.3,0,9.6,97.3,1631,390,1241,23.91,76.09,13,377,66,1175,79,1552,3.3,5.3,4.8,"75% or more P.O.C.","Less than $51000"
"34021001402","Census Tract 14.02, Mercer County, New Jersey",2053,42768,8,1702,15,54,0,274,0.4,82.9,0.7,2.6,0,13.3,99.6,603,322,281,53.4,46.6,29,293,69,212,98,505,9,24.6,16.3,"75% or more P.O.C.","Less than $51000"
"34021001500","Census Tract 15, Mercer County, New Jersey",3102,23813,321,2073,0,0,0,639,10.3,66.8,0,0,0,20.6,89.7,1058,329,729,31.1,68.9,0,329,161,568,161,897,0,22.1,15.2,"75% or more P.O.C.","Less than $51000"
"34021001600","Census Tract 16, Mercer County, New Jersey",1267,35694,33,1027,0,2,0,192,2.6,81.1,0,0.2,0,15.2,97.4,454,141,313,31.06,68.94,0,141,52,261,52,402,0,16.6,11.5,"75% or more P.O.C.","Less than $51000"
"34021001700","Census Tract 17, Mercer County, New Jersey",3151,20807,74,2606,0,0,0,460,2.3,82.7,0,0,0,14.6,97.7,1285,360,925,28.02,71.98,14,346,106,819,120,1165,3.9,11.5,9.3,"75% or more P.O.C.","Less than $51000"
"34021001800","Census Tract 18, Mercer County, New Jersey",4484,34332,1337,1594,0,0,0,1492,29.8,35.5,0,0,0,33.3,70.2,1350,528,822,39.11,60.89,50,478,89,733,139,1211,9.5,10.8,10.3,"50% - 75% P.O.C.","Less than $51000"
"34021001900","Census Tract 19, Mercer County, New Jersey",1609,31771,130,638,0,12,0,812,8.1,39.7,0,0.7,0,50.5,91.9,418,144,274,34.45,65.55,34,110,71,203,105,313,23.6,25.9,25.1,"75% or more P.O.C.","Less than $51000"
"34021002000","Census Tract 20, Mercer County, New Jersey",1343,38534,45,892,0,0,0,389,3.4,66.4,0,0,0,29,96.6,429,147,282,34.27,65.73,7,140,22,260,29,400,4.8,7.8,6.8,"75% or more P.O.C.","Less than $51000"
"34021002100","Census Tract 21, Mercer County, New Jersey",4591,30673,529,2440,0,25,0,1574,11.5,53.1,0,0.5,0,34.3,88.5,1702,477,1225,28.03,71.97,45,432,205,1020,250,1452,9.4,16.7,14.7,"75% or more P.O.C.","Less than $51000"
"34021002200","Census Tract 22, Mercer County, New Jersey",5623,52646,200,3214,0,154,0,2055,3.6,57.2,0,2.7,0,36.5,96.4,1701,860,841,50.56,49.44,104,756,173,668,277,1424,12.1,20.6,16.3,"75% or more P.O.C.","$51000 - $72000"
"34021002400","Census Tract 24, Mercer County, New Jersey",485,NA,119,279,0,13,0,74,24.5,57.5,0,2.7,0,15.3,75.5,0,0,0,NA,NA,0,0,0,0,0,0,NA,NA,NA,"75% or more P.O.C.","N/A"
"34021002500","Census Tract 25, Mercer County, New Jersey",6722,64915,3176,811,0,272,0,2457,47.2,12.1,0,4,0,36.6,52.8,2485,1848,637,74.37,25.63,107,1741,32,605,139,2346,5.8,5,5.6,"50% - 75% P.O.C.","$51000 - $72000"
"34021002601","Census Tract 26.01, Mercer County, New Jersey",4674,58750,906,1643,0,142,0,1977,19.4,35.2,0,3,0,42.3,80.6,1372,888,484,64.72,35.28,168,720,115,369,283,1089,18.9,23.8,20.6,"75% or more P.O.C.","$51000 - $72000"
"34021002602","Census Tract 26.02, Mercer County, New Jersey",4425,76692,2059,1082,0,267,0,880,46.5,24.5,0,6,0,19.9,53.5,1641,994,647,60.57,39.43,95,899,11,636,106,1535,9.6,1.7,6.5,"50% - 75% P.O.C.","$72000 - $96000"
"34021002701","Census Tract 27.01, Mercer County, New Jersey",4092,47079,1784,982,0,206,27,1091,43.6,24,0,5,0.7,26.7,56.4,1531,797,734,52.06,47.94,127,670,23,711,150,1381,15.9,3.1,9.8,"50% - 75% P.O.C.","Less than $51000"
"34021002702","Census Tract 27.02, Mercer County, New Jersey",5956,53219,4045,997,0,90,0,599,67.9,16.7,0,1.5,0,10.1,32.1,2851,1262,1589,44.27,55.73,157,1105,15,1574,172,2679,12.4,0.9,6,"25% - 50% P.O.C.","$51000 - $72000"
"34021002800","Census Tract 28, Mercer County, New Jersey",7177,60714,785,3442,52,301,0,2388,10.9,48,0.7,4.2,0,33.3,89.1,2162,1061,1101,49.07,50.93,129,932,168,933,297,1865,12.2,15.3,13.7,"75% or more P.O.C.","$51000 - $72000"
"34021002902","Census Tract 29.02, Mercer County, New Jersey",4683,63949,2419,1395,0,221,0,572,51.7,29.8,0,4.7,0,12.2,48.3,1703,955,748,56.08,43.92,102,853,39,709,141,1562,10.7,5.2,8.3,"25% - 50% P.O.C.","$51000 - $72000"
"34021002903","Census Tract 29.03, Mercer County, New Jersey",3416,105313,2519,182,0,246,34,357,73.7,5.3,0,7.2,1,10.5,26.3,1194,984,210,82.41,17.59,105,879,48,162,153,1041,10.7,22.9,12.8,"25% - 50% P.O.C.","$96000 or more"
"34021002904","Census Tract 29.04, Mercer County, New Jersey",5011,105227,4083,133,0,367,0,307,81.5,2.7,0,7.3,0,6.1,18.5,1858,1570,288,84.5,15.5,94,1476,46,242,140,1718,6,16,7.5,"Less than 25% P.O.C.","$96000 or more"
"34021003001","Census Tract 30.01, Mercer County, New Jersey",5414,98900,4786,257,0,155,0,216,88.4,4.7,0,2.9,0,4,11.6,2144,1778,366,82.93,17.07,105,1673,20,346,125,2019,5.9,5.5,5.8,"Less than 25% P.O.C.","$96000 or more"
"34021003002","Census Tract 30.02, Mercer County, New Jersey",5318,114444,4464,180,0,264,0,358,83.9,3.4,0,5,0,6.7,16.1,1804,1666,138,92.35,7.65,196,1470,0,138,196,1608,11.8,0,10.9,"Less than 25% P.O.C.","$96000 or more"
"34021003003","Census Tract 30.03, Mercer County, New Jersey",6122,86146,5097,166,0,282,0,546,83.3,2.7,0,4.6,0,8.9,16.7,2402,1930,472,80.35,19.65,120,1810,0,472,120,2282,6.2,0,5,"Less than 25% P.O.C.","$72000 - $96000"
"34021003004","Census Tract 30.04, Mercer County, New Jersey",5237,88938,4117,322,0,217,0,426,78.6,6.1,0,4.1,0,8.1,21.4,2133,1647,486,77.22,22.78,46,1601,20,466,66,2067,2.8,4.1,3.1,"Less than 25% P.O.C.","$72000 - $96000"
"34021003006","Census Tract 30.06, Mercer County, New Jersey",5266,99796,4468,39,0,259,0,441,84.8,0.7,0,4.9,0,8.4,15.2,1966,1750,216,89.01,10.99,181,1569,59,157,240,1726,10.3,27.3,12.2,"Less than 25% P.O.C.","$96000 or more"
"34021003007","Census Tract 30.07, Mercer County, New Jersey",3200,116806,2967,58,0,37,0,127,92.7,1.8,0,1.2,0,4,7.3,1099,1056,43,96.09,3.91,128,928,0,43,128,971,12.1,0,11.6,"Less than 25% P.O.C.","$96000 or more"
"34021003008","Census Tract 30.08, Mercer County, New Jersey",5001,85385,3881,141,0,223,0,628,77.6,2.8,0,4.5,0,12.6,22.4,1922,1475,447,76.74,23.26,53,1422,0,447,53,1869,3.6,0,2.8,"Less than 25% P.O.C.","$72000 - $96000"
"34021003009","Census Tract 30.09, Mercer County, New Jersey",5710,72083,4165,776,0,261,0,415,72.9,13.6,0,4.6,0,7.3,27.1,2669,1745,924,65.38,34.62,51,1694,0,924,51,2618,2.9,0,1.9,"25% - 50% P.O.C.","$72000 - $96000"
"34021003100","Census Tract 31, Mercer County, New Jersey",4381,72547,2411,627,0,237,0,991,55,14.3,0,5.4,0,22.6,45,1694,1094,600,64.58,35.42,79,1015,38,562,117,1577,7.2,6.3,6.9,"25% - 50% P.O.C.","$72000 - $96000"
"34021003201","Census Tract 32.01, Mercer County, New Jersey",7859,89324,4737,1573,0,747,4,719,60.3,20,0,9.5,0.1,9.1,39.7,2296,1488,808,64.81,35.19,84,1404,126,682,210,2086,5.6,15.6,9.1,"25% - 50% P.O.C.","$72000 - $96000"
"34021003202","Census Tract 32.02, Mercer County, New Jersey",5565,119135,4400,322,0,625,0,176,79.1,5.8,0,11.2,0,3.2,20.9,2331,1818,513,77.99,22.01,94,1724,37,476,131,2200,5.2,7.2,5.6,"Less than 25% P.O.C.","$96000 or more"
"34021003301","Census Tract 33.01, Mercer County, New Jersey",6863,111504,5793,265,0,365,0,279,84.4,3.9,0,5.3,0,4.1,15.6,2809,2187,622,77.86,22.14,211,1976,0,622,211,2598,9.6,0,7.5,"Less than 25% P.O.C.","$96000 or more"
"34021003302","Census Tract 33.02, Mercer County, New Jersey",7946,118086,3323,672,0,3004,13,759,41.8,8.5,0,37.8,0.2,9.6,58.2,2937,1657,1280,56.42,43.58,121,1536,65,1215,186,2751,7.3,5.1,6.3,"50% - 75% P.O.C.","$96000 or more"
"34021003400","Census Tract 34, Mercer County, New Jersey",2525,71288,829,1469,14,10,0,173,32.8,58.2,0.6,0.4,0,6.9,67.2,926,765,161,82.61,17.39,20,745,0,161,20,906,2.6,0,2.2,"50% - 75% P.O.C.","$51000 - $72000"
"34021003500","Census Tract 35, Mercer County, New Jersey",6905,62292,3367,2626,0,87,0,825,48.8,38,0,1.3,0,11.9,51.2,2857,1892,965,66.22,33.78,143,1749,32,933,175,2682,7.6,3.3,6.1,"50% - 75% P.O.C.","$51000 - $72000"
"34021003601","Census Tract 36.01, Mercer County, New Jersey",3660,67614,1105,1850,0,60,0,538,30.2,50.5,0,1.6,0,14.7,69.8,1305,718,587,55.02,44.98,123,595,49,538,172,1133,17.1,8.3,13.2,"50% - 75% P.O.C.","$51000 - $72000"
"34021003602","Census Tract 36.02, Mercer County, New Jersey",3731,71339,1724,1221,0,122,4,361,46.2,32.7,0,3.3,0.1,9.7,53.8,1244,779,465,62.62,37.38,50,729,67,398,117,1127,6.4,14.4,9.4,"50% - 75% P.O.C.","$51000 - $72000"
"34021003703","Census Tract 37.03, Mercer County, New Jersey",7096,95150,4347,1271,48,541,0,769,61.3,17.9,0.7,7.6,0,10.8,38.7,1324,978,346,73.87,26.13,129,849,0,346,129,1195,13.2,0,9.7,"25% - 50% P.O.C.","$72000 - $96000"
"34021003704","Census Tract 37.04, Mercer County, New Jersey",2877,121442,2134,301,0,262,0,99,74.2,10.5,0,9.1,0,3.4,25.8,1117,846,271,75.74,24.26,36,810,9,262,45,1072,4.3,3.3,4,"25% - 50% P.O.C.","$96000 or more"
"34021003705","Census Tract 37.05, Mercer County, New Jersey",5899,83005,3966,1288,0,167,0,338,67.2,21.8,0,2.8,0,5.7,32.8,2535,1557,978,61.42,38.58,45,1512,20,958,65,2470,2.9,2,2.6,"25% - 50% P.O.C.","$72000 - $96000"
"34021003706","Census Tract 37.06, Mercer County, New Jersey",3344,110236,2394,517,0,397,0,36,71.6,15.5,0,11.9,0,1.1,28.4,1440,1089,351,75.62,24.38,75,1014,15,336,90,1350,6.9,4.3,6.2,"25% - 50% P.O.C.","$96000 or more"
"34021003800","Census Tract 38, Mercer County, New Jersey",7204,120250,5621,607,0,485,0,332,78,8.4,0,6.7,0,4.6,22,2438,2243,195,92,8,222,2021,52,143,274,2164,9.9,26.7,11.2,"Less than 25% P.O.C.","$96000 or more"
"34021003902","Census Tract 39.02, Mercer County, New Jersey",1915,109231,1771,4,0,20,6,90,92.5,0.2,0,1,0.3,4.7,7.5,742,557,185,75.07,24.93,46,511,10,175,56,686,8.3,5.4,7.5,"Less than 25% P.O.C.","$96000 or more"
"34021003903","Census Tract 39.03, Mercer County, New Jersey",2531,132500,2243,111,0,73,0,66,88.6,4.4,0,2.9,0,2.6,11.4,988,725,263,73.38,26.62,59,666,0,263,59,929,8.1,0,6,"Less than 25% P.O.C.","$96000 or more"
"34021003904","Census Tract 39.04, Mercer County, New Jersey",5976,128405,4145,119,0,1300,0,282,69.4,2,0,21.8,0,4.7,30.6,2260,1999,261,88.45,11.55,151,1848,0,261,151,2109,7.6,0,6.7,"25% - 50% P.O.C.","$96000 or more"
"34021003905","Census Tract 39.05, Mercer County, New Jersey",4887,168472,4446,65,0,116,0,260,91,1.3,0,2.4,0,5.3,9,1627,1441,186,88.57,11.43,207,1234,6,180,213,1414,14.4,3.2,13.1,"Less than 25% P.O.C.","$96000 or more"
"34021004000","Census Tract 40, Mercer County, New Jersey",5881,87938,3542,574,0,669,0,872,60.2,9.8,0,11.4,0,14.8,39.8,2396,868,1528,36.23,63.77,60,808,23,1505,83,2313,6.9,1.5,3.5,"25% - 50% P.O.C.","$72000 - $96000"
"34021004201","Census Tract 42.01, Mercer County, New Jersey",7867,144803,5665,452,0,1146,0,512,72,5.7,0,14.6,0,6.5,28,2819,1938,881,68.75,31.25,230,1708,106,775,336,2483,11.9,12,11.9,"25% - 50% P.O.C.","$96000 or more"
"34021004203","Census Tract 42.03, Mercer County, New Jersey",3974,180489,2592,142,0,979,0,83,65.2,3.6,0,24.6,0,2.1,34.8,1527,1219,308,79.83,20.17,101,1118,19,289,120,1407,8.3,6.2,7.9,"25% - 50% P.O.C.","$96000 or more"
"34021004204","Census Tract 42.04, Mercer County, New Jersey",5209,185224,3411,38,0,1144,0,426,65.5,0.7,0,22,0,8.2,34.5,1901,1248,653,65.65,34.35,85,1163,90,563,175,1726,6.8,13.8,9.2,"25% - 50% P.O.C.","$96000 or more"
"34021004301","Census Tract 43.01, Mercer County, New Jersey",8660,115396,2774,570,0,4676,0,408,32,6.6,0,54,0,4.7,68,3281,1334,1947,40.66,59.34,74,1260,31,1916,105,3176,5.5,1.6,3.2,"50% - 75% P.O.C.","$96000 or more"
"34021004304","Census Tract 43.04, Mercer County, New Jersey",7921,191190,3943,57,0,3457,0,217,49.8,0.7,0,43.6,0,2.7,50.2,2790,2597,193,93.08,6.92,152,2445,0,193,152,2638,5.9,0,5.4,"50% - 75% P.O.C.","$96000 or more"
"34021004306","Census Tract 43.06, Mercer County, New Jersey",5618,202628,2343,130,201,2680,0,95,41.7,2.3,3.6,47.7,0,1.7,58.3,1719,1455,264,84.64,15.36,116,1339,0,264,116,1603,8,0,6.7,"50% - 75% P.O.C.","$96000 or more"
"34021004307","Census Tract 43.07, Mercer County, New Jersey",5738,189966,3140,84,0,2357,0,96,54.7,1.5,0,41.1,0,1.7,45.3,2148,1603,545,74.63,25.37,82,1521,0,545,82,2066,5.1,0,3.8,"25% - 50% P.O.C.","$96000 or more"
"34021004309","Census Tract 43.09, Mercer County, New Jersey",4530,157222,3385,153,0,701,0,270,74.7,3.4,0,15.5,0,6,25.3,1462,1304,158,89.19,10.81,152,1152,0,158,152,1310,11.7,0,10.4,"25% - 50% P.O.C.","$96000 or more"
"34021004310","Census Tract 43.10, Mercer County, New Jersey",9835,154291,6121,566,0,2387,0,468,62.2,5.8,0,24.3,0,4.8,37.8,3632,3181,451,87.58,12.42,225,2956,29,422,254,3378,7.1,6.4,7,"25% - 50% P.O.C.","$96000 or more"
"34021004403","Census Tract 44.03, Mercer County, New Jersey",5375,80410,2849,653,0,242,0,1571,53,12.1,0,4.5,0,29.2,47,1867,1161,706,62.19,37.81,46,1115,104,602,150,1717,4,14.7,8,"25% - 50% P.O.C.","$72000 - $96000"
"34021004404","Census Tract 44.04, Mercer County, New Jersey",6870,89746,2871,729,0,494,0,2761,41.8,10.6,0,7.2,0,40.2,58.2,2284,1646,638,72.07,27.93,214,1432,80,558,294,1990,13,12.5,12.9,"50% - 75% P.O.C.","$72000 - $96000"
"34021004405","Census Tract 44.05, Mercer County, New Jersey",8453,115607,3677,788,0,2746,0,1133,43.5,9.3,0,32.5,0,13.4,56.5,2961,1955,1006,66.02,33.98,240,1715,62,944,302,2659,12.3,6.2,10.2,"50% - 75% P.O.C.","$96000 or more"
"34021004406","Census Tract 44.06, Mercer County, New Jersey",4955,57782,2403,19,0,1053,0,1371,48.5,0.4,0,21.3,0,27.7,51.5,2213,1245,968,56.26,43.74,15,1230,19,949,34,2179,1.2,2,1.5,"50% - 75% P.O.C.","$51000 - $72000"
"34021004407","Census Tract 44.07, Mercer County, New Jersey",6967,96074,3990,593,0,1161,0,1140,57.3,8.5,0,16.7,0,16.4,42.7,2253,1286,967,57.08,42.92,237,1049,52,915,289,1964,18.4,5.4,12.8,"25% - 50% P.O.C.","$96000 or more"
"34021004501","Census Tract 45.01, Mercer County, New Jersey",6762,170313,4480,436,0,1201,0,384,66.3,6.4,0,17.8,0,5.7,33.7,738,380,358,51.49,48.51,32,348,14,344,46,692,8.4,3.9,6.2,"25% - 50% P.O.C.","$96000 or more"
"34021004502","Census Tract 45.02, Mercer County, New Jersey",1307,138929,1136,34,0,87,0,39,86.9,2.6,0,6.7,0,3,13.1,578,341,237,59,41,51,290,0,237,51,527,15,0,8.8,"Less than 25% P.O.C.","$96000 or more"
"34033020100","Census Tract 201, Salem County, New Jersey",1760,82500,1478,94,17,8,0,110,84,5.3,1,0.5,0,6.2,16,638,562,76,88.09,11.91,45,517,3,73,48,590,8,3.9,7.5,"Less than 25% P.O.C.","$72000 - $96000"
"34033020200","Census Tract 202, Salem County, New Jersey",2063,48125,385,755,0,48,0,857,18.7,36.6,0,2.3,0,41.5,81.3,677,310,367,45.79,54.21,44,266,46,321,90,587,14.2,12.5,13.3,"75% or more P.O.C.","Less than $51000"
"34033020300","Census Tract 203, Salem County, New Jersey",2753,22260,861,742,0,3,0,916,31.3,27,0,0.1,0,33.3,68.7,1078,213,865,19.76,80.24,20,193,63,802,83,995,9.4,7.3,7.7,"50% - 75% P.O.C.","Less than $51000"
"34033020400","Census Tract 204, Salem County, New Jersey",2769,51306,1356,628,3,21,0,751,49,22.7,0.1,0.8,0,27.1,51,1024,470,554,45.9,54.1,49,421,0,554,49,975,10.4,0,4.8,"50% - 75% P.O.C.","$51000 - $72000"
"34033020500","Census Tract 205, Salem County, New Jersey",2665,57723,1889,489,0,12,0,195,70.9,18.3,0,0.5,0,7.3,29.1,1133,841,292,74.23,25.77,89,752,10,282,99,1034,10.6,3.4,8.7,"25% - 50% P.O.C.","$51000 - $72000"
"34033020600","Census Tract 206, Salem County, New Jersey",2300,63681,1772,120,10,6,0,370,77,5.2,0.4,0.3,0,16.1,23,832,641,191,77.04,22.96,71,570,15,176,86,746,11.1,7.9,10.3,"Less than 25% P.O.C.","$51000 - $72000"
"34033020700","Census Tract 207, Salem County, New Jersey",4011,102703,3639,183,0,111,0,78,90.7,4.6,0,2.8,0,1.9,9.3,1619,1299,320,80.23,19.77,95,1204,13,307,108,1511,7.3,4.1,6.7,"Less than 25% P.O.C.","$96000 or more"
"34033020800","Census Tract 208, Salem County, New Jersey",3456,77083,2851,129,0,7,0,300,82.5,3.7,0,0.2,0,8.7,17.5,1255,674,581,53.71,46.29,93,581,58,523,151,1104,13.8,10,12,"Less than 25% P.O.C.","$72000 - $96000"
"34033020900","Census Tract 209, Salem County, New Jersey",3373,86622,2987,59,18,50,0,168,88.6,1.7,0.5,1.5,0,5,11.4,1122,950,172,84.67,15.33,97,853,26,146,123,999,10.2,15.1,11,"Less than 25% P.O.C.","$72000 - $96000"
"34033021000","Census Tract 210, Salem County, New Jersey",1436,77734,1312,17,0,24,0,45,91.4,1.2,0,1.7,0,3.1,8.6,495,339,156,68.48,31.52,47,292,13,143,60,435,13.9,8.3,12.1,"Less than 25% P.O.C.","$72000 - $96000"
"34033021101","Census Tract 211.01, Salem County, New Jersey",4650,88971,4403,25,0,54,0,58,94.7,0.5,0,1.2,0,1.2,5.3,1750,1641,109,93.77,6.23,110,1531,0,109,110,1640,6.7,0,6.3,"Less than 25% P.O.C.","$72000 - $96000"
"34033021102","Census Tract 211.02, Salem County, New Jersey",4248,67978,3170,605,20,2,0,322,74.6,14.2,0.5,0,0,7.6,25.4,1643,1504,139,91.54,8.46,127,1377,0,139,127,1516,8.4,0,7.7,"25% - 50% P.O.C.","$51000 - $72000"
"34033021201","Census Tract 212.01, Salem County, New Jersey",3220,89250,2864,121,0,32,31,89,88.9,3.8,0,1,1,2.8,11.1,1179,1067,112,90.5,9.5,100,967,15,97,115,1064,9.4,13.4,9.8,"Less than 25% P.O.C.","$72000 - $96000"
"34033021202","Census Tract 212.02, Salem County, New Jersey",2278,64500,1761,369,9,0,0,139,77.3,16.2,0.4,0,0,6.1,22.7,940,812,128,86.38,13.62,49,763,8,120,57,883,6,6.2,6.1,"Less than 25% P.O.C.","$51000 - $72000"
"34033021300","Census Tract 213, Salem County, New Jersey",1885,86607,1335,254,40,25,0,205,70.8,13.5,2.1,1.3,0,10.9,29.2,495,452,43,91.31,8.69,48,404,9,34,57,438,10.6,20.9,11.5,"25% - 50% P.O.C.","$72000 - $96000"
"34033021400","Census Tract 214, Salem County, New Jersey",3255,68906,2841,89,29,38,0,166,87.3,2.7,0.9,1.2,0,5.1,12.7,1338,1047,291,78.25,21.75,61,986,33,258,94,1244,5.8,11.3,7,"Less than 25% P.O.C.","$51000 - $72000"
"34033021500","Census Tract 215, Salem County, New Jersey",1901,55341,1507,199,0,64,0,60,79.3,10.5,0,3.4,0,3.2,20.7,717,451,266,62.9,37.1,60,391,0,266,60,657,13.3,0,8.4,"Less than 25% P.O.C.","$51000 - $72000"
"34033021600","Census Tract 216, Salem County, New Jersey",5411,71284,5122,57,0,84,0,135,94.7,1.1,0,1.6,0,2.5,5.3,2142,1695,447,79.13,20.87,187,1508,33,414,220,1922,11,7.4,10.3,"Less than 25% P.O.C.","$51000 - $72000"
"34033021700","Census Tract 217, Salem County, New Jersey",2004,67083,1659,158,0,47,0,31,82.8,7.9,0,2.3,0,1.5,17.2,922,528,394,57.27,42.73,31,497,14,380,45,877,5.9,3.6,4.9,"Less than 25% P.O.C.","$51000 - $72000"
"34033021900","Census Tract 219, Salem County, New Jersey",1382,33393,429,701,0,0,0,193,31,50.7,0,0,0,14,69,589,288,301,48.9,51.1,14,274,45,256,59,530,4.9,15,10,"50% - 75% P.O.C.","Less than $51000"
"34033022000","Census Tract 220, Salem County, New Jersey",1897,17656,261,1311,0,13,0,261,13.8,69.1,0,0.7,0,13.8,86.2,658,114,544,17.33,82.67,2,112,47,497,49,609,1.8,8.6,7.4,"75% or more P.O.C.","Less than $51000"
"34033022100","Census Tract 221, Salem County, New Jersey",1502,25219,436,806,0,0,0,142,29,53.7,0,0,0,9.5,71,617,234,383,37.93,62.07,0,234,60,323,60,557,0,15.7,9.7,"50% - 75% P.O.C.","Less than $51000"
"34033022201","Census Tract 222.01, Salem County, New Jersey",1719,95000,1599,72,10,0,0,31,93,4.2,0.6,0,0,1.8,7,646,530,116,82.04,17.96,71,459,0,116,71,575,13.4,0,11,"Less than 25% P.O.C.","$72000 - $96000"
"34033022202","Census Tract 222.02, Salem County, New Jersey",1052,88182,855,124,3,14,0,54,81.3,11.8,0.3,1.3,0,5.1,18.7,424,357,67,84.2,15.8,31,326,3,64,34,390,8.7,4.5,8,"Less than 25% P.O.C.","$72000 - $96000"
"34033990000","Census Tract 9900, Salem County, New Jersey",0,NA,0,0,0,0,0,0,NA,NA,NA,NA,NA,NA,NA,0,0,0,NA,NA,0,0,0,0,0,0,NA,NA,NA,"N/A","N/A"
"42011000100","Census Tract 1, Berks County, Pennsylvania",4829,16629,1097,615,5,50,0,3029,22.7,12.7,0.1,1,0,62.7,77.3,2378,200,2178,8.41,91.59,0,200,91,2087,91,2287,0,4.2,3.8,"75% or more P.O.C.","Less than $51000"
"42011000200","Census Tract 2, Berks County, Pennsylvania",4054,20655,850,309,0,52,0,2710,21,7.6,0,1.3,0,66.8,79,1661,536,1125,32.27,67.73,126,410,18,1107,144,1517,23.5,1.6,8.7,"75% or more P.O.C.","Less than $51000"
"42011000300","Census Tract 3, Berks County, Pennsylvania",2384,49007,635,191,0,33,0,1470,26.6,8,0,1.4,0,61.7,73.4,741,515,226,69.5,30.5,65,450,34,192,99,642,12.6,15,13.4,"50% - 75% P.O.C.","Less than $51000"
"42011000400","Census Tract 4, Berks County, Pennsylvania",3716,32371,662,623,0,0,0,2338,17.8,16.8,0,0,0,62.9,82.2,1206,510,696,42.29,57.71,64,446,167,529,231,975,12.5,24,19.2,"75% or more P.O.C.","Less than $51000"
"42011000500","Census Tract 5, Berks County, Pennsylvania",4161,44130,784,102,0,0,0,3206,18.8,2.5,0,0,0,77,81.2,1296,743,553,57.33,42.67,188,555,126,427,314,982,25.3,22.8,24.2,"75% or more P.O.C.","Less than $51000"
"42011000600","Census Tract 6, Berks County, Pennsylvania",3453,66875,1830,273,7,36,0,1196,53,7.9,0.2,1,0,34.6,47,894,682,212,76.29,23.71,110,572,11,201,121,773,16.1,5.2,13.5,"25% - 50% P.O.C.","$51000 - $72000"
"42011000700","Census Tract 7, Berks County, Pennsylvania",4538,54031,965,122,0,8,0,3381,21.3,2.7,0,0.2,0,74.5,78.7,1227,641,586,52.24,47.76,217,424,178,408,395,832,33.9,30.4,32.2,"75% or more P.O.C.","$51000 - $72000"
"42011000800","Census Tract 8, Berks County, Pennsylvania",4492,35326,712,172,0,0,0,3563,15.9,3.8,0,0,0,79.3,84.1,1266,522,744,41.23,58.77,159,363,192,552,351,915,30.5,25.8,27.7,"75% or more P.O.C.","Less than $51000"
"42011000900","Census Tract 9, Berks County, Pennsylvania",2524,32083,592,307,63,115,0,1390,23.5,12.2,2.5,4.6,0,55.1,76.5,921,288,633,31.27,68.73,92,196,68,565,160,761,31.9,10.7,17.4,"75% or more P.O.C.","Less than $51000"
"42011001000","Census Tract 10, Berks County, Pennsylvania",2987,30117,261,162,0,102,0,2337,8.7,5.4,0,3.4,0,78.2,91.3,969,386,583,39.83,60.17,61,325,101,482,162,807,15.8,17.3,16.7,"75% or more P.O.C.","Less than $51000"
"42011001100","Census Tract 11, Berks County, Pennsylvania",3986,40280,274,588,3,7,0,3039,6.9,14.8,0.1,0.2,0,76.2,93.1,1152,544,608,47.22,52.78,94,450,171,437,265,887,17.3,28.1,23,"75% or more P.O.C.","Less than $51000"
"42011001200","Census Tract 12, Berks County, Pennsylvania",1732,28984,169,177,0,0,0,1324,9.8,10.2,0,0,0,76.4,90.2,478,272,206,56.9,43.1,37,235,43,163,80,398,13.6,20.9,16.7,"75% or more P.O.C.","Less than $51000"
"42011001300","Census Tract 13, Berks County, Pennsylvania",3331,26047,382,132,1,7,0,2788,11.5,4,0,0.2,0,83.7,88.5,1075,213,862,19.81,80.19,79,134,144,718,223,852,37.1,16.7,20.7,"75% or more P.O.C.","Less than $51000"
"42011001400","Census Tract 14, Berks County, Pennsylvania",3765,21276,302,298,0,18,0,3118,8,7.9,0,0.5,0,82.8,92,1349,332,1017,24.61,75.39,41,291,111,906,152,1197,12.3,10.9,11.3,"75% or more P.O.C.","Less than $51000"
"42011001500","Census Tract 15, Berks County, Pennsylvania",3543,21659,477,233,0,0,0,2827,13.5,6.6,0,0,0,79.8,86.5,971,355,616,36.56,63.44,64,291,147,469,211,760,18,23.9,21.7,"75% or more P.O.C.","Less than $51000"
"42011001600","Census Tract 16, Berks County, Pennsylvania",3112,42847,509,141,0,97,0,2258,16.4,4.5,0,3.1,0,72.6,83.6,853,439,414,51.47,48.53,76,363,165,249,241,612,17.3,39.9,28.3,"75% or more P.O.C.","Less than $51000"
"42011001700","Census Tract 17, Berks County, Pennsylvania",3252,32480,260,171,0,0,0,2789,8,5.3,0,0,0,85.8,92,985,364,621,36.95,63.05,119,245,116,505,235,750,32.7,18.7,23.9,"75% or more P.O.C.","Less than $51000"
"42011001800","Census Tract 18, Berks County, Pennsylvania",2585,46875,1148,387,0,26,0,1024,44.4,15,0,1,0,39.6,55.6,930,416,514,44.73,55.27,105,311,87,427,192,738,25.2,16.9,20.6,"50% - 75% P.O.C.","Less than $51000"
"42011001900","Census Tract 19, Berks County, Pennsylvania",2187,23442,648,264,0,28,0,1188,29.6,12.1,0,1.3,0,54.3,70.4,997,204,793,20.46,79.54,51,153,62,731,113,884,25,7.8,11.3,"50% - 75% P.O.C.","Less than $51000"
"42011002000","Census Tract 20, Berks County, Pennsylvania",4285,37712,1081,751,0,28,0,2390,25.2,17.5,0,0.7,0,55.8,74.8,1431,610,821,42.63,57.37,10,600,172,649,182,1249,1.6,21,12.7,"50% - 75% P.O.C.","Less than $51000"
"42011002100","Census Tract 21, Berks County, Pennsylvania",2607,39761,462,220,12,30,0,1849,17.7,8.4,0.5,1.2,0,70.9,82.3,811,405,406,49.94,50.06,70,335,116,290,186,625,17.3,28.6,22.9,"75% or more P.O.C.","Less than $51000"
"42011002200","Census Tract 22, Berks County, Pennsylvania",2171,29107,244,102,0,0,0,1806,11.2,4.7,0,0,0,83.2,88.8,649,263,386,40.52,59.48,76,187,59,327,135,514,28.9,15.3,20.8,"75% or more P.O.C.","Less than $51000"
"42011002300","Census Tract 23, Berks County, Pennsylvania",2622,29688,350,340,0,7,0,1882,13.3,13,0,0.3,0,71.8,86.7,773,319,454,41.27,58.73,42,277,85,369,127,646,13.2,18.7,16.4,"75% or more P.O.C.","Less than $51000"
"42011002500","Census Tract 25, Berks County, Pennsylvania",3132,20909,405,309,0,16,0,2163,12.9,9.9,0,0.5,0,69.1,87.1,1244,309,935,24.84,75.16,65,244,79,856,144,1100,21,8.4,11.6,"75% or more P.O.C.","Less than $51000"
"42011002600","Census Tract 26, Berks County, Pennsylvania",3370,28292,490,360,6,32,0,2444,14.5,10.7,0.2,0.9,0,72.5,85.5,1103,185,918,16.77,83.23,18,167,139,779,157,946,9.7,15.1,14.2,"75% or more P.O.C.","Less than $51000"
"42011002700","Census Tract 27, Berks County, Pennsylvania",2003,54375,1293,153,0,66,0,456,64.6,7.6,0,3.3,0,22.8,35.4,874,648,226,74.14,25.86,33,615,0,226,33,841,5.1,0,3.8,"25% - 50% P.O.C.","$51000 - $72000"
"42011002900","Census Tract 29, Berks County, Pennsylvania",3411,57202,1922,282,0,18,0,1120,56.3,8.3,0,0.5,0,32.8,43.7,836,562,274,67.22,32.78,62,500,30,244,92,744,11,10.9,11,"25% - 50% P.O.C.","$51000 - $72000"
"42011010100","Census Tract 101, Berks County, Pennsylvania",6036,69564,5744,10,35,32,0,215,95.2,0.2,0.6,0.5,0,3.6,4.8,2117,1818,299,85.88,14.12,266,1552,57,242,323,1794,14.6,19.1,15.3,"Less than 25% P.O.C.","$51000 - $72000"
"42011010201","Census Tract 102.01, Berks County, Pennsylvania",4406,67092,4224,1,0,0,0,166,95.9,0,0,0,0,3.8,4.1,1780,1523,257,85.56,14.44,92,1431,3,254,95,1685,6,1.2,5.3,"Less than 25% P.O.C.","$51000 - $72000"
"42011010202","Census Tract 102.02, Berks County, Pennsylvania",5137,57738,4888,153,0,20,0,59,95.2,3,0,0.4,0,1.1,4.8,2062,1625,437,78.81,21.19,81,1544,40,397,121,1941,5,9.2,5.9,"Less than 25% P.O.C.","$51000 - $72000"
"42011010302","Census Tract 103.02, Berks County, Pennsylvania",2918,79125,2605,64,0,14,0,198,89.3,2.2,0,0.5,0,6.8,10.7,1134,944,190,83.25,16.75,75,869,40,150,115,1019,7.9,21.1,10.1,"Less than 25% P.O.C.","$72000 - $96000"
"42011010303","Census Tract 103.03, Berks County, Pennsylvania",2144,68615,1956,10,0,20,0,148,91.2,0.5,0,0.9,0,6.9,8.8,779,581,198,74.58,25.42,94,487,14,184,108,671,16.2,7.1,13.9,"Less than 25% P.O.C.","$51000 - $72000"
"42011010304","Census Tract 103.04, Berks County, Pennsylvania",6801,80325,5231,221,30,207,0,1018,76.9,3.2,0.4,3,0,15,23.1,1909,1655,254,86.69,13.31,199,1456,0,254,199,1710,12,0,10.4,"Less than 25% P.O.C.","$72000 - $96000"
"42011010400","Census Tract 104, Berks County, Pennsylvania",8491,72979,7791,86,0,91,0,402,91.8,1,0,1.1,0,4.7,8.2,2927,2405,522,82.17,17.83,282,2123,50,472,332,2595,11.7,9.6,11.3,"Less than 25% P.O.C.","$72000 - $96000"
"42011010500","Census Tract 105, Berks County, Pennsylvania",6533,64099,5869,112,11,65,0,431,89.8,1.7,0.2,1,0,6.6,10.2,2512,1843,669,73.37,26.63,152,1691,48,621,200,2312,8.2,7.2,8,"Less than 25% P.O.C.","$51000 - $72000"
"42011010600","Census Tract 106, Berks County, Pennsylvania",8758,82335,7603,110,0,322,17,534,86.8,1.3,0,3.7,0.2,6.1,13.2,3366,2690,676,79.92,20.08,311,2379,13,663,324,3042,11.6,1.9,9.6,"Less than 25% P.O.C.","$72000 - $96000"
"42011010700","Census Tract 107, Berks County, Pennsylvania",7461,92250,6283,419,0,113,0,426,84.2,5.6,0,1.5,0,5.7,15.8,2623,2261,362,86.2,13.8,299,1962,0,362,299,2324,13.2,0,11.4,"Less than 25% P.O.C.","$72000 - $96000"
"42011010801","Census Tract 108.01, Berks County, Pennsylvania",1887,77008,1774,9,7,16,0,44,94,0.5,0.4,0.8,0,2.3,6,711,585,126,82.28,17.72,52,533,0,126,52,659,8.9,0,7.3,"Less than 25% P.O.C.","$72000 - $96000"
"42011010802","Census Tract 108.02, Berks County, Pennsylvania",9301,79583,6648,693,0,162,0,1641,71.5,7.5,0,1.7,0,17.6,28.5,3309,2197,1112,66.39,33.61,112,2085,136,976,248,3061,5.1,12.2,7.5,"25% - 50% P.O.C.","$72000 - $96000"
"42011010902","Census Tract 109.02, Berks County, Pennsylvania",4101,57547,3028,171,50,234,0,605,73.8,4.2,1.2,5.7,0,14.8,26.2,1646,875,771,53.16,46.84,78,797,41,730,119,1527,8.9,5.3,7.2,"25% - 50% P.O.C.","$51000 - $72000"
"42011010903","Census Tract 109.03, Berks County, Pennsylvania",6419,79214,5056,180,0,217,0,764,78.8,2.8,0,3.4,0,11.9,21.2,2434,2066,368,84.88,15.12,228,1838,0,368,228,2206,11,0,9.4,"Less than 25% P.O.C.","$72000 - $96000"
"42011010904","Census Tract 109.04, Berks County, Pennsylvania",3827,81250,2763,97,0,278,0,655,72.2,2.5,0,7.3,0,17.1,27.8,1432,1273,159,88.9,11.1,151,1122,0,159,151,1281,11.9,0,10.5,"25% - 50% P.O.C.","$72000 - $96000"
"42011010905","Census Tract 109.05, Berks County, Pennsylvania",4659,79821,3526,168,32,55,0,861,75.7,3.6,0.7,1.2,0,18.5,24.3,1879,1531,348,81.48,18.52,55,1476,46,302,101,1778,3.6,13.2,5.4,"Less than 25% P.O.C.","$72000 - $96000"
"42011011000","Census Tract 110, Berks County, Pennsylvania",4353,68810,3184,220,0,98,0,728,73.1,5.1,0,2.3,0,16.7,26.9,1726,1414,312,81.92,18.08,125,1289,49,263,174,1552,8.8,15.7,10.1,"25% - 50% P.O.C.","$51000 - $72000"
"42011011101","Census Tract 111.01, Berks County, Pennsylvania",2117,50543,1564,92,0,176,0,180,73.9,4.3,0,8.3,0,8.5,26.1,1088,186,902,17.1,82.9,24,162,0,902,24,1064,12.9,0,2.2,"25% - 50% P.O.C.","Less than $51000"
"42011011102","Census Tract 111.02, Berks County, Pennsylvania",5570,106973,4863,78,0,56,0,540,87.3,1.4,0,1,0,9.7,12.7,2209,1695,514,76.73,23.27,110,1585,41,473,151,2058,6.5,8,6.8,"Less than 25% P.O.C.","$96000 or more"
"42011011200","Census Tract 112, Berks County, Pennsylvania",4268,47071,2462,299,0,130,0,1109,57.7,7,0,3,0,26,42.3,1570,900,670,57.32,42.68,82,818,53,617,135,1435,9.1,7.9,8.6,"25% - 50% P.O.C.","Less than $51000"
"42011011300","Census Tract 113, Berks County, Pennsylvania",2803,55272,1843,210,0,0,0,734,65.8,7.5,0,0,0,26.2,34.2,1097,890,207,81.13,18.87,81,809,28,179,109,988,9.1,13.5,9.9,"25% - 50% P.O.C.","$51000 - $72000"
"42011011400","Census Tract 114, Berks County, Pennsylvania",5300,65032,4276,34,0,0,0,803,80.7,0.6,0,0,0,15.2,19.3,2183,1674,509,76.68,23.32,52,1622,109,400,161,2022,3.1,21.4,7.4,"Less than 25% P.O.C.","$51000 - $72000"
"42011011500","Census Tract 115, Berks County, Pennsylvania",3015,70819,2577,0,0,9,0,408,85.5,0,0,0.3,0,13.5,14.5,1196,807,389,67.47,32.53,59,748,47,342,106,1090,7.3,12.1,8.9,"Less than 25% P.O.C.","$51000 - $72000"
"42011011601","Census Tract 116.01, Berks County, Pennsylvania",5127,55682,3838,409,0,86,0,773,74.9,8,0,1.7,0,15.1,25.1,2250,1232,1018,54.76,45.24,126,1106,47,971,173,2077,10.2,4.6,7.7,"25% - 50% P.O.C.","$51000 - $72000"
"42011011602","Census Tract 116.02, Berks County, Pennsylvania",4211,80114,3495,127,19,130,0,270,83,3,0.5,3.1,0,6.4,17,1662,1524,138,91.7,8.3,175,1349,0,138,175,1487,11.5,0,10.5,"Less than 25% P.O.C.","$72000 - $96000"
"42011011603","Census Tract 116.03, Berks County, Pennsylvania",6076,79911,5329,115,0,137,0,465,87.7,1.9,0,2.3,0,7.7,12.3,2695,1744,951,64.71,35.29,195,1549,13,938,208,2487,11.2,1.4,7.7,"Less than 25% P.O.C.","$72000 - $96000"
"42011011701","Census Tract 117.01, Berks County, Pennsylvania",7379,81029,6956,90,0,32,0,191,94.3,1.2,0,0.4,0,2.6,5.7,2656,2423,233,91.23,8.77,244,2179,18,215,262,2394,10.1,7.7,9.9,"Less than 25% P.O.C.","$72000 - $96000"
"42011011702","Census Tract 117.02, Berks County, Pennsylvania",4689,90417,4450,45,0,24,0,70,94.9,1,0,0.5,0,1.5,5.1,1815,1581,234,87.11,12.89,134,1447,0,234,134,1681,8.5,0,7.4,"Less than 25% P.O.C.","$72000 - $96000"
"42011011703","Census Tract 117.03, Berks County, Pennsylvania",4218,92917,4022,35,0,56,0,26,95.4,0.8,0,1.3,0,0.6,4.6,1505,1197,308,79.53,20.47,155,1042,34,274,189,1316,12.9,11,12.6,"Less than 25% P.O.C.","$72000 - $96000"
"42011011800","Census Tract 118, Berks County, Pennsylvania",5131,64722,4756,52,0,68,0,162,92.7,1,0,1.3,0,3.2,7.3,2058,1678,380,81.54,18.46,173,1505,25,355,198,1860,10.3,6.6,9.6,"Less than 25% P.O.C.","$51000 - $72000"
"42011011902","Census Tract 119.02, Berks County, Pennsylvania",3664,84815,3265,13,0,0,0,339,89.1,0.4,0,0,0,9.3,10.9,1440,1208,232,83.89,16.11,124,1084,53,179,177,1263,10.3,22.8,12.3,"Less than 25% P.O.C.","$72000 - $96000"
"42011011903","Census Tract 119.03, Berks County, Pennsylvania",5040,119167,4475,94,0,162,0,164,88.8,1.9,0,3.2,0,3.3,11.2,1640,1540,100,93.9,6.1,274,1266,0,100,274,1366,17.8,0,16.7,"Less than 25% P.O.C.","$96000 or more"
"42011011904","Census Tract 119.04, Berks County, Pennsylvania",7967,91974,6725,389,9,104,0,720,84.4,4.9,0.1,1.3,0,9,15.6,2906,2380,526,81.9,18.1,258,2122,38,488,296,2610,10.8,7.2,10.2,"Less than 25% P.O.C.","$72000 - $96000"
"42011012001","Census Tract 120.01, Berks County, Pennsylvania",2375,50625,1904,296,0,0,0,72,80.2,12.5,0,0,0,3,19.8,982,824,158,83.91,16.09,98,726,26,132,124,858,11.9,16.5,12.6,"Less than 25% P.O.C.","Less than $51000"
"42011012002","Census Tract 120.02, Berks County, Pennsylvania",9498,78539,7833,476,8,120,0,911,82.5,5,0.1,1.3,0,9.6,17.5,3736,2926,810,78.32,21.68,198,2728,50,760,248,3488,6.8,6.2,6.6,"Less than 25% P.O.C.","$72000 - $96000"
"42011012101","Census Tract 121.01, Berks County, Pennsylvania",2022,63750,1733,63,0,30,0,157,85.7,3.1,0,1.5,0,7.8,14.3,807,555,252,68.77,31.23,65,490,22,230,87,720,11.7,8.7,10.8,"Less than 25% P.O.C.","$51000 - $72000"
"42011012103","Census Tract 121.03, Berks County, Pennsylvania",2374,80875,2186,0,0,72,0,101,92.1,0,0,3,0,4.3,7.9,879,757,122,86.12,13.88,59,698,18,104,77,802,7.8,14.8,8.8,"Less than 25% P.O.C.","$72000 - $96000"
"42011012104","Census Tract 121.04, Berks County, Pennsylvania",3048,79519,2427,205,0,15,0,358,79.6,6.7,0,0.5,0,11.7,20.4,1159,1017,142,87.75,12.25,64,953,0,142,64,1095,6.3,0,5.5,"Less than 25% P.O.C.","$72000 - $96000"
"42011012105","Census Tract 121.05, Berks County, Pennsylvania",8394,103534,7166,338,0,291,0,496,85.4,4,0,3.5,0,5.9,14.6,2832,2700,132,95.34,4.66,313,2387,22,110,335,2497,11.6,16.7,11.8,"Less than 25% P.O.C.","$96000 or more"
"42011012200","Census Tract 122, Berks County, Pennsylvania",3217,48393,1985,170,0,77,0,788,61.7,5.3,0,2.4,0,24.5,38.3,1347,857,490,63.62,36.38,54,803,19,471,73,1274,6.3,3.9,5.4,"25% - 50% P.O.C.","Less than $51000"
"42011012300","Census Tract 123, Berks County, Pennsylvania",4551,60139,3735,81,0,48,33,583,82.1,1.8,0,1.1,0.7,12.8,17.9,1801,1286,515,71.4,28.6,112,1174,10,505,122,1679,8.7,1.9,6.8,"Less than 25% P.O.C.","$51000 - $72000"
"42011012400","Census Tract 124, Berks County, Pennsylvania",7023,63724,4177,554,0,93,0,2151,59.5,7.9,0,1.3,0,30.6,40.5,2578,1774,804,68.81,31.19,168,1606,90,714,258,2320,9.5,11.2,10,"25% - 50% P.O.C.","$51000 - $72000"
"42011012500","Census Tract 125, Berks County, Pennsylvania",2117,57429,1260,40,0,0,0,803,59.5,1.9,0,0,0,37.9,40.5,766,679,87,88.64,11.36,61,618,18,69,79,687,9,20.7,10.3,"25% - 50% P.O.C.","$51000 - $72000"
"42011012600","Census Tract 126, Berks County, Pennsylvania",2323,54745,1066,281,0,0,0,890,45.9,12.1,0,0,0,38.3,54.1,797,625,172,78.42,21.58,141,484,13,159,154,643,22.6,7.6,19.3,"50% - 75% P.O.C.","$51000 - $72000"
"42011012700","Census Tract 127, Berks County, Pennsylvania",8760,75452,6589,685,15,276,0,1062,75.2,7.8,0.2,3.2,0,12.1,24.8,3422,3175,247,92.78,7.22,178,2997,9,238,187,3235,5.6,3.6,5.5,"Less than 25% P.O.C.","$72000 - $96000"
"42011012800","Census Tract 128, Berks County, Pennsylvania",3900,54483,2741,156,0,8,0,926,70.3,4,0,0.2,0,23.7,29.7,1554,1318,236,84.81,15.19,71,1247,29,207,100,1454,5.4,12.3,6.4,"25% - 50% P.O.C.","$51000 - $72000"
"42011012900","Census Tract 129, Berks County, Pennsylvania",7703,72939,7189,46,0,10,0,458,93.3,0.6,0,0.1,0,5.9,6.7,3240,2680,560,82.72,17.28,165,2515,0,560,165,3075,6.2,0,5.1,"Less than 25% P.O.C.","$72000 - $96000"
"42011013000","Census Tract 130, Berks County, Pennsylvania",6854,72790,6305,186,0,0,0,249,92,2.7,0,0,0,3.6,8,2641,2524,117,95.57,4.43,215,2309,10,107,225,2416,8.5,8.5,8.5,"Less than 25% P.O.C.","$72000 - $96000"
"42011013100","Census Tract 131, Berks County, Pennsylvania",5139,79452,5020,0,0,60,0,0,97.7,0,0,1.2,0,0,2.3,2156,1827,329,84.74,15.26,35,1792,0,329,35,2121,1.9,0,1.6,"Less than 25% P.O.C.","$72000 - $96000"
"42011013200","Census Tract 132, Berks County, Pennsylvania",4064,51392,3513,257,0,41,0,240,86.4,6.3,0,1,0,5.9,13.6,1857,939,918,50.57,49.43,135,804,56,862,191,1666,14.4,6.1,10.3,"Less than 25% P.O.C.","$51000 - $72000"
"42011013301","Census Tract 133.01, Berks County, Pennsylvania",2984,74583,2826,10,0,91,0,52,94.7,0.3,0,3,0,1.7,5.3,1250,1153,97,92.24,7.76,60,1093,4,93,64,1186,5.2,4.1,5.1,"Less than 25% P.O.C.","$72000 - $96000"
"42011013302","Census Tract 133.02, Berks County, Pennsylvania",6525,73326,6404,33,0,6,0,70,98.1,0.5,0,0.1,0,1.1,1.9,2658,2108,550,79.31,20.69,134,1974,29,521,163,2495,6.4,5.3,6.1,"Less than 25% P.O.C.","$72000 - $96000"
"42011013401","Census Tract 134.01, Berks County, Pennsylvania",7974,86167,7922,0,0,0,0,16,99.3,0,0,0,0,0.2,0.7,3008,2783,225,92.52,7.48,359,2424,0,225,359,2649,12.9,0,11.9,"Less than 25% P.O.C.","$72000 - $96000"
"42011013402","Census Tract 134.02, Berks County, Pennsylvania",2986,86875,2830,6,29,16,0,22,94.8,0.2,1,0.5,0,0.7,5.2,1189,1078,111,90.66,9.34,75,1003,7,104,82,1107,7,6.3,6.9,"Less than 25% P.O.C.","$72000 - $96000"
"42011013500","Census Tract 135, Berks County, Pennsylvania",12039,88955,10237,479,0,293,0,944,85,4,0,2.4,0,7.8,15,4549,3861,688,84.88,15.12,234,3627,68,620,302,4247,6.1,9.9,6.6,"Less than 25% P.O.C.","$72000 - $96000"
"42011013600","Census Tract 136, Berks County, Pennsylvania",4095,76042,3695,25,0,28,0,314,90.2,0.6,0,0.7,0,7.7,9.8,1625,1195,430,73.54,26.46,124,1071,44,386,168,1457,10.4,10.2,10.3,"Less than 25% P.O.C.","$72000 - $96000"
"42011013701","Census Tract 137.01, Berks County, Pennsylvania",3561,62414,3290,34,0,0,0,102,92.4,1,0,0,0,2.9,7.6,1450,1174,276,80.97,19.03,93,1081,26,250,119,1331,7.9,9.4,8.2,"Less than 25% P.O.C.","$51000 - $72000"
"42011013702","Census Tract 137.02, Berks County, Pennsylvania",3821,64419,3643,0,0,18,0,151,95.3,0,0,0.5,0,4,4.7,1566,1225,341,78.22,21.78,82,1143,25,316,107,1459,6.7,7.3,6.8,"Less than 25% P.O.C.","$51000 - $72000"
"42011013800","Census Tract 138, Berks County, Pennsylvania",4356,56893,4043,8,11,19,0,184,92.8,0.2,0.3,0.4,0,4.2,7.2,1852,1182,670,63.82,36.18,62,1120,52,618,114,1738,5.2,7.8,6.2,"Less than 25% P.O.C.","$51000 - $72000"
"42011013900","Census Tract 139, Berks County, Pennsylvania",7979,76289,7702,8,0,4,0,189,96.5,0.1,0,0.1,0,2.4,3.5,3140,2591,549,82.52,17.48,141,2450,23,526,164,2976,5.4,4.2,5.2,"Less than 25% P.O.C.","$72000 - $96000"
"42011014000","Census Tract 140, Berks County, Pennsylvania",5040,53125,4706,37,0,150,0,104,93.4,0.7,0,3,0,2.1,6.6,2150,1174,976,54.6,45.4,0,1174,20,956,20,2130,0,2,0.9,"Less than 25% P.O.C.","$51000 - $72000"
"42011014100","Census Tract 141, Berks County, Pennsylvania",7789,61122,6586,621,0,55,0,337,84.6,8,0,0.7,0,4.3,15.4,1437,1099,338,76.48,23.52,90,1009,27,311,117,1320,8.2,8,8.1,"Less than 25% P.O.C.","$51000 - $72000"
"42011014200","Census Tract 142, Berks County, Pennsylvania",7475,64879,7144,43,0,0,0,250,95.6,0.6,0,0,0,3.3,4.4,2898,2161,737,74.57,25.43,181,1980,41,696,222,2676,8.4,5.6,7.7,"Less than 25% P.O.C.","$51000 - $72000"
"42017100102","Census Tract 1001.02, Bucks County, Pennsylvania",2809,66638,2345,58,0,316,0,74,83.5,2.1,0,11.2,0,2.6,16.5,1302,393,909,30.18,69.82,40,353,0,909,40,1262,10.2,0,3.1,"Less than 25% P.O.C.","$51000 - $72000"
"42017100103","Census Tract 1001.03, Bucks County, Pennsylvania",2421,61141,1836,105,1,32,0,336,75.8,4.3,0,1.3,0,13.9,24.2,1040,510,530,49.04,50.96,47,463,32,498,79,961,9.2,6,7.6,"Less than 25% P.O.C.","$51000 - $72000"
"42017100104","Census Tract 1001.04, Bucks County, Pennsylvania",4730,47821,1717,943,15,825,0,945,36.3,19.9,0.3,17.4,0,20,63.7,1862,496,1366,26.64,73.36,46,450,77,1289,123,1739,9.3,5.6,6.6,"50% - 75% P.O.C.","Less than $51000"
"42017100105","Census Tract 1001.05, Bucks County, Pennsylvania",3215,57986,2639,43,0,218,0,260,82.1,1.3,0,6.8,0,8.1,17.9,1136,951,185,83.71,16.29,166,785,0,185,166,970,17.5,0,14.6,"Less than 25% P.O.C.","$51000 - $72000"
"42017100201","Census Tract 1002.01, Bucks County, Pennsylvania",4719,70510,3424,290,0,622,0,252,72.6,6.1,0,13.2,0,5.3,27.4,1836,1630,206,88.78,11.22,247,1383,6,200,253,1583,15.2,2.9,13.8,"25% - 50% P.O.C.","$51000 - $72000"
"42017100206","Census Tract 1002.06, Bucks County, Pennsylvania",5252,77990,3539,376,0,757,0,410,67.4,7.2,0,14.4,0,7.8,32.6,1904,1056,848,55.46,44.54,141,915,28,820,169,1735,13.4,3.3,8.9,"25% - 50% P.O.C.","$72000 - $96000"
"42017100207","Census Tract 1002.07, Bucks County, Pennsylvania",4209,43099,2827,336,0,607,0,389,67.2,8,0,14.4,0,9.2,32.8,1741,795,946,45.66,54.34,101,694,37,909,138,1603,12.7,3.9,7.9,"25% - 50% P.O.C.","Less than $51000"
"42017100208","Census Tract 1002.08, Bucks County, Pennsylvania",5640,46768,2934,652,37,678,67,1024,52,11.6,0.7,12,1.2,18.2,48,2701,956,1745,35.39,64.61,44,912,105,1640,149,2552,4.6,6,5.5,"25% - 50% P.O.C.","Less than $51000"
"42017100209","Census Tract 1002.09, Bucks County, Pennsylvania",9528,65132,5478,854,0,1692,0,916,57.5,9,0,17.8,0,9.6,42.5,3683,1674,2009,45.45,54.55,199,1475,25,1984,224,3459,11.9,1.2,6.1,"25% - 50% P.O.C.","$51000 - $72000"
"42017100210","Census Tract 1002.10, Bucks County, Pennsylvania",7261,86779,4875,644,0,961,0,596,67.1,8.9,0,13.2,0,8.2,32.9,2532,2435,97,96.17,3.83,267,2168,0,97,267,2265,11,0,10.5,"25% - 50% P.O.C.","$72000 - $96000"
"42017100211","Census Tract 1002.11, Bucks County, Pennsylvania",6987,88684,5197,384,0,570,0,723,74.4,5.5,0,8.2,0,10.3,25.6,2934,1791,1143,61.04,38.96,96,1695,41,1102,137,2797,5.4,3.6,4.7,"25% - 50% P.O.C.","$72000 - $96000"
"42017100212","Census Tract 1002.12, Bucks County, Pennsylvania",3657,85625,2747,246,0,293,0,305,75.1,6.7,0,8,0,8.3,24.9,1349,1315,34,97.48,2.52,131,1184,0,34,131,1218,10,0,9.7,"Less than 25% P.O.C.","$72000 - $96000"
"42017100302","Census Tract 1003.02, Bucks County, Pennsylvania",5082,62556,4559,3,0,122,0,316,89.7,0.1,0,2.4,0,6.2,10.3,1789,1397,392,78.09,21.91,229,1168,77,315,306,1483,16.4,19.6,17.1,"Less than 25% P.O.C.","$51000 - $72000"
"42017100303","Census Tract 1003.03, Bucks County, Pennsylvania",4910,60107,2423,1239,9,113,0,947,49.3,25.2,0.2,2.3,0,19.3,50.7,1675,1196,479,71.4,28.6,167,1029,40,439,207,1468,14,8.4,12.4,"50% - 75% P.O.C.","$51000 - $72000"
"42017100304","Census Tract 1003.04, Bucks County, Pennsylvania",2332,51905,1688,203,0,243,0,198,72.4,8.7,0,10.4,0,8.5,27.6,1032,375,657,36.34,63.66,46,329,42,615,88,944,12.3,6.4,8.5,"25% - 50% P.O.C.","$51000 - $72000"
"42017100306","Census Tract 1003.06, Bucks County, Pennsylvania",3494,56775,2021,649,13,177,0,582,57.8,18.6,0.4,5.1,0,16.7,42.2,1387,933,454,67.27,32.73,139,794,11,443,150,1237,14.9,2.4,10.8,"25% - 50% P.O.C.","$51000 - $72000"
"42017100307","Census Tract 1003.07, Bucks County, Pennsylvania",5013,53269,3372,478,0,201,0,875,67.3,9.5,0,4,0,17.5,32.7,2064,1277,787,61.87,38.13,107,1170,66,721,173,1891,8.4,8.4,8.4,"25% - 50% P.O.C.","$51000 - $72000"
"42017100401","Census Tract 1004.01, Bucks County, Pennsylvania",6317,63167,4742,290,0,205,0,1067,75.1,4.6,0,3.2,0,16.9,24.9,2564,1875,689,73.13,26.87,179,1696,0,689,179,2385,9.5,0,7,"Less than 25% P.O.C.","$51000 - $72000"
"42017100402","Census Tract 1004.02, Bucks County, Pennsylvania",6496,76575,5145,281,0,131,0,802,79.2,4.3,0,2,0,12.3,20.8,2231,1604,627,71.9,28.1,305,1299,0,627,305,1926,19,0,13.7,"Less than 25% P.O.C.","$72000 - $96000"
"42017100403","Census Tract 1004.03, Bucks County, Pennsylvania",2290,53472,1191,767,16,16,0,283,52,33.5,0.7,0.7,0,12.4,48,847,617,230,72.85,27.15,71,546,8,222,79,768,11.5,3.5,9.3,"25% - 50% P.O.C.","$51000 - $72000"
"42017100404","Census Tract 1004.04, Bucks County, Pennsylvania",6663,64607,5457,611,0,63,0,471,81.9,9.2,0,0.9,0,7.1,18.1,2396,1749,647,73,27,259,1490,19,628,278,2118,14.8,2.9,11.6,"Less than 25% P.O.C.","$51000 - $72000"
"42017100406","Census Tract 1004.06, Bucks County, Pennsylvania",3513,86364,2879,169,0,182,0,188,82,4.8,0,5.2,0,5.4,18,1466,962,504,65.62,34.38,72,890,0,504,72,1394,7.5,0,4.9,"Less than 25% P.O.C.","$72000 - $96000"
"42017100407","Census Tract 1004.07, Bucks County, Pennsylvania",1111,93523,991,29,0,0,0,31,89.2,2.6,0,0,0,2.8,10.8,445,430,15,96.63,3.37,13,417,0,15,13,432,3,0,2.9,"Less than 25% P.O.C.","$72000 - $96000"
"42017100408","Census Tract 1004.08, Bucks County, Pennsylvania",6428,80114,5559,143,0,139,0,455,86.5,2.2,0,2.2,0,7.1,13.5,2179,2109,70,96.79,3.21,360,1749,0,70,360,1819,17.1,0,16.5,"Less than 25% P.O.C.","$72000 - $96000"
"42017100500","Census Tract 1005, Bucks County, Pennsylvania",2295,64398,2168,45,11,0,0,71,94.5,2,0.5,0,0,3.1,5.5,1073,733,340,68.31,31.69,50,683,0,340,50,1023,6.8,0,4.7,"Less than 25% P.O.C.","$51000 - $72000"
"42017100600","Census Tract 1006, Bucks County, Pennsylvania",3985,59834,2644,269,0,67,0,644,66.3,6.8,0,1.7,0,16.2,33.7,1507,737,770,48.91,51.09,51,686,74,696,125,1382,6.9,9.6,8.3,"25% - 50% P.O.C.","$51000 - $72000"
"42017100700","Census Tract 1007, Bucks County, Pennsylvania",3325,46283,1825,650,0,83,0,588,54.9,19.5,0,2.5,0,17.7,45.1,1317,650,667,49.35,50.65,113,537,78,589,191,1126,17.4,11.7,14.5,"25% - 50% P.O.C.","Less than $51000"
"42017100803","Census Tract 1008.03, Bucks County, Pennsylvania",4506,79327,3794,17,0,169,0,489,84.2,0.4,0,3.8,0,10.9,15.8,1608,1312,296,81.59,18.41,165,1147,50,246,215,1393,12.6,16.9,13.4,"Less than 25% P.O.C.","$72000 - $96000"
"42017100804","Census Tract 1008.04, Bucks County, Pennsylvania",3741,100455,3307,172,0,16,0,171,88.4,4.6,0,0.4,0,4.6,11.6,1154,1130,24,97.92,2.08,209,921,0,24,209,945,18.5,0,18.1,"Less than 25% P.O.C.","$96000 or more"
"42017100805","Census Tract 1008.05, Bucks County, Pennsylvania",6587,98214,6012,308,0,54,0,159,91.3,4.7,0,0.8,0,2.4,8.7,2084,1851,233,88.82,11.18,266,1585,0,233,266,1818,14.4,0,12.8,"Less than 25% P.O.C.","$96000 or more"
"42017100807","Census Tract 1008.07, Bucks County, Pennsylvania",4341,71821,3735,106,0,259,0,219,86,2.4,0,6,0,5,14,1771,1343,428,75.83,24.17,45,1298,0,428,45,1726,3.4,0,2.5,"Less than 25% P.O.C.","$51000 - $72000"
"42017100808","Census Tract 1008.08, Bucks County, Pennsylvania",5005,95673,4695,43,0,102,0,140,93.8,0.9,0,2,0,2.8,6.2,1989,1413,576,71.04,28.96,103,1310,0,576,103,1886,7.3,0,5.2,"Less than 25% P.O.C.","$72000 - $96000"
"42017100809","Census Tract 1008.09, Bucks County, Pennsylvania",5589,141458,4610,262,0,442,0,246,82.5,4.7,0,7.9,0,4.4,17.5,2071,1770,301,85.47,14.53,123,1647,17,284,140,1931,6.9,5.6,6.8,"Less than 25% P.O.C.","$96000 or more"
"42017100811","Census Tract 1008.11, Bucks County, Pennsylvania",4637,56658,2614,799,13,685,0,438,56.4,17.2,0.3,14.8,0,9.4,43.6,1949,452,1497,23.19,76.81,56,396,41,1456,97,1852,12.4,2.7,5,"25% - 50% P.O.C.","$51000 - $72000"
"42017100900","Census Tract 1009, Bucks County, Pennsylvania",7635,95411,6997,114,0,267,0,126,91.6,1.5,0,3.5,0,1.7,8.4,2640,2387,253,90.42,9.58,296,2091,11,242,307,2333,12.4,4.3,11.6,"Less than 25% P.O.C.","$72000 - $96000"
"42017101100","Census Tract 1011, Bucks County, Pennsylvania",2885,55515,1921,470,0,140,0,194,66.6,16.3,0,4.9,0,6.7,33.4,1145,455,690,39.74,60.26,31,424,42,648,73,1072,6.8,6.1,6.4,"25% - 50% P.O.C.","$51000 - $72000"
"42017101401","Census Tract 1014.01, Bucks County, Pennsylvania",4874,101331,4393,65,0,233,0,143,90.1,1.3,0,4.8,0,2.9,9.9,1797,1618,179,90.04,9.96,128,1490,0,179,128,1669,7.9,0,7.1,"Less than 25% P.O.C.","$96000 or more"
"42017101403","Census Tract 1014.03, Bucks County, Pennsylvania",5355,96471,5037,78,0,39,0,89,94.1,1.5,0,0.7,0,1.7,5.9,2010,1938,72,96.42,3.58,200,1738,0,72,200,1810,10.3,0,10,"Less than 25% P.O.C.","$96000 or more"
"42017101404","Census Tract 1014.04, Bucks County, Pennsylvania",2316,93125,2162,11,0,86,0,44,93.4,0.5,0,3.7,0,1.9,6.6,820,702,118,85.61,14.39,74,628,7,111,81,739,10.5,5.9,9.9,"Less than 25% P.O.C.","$72000 - $96000"
"42017101405","Census Tract 1014.05, Bucks County, Pennsylvania",6601,67804,6141,90,0,176,0,97,93,1.4,0,2.7,0,1.5,7,2493,1553,940,62.29,37.71,120,1433,29,911,149,2344,7.7,3.1,6,"Less than 25% P.O.C.","$51000 - $72000"
"42017101503","Census Tract 1015.03, Bucks County, Pennsylvania",3737,83333,3526,1,0,172,0,4,94.4,0,0,4.6,0,0.1,5.6,1630,1371,259,84.11,15.89,21,1350,28,231,49,1581,1.5,10.8,3,"Less than 25% P.O.C.","$72000 - $96000"
"42017101504","Census Tract 1015.04, Bucks County, Pennsylvania",2602,65040,2433,11,0,119,0,39,93.5,0.4,0,4.6,0,1.5,6.5,1221,768,453,62.9,37.1,62,706,0,453,62,1159,8.1,0,5.1,"Less than 25% P.O.C.","$51000 - $72000"
"42017101505","Census Tract 1015.05, Bucks County, Pennsylvania",3391,115509,3134,38,43,103,0,7,92.4,1.1,1.3,3,0,0.2,7.6,1161,1116,45,96.12,3.88,157,959,0,45,157,1004,14.1,0,13.5,"Less than 25% P.O.C.","$96000 or more"
"42017101506","Census Tract 1015.06, Bucks County, Pennsylvania",5288,87344,5185,1,0,18,0,83,98.1,0,0,0.3,0,1.6,1.9,2080,1724,356,82.88,17.12,142,1582,0,356,142,1938,8.2,0,6.8,"Less than 25% P.O.C.","$72000 - $96000"
"42017101603","Census Tract 1016.03, Bucks County, Pennsylvania",3575,72594,2624,66,36,311,0,500,73.4,1.8,1,8.7,0,14,26.6,1218,802,416,65.85,34.15,89,713,125,291,214,1004,11.1,30,17.6,"25% - 50% P.O.C.","$72000 - $96000"
"42017101605","Census Tract 1016.05, Bucks County, Pennsylvania",4203,46377,2412,374,0,247,0,989,57.4,8.9,0,5.9,0,23.5,42.6,1889,373,1516,19.75,80.25,68,305,90,1426,158,1731,18.2,5.9,8.4,"25% - 50% P.O.C.","Less than $51000"
"42017101607","Census Tract 1016.07, Bucks County, Pennsylvania",3553,64531,3102,58,0,0,0,393,87.3,1.6,0,0,0,11.1,12.7,1483,1052,431,70.94,29.06,59,993,4,427,63,1420,5.6,0.9,4.2,"Less than 25% P.O.C.","$51000 - $72000"
"42017101609","Census Tract 1016.09, Bucks County, Pennsylvania",4214,81744,3866,71,0,140,0,70,91.7,1.7,0,3.3,0,1.7,8.3,1682,1479,203,87.93,12.07,91,1388,25,178,116,1566,6.2,12.3,6.9,"Less than 25% P.O.C.","$72000 - $96000"
"42017101610","Census Tract 1016.10, Bucks County, Pennsylvania",4934,96382,4442,62,0,113,7,268,90,1.3,0,2.3,0.1,5.4,10,1726,1620,106,93.86,6.14,220,1400,0,106,220,1506,13.6,0,12.7,"Less than 25% P.O.C.","$96000 or more"
"42017101611","Census Tract 1016.11, Bucks County, Pennsylvania",6485,96655,5852,85,0,410,0,33,90.2,1.3,0,6.3,0,0.5,9.8,2590,2297,293,88.69,11.31,156,2141,23,270,179,2411,6.8,7.8,6.9,"Less than 25% P.O.C.","$96000 or more"
"42017101802","Census Tract 1018.02, Bucks County, Pennsylvania",6390,154219,5373,174,0,686,0,123,84.1,2.7,0,10.7,0,1.9,15.9,2015,1908,107,94.69,5.31,250,1658,50,57,300,1715,13.1,46.7,14.9,"Less than 25% P.O.C.","$96000 or more"
"42017101803","Census Tract 1018.03, Bucks County, Pennsylvania",9081,100053,7403,94,2,1020,0,562,81.5,1,0,11.2,0,6.2,18.5,3252,3027,225,93.08,6.92,297,2730,53,172,350,2902,9.8,23.6,10.8,"Less than 25% P.O.C.","$96000 or more"
"42017101805","Census Tract 1018.05, Bucks County, Pennsylvania",2172,120433,1999,24,0,86,0,57,92,1.1,0,4,0,2.6,8,811,781,30,96.3,3.7,67,714,5,25,72,739,8.6,16.7,8.9,"Less than 25% P.O.C.","$96000 or more"
"42017101807","Census Tract 1018.07, Bucks County, Pennsylvania",4113,85313,2950,155,0,207,0,714,71.7,3.8,0,5,0,17.4,28.3,1455,955,500,65.64,34.36,72,883,16,484,88,1367,7.5,3.2,6,"25% - 50% P.O.C.","$72000 - $96000"
"42017101808","Census Tract 1018.08, Bucks County, Pennsylvania",2500,69821,2217,76,0,181,0,26,88.7,3,0,7.2,0,1,11.3,1136,669,467,58.89,41.11,44,625,10,457,54,1082,6.6,2.1,4.8,"Less than 25% P.O.C.","$51000 - $72000"
"42017101900","Census Tract 1019, Bucks County, Pennsylvania",4143,99867,3684,40,0,311,0,93,88.9,1,0,7.5,0,2.2,11.1,1705,1469,236,86.16,13.84,109,1360,10,226,119,1586,7.4,4.2,7,"Less than 25% P.O.C.","$96000 or more"
"42017102002","Census Tract 1020.02, Bucks County, Pennsylvania",2658,126042,2501,32,0,71,0,30,94.1,1.2,0,2.7,0,1.1,5.9,895,885,10,98.88,1.12,112,773,0,10,112,783,12.7,0,12.5,"Less than 25% P.O.C.","$96000 or more"
"42017102003","Census Tract 1020.03, Bucks County, Pennsylvania",4278,103781,3874,44,0,244,0,116,90.6,1,0,5.7,0,2.7,9.4,1533,1293,240,84.34,15.66,149,1144,10,230,159,1374,11.5,4.2,10.4,"Less than 25% P.O.C.","$96000 or more"
"42017102004","Census Tract 1020.04, Bucks County, Pennsylvania",4400,92360,3929,83,0,228,0,138,89.3,1.9,0,5.2,0,3.1,10.7,1725,1392,333,80.7,19.3,145,1247,20,313,165,1560,10.4,6,9.6,"Less than 25% P.O.C.","$72000 - $96000"
"42017102102","Census Tract 1021.02, Bucks County, Pennsylvania",2970,92222,2764,10,0,49,0,87,93.1,0.3,0,1.6,0,2.9,6.9,1138,979,159,86.03,13.97,64,915,7,152,71,1067,6.5,4.4,6.2,"Less than 25% P.O.C.","$72000 - $96000"
"42017102104","Census Tract 1021.04, Bucks County, Pennsylvania",5859,88147,4903,128,0,474,0,291,83.7,2.2,0,8.1,0,5,16.3,2197,1910,287,86.94,13.06,137,1773,69,218,206,1991,7.2,24,9.4,"Less than 25% P.O.C.","$72000 - $96000"
"42017102300","Census Tract 1023, Bucks County, Pennsylvania",5737,96518,5382,62,0,74,0,154,93.8,1.1,0,1.3,0,2.7,6.2,2047,1575,472,76.94,23.06,234,1341,13,459,247,1800,14.9,2.8,12.1,"Less than 25% P.O.C.","$96000 or more"
"42017102401","Census Tract 1024.01, Bucks County, Pennsylvania",3834,75040,3612,53,11,34,0,118,94.2,1.4,0.3,0.9,0,3.1,5.8,1587,978,609,61.63,38.37,71,907,10,599,81,1506,7.3,1.6,5.1,"Less than 25% P.O.C.","$72000 - $96000"
"42017102402","Census Tract 1024.02, Bucks County, Pennsylvania",4716,84954,4356,52,0,67,0,170,92.4,1.1,0,1.4,0,3.6,7.6,1697,1306,391,76.96,23.04,161,1145,34,357,195,1502,12.3,8.7,11.5,"Less than 25% P.O.C.","$72000 - $96000"
"42017102500","Census Tract 1025, Bucks County, Pennsylvania",4270,68443,3685,68,18,30,0,324,86.3,1.6,0.4,0.7,0,7.6,13.7,1664,1164,500,69.95,30.05,112,1052,43,457,155,1509,9.6,8.6,9.3,"Less than 25% P.O.C.","$51000 - $72000"
"42017102600","Census Tract 1026, Bucks County, Pennsylvania",2141,52109,1892,51,0,132,0,51,88.4,2.4,0,6.2,0,2.4,11.6,990,534,456,53.94,46.06,36,498,0,456,36,954,6.7,0,3.6,"Less than 25% P.O.C.","$51000 - $72000"
"42017102700","Census Tract 1027, Bucks County, Pennsylvania",5232,82227,4576,27,8,77,0,137,87.5,0.5,0.2,1.5,0,2.6,12.5,2133,1712,421,80.26,19.74,168,1544,0,421,168,1965,9.8,0,7.9,"Less than 25% P.O.C.","$72000 - $96000"
"42017102801","Census Tract 1028.01, Bucks County, Pennsylvania",3522,108125,3305,8,0,29,0,111,93.8,0.2,0,0.8,0,3.2,6.2,1261,1206,55,95.64,4.36,127,1079,2,53,129,1132,10.5,3.6,10.2,"Less than 25% P.O.C.","$96000 or more"
"42017103101","Census Tract 1031.01, Bucks County, Pennsylvania",2110,65795,1757,179,0,4,0,137,83.3,8.5,0,0.2,0,6.5,16.7,866,484,382,55.89,44.11,43,441,18,364,61,805,8.9,4.7,7,"Less than 25% P.O.C.","$51000 - $72000"
"42017103102","Census Tract 1031.02, Bucks County, Pennsylvania",2065,63542,1661,104,0,0,0,178,80.4,5,0,0,0,8.6,19.6,774,436,338,56.33,43.67,65,371,27,311,92,682,14.9,8,11.9,"Less than 25% P.O.C.","$51000 - $72000"
"42017103103","Census Tract 1031.03, Bucks County, Pennsylvania",4652,59647,4087,148,0,163,0,166,87.9,3.2,0,3.5,0,3.6,12.1,1795,1049,746,58.44,41.56,144,905,78,668,222,1573,13.7,10.5,12.4,"Less than 25% P.O.C.","$51000 - $72000"
"42017103300","Census Tract 1033, Bucks County, Pennsylvania",2100,93750,2065,0,0,14,0,21,98.3,0,0,0.7,0,1,1.7,880,762,118,86.59,13.41,33,729,0,118,33,847,4.3,0,3.8,"Less than 25% P.O.C.","$72000 - $96000"
"42017103400","Census Tract 1034, Bucks County, Pennsylvania",5040,89821,4732,0,0,134,0,95,93.9,0,0,2.7,0,1.9,6.1,2097,1786,311,85.17,14.83,140,1646,0,311,140,1957,7.8,0,6.7,"Less than 25% P.O.C.","$72000 - $96000"
"42017103700","Census Tract 1037, Bucks County, Pennsylvania",3388,89545,3285,9,0,19,0,44,97,0.3,0,0.6,0,1.3,3,1360,1091,269,80.22,19.78,46,1045,18,251,64,1296,4.2,6.7,4.7,"Less than 25% P.O.C.","$72000 - $96000"
"42017103800","Census Tract 1038, Bucks County, Pennsylvania",1127,77841,1105,2,0,3,0,11,98,0.2,0,0.3,0,1,2,533,497,36,93.25,6.75,25,472,0,36,25,508,5,0,4.7,"Less than 25% P.O.C.","$72000 - $96000"
"42017103900","Census Tract 1039, Bucks County, Pennsylvania",3954,85563,3788,8,0,33,0,48,95.8,0.2,0,0.8,0,1.2,4.2,1932,1645,287,85.14,14.86,0,1645,0,287,0,1932,0,0,0,"Less than 25% P.O.C.","$72000 - $96000"
"42017104000","Census Tract 1040, Bucks County, Pennsylvania",7128,97396,6744,0,0,246,0,68,94.6,0,0,3.5,0,1,5.4,2605,2424,181,93.05,6.95,291,2133,0,181,291,2314,12,0,11.2,"Less than 25% P.O.C.","$96000 or more"
"42017104100","Census Tract 1041, Bucks County, Pennsylvania",2178,68824,1769,78,5,89,0,237,81.2,3.6,0.2,4.1,0,10.9,18.8,884,409,475,46.27,53.73,55,354,48,427,103,781,13.4,10.1,11.7,"Less than 25% P.O.C.","$51000 - $72000"
"42017104201","Census Tract 1042.01, Bucks County, Pennsylvania",3016,136200,2861,5,0,52,0,55,94.9,0.2,0,1.7,0,1.8,5.1,1088,1015,73,93.29,6.71,118,897,10,63,128,960,11.6,13.7,11.8,"Less than 25% P.O.C.","$96000 or more"
"42017104203","Census Tract 1042.03, Bucks County, Pennsylvania",5775,119063,4996,20,0,133,19,582,86.5,0.3,0,2.3,0.3,10.1,13.5,1894,1633,261,86.22,13.78,197,1436,40,221,237,1657,12.1,15.3,12.5,"Less than 25% P.O.C.","$96000 or more"
"42017104204","Census Tract 1042.04, Bucks County, Pennsylvania",5189,103272,4315,52,0,433,0,294,83.2,1,0,8.3,0,5.7,16.8,1983,1747,236,88.1,11.9,126,1621,53,183,179,1804,7.2,22.5,9,"Less than 25% P.O.C.","$96000 or more"
"42017104301","Census Tract 1043.01, Bucks County, Pennsylvania",2644,152222,2569,8,0,0,0,34,97.2,0.3,0,0,0,1.3,2.8,1150,1010,140,87.83,12.17,21,989,0,140,21,1129,2.1,0,1.8,"Less than 25% P.O.C.","$96000 or more"
"42017104303","Census Tract 1043.03, Bucks County, Pennsylvania",4705,128523,4192,24,11,324,0,99,89.1,0.5,0.2,6.9,0,2.1,10.9,1997,1786,211,89.43,10.57,99,1687,13,198,112,1885,5.5,6.2,5.6,"Less than 25% P.O.C.","$96000 or more"
"42017104304","Census Tract 1043.04, Bucks County, Pennsylvania",1228,121136,1131,8,0,38,0,32,92.1,0.7,0,3.1,0,2.6,7.9,488,430,58,88.11,11.89,29,401,0,58,29,459,6.7,0,5.9,"Less than 25% P.O.C.","$96000 or more"
"42017104400","Census Tract 1044, Bucks County, Pennsylvania",2513,89861,2227,0,11,58,0,178,88.6,0,0.4,2.3,0,7.1,11.4,1188,674,514,56.73,43.27,22,652,15,499,37,1151,3.3,2.9,3.1,"Less than 25% P.O.C.","$72000 - $96000"
"42017104502","Census Tract 1045.02, Bucks County, Pennsylvania",7976,103926,7121,45,0,425,0,101,89.3,0.6,0,5.3,0,1.3,10.7,3031,2833,198,93.47,6.53,289,2544,9,189,298,2733,10.2,4.5,9.8,"Less than 25% P.O.C.","$96000 or more"
"42017104503","Census Tract 1045.03, Bucks County, Pennsylvania",4193,159107,3947,0,0,106,0,136,94.1,0,0,2.5,0,3.2,5.9,1463,1390,73,95.01,4.99,158,1232,0,73,158,1305,11.4,0,10.8,"Less than 25% P.O.C.","$96000 or more"
"42017104505","Census Tract 1045.05, Bucks County, Pennsylvania",5658,160306,4938,80,0,480,0,151,87.3,1.4,0,8.5,0,2.7,12.7,1911,1846,65,96.6,3.4,246,1600,0,65,246,1665,13.3,0,12.9,"Less than 25% P.O.C.","$96000 or more"
"42017104506","Census Tract 1045.06, Bucks County, Pennsylvania",2421,150938,2055,13,8,53,0,160,84.9,0.5,0.3,2.2,0,6.6,15.1,901,840,61,93.23,6.77,116,724,0,61,116,785,13.8,0,12.9,"Less than 25% P.O.C.","$96000 or more"
"42017104601","Census Tract 1046.01, Bucks County, Pennsylvania",4515,156125,4183,0,0,182,0,86,92.6,0,0,4,0,1.9,7.4,1593,1561,32,97.99,2.01,169,1392,7,25,176,1417,10.8,21.9,11,"Less than 25% P.O.C.","$96000 or more"
"42017104603","Census Tract 1046.03, Bucks County, Pennsylvania",7145,110694,6275,266,28,261,0,219,87.8,3.7,0.4,3.7,0,3.1,12.2,2083,1549,534,74.36,25.64,106,1443,25,509,131,1952,6.8,4.7,6.3,"Less than 25% P.O.C.","$96000 or more"
"42017104604","Census Tract 1046.04, Bucks County, Pennsylvania",5771,107902,5508,6,0,49,0,138,95.4,0.1,0,0.8,0,2.4,4.6,2411,1829,582,75.86,24.14,158,1671,0,582,158,2253,8.6,0,6.6,"Less than 25% P.O.C.","$96000 or more"
"42017104701","Census Tract 1047.01, Bucks County, Pennsylvania",3355,51765,3015,22,2,88,0,168,89.9,0.7,0.1,2.6,0,5,10.1,1760,586,1174,33.3,66.7,26,560,0,1174,26,1734,4.4,0,1.5,"Less than 25% P.O.C.","$51000 - $72000"
"42017104702","Census Tract 1047.02, Bucks County, Pennsylvania",2585,79615,2323,31,0,5,0,163,89.9,1.2,0,0.2,0,6.3,10.1,1146,648,498,56.54,43.46,0,648,45,453,45,1101,0,9,3.9,"Less than 25% P.O.C.","$72000 - $96000"
"42017104703","Census Tract 1047.03, Bucks County, Pennsylvania",2346,119821,2193,10,0,75,0,53,93.5,0.4,0,3.2,0,2.3,6.5,869,767,102,88.26,11.74,41,726,0,102,41,828,5.3,0,4.7,"Less than 25% P.O.C.","$96000 or more"
"42017104800","Census Tract 1048, Bucks County, Pennsylvania",2966,98088,2783,74,4,10,0,78,93.8,2.5,0.1,0.3,0,2.6,6.2,960,850,110,88.54,11.46,34,816,15,95,49,911,4,13.6,5.1,"Less than 25% P.O.C.","$96000 or more"
"42017104901","Census Tract 1049.01, Bucks County, Pennsylvania",7217,161949,6740,56,0,330,0,0,93.4,0.8,0,4.6,0,0,6.6,2449,2365,84,96.57,3.43,300,2065,0,84,300,2149,12.7,0,12.2,"Less than 25% P.O.C.","$96000 or more"
"42017104902","Census Tract 1049.02, Bucks County, Pennsylvania",7395,104969,6996,12,0,217,0,170,94.6,0.2,0,2.9,0,2.3,5.4,2951,2746,205,93.05,6.95,311,2435,42,163,353,2598,11.3,20.5,12,"Less than 25% P.O.C.","$96000 or more"
"42017105003","Census Tract 1050.03, Bucks County, Pennsylvania",4857,121750,4454,4,8,218,0,140,91.7,0.1,0.2,4.5,0,2.9,8.3,1659,1608,51,96.93,3.07,212,1396,0,51,212,1447,13.2,0,12.8,"Less than 25% P.O.C.","$96000 or more"
"42017105004","Census Tract 1050.04, Bucks County, Pennsylvania",5771,129728,4985,291,0,259,0,90,86.4,5,0,4.5,0,1.6,13.6,1883,1778,105,94.42,5.58,233,1545,28,77,261,1622,13.1,26.7,13.9,"Less than 25% P.O.C.","$96000 or more"
"42017105006","Census Tract 1050.06, Bucks County, Pennsylvania",5548,136354,5057,27,17,326,0,110,91.1,0.5,0.3,5.9,0,2,8.9,1884,1829,55,97.08,2.92,255,1574,0,55,255,1629,13.9,0,13.5,"Less than 25% P.O.C.","$96000 or more"
"42017105008","Census Tract 1050.08, Bucks County, Pennsylvania",3720,121750,3237,57,0,244,0,47,87,1.5,0,6.6,0,1.3,13,1251,1190,61,95.12,4.88,157,1033,24,37,181,1070,13.2,39.3,14.5,"Less than 25% P.O.C.","$96000 or more"
"42017105009","Census Tract 1050.09, Bucks County, Pennsylvania",3534,85043,3278,32,9,115,0,100,92.8,0.9,0.3,3.3,0,2.8,7.2,1523,1034,489,67.89,32.11,126,908,10,479,136,1387,12.2,2,8.9,"Less than 25% P.O.C.","$72000 - $96000"
"42017105010","Census Tract 1050.10, Bucks County, Pennsylvania",3829,97977,3355,94,0,193,0,155,87.6,2.5,0,5,0,4,12.4,1541,1390,151,90.2,9.8,95,1295,16,135,111,1430,6.8,10.6,7.2,"Less than 25% P.O.C.","$96000 or more"
"42017105011","Census Tract 1050.11, Bucks County, Pennsylvania",3311,118125,2820,12,0,120,0,268,85.2,0.4,0,3.6,0,8.1,14.8,1326,1119,207,84.39,15.61,107,1012,14,193,121,1205,9.6,6.8,9.1,"Less than 25% P.O.C.","$96000 or more"
"42017105012","Census Tract 1050.12, Bucks County, Pennsylvania",2856,128601,2747,0,0,5,0,104,96.2,0,0,0.2,0,3.6,3.8,949,909,40,95.79,4.21,110,799,0,40,110,839,12.1,0,11.6,"Less than 25% P.O.C.","$96000 or more"
"42017105013","Census Tract 1050.13, Bucks County, Pennsylvania",5837,142422,5363,63,0,186,0,132,91.9,1.1,0,3.2,0,2.3,8.1,1950,1939,11,99.44,0.56,203,1736,0,11,203,1747,10.5,0,10.4,"Less than 25% P.O.C.","$96000 or more"
"42017105100","Census Tract 1051, Bucks County, Pennsylvania",3099,115781,2786,52,0,136,0,53,89.9,1.7,0,4.4,0,1.7,10.1,1139,952,187,83.58,16.42,136,816,0,187,136,1003,14.3,0,11.9,"Less than 25% P.O.C.","$96000 or more"
"42017105202","Census Tract 1052.02, Bucks County, Pennsylvania",4895,85536,4441,108,0,209,0,42,90.7,2.2,0,4.3,0,0.9,9.3,2256,1714,542,75.98,24.02,32,1682,0,542,32,2224,1.9,0,1.4,"Less than 25% P.O.C.","$72000 - $96000"
"42017105203","Census Tract 1052.03, Bucks County, Pennsylvania",2100,122188,1818,30,0,163,0,26,86.6,1.4,0,7.8,0,1.2,13.4,767,709,58,92.44,7.56,68,641,0,58,68,699,9.6,0,8.9,"Less than 25% P.O.C.","$96000 or more"
"42017105206","Census Tract 1052.06, Bucks County, Pennsylvania",5355,139375,4284,238,0,529,0,213,80,4.4,0,9.9,0,4,20,2086,1815,271,87.01,12.99,191,1624,0,271,191,1895,10.5,0,9.2,"Less than 25% P.O.C.","$96000 or more"
"42017105207","Census Tract 1052.07, Bucks County, Pennsylvania",4989,139722,4152,165,0,458,0,194,83.2,3.3,0,9.2,0,3.9,16.8,2028,1720,308,84.81,15.19,69,1651,17,291,86,1942,4,5.5,4.2,"Less than 25% P.O.C.","$96000 or more"
"42017105208","Census Tract 1052.08, Bucks County, Pennsylvania",2271,183221,1811,12,6,309,0,78,79.7,0.5,0.3,13.6,0,3.4,20.3,729,698,31,95.75,4.25,95,603,5,26,100,629,13.6,16.1,13.7,"Less than 25% P.O.C.","$96000 or more"
"42017105300","Census Tract 1053, Bucks County, Pennsylvania",1957,112083,1889,3,0,5,0,18,96.5,0.2,0,0.3,0,0.9,3.5,933,651,282,69.77,30.23,22,629,0,282,22,911,3.4,0,2.4,"Less than 25% P.O.C.","$96000 or more"
"42017105400","Census Tract 1054, Bucks County, Pennsylvania",8417,157014,7173,283,94,428,0,167,85.2,3.4,1.1,5.1,0,2,14.8,3139,2901,238,92.42,7.58,293,2608,0,238,293,2846,10.1,0,9.3,"Less than 25% P.O.C.","$96000 or more"
"42017105505","Census Tract 1055.05, Bucks County, Pennsylvania",4039,153095,3557,22,0,133,0,202,88.1,0.5,0,3.3,0,5,11.9,1508,1333,175,88.4,11.6,100,1233,10,165,110,1398,7.5,5.7,7.3,"Less than 25% P.O.C.","$96000 or more"
"42017105506","Census Tract 1055.06, Bucks County, Pennsylvania",4154,217719,3502,256,0,222,0,39,84.3,6.2,0,5.3,0,0.9,15.7,1344,1307,37,97.25,2.75,187,1120,0,37,187,1157,14.3,0,13.9,"Less than 25% P.O.C.","$96000 or more"
"42017105507","Census Tract 1055.07, Bucks County, Pennsylvania",6822,155000,6081,96,0,273,0,205,89.1,1.4,0,4,0,3,10.9,2386,2271,115,95.18,4.82,189,2082,15,100,204,2182,8.3,13,8.5,"Less than 25% P.O.C.","$96000 or more"
"42017105508","Census Tract 1055.08, Bucks County, Pennsylvania",3477,216563,2902,58,0,346,0,156,83.5,1.7,0,10,0,4.5,16.5,1108,1092,16,98.56,1.44,136,956,0,16,136,972,12.5,0,12.3,"Less than 25% P.O.C.","$96000 or more"
"42017105509","Census Tract 1055.09, Bucks County, Pennsylvania",4363,164743,3803,109,59,241,0,97,87.2,2.5,1.4,5.5,0,2.2,12.8,1519,1483,36,97.63,2.37,163,1320,0,36,163,1356,11,0,10.7,"Less than 25% P.O.C.","$96000 or more"
"42017105510","Census Tract 1055.10, Bucks County, Pennsylvania",5585,97170,4227,299,0,343,0,460,75.7,5.4,0,6.1,0,8.2,24.3,2723,1791,932,65.77,34.23,24,1767,0,932,24,2699,1.3,0,0.9,"Less than 25% P.O.C.","$96000 or more"
"42017105511","Census Tract 1055.11, Bucks County, Pennsylvania",4222,133988,3660,145,9,292,0,78,86.7,3.4,0.2,6.9,0,1.8,13.3,1419,1370,49,96.55,3.45,127,1243,0,49,127,1292,9.3,0,8.9,"Less than 25% P.O.C.","$96000 or more"
"42017105600","Census Tract 1056, Bucks County, Pennsylvania",2480,93875,2229,67,0,99,0,41,89.9,2.7,0,4,0,1.7,10.1,1159,927,232,79.98,20.02,48,879,6,226,54,1105,5.2,2.6,4.7,"Less than 25% P.O.C.","$72000 - $96000"
"42017105702","Census Tract 1057.02, Bucks County, Pennsylvania",3040,57132,2236,402,0,36,0,266,73.6,13.2,0,1.2,0,8.8,26.4,1393,638,755,45.8,54.2,66,572,10,745,76,1317,10.3,1.3,5.5,"25% - 50% P.O.C.","$51000 - $72000"
"42017105704","Census Tract 1057.04, Bucks County, Pennsylvania",6708,74219,4233,1603,10,181,0,433,63.1,23.9,0.1,2.7,0,6.5,36.9,2639,1637,1002,62.03,37.97,127,1510,50,952,177,2462,7.8,5,6.7,"25% - 50% P.O.C.","$72000 - $96000"
"42017105801","Census Tract 1058.01, Bucks County, Pennsylvania",5842,63500,3830,1163,0,243,0,518,65.6,19.9,0,4.2,0,8.9,34.4,2308,1409,899,61.05,38.95,73,1336,96,803,169,2139,5.2,10.7,7.3,"25% - 50% P.O.C.","$51000 - $72000"
"42017105805","Census Tract 1058.05, Bucks County, Pennsylvania",5666,70000,4518,209,11,301,0,589,79.7,3.7,0.2,5.3,0,10.4,20.3,2154,1554,600,72.14,27.86,206,1348,18,582,224,1930,13.3,3,10.4,"Less than 25% P.O.C.","$51000 - $72000"
"42017105807","Census Tract 1058.07, Bucks County, Pennsylvania",3819,55643,2825,223,0,352,0,348,74,5.8,0,9.2,0,9.1,26,1544,718,826,46.5,53.5,86,632,75,751,161,1383,12,9.1,10.4,"25% - 50% P.O.C.","$51000 - $72000"
"42017105808","Census Tract 1058.08, Bucks County, Pennsylvania",3425,86917,3064,63,0,113,0,100,89.5,1.8,0,3.3,0,2.9,10.5,1271,1187,84,93.39,6.61,83,1104,0,84,83,1188,7,0,6.5,"Less than 25% P.O.C.","$72000 - $96000"
"42017105809","Census Tract 1058.09, Bucks County, Pennsylvania",4113,84959,3588,111,0,54,0,238,87.2,2.7,0,1.3,0,5.8,12.8,1463,1254,209,85.71,14.29,117,1137,8,201,125,1338,9.3,3.8,8.5,"Less than 25% P.O.C.","$72000 - $96000"
"42017105810","Census Tract 1058.10, Bucks County, Pennsylvania",2206,73427,1977,113,0,23,0,52,89.6,5.1,0,1,0,2.4,10.4,809,638,171,78.86,21.14,85,553,7,164,92,717,13.3,4.1,11.4,"Less than 25% P.O.C.","$72000 - $96000"
"42017105811","Census Tract 1058.11, Bucks County, Pennsylvania",5705,83393,4850,304,0,227,0,274,85,5.3,0,4,0,4.8,15,2072,1732,340,83.59,16.41,201,1531,18,322,219,1853,11.6,5.3,10.6,"Less than 25% P.O.C.","$72000 - $96000"
"42017105812","Census Tract 1058.12, Bucks County, Pennsylvania",1591,96453,1390,56,0,15,0,95,87.4,3.5,0,0.9,0,6,12.6,545,524,21,96.15,3.85,52,472,0,21,52,493,9.9,0,9.5,"Less than 25% P.O.C.","$96000 or more"
"42017105900","Census Tract 1059, Bucks County, Pennsylvania",2169,65341,2050,44,0,0,0,73,94.5,2,0,0,0,3.4,5.5,867,466,401,53.75,46.25,39,427,32,369,71,796,8.4,8,8.2,"Less than 25% P.O.C.","$51000 - $72000"
"42017106000","Census Tract 1060, Bucks County, Pennsylvania",4008,92798,3505,51,16,307,0,73,87.5,1.3,0.4,7.7,0,1.8,12.5,1623,994,629,61.24,38.76,58,936,46,583,104,1519,5.8,7.3,6.4,"Less than 25% P.O.C.","$72000 - $96000"
"42017106100","Census Tract 1061, Bucks County, Pennsylvania",3245,88472,2905,131,12,36,0,119,89.5,4,0.4,1.1,0,3.7,10.5,926,578,348,62.42,37.58,51,527,0,348,51,875,8.8,0,5.5,"Less than 25% P.O.C.","$72000 - $96000"
"42017106200","Census Tract 1062, Bucks County, Pennsylvania",6476,77522,5630,379,2,168,0,178,86.9,5.9,0,2.6,0,2.7,13.1,3041,1713,1328,56.33,43.67,86,1627,9,1319,95,2946,5,0.7,3.1,"Less than 25% P.O.C.","$72000 - $96000"
"42017106300","Census Tract 1063, Bucks County, Pennsylvania",7254,107043,6823,113,0,129,0,144,94.1,1.6,0,1.8,0,2,5.9,2391,1948,443,81.47,18.53,306,1642,48,395,354,2037,15.7,10.8,14.8,"Less than 25% P.O.C.","$96000 or more"
"42017106401","Census Tract 1064.01, Bucks County, Pennsylvania",7694,77128,6940,35,0,307,0,182,90.2,0.5,0,4,0,2.4,9.8,2752,2313,439,84.05,15.95,320,1993,20,419,340,2412,13.8,4.6,12.4,"Less than 25% P.O.C.","$72000 - $96000"
"42017106402","Census Tract 1064.02, Bucks County, Pennsylvania",7503,92349,7133,106,0,14,0,144,95.1,1.4,0,0.2,0,1.9,4.9,2767,2498,269,90.28,9.72,200,2298,47,222,247,2520,8,17.5,8.9,"Less than 25% P.O.C.","$72000 - $96000"
"42017106500","Census Tract 1065, Bucks County, Pennsylvania",6830,71944,5978,66,322,0,0,339,87.5,1,4.7,0,0,5,12.5,2772,2288,484,82.54,17.46,214,2074,19,465,233,2539,9.4,3.9,8.4,"Less than 25% P.O.C.","$51000 - $72000"
"42017106600","Census Tract 1066, Bucks County, Pennsylvania",1917,82188,1798,21,0,14,0,66,93.8,1.1,0,0.7,0,3.4,6.2,798,631,167,79.07,20.93,47,584,6,161,53,745,7.4,3.6,6.6,"Less than 25% P.O.C.","$72000 - $96000"
"42017980000","Census Tract 9800, Bucks County, Pennsylvania",0,NA,0,0,0,0,0,0,NA,NA,NA,NA,NA,NA,NA,0,0,0,NA,NA,0,0,0,0,0,0,NA,NA,NA,"N/A","N/A"
"42029300101","Census Tract 3001.01, Chester County, Pennsylvania",2980,119063,2601,80,0,229,0,65,87.3,2.7,0,7.7,0,2.2,12.7,1174,986,188,83.99,16.01,97,889,12,176,109,1065,9.8,6.4,9.3,"Less than 25% P.O.C.","$96000 or more"
"42029300103","Census Tract 3001.03, Chester County, Pennsylvania",2530,67344,1801,133,0,380,0,137,71.2,5.3,0,15,0,5.4,28.8,1117,721,396,64.55,35.45,50,671,27,369,77,1040,6.9,6.8,6.9,"25% - 50% P.O.C.","$51000 - $72000"
"42029300104","Census Tract 3001.04, Chester County, Pennsylvania",5040,142941,4342,212,0,396,0,41,86.2,4.2,0,7.9,0,0.8,13.8,1908,1547,361,81.08,18.92,72,1475,9,352,81,1827,4.7,2.5,4.2,"Less than 25% P.O.C.","$96000 or more"
"42029300106","Census Tract 3001.06, Chester County, Pennsylvania",4800,130000,3023,143,0,1366,0,44,63,3,0,28.5,0,0.9,37,2114,1635,479,77.34,22.66,105,1530,6,473,111,2003,6.4,1.3,5.3,"25% - 50% P.O.C.","$96000 or more"
"42029300107","Census Tract 3001.07, Chester County, Pennsylvania",4433,202625,3323,61,0,912,0,45,75,1.4,0,20.6,0,1,25,1496,1390,106,92.91,7.09,186,1204,48,58,234,1262,13.4,45.3,15.6,"25% - 50% P.O.C.","$96000 or more"
"42029300108","Census Tract 3001.08, Chester County, Pennsylvania",6282,119598,4281,201,0,1369,0,265,68.1,3.2,0,21.8,0,4.2,31.9,2605,1523,1082,58.46,41.54,129,1394,15,1067,144,2461,8.5,1.4,5.5,"25% - 50% P.O.C.","$96000 or more"
"42029300109","Census Tract 3001.09, Chester County, Pennsylvania",3396,197813,2870,59,0,166,0,263,84.5,1.7,0,4.9,0,7.7,15.5,1184,1090,94,92.06,7.94,110,980,32,62,142,1042,10.1,34,12,"Less than 25% P.O.C.","$96000 or more"
"42029300201","Census Tract 3002.01, Chester County, Pennsylvania",5400,114958,4640,103,0,295,0,150,85.9,1.9,0,5.5,0,2.8,14.1,2075,1552,523,74.8,25.2,146,1406,0,523,146,1929,9.4,0,7,"Less than 25% P.O.C.","$96000 or more"
"42029300202","Census Tract 3002.02, Chester County, Pennsylvania",5218,223913,4504,22,0,428,0,126,86.3,0.4,0,8.2,0,2.4,13.7,1800,1771,29,98.39,1.61,298,1473,0,29,298,1502,16.8,0,16.6,"Less than 25% P.O.C.","$96000 or more"
"42029300301","Census Tract 3003.01, Chester County, Pennsylvania",4060,114904,3569,156,0,278,0,10,87.9,3.8,0,6.8,0,0.2,12.1,1704,1450,254,85.09,14.91,99,1351,18,236,117,1587,6.8,7.1,6.9,"Less than 25% P.O.C.","$96000 or more"
"42029300302","Census Tract 3003.02, Chester County, Pennsylvania",3766,183839,3607,1,0,94,0,22,95.8,0,0,2.5,0,0.6,4.2,1279,1242,37,97.11,2.89,143,1099,0,37,143,1136,11.5,0,11.2,"Less than 25% P.O.C.","$96000 or more"
"42029300303","Census Tract 3003.03, Chester County, Pennsylvania",3121,75800,2680,122,0,109,0,117,85.9,3.9,0,3.5,0,3.7,14.1,1312,1064,248,81.1,18.9,59,1005,0,248,59,1253,5.5,0,4.5,"Less than 25% P.O.C.","$72000 - $96000"
"42029300400","Census Tract 3004, Chester County, Pennsylvania",3447,101345,2955,87,0,171,0,124,85.7,2.5,0,5,0,3.6,14.3,1575,884,691,56.13,43.87,90,794,6,685,96,1479,10.2,0.9,6.1,"Less than 25% P.O.C.","$96000 or more"
"42029300501","Census Tract 3005.01, Chester County, Pennsylvania",4852,169737,4429,54,0,115,0,254,91.3,1.1,0,2.4,0,5.2,8.7,1588,1484,104,93.45,6.55,171,1313,19,85,190,1398,11.5,18.3,12,"Less than 25% P.O.C.","$96000 or more"
"42029300502","Census Tract 3005.02, Chester County, Pennsylvania",3571,108380,2967,40,0,161,0,344,83.1,1.1,0,4.5,0,9.6,16.9,1279,1083,196,84.68,15.32,125,958,32,164,157,1122,11.5,16.3,12.3,"Less than 25% P.O.C.","$96000 or more"
"42029300600","Census Tract 3006, Chester County, Pennsylvania",5400,95652,4005,864,0,102,0,352,74.2,16,0,1.9,0,6.5,25.8,2116,1395,721,65.93,34.07,93,1302,59,662,152,1964,6.7,8.2,7.2,"25% - 50% P.O.C.","$72000 - $96000"
"42029300700","Census Tract 3007, Chester County, Pennsylvania",4993,64452,4333,180,0,96,27,272,86.8,3.6,0,1.9,0.5,5.4,13.2,2319,994,1325,42.86,57.14,119,875,32,1293,151,2168,12,2.4,6.5,"Less than 25% P.O.C.","$51000 - $72000"
"42029300800","Census Tract 3008, Chester County, Pennsylvania",4276,65833,3617,257,0,106,0,126,84.6,6,0,2.5,0,2.9,15.4,2028,799,1229,39.4,60.6,34,765,13,1216,47,1981,4.3,1.1,2.3,"Less than 25% P.O.C.","$51000 - $72000"
"42029300900","Census Tract 3009, Chester County, Pennsylvania",2414,82974,1991,51,0,69,0,268,82.5,2.1,0,2.9,0,11.1,17.5,987,729,258,73.86,26.14,13,716,18,240,31,956,1.8,7,3.1,"Less than 25% P.O.C.","$72000 - $96000"
"42029301000","Census Tract 3010, Chester County, Pennsylvania",7365,111867,6665,351,0,191,0,111,90.5,4.8,0,2.6,0,1.5,9.5,3072,2638,434,85.87,14.13,182,2456,0,434,182,2890,6.9,0,5.9,"Less than 25% P.O.C.","$96000 or more"
"42029301100","Census Tract 3011, Chester County, Pennsylvania",3307,58673,3106,108,0,37,0,11,93.9,3.3,0,1.1,0,0.3,6.1,1511,744,767,49.24,50.76,93,651,16,751,109,1402,12.5,2.1,7.2,"Less than 25% P.O.C.","$51000 - $72000"
"42029301300","Census Tract 3013, Chester County, Pennsylvania",6759,102009,5871,259,0,352,0,229,86.9,3.8,0,5.2,0,3.4,13.1,2449,1889,560,77.13,22.87,252,1637,23,537,275,2174,13.3,4.1,11.2,"Less than 25% P.O.C.","$96000 or more"
"42029301401","Census Tract 3014.01, Chester County, Pennsylvania",2872,57719,2452,103,11,34,0,176,85.4,3.6,0.4,1.2,0,6.1,14.6,1205,604,601,50.12,49.88,95,509,29,572,124,1081,15.7,4.8,10.3,"Less than 25% P.O.C.","$51000 - $72000"
"42029301402","Census Tract 3014.02, Chester County, Pennsylvania",5116,89041,4829,28,0,16,0,184,94.4,0.5,0,0.3,0,3.6,5.6,1943,1671,272,86,14,149,1522,4,268,153,1790,8.9,1.5,7.9,"Less than 25% P.O.C.","$72000 - $96000"
"42029301500","Census Tract 3015, Chester County, Pennsylvania",2632,105774,2496,12,0,81,0,43,94.8,0.5,0,3.1,0,1.6,5.2,979,912,67,93.16,6.84,58,854,7,60,65,914,6.4,10.4,6.6,"Less than 25% P.O.C.","$96000 or more"
"42029301600","Census Tract 3016, Chester County, Pennsylvania",2545,89330,2391,0,0,20,6,8,93.9,0,0,0.8,0.2,0.3,6.1,1045,961,84,91.96,8.04,54,907,12,72,66,979,5.6,14.3,6.3,"Less than 25% P.O.C.","$72000 - $96000"
"42029301700","Census Tract 3017, Chester County, Pennsylvania",1662,146250,1556,21,7,15,0,57,93.6,1.3,0.4,0.9,0,3.4,6.4,598,518,80,86.62,13.38,37,481,11,69,48,550,7.1,13.8,8,"Less than 25% P.O.C.","$96000 or more"
"42029301800","Census Tract 3018, Chester County, Pennsylvania",5429,174712,4657,50,0,405,0,231,85.8,0.9,0,7.5,0,4.3,14.2,1821,1604,217,88.08,11.92,122,1482,26,191,148,1673,7.6,12,8.1,"Less than 25% P.O.C.","$96000 or more"
"42029301900","Census Tract 3019, Chester County, Pennsylvania",4075,173977,3916,0,0,137,0,15,96.1,0,0,3.4,0,0.4,3.9,1450,1411,39,97.31,2.69,129,1282,0,39,129,1321,9.1,0,8.9,"Less than 25% P.O.C.","$96000 or more"
"42029302000","Census Tract 3020, Chester County, Pennsylvania",5941,140179,4633,378,0,597,0,177,78,6.4,0,10,0,3,22,2010,1732,278,86.17,13.83,133,1599,29,249,162,1848,7.7,10.4,8.1,"Less than 25% P.O.C.","$96000 or more"
"42029302101","Census Tract 3021.01, Chester County, Pennsylvania",7320,116944,4799,327,0,1559,0,543,65.6,4.5,0,21.3,0,7.4,34.4,2684,1885,799,70.23,29.77,188,1697,121,678,309,2375,10,15.1,11.5,"25% - 50% P.O.C.","$96000 or more"
"42029302102","Census Tract 3021.02, Chester County, Pennsylvania",4521,103814,3320,289,17,415,0,385,73.4,6.4,0.4,9.2,0,8.5,26.6,1539,934,605,60.69,39.31,84,850,33,572,117,1422,9,5.5,7.6,"25% - 50% P.O.C.","$96000 or more"
"42029302202","Census Tract 3022.02, Chester County, Pennsylvania",7417,107175,4794,289,0,1898,0,370,64.6,3.9,0,25.6,0,5,35.4,2849,1537,1312,53.95,46.05,140,1397,22,1290,162,2687,9.1,1.7,5.7,"25% - 50% P.O.C.","$96000 or more"
"42029302203","Census Tract 3022.03, Chester County, Pennsylvania",5036,119205,3870,185,0,638,0,263,76.8,3.7,0,12.7,0,5.2,23.2,1865,1631,234,87.45,12.55,173,1458,0,234,173,1692,10.6,0,9.3,"Less than 25% P.O.C.","$96000 or more"
"42029302204","Census Tract 3022.04, Chester County, Pennsylvania",6197,123622,4860,423,0,515,0,304,78.4,6.8,0,8.3,0,4.9,21.6,2221,1863,358,83.88,16.12,212,1651,15,343,227,1994,11.4,4.2,10.2,"Less than 25% P.O.C.","$96000 or more"
"42029302300","Census Tract 3023, Chester County, Pennsylvania",3080,74153,2429,248,0,223,0,72,78.9,8.1,0,7.2,0,2.3,21.1,1575,480,1095,30.48,69.52,30,450,10,1085,40,1535,6.2,0.9,2.5,"Less than 25% P.O.C.","$72000 - $96000"
"42029302400","Census Tract 3024, Chester County, Pennsylvania",4559,58872,2796,525,1,81,0,1025,61.3,11.5,0,1.8,0,22.5,38.7,1961,741,1220,37.79,62.21,14,727,73,1147,87,1874,1.9,6,4.4,"25% - 50% P.O.C.","$51000 - $72000"
"42029302500","Census Tract 3025, Chester County, Pennsylvania",4298,66630,3945,35,0,22,0,271,91.8,0.8,0,0.5,0,6.3,8.2,1876,857,1019,45.68,54.32,92,765,11,1008,103,1773,10.7,1.1,5.5,"Less than 25% P.O.C.","$51000 - $72000"
"42029302600","Census Tract 3026, Chester County, Pennsylvania",4968,48992,3719,312,0,88,0,718,74.9,6.3,0,1.8,0,14.5,25.1,1839,513,1326,27.9,72.1,37,476,53,1273,90,1749,7.2,4,4.9,"25% - 50% P.O.C.","Less than $51000"
"42029302702","Census Tract 3027.02, Chester County, Pennsylvania",4755,76469,3184,304,0,988,0,239,67,6.4,0,20.8,0,5,33,2045,1085,960,53.06,46.94,134,951,0,960,134,1911,12.4,0,6.6,"25% - 50% P.O.C.","$72000 - $96000"
"42029302703","Census Tract 3027.03, Chester County, Pennsylvania",4429,143432,3921,104,0,243,0,44,88.5,2.3,0,5.5,0,1,11.5,1618,1478,140,91.35,8.65,169,1309,0,140,169,1449,11.4,0,10.4,"Less than 25% P.O.C.","$96000 or more"
"42029302704","Census Tract 3027.04, Chester County, Pennsylvania",5112,122257,4437,113,47,199,21,138,86.8,2.2,0.9,3.9,0.4,2.7,13.2,1848,1735,113,93.89,6.11,115,1620,8,105,123,1725,6.6,7.1,6.7,"Less than 25% P.O.C.","$96000 or more"
"42029302705","Census Tract 3027.05, Chester County, Pennsylvania",3903,84873,3207,123,0,268,0,218,82.2,3.2,0,6.9,0,5.6,17.8,1491,888,603,59.56,40.44,99,789,13,590,112,1379,11.1,2.2,7.5,"Less than 25% P.O.C.","$72000 - $96000"
"42029302706","Census Tract 3027.06, Chester County, Pennsylvania",4802,76543,4529,49,0,44,0,81,94.3,1,0,0.9,0,1.7,5.7,1868,1190,678,63.7,36.3,84,1106,13,665,97,1771,7.1,1.9,5.2,"Less than 25% P.O.C.","$72000 - $96000"
"42029302802","Census Tract 3028.02, Chester County, Pennsylvania",4991,127422,4821,104,0,29,20,0,96.6,2.1,0,0.6,0.4,0,3.4,2071,1737,334,83.87,16.13,139,1598,0,334,139,1932,8,0,6.7,"Less than 25% P.O.C.","$96000 or more"
"42029302803","Census Tract 3028.03, Chester County, Pennsylvania",2031,68333,2031,0,0,0,0,0,100,0,0,0,0,0,0,1196,1076,120,89.97,10.03,8,1068,0,120,8,1188,0.7,0,0.7,"Less than 25% P.O.C.","$51000 - $72000"
"42029302804","Census Tract 3028.04, Chester County, Pennsylvania",3951,107214,3735,77,0,109,0,22,94.5,1.9,0,2.8,0,0.6,5.5,1623,953,670,58.72,41.28,111,842,0,670,111,1512,11.6,0,6.8,"Less than 25% P.O.C.","$96000 or more"
"42029302805","Census Tract 3028.05, Chester County, Pennsylvania",7231,71899,6295,228,0,286,0,403,87.1,3.2,0,4,0,5.6,12.9,3447,1947,1500,56.48,43.52,121,1826,0,1500,121,3326,6.2,0,3.5,"Less than 25% P.O.C.","$51000 - $72000"
"42029302901","Census Tract 3029.01, Chester County, Pennsylvania",4558,120125,3986,24,0,336,0,169,87.5,0.5,0,7.4,0,3.7,12.5,1734,1424,310,82.12,17.88,99,1325,0,310,99,1635,7,0,5.7,"Less than 25% P.O.C.","$96000 or more"
"42029302902","Census Tract 3029.02, Chester County, Pennsylvania",6366,117422,5685,227,0,161,0,182,89.3,3.6,0,2.5,0,2.9,10.7,2131,1770,361,83.06,16.94,255,1515,0,361,255,1876,14.4,0,12,"Less than 25% P.O.C.","$96000 or more"
"42029303000","Census Tract 3030, Chester County, Pennsylvania",3139,154792,2711,154,0,168,0,60,86.4,4.9,0,5.4,0,1.9,13.6,1161,897,264,77.26,22.74,98,799,0,264,98,1063,10.9,0,8.4,"Less than 25% P.O.C.","$96000 or more"
"42029303100","Census Tract 3031, Chester County, Pennsylvania",4204,199830,3695,116,0,198,0,123,87.9,2.8,0,4.7,0,2.9,12.1,1433,1403,30,97.91,2.09,133,1270,0,30,133,1300,9.5,0,9.3,"Less than 25% P.O.C.","$96000 or more"
"42029303301","Census Tract 3033.01, Chester County, Pennsylvania",3389,103088,2056,105,0,163,0,1052,60.7,3.1,0,4.8,0,31,39.3,1152,846,306,73.44,26.56,41,805,143,163,184,968,4.8,46.7,16,"25% - 50% P.O.C.","$96000 or more"
"42029303302","Census Tract 3033.02, Chester County, Pennsylvania",4837,123958,4256,359,0,75,0,45,88,7.4,0,1.6,0,0.9,12,2108,1799,309,85.34,14.66,144,1655,0,309,144,1964,8,0,6.8,"Less than 25% P.O.C.","$96000 or more"
"42029303401","Census Tract 3034.01, Chester County, Pennsylvania",4063,86227,2382,108,0,34,0,1539,58.6,2.7,0,0.8,0,37.9,41.4,1410,841,569,59.65,40.35,140,701,24,545,164,1246,16.6,4.2,11.6,"25% - 50% P.O.C.","$72000 - $96000"
"42029303402","Census Tract 3034.02, Chester County, Pennsylvania",2127,66957,1020,207,0,14,0,880,48,9.7,0,0.7,0,41.4,52,726,354,372,48.76,51.24,55,299,60,312,115,611,15.5,16.1,15.8,"50% - 75% P.O.C.","$51000 - $72000"
"42029303501","Census Tract 3035.01, Chester County, Pennsylvania",4428,99960,3885,123,0,215,0,157,87.7,2.8,0,4.9,0,3.5,12.3,1733,1560,173,90.02,9.98,85,1475,0,173,85,1648,5.4,0,4.9,"Less than 25% P.O.C.","$96000 or more"
"42029303502","Census Tract 3035.02, Chester County, Pennsylvania",2960,147645,2402,69,46,286,0,85,81.1,2.3,1.6,9.7,0,2.9,18.9,1089,903,186,82.92,17.08,29,874,55,131,84,1005,3.2,29.6,7.7,"Less than 25% P.O.C.","$96000 or more"
"42029303801","Census Tract 3038.01, Chester County, Pennsylvania",4310,107047,3872,101,0,19,0,256,89.8,2.3,0,0.4,0,5.9,10.2,1585,1411,174,89.02,10.98,128,1283,32,142,160,1425,9.1,18.4,10.1,"Less than 25% P.O.C.","$96000 or more"
"42029303802","Census Tract 3038.02, Chester County, Pennsylvania",8705,141908,7426,303,0,438,0,269,85.3,3.5,0,5,0,3.1,14.7,2938,2819,119,95.95,4.05,275,2544,40,79,315,2623,9.8,33.6,10.7,"Less than 25% P.O.C.","$96000 or more"
"42029303901","Census Tract 3039.01, Chester County, Pennsylvania",4653,143625,3960,370,0,53,0,126,85.1,8,0,1.1,0,2.7,14.9,1497,1390,107,92.85,7.15,131,1259,9,98,140,1357,9.4,8.4,9.4,"Less than 25% P.O.C.","$96000 or more"
"42029303902","Census Tract 3039.02, Chester County, Pennsylvania",5283,110893,4746,55,0,58,0,260,89.8,1,0,1.1,0,4.9,10.2,2031,1742,289,85.77,14.23,217,1525,30,259,247,1784,12.5,10.4,12.2,"Less than 25% P.O.C.","$96000 or more"
"42029304000","Census Tract 3040, Chester County, Pennsylvania",4854,93750,3261,69,62,920,21,475,67.2,1.4,1.3,19,0.4,9.8,32.8,2107,1338,769,63.5,36.5,117,1221,16,753,133,1974,8.7,2.1,6.3,"25% - 50% P.O.C.","$72000 - $96000"
"42029304101","Census Tract 3041.01, Chester County, Pennsylvania",4292,64776,2762,536,0,521,0,336,64.4,12.5,0,12.1,0,7.8,35.6,1846,912,934,49.4,50.6,94,818,0,934,94,1752,10.3,0,5.1,"25% - 50% P.O.C.","$51000 - $72000"
"42029304102","Census Tract 3041.02, Chester County, Pennsylvania",3634,73818,2676,463,0,117,0,321,73.6,12.7,0,3.2,0,8.8,26.4,1329,842,487,63.36,36.64,105,737,10,477,115,1214,12.5,2.1,8.7,"25% - 50% P.O.C.","$72000 - $96000"
"42029304201","Census Tract 3042.01, Chester County, Pennsylvania",7046,105043,5374,364,0,792,0,407,76.3,5.2,0,11.2,0,5.8,23.7,2835,2239,596,78.98,21.02,191,2048,13,583,204,2631,8.5,2.2,7.2,"Less than 25% P.O.C.","$96000 or more"
"42029304300","Census Tract 3043, Chester County, Pennsylvania",8601,138682,6977,425,0,656,0,253,81.1,4.9,0,7.6,0,2.9,18.9,3011,2720,291,90.34,9.66,266,2454,7,284,273,2738,9.8,2.4,9.1,"Less than 25% P.O.C.","$96000 or more"
"42029304403","Census Tract 3044.03, Chester County, Pennsylvania",3979,111625,3594,63,0,224,0,41,90.3,1.6,0,5.6,0,1,9.7,1533,1359,174,88.65,11.35,82,1277,15,159,97,1436,6,8.6,6.3,"Less than 25% P.O.C.","$96000 or more"
"42029304404","Census Tract 3044.04, Chester County, Pennsylvania",5014,87105,3822,420,0,372,0,342,76.2,8.4,0,7.4,0,6.8,23.8,2058,1129,929,54.86,45.14,136,993,76,853,212,1846,12,8.2,10.3,"Less than 25% P.O.C.","$72000 - $96000"
"42029304405","Census Tract 3044.05, Chester County, Pennsylvania",6394,174375,5442,62,0,549,0,310,85.1,1,0,8.6,0,4.8,14.9,2018,1945,73,96.38,3.62,234,1711,22,51,256,1762,12,30.1,12.7,"Less than 25% P.O.C.","$96000 or more"
"42029304406","Census Tract 3044.06, Chester County, Pennsylvania",3547,108382,3376,35,0,31,0,88,95.2,1,0,0.9,0,2.5,4.8,1482,1002,480,67.61,32.39,65,937,8,472,73,1409,6.5,1.7,4.9,"Less than 25% P.O.C.","$96000 or more"
"42029304501","Census Tract 3045.01, Chester County, Pennsylvania",8566,179727,5688,72,0,2284,0,423,66.4,0.8,0,26.7,0,4.9,33.6,2616,2397,219,91.63,8.37,297,2100,0,219,297,2319,12.4,0,11.4,"25% - 50% P.O.C.","$96000 or more"
"42029304502","Census Tract 3045.02, Chester County, Pennsylvania",2994,140938,2825,0,0,60,11,55,94.4,0,0,2,0.4,1.8,5.6,1013,991,22,97.83,2.17,137,854,8,14,145,868,13.8,36.4,14.3,"Less than 25% P.O.C.","$96000 or more"
"42029304600","Census Tract 3046, Chester County, Pennsylvania",3676,129938,3319,138,0,136,0,44,90.3,3.8,0,3.7,0,1.2,9.7,1167,1002,165,85.86,14.14,180,822,19,146,199,968,18,11.5,17.1,"Less than 25% P.O.C.","$96000 or more"
"42029304900","Census Tract 3049, Chester County, Pennsylvania",8240,65896,7809,250,0,79,0,102,94.8,3,0,1,0,1.2,5.2,2832,2005,827,70.8,29.2,363,1642,39,788,402,2430,18.1,4.7,14.2,"Less than 25% P.O.C.","$51000 - $72000"
"42029305000","Census Tract 3050, Chester County, Pennsylvania",1980,69861,1859,55,0,0,0,28,93.9,2.8,0,0,0,1.4,6.1,711,463,248,65.12,34.88,55,408,30,218,85,626,11.9,12.1,12,"Less than 25% P.O.C.","$51000 - $72000"
"42029305101","Census Tract 3051.01, Chester County, Pennsylvania",4474,80833,3924,134,0,102,0,135,87.7,3,0,2.3,0,3,12.3,1776,1548,228,87.16,12.84,177,1371,0,228,177,1599,11.4,0,10,"Less than 25% P.O.C.","$72000 - $96000"
"42029305102","Census Tract 3051.02, Chester County, Pennsylvania",4629,96013,4058,361,0,74,0,53,87.7,7.8,0,1.6,0,1.1,12.3,1768,1539,229,87.05,12.95,142,1397,0,229,142,1626,9.2,0,8,"Less than 25% P.O.C.","$96000 or more"
"42029305300","Census Tract 3053, Chester County, Pennsylvania",7718,77198,4702,1629,0,146,0,615,60.9,21.1,0,1.9,0,8,39.1,2896,2190,706,75.62,24.38,221,1969,96,610,317,2579,10.1,13.6,10.9,"25% - 50% P.O.C.","$72000 - $96000"
"42029305400","Census Tract 3054, Chester County, Pennsylvania",4271,44474,1598,1662,0,53,0,775,37.4,38.9,0,1.2,0,18.1,62.6,1486,434,1052,29.21,70.79,85,349,88,964,173,1313,19.6,8.4,11.6,"50% - 75% P.O.C.","Less than $51000"
"42029305500","Census Tract 3055, Chester County, Pennsylvania",3789,48616,548,1295,0,0,0,1721,14.5,34.2,0,0,0,45.4,85.5,1255,458,797,36.49,63.51,46,412,93,704,139,1116,10,11.7,11.1,"75% or more P.O.C.","Less than $51000"
"42029305600","Census Tract 3056, Chester County, Pennsylvania",2725,36250,449,1716,7,0,0,481,16.5,63,0.3,0,0,17.7,83.5,969,318,651,32.82,67.18,23,295,126,525,149,820,7.2,19.4,15.4,"75% or more P.O.C.","Less than $51000"
"42029305700","Census Tract 3057, Chester County, Pennsylvania",2351,52533,752,752,0,16,0,722,32,32,0,0.7,0,30.7,68,775,455,320,58.71,41.29,39,416,97,223,136,639,8.6,30.3,17.5,"50% - 75% P.O.C.","$51000 - $72000"
"42029306000","Census Tract 3060, Chester County, Pennsylvania",7560,1e+05,6432,481,0,88,0,394,85.1,6.4,0,1.2,0,5.2,14.9,2810,2425,385,86.3,13.7,271,2154,33,352,304,2506,11.2,8.6,10.8,"Less than 25% P.O.C.","$96000 or more"
"42029306300","Census Tract 3063, Chester County, Pennsylvania",2845,64479,1364,183,0,17,0,1248,47.9,6.4,0,0.6,0,43.9,52.1,907,616,291,67.92,32.08,62,554,59,232,121,786,10.1,20.3,13.3,"50% - 75% P.O.C.","$51000 - $72000"
"42029306501","Census Tract 3065.01, Chester County, Pennsylvania",4299,141875,3293,154,0,272,0,438,76.6,3.6,0,6.3,0,10.2,23.4,1603,1425,178,88.9,11.1,85,1340,0,178,85,1518,6,0,5.3,"Less than 25% P.O.C.","$96000 or more"
"42029306503","Census Tract 3065.03, Chester County, Pennsylvania",3075,71957,1300,192,0,0,0,1538,42.3,6.2,0,0,0,50,57.7,878,469,409,53.42,46.58,68,401,64,345,132,746,14.5,15.6,15,"50% - 75% P.O.C.","$51000 - $72000"
"42029306504","Census Tract 3065.04, Chester County, Pennsylvania",4779,120583,3075,51,0,192,0,1444,64.3,1.1,0,4,0,30.2,35.7,1553,1312,241,84.48,15.52,144,1168,54,187,198,1355,11,22.4,12.7,"25% - 50% P.O.C.","$96000 or more"
"42029306600","Census Tract 3066, Chester County, Pennsylvania",3238,139965,3098,8,0,29,0,40,95.7,0.2,0,0.9,0,1.2,4.3,1131,1066,65,94.25,5.75,122,944,6,59,128,1003,11.4,9.2,11.3,"Less than 25% P.O.C.","$96000 or more"
"42029306700","Census Tract 3067, Chester County, Pennsylvania",4514,138750,4152,16,0,99,0,215,92,0.4,0,2.2,0,4.8,8,1621,1522,99,93.89,6.11,125,1397,0,99,125,1496,8.2,0,7.7,"Less than 25% P.O.C.","$96000 or more"
"42029306800","Census Tract 3068, Chester County, Pennsylvania",1761,94750,1645,0,0,5,0,99,93.4,0,0,0.3,0,5.6,6.6,622,547,75,87.94,12.06,69,478,0,75,69,553,12.6,0,11.1,"Less than 25% P.O.C.","$72000 - $96000"
"42029306900","Census Tract 3069, Chester County, Pennsylvania",5946,126250,5224,22,0,80,0,545,87.9,0.4,0,1.3,0,9.2,12.1,1873,1644,229,87.77,12.23,216,1428,20,209,236,1637,13.1,8.7,12.6,"Less than 25% P.O.C.","$96000 or more"
"42029307000","Census Tract 3070, Chester County, Pennsylvania",5501,75512,4367,88,0,51,0,905,79.4,1.6,0,0.9,0,16.5,20.6,2266,1674,592,73.87,26.13,156,1518,86,506,242,2024,9.3,14.5,10.7,"Less than 25% P.O.C.","$72000 - $96000"
"42029307100","Census Tract 3071, Chester County, Pennsylvania",2475,97125,2108,62,20,37,0,175,85.2,2.5,0.8,1.5,0,7.1,14.8,868,736,132,84.79,15.21,79,657,21,111,100,768,10.7,15.9,11.5,"Less than 25% P.O.C.","$96000 or more"
"42029307200","Census Tract 3072, Chester County, Pennsylvania",1313,79417,1122,43,0,0,0,130,85.5,3.3,0,0,0,9.9,14.5,443,341,102,76.98,23.02,33,308,9,93,42,401,9.7,8.8,9.5,"Less than 25% P.O.C.","$72000 - $96000"
"42029307300","Census Tract 3073, Chester County, Pennsylvania",3983,83355,3124,505,0,36,0,191,78.4,12.7,0,0.9,0,4.8,21.6,1503,1156,347,76.91,23.09,88,1068,10,337,98,1405,7.6,2.9,6.5,"Less than 25% P.O.C.","$72000 - $96000"
"42029307400","Census Tract 3074, Chester County, Pennsylvania",3842,72250,3020,256,54,0,0,271,78.6,6.7,1.4,0,0,7.1,21.4,1300,901,399,69.31,30.69,85,816,84,315,169,1131,9.4,21.1,13,"Less than 25% P.O.C.","$72000 - $96000"
"42029307700","Census Tract 3077, Chester County, Pennsylvania",2590,69844,2418,0,0,0,0,172,93.4,0,0,0,0,6.6,6.6,869,731,138,84.12,15.88,92,639,25,113,117,752,12.6,18.1,13.5,"Less than 25% P.O.C.","$51000 - $72000"
"42029307800","Census Tract 3078, Chester County, Pennsylvania",2519,88750,2052,165,0,0,0,273,81.5,6.6,0,0,0,10.8,18.5,826,692,134,83.78,16.22,83,609,19,115,102,724,12,14.2,12.3,"Less than 25% P.O.C.","$72000 - $96000"
"42029307900","Census Tract 3079, Chester County, Pennsylvania",5064,88940,3055,1238,0,69,0,511,60.3,24.4,0,1.4,0,10.1,39.7,1005,838,167,83.38,16.62,145,693,23,144,168,837,17.3,13.8,16.7,"25% - 50% P.O.C.","$72000 - $96000"
"42029308000","Census Tract 3080, Chester County, Pennsylvania",5515,55380,3073,330,40,0,0,1933,55.7,6,0.7,0,0,35,44.3,1963,784,1179,39.94,60.06,115,669,101,1078,216,1747,14.7,8.6,11,"25% - 50% P.O.C.","$51000 - $72000"
"42029308101","Census Tract 3081.01, Chester County, Pennsylvania",4610,123787,4273,58,0,116,0,117,92.7,1.3,0,2.5,0,2.5,7.3,1399,1363,36,97.43,2.57,221,1142,0,36,221,1178,16.2,0,15.8,"Less than 25% P.O.C.","$96000 or more"
"42029308102","Census Tract 3081.02, Chester County, Pennsylvania",4365,95726,3341,231,0,7,0,691,76.5,5.3,0,0.2,0,15.8,23.5,1390,1128,262,81.15,18.85,198,930,40,222,238,1152,17.6,15.3,17.1,"Less than 25% P.O.C.","$72000 - $96000"
"42029308200","Census Tract 3082, Chester County, Pennsylvania",2723,62991,2097,42,0,8,0,561,77,1.5,0,0.3,0,20.6,23,971,819,152,84.35,15.65,84,735,21,131,105,866,10.3,13.8,10.8,"Less than 25% P.O.C.","$51000 - $72000"
"42029310400","Census Tract 3104, Chester County, Pennsylvania",3129,NA,2381,423,0,63,0,187,76.1,13.5,0,2,0,6,23.9,0,0,0,NA,NA,0,0,0,0,0,0,NA,NA,NA,"Less than 25% P.O.C.","N/A"
"42029311000","Census Tract 3110, Chester County, Pennsylvania",7162,103902,5996,355,0,304,0,290,83.7,5,0,4.2,0,4,16.3,2333,2120,213,90.87,9.13,375,1745,17,196,392,1941,17.7,8,16.8,"Less than 25% P.O.C.","$96000 or more"
"42029311100","Census Tract 3111, Chester County, Pennsylvania",3640,126594,3137,26,0,404,0,34,86.2,0.7,0,11.1,0,0.9,13.8,1309,1026,283,78.38,21.62,119,907,0,283,119,1190,11.6,0,9.1,"Less than 25% P.O.C.","$96000 or more"
"42029311200","Census Tract 3112, Chester County, Pennsylvania",2089,110069,1961,25,0,21,0,71,93.9,1.2,0,1,0,3.4,6.1,835,594,241,71.14,28.86,53,541,9,232,62,773,8.9,3.7,7.4,"Less than 25% P.O.C.","$96000 or more"
"42029311300","Census Tract 3113, Chester County, Pennsylvania",4842,143382,3725,448,91,251,0,202,76.9,9.3,1.9,5.2,0,4.2,23.1,990,934,56,94.34,5.66,153,781,0,56,153,837,16.4,0,15.5,"Less than 25% P.O.C.","$96000 or more"
"42029311401","Census Tract 3114.01, Chester County, Pennsylvania",7176,80221,4827,1331,49,304,0,413,67.3,18.5,0.7,4.2,0,5.8,32.7,2745,1847,898,67.29,32.71,116,1731,106,792,222,2523,6.3,11.8,8.1,"25% - 50% P.O.C.","$72000 - $96000"
"42029311403","Census Tract 3114.03, Chester County, Pennsylvania",3726,88235,3399,181,0,0,0,53,91.2,4.9,0,0,0,1.4,8.8,1478,1255,223,84.91,15.09,140,1115,0,223,140,1338,11.2,0,9.5,"Less than 25% P.O.C.","$72000 - $96000"
"42029311404","Census Tract 3114.04, Chester County, Pennsylvania",3744,106724,3393,76,0,22,0,241,90.6,2,0,0.6,0,6.4,9.4,1340,1209,131,90.22,9.78,96,1113,0,131,96,1244,7.9,0,7.2,"Less than 25% P.O.C.","$96000 or more"
"42029311500","Census Tract 3115, Chester County, Pennsylvania",3370,77188,3241,37,0,0,0,81,96.2,1.1,0,0,0,2.4,3.8,1439,1149,290,79.85,20.15,99,1050,11,279,110,1329,8.6,3.8,7.6,"Less than 25% P.O.C.","$72000 - $96000"
"42029311600","Census Tract 3116, Chester County, Pennsylvania",2272,49500,1118,841,0,9,0,233,49.2,37,0,0.4,0,10.3,50.8,794,330,464,41.56,58.44,16,314,109,355,125,669,4.8,23.5,15.7,"50% - 75% P.O.C.","Less than $51000"
"42029311700","Census Tract 3117, Chester County, Pennsylvania",10102,101122,6951,415,0,201,0,2400,68.8,4.1,0,2,0,23.8,31.2,3081,2609,472,84.68,15.32,477,2132,164,308,641,2440,18.3,34.7,20.8,"25% - 50% P.O.C.","$96000 or more"
"42029311800","Census Tract 3118, Chester County, Pennsylvania",3712,73264,3259,170,0,6,0,133,87.8,4.6,0,0.2,0,3.6,12.2,1265,932,333,73.68,26.32,123,809,13,320,136,1129,13.2,3.9,10.8,"Less than 25% P.O.C.","$72000 - $96000"
"42045400301","Census Tract 4003.01, Delaware County, Pennsylvania",6320,32392,696,4335,0,548,0,505,11,68.6,0,8.7,0,8,89,2273,898,1375,39.51,60.49,172,726,119,1256,291,1982,19.2,8.7,12.8,"75% or more P.O.C.","Less than $51000"
"42045400302","Census Tract 4003.02, Delaware County, Pennsylvania",3755,43872,671,2653,0,47,0,295,17.9,70.7,0,1.3,0,7.9,82.1,1237,607,630,49.07,50.93,34,573,97,533,131,1106,5.6,15.4,10.6,"75% or more P.O.C.","Less than $51000"
"42045400401","Census Tract 4004.01, Delaware County, Pennsylvania",5420,45013,685,2619,15,1617,0,373,12.6,48.3,0.3,29.8,0,6.9,87.4,1959,861,1098,43.95,56.05,160,701,127,971,287,1672,18.6,11.6,14.7,"75% or more P.O.C.","Less than $51000"
"42045400402","Census Tract 4004.02, Delaware County, Pennsylvania",4791,35112,689,3179,0,520,0,380,14.4,66.4,0,10.9,0,7.9,85.6,1837,801,1036,43.6,56.4,121,680,88,948,209,1628,15.1,8.5,11.4,"75% or more P.O.C.","Less than $51000"
"42045400500","Census Tract 4005, Delaware County, Pennsylvania",4106,39985,907,1746,0,1007,0,225,22.1,42.5,0,24.5,0,5.5,77.9,1455,674,781,46.32,53.68,142,532,115,666,257,1198,21.1,14.7,17.7,"75% or more P.O.C.","Less than $51000"
"42045400600","Census Tract 4006, Delaware County, Pennsylvania",5110,50688,2512,1071,44,921,0,436,49.2,21,0.9,18,0,8.5,50.8,1949,1203,746,61.72,38.28,74,1129,37,709,111,1838,6.2,5,5.7,"50% - 75% P.O.C.","Less than $51000"
"42045400700","Census Tract 4007, Delaware County, Pennsylvania",5875,64119,1785,2414,0,960,0,609,30.4,41.1,0,16.3,0,10.4,69.6,1742,1188,554,68.2,31.8,275,913,9,545,284,1458,23.1,1.6,16.3,"50% - 75% P.O.C.","$51000 - $72000"
"42045400801","Census Tract 4008.01, Delaware County, Pennsylvania",2270,52094,182,1761,0,248,0,59,8,77.6,0,10.9,0,2.6,92,1043,88,955,8.44,91.56,0,88,67,888,67,976,0,7,6.4,"75% or more P.O.C.","$51000 - $72000"
"42045400802","Census Tract 4008.02, Delaware County, Pennsylvania",3472,61893,1919,932,0,140,0,237,55.3,26.8,0,4,0,6.8,44.7,1237,861,376,69.6,30.4,98,763,0,376,98,1139,11.4,0,7.9,"25% - 50% P.O.C.","$51000 - $72000"
"42045400900","Census Tract 4009, Delaware County, Pennsylvania",1497,121964,1211,226,0,54,0,0,80.9,15.1,0,3.6,0,0,19.1,513,495,18,96.49,3.51,68,427,0,18,68,445,13.7,0,13.3,"Less than 25% P.O.C.","$96000 or more"
"42045401000","Census Tract 4010, Delaware County, Pennsylvania",1864,75500,1470,265,0,71,0,27,78.9,14.2,0,3.8,0,1.4,21.1,668,419,249,62.72,37.28,66,353,14,235,80,588,15.8,5.6,12,"Less than 25% P.O.C.","$72000 - $96000"
"42045401101","Census Tract 4011.01, Delaware County, Pennsylvania",2895,80435,2189,465,0,7,0,71,75.6,16.1,0,0.2,0,2.5,24.4,1164,895,269,76.89,23.11,55,840,0,269,55,1109,6.1,0,4.7,"Less than 25% P.O.C.","$72000 - $96000"
"42045401103","Census Tract 4011.03, Delaware County, Pennsylvania",3641,109167,2675,402,0,320,0,75,73.5,11,0,8.8,0,2.1,26.5,1130,892,238,78.94,21.06,218,674,0,238,218,912,24.4,0,19.3,"25% - 50% P.O.C.","$96000 or more"
"42045401104","Census Tract 4011.04, Delaware County, Pennsylvania",4090,76563,3165,404,0,177,0,163,77.4,9.9,0,4.3,0,4,22.6,1501,1077,424,71.75,28.25,131,946,77,347,208,1293,12.2,18.2,13.9,"Less than 25% P.O.C.","$72000 - $96000"
"42045401200","Census Tract 4012, Delaware County, Pennsylvania",3329,59475,2713,191,0,315,0,57,81.5,5.7,0,9.5,0,1.7,18.5,1435,953,482,66.41,33.59,122,831,4,478,126,1309,12.8,0.8,8.8,"Less than 25% P.O.C.","$51000 - $72000"
"42045401301","Census Tract 4013.01, Delaware County, Pennsylvania",2587,64758,1035,878,0,278,0,209,40,33.9,0,10.7,0,8.1,60,1168,20,1148,1.71,98.29,0,20,86,1062,86,1082,0,7.5,7.4,"50% - 75% P.O.C.","$51000 - $72000"
"42045401302","Census Tract 4013.02, Delaware County, Pennsylvania",2650,80223,2077,345,0,59,0,93,78.4,13,0,2.2,0,3.5,21.6,1103,817,286,74.07,25.93,70,747,10,276,80,1023,8.6,3.5,7.3,"Less than 25% P.O.C.","$72000 - $96000"
"42045401401","Census Tract 4014.01, Delaware County, Pennsylvania",2089,71233,1456,369,0,163,0,60,69.7,17.7,0,7.8,0,2.9,30.3,830,612,218,73.73,26.27,76,536,0,218,76,754,12.4,0,9.2,"25% - 50% P.O.C.","$51000 - $72000"
"42045401402","Census Tract 4014.02, Delaware County, Pennsylvania",3656,51128,2263,845,0,148,0,299,61.9,23.1,0,4,0,8.2,38.1,1635,854,781,52.23,47.77,41,813,15,766,56,1579,4.8,1.9,3.4,"25% - 50% P.O.C.","$51000 - $72000"
"42045401501","Census Tract 4015.01, Delaware County, Pennsylvania",3449,70000,2912,321,0,33,0,149,84.4,9.3,0,1,0,4.3,15.6,1334,1145,189,85.83,14.17,37,1108,36,153,73,1261,3.2,19,5.5,"Less than 25% P.O.C.","$51000 - $72000"
"42045401502","Census Tract 4015.02, Delaware County, Pennsylvania",4169,60044,2304,924,0,661,0,152,55.3,22.2,0,15.9,0,3.6,44.7,1856,678,1178,36.53,63.47,37,641,0,1178,37,1819,5.5,0,2,"25% - 50% P.O.C.","$51000 - $72000"
"42045401600","Census Tract 4016, Delaware County, Pennsylvania",1789,57125,826,790,0,94,0,19,46.2,44.2,0,5.3,0,1.1,53.8,761,420,341,55.19,44.81,25,395,26,315,51,710,6,7.6,6.7,"50% - 75% P.O.C.","$51000 - $72000"
"42045401700","Census Tract 4017, Delaware County, Pennsylvania",2674,59798,623,1366,13,439,0,118,23.3,51.1,0.5,16.4,0,4.4,76.7,893,610,283,68.31,31.69,99,511,41,242,140,753,16.2,14.5,15.7,"75% or more P.O.C.","$51000 - $72000"
"42045401800","Census Tract 4018, Delaware County, Pennsylvania",4183,58438,1159,2585,0,123,0,195,27.7,61.8,0,2.9,0,4.7,72.3,1511,944,567,62.48,37.52,131,813,33,534,164,1347,13.9,5.8,10.9,"50% - 75% P.O.C.","$51000 - $72000"
"42045401900","Census Tract 4019, Delaware County, Pennsylvania",4214,53111,1782,1789,0,160,0,347,42.3,42.5,0,3.8,0,8.2,57.7,1890,1207,683,63.86,36.14,151,1056,26,657,177,1713,12.5,3.8,9.4,"50% - 75% P.O.C.","$51000 - $72000"
"42045402000","Census Tract 4020, Delaware County, Pennsylvania",2241,54579,1094,1004,21,38,0,51,48.8,44.8,0.9,1.7,0,2.3,51.2,1231,671,560,54.51,45.49,64,607,9,551,73,1158,9.5,1.6,5.9,"50% - 75% P.O.C.","$51000 - $72000"
"42045402100","Census Tract 4021, Delaware County, Pennsylvania",5843,60262,386,5223,0,13,0,0,6.6,89.4,0,0.2,0,0,93.4,2119,1490,629,70.32,29.68,145,1345,59,570,204,1915,9.7,9.4,9.6,"75% or more P.O.C.","$51000 - $72000"
"42045402200","Census Tract 4022, Delaware County, Pennsylvania",2360,53000,313,1844,0,22,0,82,13.3,78.1,0,0.9,0,3.5,86.7,870,503,367,57.82,42.18,12,491,23,344,35,835,2.4,6.3,4,"75% or more P.O.C.","$51000 - $72000"
"42045402300","Census Tract 4023, Delaware County, Pennsylvania",3282,48168,89,3045,12,0,0,81,2.7,92.8,0.4,0,0,2.5,97.3,1499,413,1086,27.55,72.45,51,362,0,1086,51,1448,12.3,0,3.4,"75% or more P.O.C.","Less than $51000"
"42045402400","Census Tract 4024, Delaware County, Pennsylvania",3017,37708,307,2593,0,0,0,117,10.2,85.9,0,0,0,3.9,89.8,1094,581,513,53.11,46.89,63,518,38,475,101,993,10.8,7.4,9.2,"75% or more P.O.C.","Less than $51000"
"42045402500","Census Tract 4025, Delaware County, Pennsylvania",3734,48015,262,3224,0,101,0,136,7,86.3,0,2.7,0,3.6,93,1311,506,805,38.6,61.4,84,422,126,679,210,1101,16.6,15.7,16,"75% or more P.O.C.","Less than $51000"
"42045402600","Census Tract 4026, Delaware County, Pennsylvania",3944,57273,1018,2870,0,13,0,0,25.8,72.8,0,0.3,0,0,74.2,1032,560,472,54.26,45.74,64,496,104,368,168,864,11.4,22,16.3,"50% - 75% P.O.C.","$51000 - $72000"
"42045402700","Census Tract 4027, Delaware County, Pennsylvania",2546,49738,263,2112,0,0,0,152,10.3,83,0,0,0,6,89.7,765,427,338,55.82,44.18,94,333,82,256,176,589,22,24.3,23,"75% or more P.O.C.","Less than $51000"
"42045402800","Census Tract 4028, Delaware County, Pennsylvania",5684,57206,1193,4044,0,121,0,215,21,71.1,0,2.1,0,3.8,79,2062,1506,556,73.04,26.96,272,1234,77,479,349,1713,18.1,13.8,16.9,"75% or more P.O.C.","$51000 - $72000"
"42045402900","Census Tract 4029, Delaware County, Pennsylvania",3539,36316,144,3013,11,0,0,308,4.1,85.1,0.3,0,0,8.7,95.9,1434,820,614,57.18,42.82,25,795,78,536,103,1331,3,12.7,7.2,"75% or more P.O.C.","Less than $51000"
"42045403001","Census Tract 4030.01, Delaware County, Pennsylvania",3071,71522,2930,30,0,51,0,0,95.4,1,0,1.7,0,0,4.6,1284,1120,164,87.23,12.77,62,1058,0,164,62,1222,5.5,0,4.8,"Less than 25% P.O.C.","$51000 - $72000"
"42045403002","Census Tract 4030.02, Delaware County, Pennsylvania",2662,53262,1911,711,0,0,0,33,71.8,26.7,0,0,0,1.2,28.2,1131,777,354,68.7,31.3,41,736,19,335,60,1071,5.3,5.4,5.3,"25% - 50% P.O.C.","$51000 - $72000"
"42045403101","Census Tract 4031.01, Delaware County, Pennsylvania",3621,66302,1661,1624,0,109,0,104,45.9,44.8,0,3,0,2.9,54.1,1247,828,419,66.4,33.6,140,688,39,380,179,1068,16.9,9.3,14.4,"50% - 75% P.O.C.","$51000 - $72000"
"42045403103","Census Tract 4031.03, Delaware County, Pennsylvania",2682,64783,1067,1309,0,0,0,201,39.8,48.8,0,0,0,7.5,60.2,996,726,270,72.89,27.11,32,694,73,197,105,891,4.4,27,10.5,"50% - 75% P.O.C.","$51000 - $72000"
"42045403104","Census Tract 4031.04, Delaware County, Pennsylvania",2488,52841,638,1682,4,10,0,42,25.6,67.6,0.2,0.4,0,1.7,74.4,897,422,475,47.05,52.95,64,358,72,403,136,761,15.2,15.2,15.2,"50% - 75% P.O.C.","$51000 - $72000"
"42045403200","Census Tract 4032, Delaware County, Pennsylvania",4153,74474,2564,1259,0,97,0,119,61.7,30.3,0,2.3,0,2.9,38.3,1720,1241,479,72.15,27.85,102,1139,66,413,168,1552,8.2,13.8,9.8,"25% - 50% P.O.C.","$72000 - $96000"
"42045403300","Census Tract 4033, Delaware County, Pennsylvania",6696,48905,4817,1557,32,167,0,53,71.9,23.3,0.5,2.5,0,0.8,28.1,2658,1507,1151,56.7,43.3,141,1366,22,1129,163,2495,9.4,1.9,6.1,"25% - 50% P.O.C.","Less than $51000"
"42045403401","Census Tract 4034.01, Delaware County, Pennsylvania",3022,70411,1451,1188,0,30,29,239,48,39.3,0,1,1,7.9,52,1113,789,324,70.89,29.11,88,701,11,313,99,1014,11.2,3.4,8.9,"50% - 75% P.O.C.","$51000 - $72000"
"42045403402","Census Tract 4034.02, Delaware County, Pennsylvania",3605,60000,1906,1120,0,69,0,462,52.9,31.1,0,1.9,0,12.8,47.1,1232,859,373,69.72,30.28,101,758,108,265,209,1023,11.8,29,17,"25% - 50% P.O.C.","$51000 - $72000"
"42045403501","Census Tract 4035.01, Delaware County, Pennsylvania",4238,60133,3635,287,0,70,0,141,85.8,6.8,0,1.7,0,3.3,14.2,1793,972,821,54.21,45.79,109,863,14,807,123,1670,11.2,1.7,6.9,"Less than 25% P.O.C.","$51000 - $72000"
"42045403502","Census Tract 4035.02, Delaware County, Pennsylvania",2923,54799,2430,349,0,0,0,58,83.1,11.9,0,0,0,2,16.9,1119,921,198,82.31,17.69,65,856,13,185,78,1041,7.1,6.6,7,"Less than 25% P.O.C.","$51000 - $72000"
"42045403601","Census Tract 4036.01, Delaware County, Pennsylvania",4107,72802,3569,62,0,93,0,167,86.9,1.5,0,2.3,0,4.1,13.1,1445,992,453,68.65,31.35,249,743,0,453,249,1196,25.1,0,17.2,"Less than 25% P.O.C.","$72000 - $96000"
"42045403602","Census Tract 4036.02, Delaware County, Pennsylvania",1786,87875,1545,7,0,212,0,8,86.5,0.4,0,11.9,0,0.4,13.5,634,559,75,88.17,11.83,25,534,6,69,31,603,4.5,8,4.9,"Less than 25% P.O.C.","$72000 - $96000"
"42045403701","Census Tract 4037.01, Delaware County, Pennsylvania",1548,70926,1414,28,0,65,0,20,91.3,1.8,0,4.2,0,1.3,8.7,618,445,173,72.01,27.99,28,417,4,169,32,586,6.3,2.3,5.2,"Less than 25% P.O.C.","$51000 - $72000"
"42045403702","Census Tract 4037.02, Delaware County, Pennsylvania",2561,46273,2441,55,0,0,0,0,95.3,2.1,0,0,0,0,4.7,854,547,307,64.05,35.95,87,460,47,260,134,720,15.9,15.3,15.7,"Less than 25% P.O.C.","Less than $51000"
"42045403800","Census Tract 4038, Delaware County, Pennsylvania",6483,60569,5826,390,0,46,0,48,89.9,6,0,0.7,0,0.7,10.1,2659,1751,908,65.85,34.15,200,1551,22,886,222,2437,11.4,2.4,8.3,"Less than 25% P.O.C.","$51000 - $72000"
"42045403901","Census Tract 4039.01, Delaware County, Pennsylvania",3430,70893,3038,93,0,121,0,152,88.6,2.7,0,3.5,0,4.4,11.4,1476,802,674,54.34,45.66,56,746,0,674,56,1420,7,0,3.8,"Less than 25% P.O.C.","$51000 - $72000"
"42045403902","Census Tract 4039.02, Delaware County, Pennsylvania",3618,94453,3398,100,0,0,0,95,93.9,2.8,0,0,0,2.6,6.1,1401,1245,156,88.87,11.13,63,1182,0,156,63,1338,5.1,0,4.5,"Less than 25% P.O.C.","$72000 - $96000"
"42045404003","Census Tract 4040.03, Delaware County, Pennsylvania",2280,57088,1709,132,0,349,0,33,75,5.8,0,15.3,0,1.4,25,1007,439,568,43.59,56.41,100,339,7,561,107,900,22.8,1.2,10.6,"25% - 50% P.O.C.","$51000 - $72000"
"42045404004","Census Tract 4040.04, Delaware County, Pennsylvania",6190,85853,6008,45,0,102,0,35,97.1,0.7,0,1.6,0,0.6,2.9,2377,2115,262,88.98,11.02,221,1894,0,262,221,2156,10.4,0,9.3,"Less than 25% P.O.C.","$72000 - $96000"
"42045404101","Census Tract 4041.01, Delaware County, Pennsylvania",6370,75000,5598,384,0,59,0,314,87.9,6,0,0.9,0,4.9,12.1,2574,1845,729,71.68,28.32,151,1694,42,687,193,2381,8.2,5.8,7.5,"Less than 25% P.O.C.","$72000 - $96000"
"42045404102","Census Tract 4041.02, Delaware County, Pennsylvania",5262,55714,3800,1067,0,0,0,330,72.2,20.3,0,0,0,6.3,27.8,1958,1210,748,61.8,38.2,162,1048,56,692,218,1740,13.4,7.5,11.1,"25% - 50% P.O.C.","$51000 - $72000"
"42045404103","Census Tract 4041.03, Delaware County, Pennsylvania",3668,76047,3435,48,0,79,0,100,93.6,1.3,0,2.2,0,2.7,6.4,1398,1035,363,74.03,25.97,144,891,8,355,152,1246,13.9,2.2,10.9,"Less than 25% P.O.C.","$72000 - $96000"
"42045404300","Census Tract 4043, Delaware County, Pennsylvania",2530,52500,1581,480,0,61,0,162,62.5,19,0,2.4,0,6.4,37.5,762,412,350,54.07,45.93,61,351,76,274,137,625,14.8,21.7,18,"25% - 50% P.O.C.","$51000 - $72000"
"42045404400","Census Tract 4044, Delaware County, Pennsylvania",1723,46538,732,949,0,0,0,27,42.5,55.1,0,0,0,1.6,57.5,638,342,296,53.61,46.39,34,308,15,281,49,589,9.9,5.1,7.7,"50% - 75% P.O.C.","Less than $51000"
"42045404500","Census Tract 4045, Delaware County, Pennsylvania",5573,36844,849,3288,0,86,0,1099,15.2,59,0,1.5,0,19.7,84.8,1814,471,1343,25.96,74.04,33,438,188,1155,221,1593,7,14,12.2,"75% or more P.O.C.","Less than $51000"
"42045404600","Census Tract 4046, Delaware County, Pennsylvania",1969,53793,319,1469,0,0,0,84,16.2,74.6,0,0,0,4.3,83.8,770,320,450,41.56,58.44,22,298,34,416,56,714,6.9,7.6,7.3,"75% or more P.O.C.","$51000 - $72000"
"42045404700","Census Tract 4047, Delaware County, Pennsylvania",3949,30948,2020,1259,0,118,0,462,51.2,31.9,0,3,0,11.7,48.8,922,222,700,24.08,75.92,39,183,40,660,79,843,17.6,5.7,8.6,"25% - 50% P.O.C.","Less than $51000"
"42045404800","Census Tract 4048, Delaware County, Pennsylvania",2045,32176,171,1461,0,0,0,379,8.4,71.4,0,0,0,18.5,91.6,661,234,427,35.4,64.6,15,219,113,314,128,533,6.4,26.5,19.4,"75% or more P.O.C.","Less than $51000"
"42045404900","Census Tract 4049, Delaware County, Pennsylvania",1219,27303,15,998,0,0,0,124,1.2,81.9,0,0,0,10.2,98.8,372,163,209,43.82,56.18,0,163,21,188,21,351,0,10,5.6,"75% or more P.O.C.","Less than $51000"
"42045405000","Census Tract 4050, Delaware County, Pennsylvania",1786,22174,137,1514,0,0,0,109,7.7,84.8,0,0,0,6.1,92.3,778,308,470,39.59,60.41,25,283,11,459,36,742,8.1,2.3,4.6,"75% or more P.O.C.","Less than $51000"
"42045405100","Census Tract 4051, Delaware County, Pennsylvania",2055,32617,55,1696,0,0,0,298,2.7,82.5,0,0,0,14.5,97.3,791,390,401,49.3,50.7,21,369,55,346,76,715,5.4,13.7,9.6,"75% or more P.O.C.","Less than $51000"
"42045405200","Census Tract 4052, Delaware County, Pennsylvania",2828,21532,24,2636,9,0,0,102,0.8,93.2,0.3,0,0,3.6,99.2,1310,363,947,27.71,72.29,3,360,70,877,73,1237,0.8,7.4,5.6,"75% or more P.O.C.","Less than $51000"
"42045405300","Census Tract 4053, Delaware County, Pennsylvania",2979,38950,251,1835,0,0,0,697,8.4,61.6,0,0,0,23.4,91.6,1005,487,518,48.46,51.54,39,448,72,446,111,894,8,13.9,11,"75% or more P.O.C.","Less than $51000"
"42045405400","Census Tract 4054, Delaware County, Pennsylvania",2368,37227,332,1851,0,14,0,102,14,78.2,0,0.6,0,4.3,86,937,282,655,30.1,69.9,34,248,74,581,108,829,12.1,11.3,11.5,"75% or more P.O.C.","Less than $51000"
"42045406100","Census Tract 4061, Delaware County, Pennsylvania",2227,66968,1552,480,0,28,0,112,69.7,21.6,0,1.3,0,5,30.3,782,584,198,74.68,25.32,79,505,0,198,79,703,13.5,0,10.1,"25% - 50% P.O.C.","$51000 - $72000"
"42045406201","Census Tract 4062.01, Delaware County, Pennsylvania",3196,74167,2896,266,0,17,0,17,90.6,8.3,0,0.5,0,0.5,9.4,1256,1188,68,94.59,5.41,88,1100,0,68,88,1168,7.4,0,7,"Less than 25% P.O.C.","$72000 - $96000"
"42045406202","Census Tract 4062.02, Delaware County, Pennsylvania",4842,66205,4285,231,0,85,0,62,88.5,4.8,0,1.8,0,1.3,11.5,2162,1758,404,81.31,18.69,44,1714,0,404,44,2118,2.5,0,2,"Less than 25% P.O.C.","$51000 - $72000"
"42045406300","Census Tract 4063, Delaware County, Pennsylvania",3322,44503,1572,1210,0,64,0,218,47.3,36.4,0,1.9,0,6.6,52.7,1319,590,729,44.73,55.27,16,574,108,621,124,1195,2.7,14.8,9.4,"50% - 75% P.O.C.","Less than $51000"
"42045406401","Census Tract 4064.01, Delaware County, Pennsylvania",2823,43000,320,2401,25,5,0,67,11.3,85.1,0.9,0.2,0,2.4,88.7,948,627,321,66.14,33.86,40,587,82,239,122,826,6.4,25.5,12.9,"75% or more P.O.C.","Less than $51000"
"42045406402","Census Tract 4064.02, Delaware County, Pennsylvania",1245,34097,145,1004,0,0,0,17,11.6,80.6,0,0,0,1.4,88.4,595,202,393,33.95,66.05,22,180,8,385,30,565,10.9,2,5,"75% or more P.O.C.","Less than $51000"
"42045406500","Census Tract 4065, Delaware County, Pennsylvania",1911,47500,1068,565,0,0,0,135,55.9,29.6,0,0,0,7.1,44.1,588,405,183,68.88,31.12,59,346,48,135,107,481,14.6,26.2,18.2,"25% - 50% P.O.C.","Less than $51000"
"42045406600","Census Tract 4066, Delaware County, Pennsylvania",2258,36250,1549,534,0,38,0,105,68.6,23.6,0,1.7,0,4.7,31.4,886,253,633,28.56,71.44,45,208,21,612,66,820,17.8,3.3,7.4,"25% - 50% P.O.C.","Less than $51000"
"42045406700","Census Tract 4067, Delaware County, Pennsylvania",3468,58480,2720,572,0,40,0,70,78.4,16.5,0,1.2,0,2,21.6,1183,623,560,52.66,47.34,48,575,30,530,78,1105,7.7,5.4,6.6,"Less than 25% P.O.C.","$51000 - $72000"
"42045406801","Census Tract 4068.01, Delaware County, Pennsylvania",4132,82763,3297,607,88,41,0,47,79.8,14.7,2.1,1,0,1.1,20.2,1666,1349,317,80.97,19.03,123,1226,25,292,148,1518,9.1,7.9,8.9,"Less than 25% P.O.C.","$72000 - $96000"
"42045406802","Census Tract 4068.02, Delaware County, Pennsylvania",4251,58674,3337,729,0,0,0,126,78.5,17.1,0,0,0,3,21.5,1583,1219,364,77.01,22.99,143,1076,65,299,208,1375,11.7,17.9,13.1,"Less than 25% P.O.C.","$51000 - $72000"
"42045406803","Census Tract 4068.03, Delaware County, Pennsylvania",8546,76559,6839,861,0,589,0,152,80,10.1,0,6.9,0,1.8,20,3576,2181,1395,60.99,39.01,248,1933,21,1374,269,3307,11.4,1.5,7.5,"Less than 25% P.O.C.","$72000 - $96000"
"42045406902","Census Tract 4069.02, Delaware County, Pennsylvania",6299,91276,5826,278,0,62,0,33,92.5,4.4,0,1,0,0.5,7.5,2312,2092,220,90.48,9.52,243,1849,67,153,310,2002,11.6,30.5,13.4,"Less than 25% P.O.C.","$72000 - $96000"
"42045406903","Census Tract 4069.03, Delaware County, Pennsylvania",4914,86007,4570,114,0,142,0,43,93,2.3,0,2.9,0,0.9,7,1792,1557,235,86.89,13.11,152,1405,9,226,161,1631,9.8,3.8,9,"Less than 25% P.O.C.","$72000 - $96000"
"42045406904","Census Tract 4069.04, Delaware County, Pennsylvania",5493,96952,4651,327,11,270,0,115,84.7,6,0.2,4.9,0,2.1,15.3,1961,1741,220,88.78,11.22,137,1604,0,220,137,1824,7.9,0,7,"Less than 25% P.O.C.","$96000 or more"
"42045407000","Census Tract 4070, Delaware County, Pennsylvania",2661,85954,2346,119,0,95,0,61,88.2,4.5,0,3.6,0,2.3,11.8,1065,638,427,59.91,40.09,34,604,11,416,45,1020,5.3,2.6,4.2,"Less than 25% P.O.C.","$72000 - $96000"
"42045407101","Census Tract 4071.01, Delaware County, Pennsylvania",4500,110183,3808,143,0,210,0,187,84.6,3.2,0,4.7,0,4.2,15.4,1696,1214,482,71.58,28.42,133,1081,0,482,133,1563,11,0,7.8,"Less than 25% P.O.C.","$96000 or more"
"42045407102","Census Tract 4071.02, Delaware County, Pennsylvania",3290,109550,3012,47,0,157,0,74,91.6,1.4,0,4.8,0,2.2,8.4,1225,1203,22,98.2,1.8,101,1102,0,22,101,1124,8.4,0,8.2,"Less than 25% P.O.C.","$96000 or more"
"42045407201","Census Tract 4072.01, Delaware County, Pennsylvania",4543,82274,4247,41,0,184,0,71,93.5,0.9,0,4.1,0,1.6,6.5,2087,1334,753,63.92,36.08,117,1217,0,753,117,1970,8.8,0,5.6,"Less than 25% P.O.C.","$72000 - $96000"
"42045407202","Census Tract 4072.02, Delaware County, Pennsylvania",3636,98393,3525,68,0,6,0,32,96.9,1.9,0,0.2,0,0.9,3.1,1459,1051,408,72.04,27.96,58,993,23,385,81,1378,5.5,5.6,5.6,"Less than 25% P.O.C.","$96000 or more"
"42045407401","Census Tract 4074.01, Delaware County, Pennsylvania",3709,141250,3099,392,0,92,0,82,83.6,10.6,0,2.5,0,2.2,16.4,1486,1190,296,80.08,19.92,37,1153,21,275,58,1428,3.1,7.1,3.9,"Less than 25% P.O.C.","$96000 or more"
"42045407404","Census Tract 4074.04, Delaware County, Pennsylvania",2941,124531,2453,65,0,271,0,43,83.4,2.2,0,9.2,0,1.5,16.6,1054,1027,27,97.44,2.56,44,983,0,27,44,1010,4.3,0,4.2,"Less than 25% P.O.C.","$96000 or more"
"42045407501","Census Tract 4075.01, Delaware County, Pennsylvania",2463,82639,2205,48,21,104,0,61,89.5,1.9,0.9,4.2,0,2.5,10.5,1110,807,303,72.7,27.3,38,769,20,283,58,1052,4.7,6.6,5.2,"Less than 25% P.O.C.","$72000 - $96000"
"42045407502","Census Tract 4075.02, Delaware County, Pennsylvania",3024,77045,2442,264,20,171,0,54,80.8,8.7,0.7,5.7,0,1.8,19.2,1608,427,1181,26.55,73.45,23,404,0,1181,23,1585,5.4,0,1.4,"Less than 25% P.O.C.","$72000 - $96000"
"42045407600","Census Tract 4076, Delaware County, Pennsylvania",6318,107778,5168,287,57,332,0,221,81.8,4.5,0.9,5.3,0,3.5,18.2,1942,1487,455,76.57,23.43,157,1330,0,455,157,1785,10.6,0,8.1,"Less than 25% P.O.C.","$96000 or more"
"42045407700","Census Tract 4077, Delaware County, Pennsylvania",2662,68942,1867,603,0,112,0,44,70.1,22.7,0,4.2,0,1.7,29.9,1125,543,582,48.27,51.73,53,490,8,574,61,1064,9.8,1.4,5.4,"25% - 50% P.O.C.","$51000 - $72000"
"42045407801","Census Tract 4078.01, Delaware County, Pennsylvania",4608,110938,4368,125,2,30,0,83,94.8,2.7,0,0.7,0,1.8,5.2,1622,1481,141,91.31,8.69,207,1274,0,141,207,1415,14,0,12.8,"Less than 25% P.O.C.","$96000 or more"
"42045407802","Census Tract 4078.02, Delaware County, Pennsylvania",6190,122065,5941,0,0,155,0,30,96,0,0,2.5,0,0.5,4,2132,1987,145,93.2,6.8,185,1802,0,145,185,1947,9.3,0,8.7,"Less than 25% P.O.C.","$96000 or more"
"42045407803","Census Tract 4078.03, Delaware County, Pennsylvania",5483,113011,4943,0,0,234,0,60,90.2,0,0,4.3,0,1.1,9.8,1883,1655,228,87.89,12.11,192,1463,16,212,208,1675,11.6,7,11,"Less than 25% P.O.C.","$96000 or more"
"42045407804","Census Tract 4078.04, Delaware County, Pennsylvania",4420,115982,4062,10,0,228,0,73,91.9,0.2,0,5.2,0,1.7,8.1,1522,1491,31,97.96,2.04,158,1333,12,19,170,1352,10.6,38.7,11.2,"Less than 25% P.O.C.","$96000 or more"
"42045407805","Census Tract 4078.05, Delaware County, Pennsylvania",1841,117581,1766,35,0,28,0,12,95.9,1.9,0,1.5,0,0.7,4.1,576,527,49,91.49,8.51,71,456,0,49,71,505,13.5,0,12.3,"Less than 25% P.O.C.","$96000 or more"
"42045407806","Census Tract 4078.06, Delaware County, Pennsylvania",1705,101823,1225,90,0,190,0,94,71.8,5.3,0,11.1,0,5.5,28.2,601,557,44,92.68,7.32,44,513,0,44,44,557,7.9,0,7.3,"25% - 50% P.O.C.","$96000 or more"
"42045407901","Census Tract 4079.01, Delaware County, Pennsylvania",3852,173427,3468,66,0,195,0,35,90,1.7,0,5.1,0,0.9,10,1347,1280,67,95.03,4.97,121,1159,0,67,121,1226,9.5,0,9,"Less than 25% P.O.C.","$96000 or more"
"42045407902","Census Tract 4079.02, Delaware County, Pennsylvania",2897,104293,2474,73,22,125,0,34,85.4,2.5,0.8,4.3,0,1.2,14.6,1243,807,436,64.92,35.08,88,719,0,436,88,1155,10.9,0,7.1,"Less than 25% P.O.C.","$96000 or more"
"42045407903","Census Tract 4079.03, Delaware County, Pennsylvania",3667,98438,2518,334,0,597,0,71,68.7,9.1,0,16.3,0,1.9,31.3,1516,956,560,63.06,36.94,103,853,0,560,103,1413,10.8,0,6.8,"25% - 50% P.O.C.","$96000 or more"
"42045408001","Census Tract 4080.01, Delaware County, Pennsylvania",5972,122432,5284,2,0,594,0,1,88.5,0,0,9.9,0,0,11.5,2154,2044,110,94.89,5.11,251,1793,0,110,251,1903,12.3,0,11.7,"Less than 25% P.O.C.","$96000 or more"
"42045408002","Census Tract 4080.02, Delaware County, Pennsylvania",4088,108345,3428,125,0,340,0,35,83.9,3.1,0,8.3,0,0.9,16.1,1587,1377,210,86.77,13.23,127,1250,0,210,127,1460,9.2,0,8,"Less than 25% P.O.C.","$96000 or more"
"42045408101","Census Tract 4081.01, Delaware County, Pennsylvania",5552,110000,4903,156,0,349,0,67,88.3,2.8,0,6.3,0,1.2,11.7,1776,1593,183,89.7,10.3,169,1424,19,164,188,1588,10.6,10.4,10.6,"Less than 25% P.O.C.","$96000 or more"
"42045408102","Census Tract 4081.02, Delaware County, Pennsylvania",3577,88632,2970,87,94,372,0,42,83,2.4,2.6,10.4,0,1.2,17,1298,1123,175,86.52,13.48,73,1050,32,143,105,1193,6.5,18.3,8.1,"Less than 25% P.O.C.","$72000 - $96000"
"42045408103","Census Tract 4081.03, Delaware County, Pennsylvania",4590,85781,3798,84,14,417,0,131,82.7,1.8,0.3,9.1,0,2.9,17.3,1572,1158,414,73.66,26.34,95,1063,42,372,137,1435,8.2,10.1,8.7,"Less than 25% P.O.C.","$72000 - $96000"
"42045408300","Census Tract 4083, Delaware County, Pennsylvania",4501,134265,3473,244,4,168,0,334,77.2,5.4,0.1,3.7,0,7.4,22.8,1220,837,383,68.61,31.39,63,774,31,352,94,1126,7.5,8.1,7.7,"Less than 25% P.O.C.","$96000 or more"
"42045408400","Census Tract 4084, Delaware County, Pennsylvania",2109,156786,2001,21,0,71,0,7,94.9,1,0,3.4,0,0.3,5.1,978,599,379,61.25,38.75,66,533,0,379,66,912,11,0,6.7,"Less than 25% P.O.C.","$96000 or more"
"42045408500","Census Tract 4085, Delaware County, Pennsylvania",4118,114792,3386,195,0,352,0,185,82.2,4.7,0,8.5,0,4.5,17.8,1488,1315,173,88.37,11.63,174,1141,0,173,174,1314,13.2,0,11.7,"Less than 25% P.O.C.","$96000 or more"
"42045408600","Census Tract 4086, Delaware County, Pennsylvania",3335,104394,3173,31,0,87,0,26,95.1,0.9,0,2.6,0,0.8,4.9,1296,1098,198,84.72,15.28,115,983,21,177,136,1160,10.5,10.6,10.5,"Less than 25% P.O.C.","$96000 or more"
"42045408700","Census Tract 4087, Delaware County, Pennsylvania",4886,134814,4496,187,0,37,0,59,92,3.8,0,0.8,0,1.2,8,1699,1538,161,90.52,9.48,180,1358,0,161,180,1519,11.7,0,10.6,"Less than 25% P.O.C.","$96000 or more"
"42045408800","Census Tract 4088, Delaware County, Pennsylvania",4974,86278,4143,270,0,190,0,137,83.3,5.4,0,3.8,0,2.8,16.7,2041,1554,487,76.14,23.86,80,1474,0,487,80,1961,5.1,0,3.9,"Less than 25% P.O.C.","$72000 - $96000"
"42045408900","Census Tract 4089, Delaware County, Pennsylvania",2956,123854,2752,0,0,76,0,0,93.1,0,0,2.6,0,0,6.9,1046,983,63,93.98,6.02,120,863,0,63,120,926,12.2,0,11.5,"Less than 25% P.O.C.","$96000 or more"
"42045409000","Census Tract 4090, Delaware County, Pennsylvania",3732,100147,3006,174,0,214,0,153,80.5,4.7,0,5.7,0,4.1,19.5,1298,1171,127,90.22,9.78,93,1078,21,106,114,1184,7.9,16.5,8.8,"Less than 25% P.O.C.","$96000 or more"
"42045409100","Census Tract 4091, Delaware County, Pennsylvania",4271,108500,3998,36,0,67,0,90,93.6,0.8,0,1.6,0,2.1,6.4,1446,1263,183,87.34,12.66,144,1119,11,172,155,1291,11.4,6,10.7,"Less than 25% P.O.C.","$96000 or more"
"42045409200","Census Tract 4092, Delaware County, Pennsylvania",4250,115455,3821,47,0,192,0,67,89.9,1.1,0,4.5,0,1.6,10.1,1470,1337,133,90.95,9.05,135,1202,11,122,146,1324,10.1,8.3,9.9,"Less than 25% P.O.C.","$96000 or more"
"42045409300","Census Tract 4093, Delaware County, Pennsylvania",2447,102375,2225,35,0,75,0,68,90.9,1.4,0,3.1,0,2.8,9.1,849,754,95,88.81,11.19,101,653,9,86,110,739,13.4,9.5,13,"Less than 25% P.O.C.","$96000 or more"
"42045409400","Census Tract 4094, Delaware County, Pennsylvania",2972,123229,2673,96,0,141,0,13,89.9,3.2,0,4.7,0,0.4,10.1,969,882,87,91.02,8.98,103,779,0,87,103,866,11.7,0,10.6,"Less than 25% P.O.C.","$96000 or more"
"42045409500","Census Tract 4095, Delaware County, Pennsylvania",4732,97458,4190,155,0,189,0,135,88.5,3.3,0,4,0,2.9,11.5,1658,1558,100,93.97,6.03,173,1385,7,93,180,1478,11.1,7,10.9,"Less than 25% P.O.C.","$96000 or more"
"42045409601","Census Tract 4096.01, Delaware County, Pennsylvania",4394,128659,3256,264,0,670,0,95,74.1,6,0,15.2,0,2.2,25.9,1722,1065,657,61.85,38.15,89,976,22,635,111,1611,8.4,3.3,6.4,"25% - 50% P.O.C.","$96000 or more"
"42045409602","Census Tract 4096.02, Delaware County, Pennsylvania",5193,68508,3664,185,0,428,0,578,70.6,3.6,0,8.2,0,11.1,29.4,1522,676,846,44.42,55.58,60,616,55,791,115,1407,8.9,6.5,7.6,"25% - 50% P.O.C.","$51000 - $72000"
"42045409701","Census Tract 4097.01, Delaware County, Pennsylvania",7005,222917,5590,173,35,603,5,306,79.8,2.5,0.5,8.6,0.1,4.4,20.2,1866,1684,182,90.25,9.75,241,1443,12,170,253,1613,14.3,6.6,13.6,"Less than 25% P.O.C.","$96000 or more"
"42045409702","Census Tract 4097.02, Delaware County, Pennsylvania",1984,206250,1661,78,0,85,0,94,83.7,3.9,0,4.3,0,4.7,16.3,141,137,4,97.16,2.84,28,109,0,4,28,113,20.4,0,19.9,"Less than 25% P.O.C.","$96000 or more"
"42045409802","Census Tract 4098.02, Delaware County, Pennsylvania",5906,145583,4737,448,0,363,0,229,80.2,7.6,0,6.1,0,3.9,19.8,1501,988,513,65.82,34.18,183,805,0,513,183,1318,18.5,0,12.2,"Less than 25% P.O.C.","$96000 or more"
"42045409803","Census Tract 4098.03, Delaware County, Pennsylvania",7338,118831,5527,362,0,493,0,733,75.3,4.9,0,6.7,0,10,24.7,2667,1648,1019,61.79,38.21,176,1472,79,940,255,2412,10.7,7.8,9.6,"Less than 25% P.O.C.","$96000 or more"
"42045409902","Census Tract 4099.02, Delaware County, Pennsylvania",5444,86612,4673,65,0,451,0,81,85.8,1.2,0,8.3,0,1.5,14.2,2265,1575,690,69.54,30.46,103,1472,65,625,168,2097,6.5,9.4,7.4,"Less than 25% P.O.C.","$72000 - $96000"
"42045409903","Census Tract 4099.03, Delaware County, Pennsylvania",3846,93469,3450,90,0,167,0,89,89.7,2.3,0,4.3,0,2.3,10.3,1549,1265,284,81.67,18.33,101,1164,0,284,101,1448,8,0,6.5,"Less than 25% P.O.C.","$72000 - $96000"
"42045409904","Census Tract 4099.04, Delaware County, Pennsylvania",4061,152455,3894,17,0,33,0,111,95.9,0.4,0,0.8,0,2.7,4.1,1515,1345,170,88.78,11.22,177,1168,9,161,186,1329,13.2,5.3,12.3,"Less than 25% P.O.C.","$96000 or more"
"42045410000","Census Tract 4100, Delaware County, Pennsylvania",4059,114634,3529,74,0,294,0,39,86.9,1.8,0,7.2,0,1,13.1,1692,1207,485,71.34,28.66,101,1106,8,477,109,1583,8.4,1.6,6.4,"Less than 25% P.O.C.","$96000 or more"
"42045410100","Census Tract 4101, Delaware County, Pennsylvania",7700,163047,6470,560,0,412,0,117,84,7.3,0,5.4,0,1.5,16,2275,2178,97,95.74,4.26,212,1966,0,97,212,2063,9.7,0,9.3,"Less than 25% P.O.C.","$96000 or more"
"42045410200","Census Tract 4102, Delaware County, Pennsylvania",3720,113750,2795,86,8,505,0,196,75.1,2.3,0.2,13.6,0,5.3,24.9,1437,1231,206,85.66,14.34,123,1108,0,206,123,1314,10,0,8.6,"Less than 25% P.O.C.","$96000 or more"
"42045410301","Census Tract 4103.01, Delaware County, Pennsylvania",8090,112869,6177,1020,0,359,0,331,76.4,12.6,0,4.4,0,4.1,23.6,2216,1851,365,83.53,16.47,135,1716,13,352,148,2068,7.3,3.6,6.7,"Less than 25% P.O.C.","$96000 or more"
"42045410302","Census Tract 4103.02, Delaware County, Pennsylvania",9655,109548,7296,163,0,1676,0,163,75.6,1.7,0,17.4,0,1.7,24.4,4122,2143,1979,51.99,48.01,361,1782,0,1979,361,3761,16.8,0,8.8,"Less than 25% P.O.C.","$96000 or more"
"42045410400","Census Tract 4104, Delaware County, Pennsylvania",9181,140909,7715,137,12,1021,0,189,84,1.5,0.1,11.1,0,2.1,16,3038,2973,65,97.86,2.14,308,2665,0,65,308,2730,10.4,0,10.1,"Less than 25% P.O.C.","$96000 or more"
"42045410500","Census Tract 4105, Delaware County, Pennsylvania",5247,43750,431,1198,0,3315,0,135,8.2,22.8,0,63.2,0,2.6,91.8,1527,801,726,52.46,47.54,163,638,146,580,309,1218,20.3,20.1,20.2,"75% or more P.O.C.","Less than $51000"
"42045410601","Census Tract 4106.01, Delaware County, Pennsylvania",3664,103438,3421,38,0,0,0,166,93.4,1,0,0,0,4.5,6.6,1291,1036,255,80.25,19.75,171,865,41,214,212,1079,16.5,16.1,16.4,"Less than 25% P.O.C.","$96000 or more"
"42045410602","Census Tract 4106.02, Delaware County, Pennsylvania",4556,82378,4040,164,17,101,0,152,88.7,3.6,0.4,2.2,0,3.3,11.3,1770,1476,294,83.39,16.61,180,1296,0,294,180,1590,12.2,0,10.2,"Less than 25% P.O.C.","$72000 - $96000"
"42045410700","Census Tract 4107, Delaware County, Pennsylvania",5488,28524,905,4009,0,0,0,468,16.5,73.1,0,0,0,8.5,83.5,1604,609,995,37.97,62.03,34,575,120,875,154,1450,5.6,12.1,9.6,"75% or more P.O.C.","Less than $51000"
"42045410800","Census Tract 4108, Delaware County, Pennsylvania",8051,116364,6393,268,73,823,0,215,79.4,3.3,0.9,10.2,0,2.7,20.6,2892,2622,270,90.66,9.34,182,2440,0,270,182,2710,6.9,0,6.3,"Less than 25% P.O.C.","$96000 or more"
"42045980000","Census Tract 9800, Delaware County, Pennsylvania",0,NA,0,0,0,0,0,0,NA,NA,NA,NA,NA,NA,NA,0,0,0,NA,NA,0,0,0,0,0,0,NA,NA,NA,"N/A","N/A"
"42077000101","Census Tract 1.01, Lehigh County, Pennsylvania",3955,47337,1691,424,0,196,0,1546,42.8,10.7,0,5,0,39.1,57.2,1673,712,961,42.56,57.44,62,650,73,888,135,1538,8.7,7.6,8.1,"50% - 75% P.O.C.","Less than $51000"
"42077000102","Census Tract 1.02, Lehigh County, Pennsylvania",4114,47679,2021,156,7,0,0,1885,49.1,3.8,0.2,0,0,45.8,50.9,1436,975,461,67.9,32.1,117,858,15,446,132,1304,12,3.3,9.2,"50% - 75% P.O.C.","Less than $51000"
"42077000400","Census Tract 4, Lehigh County, Pennsylvania",4256,38477,1552,399,0,6,0,2285,36.5,9.4,0,0.1,0,53.7,63.5,1101,368,733,33.42,66.58,93,275,333,400,426,675,25.3,45.4,38.7,"50% - 75% P.O.C.","Less than $51000"
"42077000500","Census Tract 5, Lehigh County, Pennsylvania",2633,34528,315,292,0,51,0,1914,12,11.1,0,1.9,0,72.7,88,753,250,503,33.2,66.8,81,169,80,423,161,592,32.4,15.9,21.4,"75% or more P.O.C.","Less than $51000"
"42077000600","Census Tract 6, Lehigh County, Pennsylvania",6344,53682,1378,579,0,338,0,3912,21.7,9.1,0,5.3,0,61.7,78.3,2175,1460,715,67.13,32.87,95,1365,119,596,214,1961,6.5,16.6,9.8,"75% or more P.O.C.","$51000 - $72000"
"42077000700","Census Tract 7, Lehigh County, Pennsylvania",3773,32760,584,387,0,0,0,2715,15.5,10.3,0,0,0,72,84.5,1219,471,748,38.64,61.36,140,331,133,615,273,946,29.7,17.8,22.4,"75% or more P.O.C.","Less than $51000"
"42077000800","Census Tract 8, Lehigh County, Pennsylvania",4138,37549,588,460,0,18,0,3069,14.2,11.1,0,0.4,0,74.2,85.8,1179,316,863,26.8,73.2,70,246,192,671,262,917,22.2,22.2,22.2,"75% or more P.O.C.","Less than $51000"
"42077000900","Census Tract 9, Lehigh County, Pennsylvania",1562,32096,172,164,3,24,0,1184,11,10.5,0.2,1.5,0,75.8,89,537,151,386,28.12,71.88,20,131,84,302,104,433,13.2,21.8,19.4,"75% or more P.O.C.","Less than $51000"
"42077001000","Census Tract 10, Lehigh County, Pennsylvania",3330,27059,483,543,0,82,0,2167,14.5,16.3,0,2.5,0,65.1,85.5,1024,178,846,17.38,82.62,12,166,195,651,207,817,6.7,23,20.2,"75% or more P.O.C.","Less than $51000"
"42077001200","Census Tract 12, Lehigh County, Pennsylvania",2824,29583,617,358,0,10,0,1722,21.8,12.7,0,0.4,0,61,78.2,631,11,620,1.74,98.26,0,11,112,508,112,519,0,18.1,17.7,"75% or more P.O.C.","Less than $51000"
"42077001401","Census Tract 14.01, Lehigh County, Pennsylvania",8042,46416,2047,989,2,201,0,4499,25.5,12.3,0,2.5,0,55.9,74.5,2766,1024,1742,37.02,62.98,79,945,361,1381,440,2326,7.7,20.7,15.9,"50% - 75% P.O.C.","Less than $51000"
"42077001402","Census Tract 14.02, Lehigh County, Pennsylvania",1960,50341,1036,209,0,79,0,577,52.9,10.7,0,4,0,29.4,47.1,877,736,141,83.92,16.08,77,659,3,138,80,797,10.5,2.1,9.1,"25% - 50% P.O.C.","Less than $51000"
"42077001501","Census Tract 15.01, Lehigh County, Pennsylvania",6274,40560,1372,752,0,302,0,3848,21.9,12,0,4.8,0,61.3,78.1,2469,1095,1374,44.35,55.65,168,927,104,1270,272,2197,15.3,7.6,11,"75% or more P.O.C.","Less than $51000"
"42077001502","Census Tract 15.02, Lehigh County, Pennsylvania",7051,48592,2970,678,0,146,0,2974,42.1,9.6,0,2.1,0,42.2,57.9,2783,1204,1579,43.26,56.74,125,1079,78,1501,203,2580,10.4,4.9,7.3,"50% - 75% P.O.C.","Less than $51000"
"42077001600","Census Tract 16, Lehigh County, Pennsylvania",3812,26807,552,629,0,0,0,2498,14.5,16.5,0,0,0,65.5,85.5,1149,447,702,38.9,61.1,67,380,190,512,257,892,15,27.1,22.4,"75% or more P.O.C.","Less than $51000"
"42077001700","Census Tract 17, Lehigh County, Pennsylvania",5137,44361,556,356,0,49,0,4123,10.8,6.9,0,1,0,80.3,89.2,1461,625,836,42.78,57.22,162,463,199,637,361,1100,25.9,23.8,24.7,"75% or more P.O.C.","Less than $51000"
"42077001800","Census Tract 18, Lehigh County, Pennsylvania",4588,29846,725,591,100,23,0,3091,15.8,12.9,2.2,0.5,0,67.4,84.2,1669,275,1394,16.48,83.52,22,253,247,1147,269,1400,8,17.7,16.1,"75% or more P.O.C.","Less than $51000"
"42077001900","Census Tract 19, Lehigh County, Pennsylvania",4125,25201,1619,257,30,66,0,2099,39.2,6.2,0.7,1.6,0,50.9,60.8,1707,515,1192,30.17,69.83,86,429,60,1132,146,1561,16.7,5,8.6,"50% - 75% P.O.C.","Less than $51000"
"42077002000","Census Tract 20, Lehigh County, Pennsylvania",5562,35765,1412,547,0,49,0,3529,25.4,9.8,0,0.9,0,63.4,74.6,1903,669,1234,35.16,64.84,129,540,266,968,395,1508,19.3,21.6,20.8,"50% - 75% P.O.C.","Less than $51000"
"42077002100","Census Tract 21, Lehigh County, Pennsylvania",7185,40130,1913,846,0,755,0,3525,26.6,11.8,0,10.5,0,49.1,73.4,2760,762,1998,27.61,72.39,239,523,357,1641,596,2164,31.4,17.9,21.6,"50% - 75% P.O.C.","Less than $51000"
"42077002201","Census Tract 22.01, Lehigh County, Pennsylvania",4321,55688,2509,381,0,132,0,1228,58.1,8.8,0,3.1,0,28.4,41.9,1793,1134,659,63.25,36.75,53,1081,132,527,185,1608,4.7,20,10.3,"25% - 50% P.O.C.","$51000 - $72000"
"42077002202","Census Tract 22.02, Lehigh County, Pennsylvania",5048,49044,3468,392,14,122,0,958,68.7,7.8,0.3,2.4,0,19,31.3,853,225,628,26.38,73.62,19,206,59,569,78,775,8.4,9.4,9.1,"25% - 50% P.O.C.","Less than $51000"
"42077002301","Census Tract 23.01, Lehigh County, Pennsylvania",6844,69438,4618,248,2,629,0,1175,67.5,3.6,0,9.2,0,17.2,32.5,2982,1727,1255,57.91,42.09,36,1691,83,1172,119,2863,2.1,6.6,4,"25% - 50% P.O.C.","$51000 - $72000"
"42077002302","Census Tract 23.02, Lehigh County, Pennsylvania",2880,60156,2068,428,4,37,7,276,71.8,14.9,0.1,1.3,0.2,9.6,28.2,1058,809,249,76.47,23.53,17,792,54,195,71,987,2.1,21.7,6.7,"25% - 50% P.O.C.","$51000 - $72000"
"42077005100","Census Tract 51, Lehigh County, Pennsylvania",4291,50595,3920,8,0,11,0,219,91.4,0.2,0,0.3,0,5.1,8.6,1758,1012,746,57.57,42.43,158,854,64,682,222,1536,15.6,8.6,12.6,"Less than 25% P.O.C.","Less than $51000"
"42077005200","Census Tract 52, Lehigh County, Pennsylvania",6748,72278,6599,10,0,0,0,38,97.8,0.1,0,0,0,0.6,2.2,2642,2373,269,89.82,10.18,256,2117,39,230,295,2347,10.8,14.5,11.2,"Less than 25% P.O.C.","$72000 - $96000"
"42077005301","Census Tract 53.01, Lehigh County, Pennsylvania",3510,75536,3272,64,0,0,0,135,93.2,1.8,0,0,0,3.8,6.8,1336,1108,228,82.93,17.07,89,1019,14,214,103,1233,8,6.1,7.7,"Less than 25% P.O.C.","$72000 - $96000"
"42077005302","Census Tract 53.02, Lehigh County, Pennsylvania",4373,84313,4052,0,0,0,0,159,92.7,0,0,0,0,3.6,7.3,1665,1434,231,86.13,13.87,133,1301,8,223,141,1524,9.3,3.5,8.5,"Less than 25% P.O.C.","$72000 - $96000"
"42077005401","Census Tract 54.01, Lehigh County, Pennsylvania",2222,98631,2081,26,0,32,0,45,93.7,1.2,0,1.4,0,2,6.3,783,729,54,93.1,6.9,98,631,0,54,98,685,13.4,0,12.5,"Less than 25% P.O.C.","$96000 or more"
"42077005402","Census Tract 54.02, Lehigh County, Pennsylvania",5182,107031,4778,0,0,10,0,338,92.2,0,0,0.2,0,6.5,7.8,1889,1662,227,87.98,12.02,172,1490,55,172,227,1662,10.3,24.2,12,"Less than 25% P.O.C.","$96000 or more"
"42077005503","Census Tract 55.03, Lehigh County, Pennsylvania",4510,101641,4313,14,0,0,0,138,95.6,0.3,0,0,0,3.1,4.4,1559,1391,168,89.22,10.78,141,1250,26,142,167,1392,10.1,15.5,10.7,"Less than 25% P.O.C.","$96000 or more"
"42077005504","Census Tract 55.04, Lehigh County, Pennsylvania",4611,82050,4100,27,0,14,0,313,88.9,0.6,0,0.3,0,6.8,11.1,1721,1552,169,90.18,9.82,161,1391,19,150,180,1541,10.4,11.2,10.5,"Less than 25% P.O.C.","$72000 - $96000"
"42077005505","Census Tract 55.05, Lehigh County, Pennsylvania",3415,95573,2919,11,11,29,0,439,85.5,0.3,0.3,0.8,0,12.9,14.5,1334,1094,240,82.01,17.99,47,1047,66,174,113,1221,4.3,27.5,8.5,"Less than 25% P.O.C.","$72000 - $96000"
"42077005506","Census Tract 55.06, Lehigh County, Pennsylvania",3742,63917,3102,90,0,7,36,472,82.9,2.4,0,0.2,1,12.6,17.1,1544,1097,447,71.05,28.95,83,1014,12,435,95,1449,7.6,2.7,6.2,"Less than 25% P.O.C.","$51000 - $72000"
"42077005601","Census Tract 56.01, Lehigh County, Pennsylvania",4953,78681,4021,127,0,197,0,461,81.2,2.6,0,4,0,9.3,18.8,2005,1561,444,77.86,22.14,156,1405,8,436,164,1841,10,1.8,8.2,"Less than 25% P.O.C.","$72000 - $96000"
"42077005602","Census Tract 56.02, Lehigh County, Pennsylvania",4747,62357,3670,21,0,160,0,576,77.3,0.4,0,3.4,0,12.1,22.7,1936,1519,417,78.46,21.54,211,1308,19,398,230,1706,13.9,4.6,11.9,"Less than 25% P.O.C.","$51000 - $72000"
"42077005702","Census Tract 57.02, Lehigh County, Pennsylvania",3979,43556,3087,104,0,29,0,719,77.6,2.6,0,0.7,0,18.1,22.4,1862,1025,837,55.05,44.95,130,895,9,828,139,1723,12.7,1.1,7.5,"Less than 25% P.O.C.","Less than $51000"
"42077005703","Census Tract 57.03, Lehigh County, Pennsylvania",3726,59451,1774,413,5,149,0,1323,47.6,11.1,0.1,4,0,35.5,52.4,1463,717,746,49.01,50.99,35,682,53,693,88,1375,4.9,7.1,6,"50% - 75% P.O.C.","$51000 - $72000"
"42077005704","Census Tract 57.04, Lehigh County, Pennsylvania",3737,69976,1563,686,0,373,0,1022,41.8,18.4,0,10,0,27.3,58.2,1449,567,882,39.13,60.87,56,511,30,852,86,1363,9.9,3.4,5.9,"50% - 75% P.O.C.","$51000 - $72000"
"42077005705","Census Tract 57.05, Lehigh County, Pennsylvania",6425,75238,4138,505,0,386,0,1259,64.4,7.9,0,6,0,19.6,35.6,2376,1452,924,61.11,38.89,308,1144,54,870,362,2014,21.2,5.8,15.2,"25% - 50% P.O.C.","$72000 - $96000"
"42077005800","Census Tract 58, Lehigh County, Pennsylvania",3201,54625,2429,218,0,13,0,492,75.9,6.8,0,0.4,0,15.4,24.1,1363,985,378,72.27,27.73,42,943,21,357,63,1300,4.3,5.6,4.6,"Less than 25% P.O.C.","$51000 - $72000"
"42077005901","Census Tract 59.01, Lehigh County, Pennsylvania",6568,59460,5288,256,0,42,0,931,80.5,3.9,0,0.6,0,14.2,19.5,2705,1708,997,63.14,36.86,88,1620,35,962,123,2582,5.2,3.5,4.5,"Less than 25% P.O.C.","$51000 - $72000"
"42077005902","Census Tract 59.02, Lehigh County, Pennsylvania",1679,58304,1024,192,0,18,0,394,61,11.4,0,1.1,0,23.5,39,707,363,344,51.34,48.66,18,345,26,318,44,663,5,7.6,6.2,"25% - 50% P.O.C.","$51000 - $72000"
"42077006001","Census Tract 60.01, Lehigh County, Pennsylvania",4745,73412,3564,45,0,359,0,562,75.1,0.9,0,7.6,0,11.8,24.9,1873,1604,269,85.64,14.36,160,1444,22,247,182,1691,10,8.2,9.7,"Less than 25% P.O.C.","$72000 - $96000"
"42077006002","Census Tract 60.02, Lehigh County, Pennsylvania",5428,92750,4480,266,0,535,0,147,82.5,4.9,0,9.9,0,2.7,17.5,2104,1842,262,87.55,12.45,96,1746,23,239,119,1985,5.2,8.8,5.7,"Less than 25% P.O.C.","$72000 - $96000"
"42077006101","Census Tract 61.01, Lehigh County, Pennsylvania",3858,71364,3177,157,0,168,0,243,82.3,4.1,0,4.4,0,6.3,17.7,1494,969,525,64.86,35.14,69,900,9,516,78,1416,7.1,1.7,5.2,"Less than 25% P.O.C.","$51000 - $72000"
"42077006102","Census Tract 61.02, Lehigh County, Pennsylvania",5747,86261,4554,118,0,320,0,697,79.2,2.1,0,5.6,0,12.1,20.8,2238,1827,411,81.64,18.36,105,1722,69,342,174,2064,5.7,16.8,7.8,"Less than 25% P.O.C.","$72000 - $96000"
"42077006202","Census Tract 62.02, Lehigh County, Pennsylvania",12000,92083,8420,742,0,1270,0,1127,70.2,6.2,0,10.6,0,9.4,29.8,4615,3095,1520,67.06,32.94,202,2893,184,1336,386,4229,6.5,12.1,8.4,"25% - 50% P.O.C.","$72000 - $96000"
"42077006203","Census Tract 62.03, Lehigh County, Pennsylvania",8236,93944,6667,9,27,899,0,519,80.9,0.1,0.3,10.9,0,6.3,19.1,3316,2426,890,73.16,26.84,236,2190,49,841,285,3031,9.7,5.5,8.6,"Less than 25% P.O.C.","$72000 - $96000"
"42077006204","Census Tract 62.04, Lehigh County, Pennsylvania",3902,130547,3150,78,0,277,0,315,80.7,2,0,7.1,0,8.1,19.3,1357,1230,127,90.64,9.36,106,1124,41,86,147,1210,8.6,32.3,10.8,"Less than 25% P.O.C.","$96000 or more"
"42077006302","Census Tract 63.02, Lehigh County, Pennsylvania",7472,92950,6007,417,0,252,0,576,80.4,5.6,0,3.4,0,7.7,19.6,2730,2372,358,86.89,13.11,187,2185,47,311,234,2496,7.9,13.1,8.6,"Less than 25% P.O.C.","$72000 - $96000"
"42077006303","Census Tract 63.03, Lehigh County, Pennsylvania",3155,67586,2667,39,0,61,7,309,84.5,1.2,0,1.9,0.2,9.8,15.5,1410,764,646,54.18,45.82,86,678,0,646,86,1324,11.3,0,6.1,"Less than 25% P.O.C.","$51000 - $72000"
"42077006304","Census Tract 63.04, Lehigh County, Pennsylvania",3901,102474,3169,100,23,198,0,355,81.2,2.6,0.6,5.1,0,9.1,18.8,1539,1308,231,84.99,15.01,153,1155,27,204,180,1359,11.7,11.7,11.7,"Less than 25% P.O.C.","$96000 or more"
"42077006305","Census Tract 63.05, Lehigh County, Pennsylvania",6890,74856,5502,252,0,352,0,643,79.9,3.7,0,5.1,0,9.3,20.1,2679,2313,366,86.34,13.66,217,2096,22,344,239,2440,9.4,6,8.9,"Less than 25% P.O.C.","$72000 - $96000"
"42077006307","Census Tract 63.07, Lehigh County, Pennsylvania",8758,84098,7081,293,0,580,0,697,80.9,3.3,0,6.6,0,8,19.1,3591,3079,512,85.74,14.26,169,2910,15,497,184,3407,5.5,2.9,5.1,"Less than 25% P.O.C.","$72000 - $96000"
"42077006308","Census Tract 63.08, Lehigh County, Pennsylvania",7774,102604,6225,564,0,356,0,382,80.1,7.3,0,4.6,0,4.9,19.9,3027,2479,548,81.9,18.1,193,2286,79,469,272,2755,7.8,14.4,9,"Less than 25% P.O.C.","$96000 or more"
"42077006401","Census Tract 64.01, Lehigh County, Pennsylvania",3097,76510,2729,18,0,159,0,158,88.1,0.6,0,5.1,0,5.1,11.9,1325,985,340,74.34,25.66,82,903,43,297,125,1200,8.3,12.6,9.4,"Less than 25% P.O.C.","$72000 - $96000"
"42077006402","Census Tract 64.02, Lehigh County, Pennsylvania",5012,93000,4805,10,0,37,0,121,95.9,0.2,0,0.7,0,2.4,4.1,1964,1791,173,91.19,8.81,202,1589,0,173,202,1762,11.3,0,10.3,"Less than 25% P.O.C.","$72000 - $96000"
"42077006500","Census Tract 65, Lehigh County, Pennsylvania",5726,47328,4589,289,34,187,0,543,80.1,5,0.6,3.3,0,9.5,19.9,2482,1351,1131,54.43,45.57,114,1237,48,1083,162,2320,8.4,4.2,6.5,"Less than 25% P.O.C.","Less than $51000"
"42077006600","Census Tract 66, Lehigh County, Pennsylvania",5274,81866,4849,5,0,80,0,273,91.9,0.1,0,1.5,0,5.2,8.1,2196,1740,456,79.23,20.77,126,1614,0,456,126,2070,7.2,0,5.7,"Less than 25% P.O.C.","$72000 - $96000"
"42077006701","Census Tract 67.01, Lehigh County, Pennsylvania",5147,64135,3910,145,11,38,0,873,76,2.8,0.2,0.7,0,17,24,1949,1656,293,84.97,15.03,125,1531,13,280,138,1811,7.5,4.4,7.1,"Less than 25% P.O.C.","$51000 - $72000"
"42077006702","Census Tract 67.02, Lehigh County, Pennsylvania",2998,71458,2631,37,0,66,0,132,87.8,1.2,0,2.2,0,4.4,12.2,1099,921,178,83.8,16.2,93,828,58,120,151,948,10.1,32.6,13.7,"Less than 25% P.O.C.","$51000 - $72000"
"42077006703","Census Tract 67.03, Lehigh County, Pennsylvania",5742,92991,5277,44,0,93,0,272,91.9,0.8,0,1.6,0,4.7,8.1,2413,1928,485,79.9,20.1,212,1716,24,461,236,2177,11,4.9,9.8,"Less than 25% P.O.C.","$72000 - $96000"
"42077006800","Census Tract 68, Lehigh County, Pennsylvania",4683,46621,2753,316,0,113,0,1419,58.8,6.7,0,2.4,0,30.3,41.2,1971,1247,724,63.27,36.73,70,1177,22,702,92,1879,5.6,3,4.7,"25% - 50% P.O.C.","Less than $51000"
"42077006902","Census Tract 69.02, Lehigh County, Pennsylvania",2488,59615,2195,106,0,11,0,123,88.2,4.3,0,0.4,0,4.9,11.8,1014,626,388,61.74,38.26,58,568,11,377,69,945,9.3,2.8,6.8,"Less than 25% P.O.C.","$51000 - $72000"
"42077006903","Census Tract 69.03, Lehigh County, Pennsylvania",7052,104375,6052,14,0,327,0,464,85.8,0.2,0,4.6,0,6.6,14.2,2336,1999,337,85.57,14.43,232,1767,50,287,282,2054,11.6,14.8,12.1,"Less than 25% P.O.C.","$96000 or more"
"42077006905","Census Tract 69.05, Lehigh County, Pennsylvania",5606,120303,4826,142,0,42,0,244,86.1,2.5,0,0.7,0,4.4,13.9,2006,1759,247,87.69,12.31,105,1654,0,247,105,1901,6,0,5.2,"Less than 25% P.O.C.","$96000 or more"
"42077006906","Census Tract 69.06, Lehigh County, Pennsylvania",4078,88205,3530,18,0,134,0,295,86.6,0.4,0,3.3,0,7.2,13.4,1626,1471,155,90.47,9.53,114,1357,0,155,114,1512,7.7,0,7,"Less than 25% P.O.C.","$72000 - $96000"
"42077007000","Census Tract 70, Lehigh County, Pennsylvania",3963,101875,3776,18,0,38,0,68,95.3,0.5,0,1,0,1.7,4.7,1518,1394,124,91.83,8.17,146,1248,0,124,146,1372,10.5,0,9.6,"Less than 25% P.O.C.","$96000 or more"
"42077009100","Census Tract 91, Lehigh County, Pennsylvania",3614,47559,2695,196,0,101,0,545,74.6,5.4,0,2.8,0,15.1,25.4,1689,814,875,48.19,51.81,62,752,9,866,71,1618,7.6,1,4.2,"25% - 50% P.O.C.","Less than $51000"
"42077009200","Census Tract 92, Lehigh County, Pennsylvania",3821,68897,2800,252,0,81,0,643,73.3,6.6,0,2.1,0,16.8,26.7,1701,934,767,54.91,45.09,84,850,1,766,85,1616,9,0.1,5,"25% - 50% P.O.C.","$51000 - $72000"
"42077009300","Census Tract 93, Lehigh County, Pennsylvania",3241,69410,2640,67,0,27,0,507,81.5,2.1,0,0.8,0,15.6,18.5,1389,1083,306,77.97,22.03,87,996,0,306,87,1302,8,0,6.3,"Less than 25% P.O.C.","$51000 - $72000"
"42077009400","Census Tract 94, Lehigh County, Pennsylvania",4422,51333,2478,368,0,17,0,1385,56,8.3,0,0.4,0,31.3,44,1656,765,891,46.2,53.8,96,669,27,864,123,1533,12.5,3,7.4,"25% - 50% P.O.C.","$51000 - $72000"
"42077009500","Census Tract 95, Lehigh County, Pennsylvania",4688,46214,2633,173,18,21,0,1755,56.2,3.7,0.4,0.4,0,37.4,43.8,2065,983,1082,47.6,52.4,66,917,36,1046,102,1963,6.7,3.3,4.9,"25% - 50% P.O.C.","Less than $51000"
"42077009600","Census Tract 96, Lehigh County, Pennsylvania",7939,34217,2108,919,0,47,0,4811,26.6,11.6,0,0.6,0,60.6,73.4,2872,966,1906,33.64,66.36,56,910,223,1683,279,2593,5.8,11.7,9.7,"50% - 75% P.O.C.","Less than $51000"
"42077009700","Census Tract 97, Lehigh County, Pennsylvania",3218,26327,840,292,0,46,0,1892,26.1,9.1,0,1.4,0,58.8,73.9,1415,150,1265,10.6,89.4,8,142,174,1091,182,1233,5.3,13.8,12.9,"50% - 75% P.O.C.","Less than $51000"
"42091200103","Census Tract 2001.03, Montgomery County, Pennsylvania",4015,115345,3072,244,0,582,0,70,76.5,6.1,0,14.5,0,1.7,23.5,1254,1187,67,94.66,5.34,167,1020,26,41,193,1061,14.1,38.8,15.4,"Less than 25% P.O.C.","$96000 or more"
"42091200104","Census Tract 2001.04, Montgomery County, Pennsylvania",4389,126316,3951,13,0,351,0,20,90,0.3,0,8,0,0.5,10,1416,1369,47,96.68,3.32,164,1205,9,38,173,1243,12,19.1,12.2,"Less than 25% P.O.C.","$96000 or more"
"42091200105","Census Tract 2001.05, Montgomery County, Pennsylvania",2752,109333,2032,89,0,494,0,121,73.8,3.2,0,18,0,4.4,26.2,906,771,135,85.1,14.9,137,634,4,131,141,765,17.8,3,15.6,"25% - 50% P.O.C.","$96000 or more"
"42091200106","Census Tract 2001.06, Montgomery County, Pennsylvania",2011,37455,1509,72,13,359,0,7,75,3.6,0.6,17.9,0,0.3,25,924,390,534,42.21,57.79,71,319,4,530,75,849,18.2,0.7,8.1,"25% - 50% P.O.C.","Less than $51000"
"42091200200","Census Tract 2002, Montgomery County, Pennsylvania",1368,109028,1276,8,0,13,0,39,93.3,0.6,0,1,0,2.9,6.7,417,280,137,67.15,32.85,23,257,0,137,23,394,8.2,0,5.5,"Less than 25% P.O.C.","$96000 or more"
"42091200301","Census Tract 2003.01, Montgomery County, Pennsylvania",6866,68472,4418,446,0,679,0,756,64.3,6.5,0,9.9,0,11,35.7,2744,1132,1612,41.25,58.75,190,942,44,1568,234,2510,16.8,2.7,8.5,"25% - 50% P.O.C.","$51000 - $72000"
"42091200305","Census Tract 2003.05, Montgomery County, Pennsylvania",2117,95441,1961,14,0,48,13,67,92.6,0.7,0,2.3,0.6,3.2,7.4,802,680,122,84.79,15.21,97,583,0,122,97,705,14.3,0,12.1,"Less than 25% P.O.C.","$72000 - $96000"
"42091200306","Census Tract 2003.06, Montgomery County, Pennsylvania",3476,85727,3307,3,0,0,0,103,95.1,0.1,0,0,0,3,4.9,1292,930,362,71.98,28.02,141,789,14,348,155,1137,15.2,3.9,12,"Less than 25% P.O.C.","$72000 - $96000"
"42091200307","Census Tract 2003.07, Montgomery County, Pennsylvania",2738,56750,1941,346,26,186,0,143,70.9,12.6,0.9,6.8,0,5.2,29.1,1284,614,670,47.82,52.18,23,591,23,647,46,1238,3.7,3.4,3.6,"25% - 50% P.O.C.","$51000 - $72000"
"42091200308","Census Tract 2003.08, Montgomery County, Pennsylvania",3870,78690,3117,423,0,156,0,91,80.5,10.9,0,4,0,2.4,19.5,1536,1015,521,66.08,33.92,138,877,10,511,148,1388,13.6,1.9,9.6,"Less than 25% P.O.C.","$72000 - $96000"
"42091200309","Census Tract 2003.09, Montgomery County, Pennsylvania",2605,96908,2330,90,0,69,0,46,89.4,3.5,0,2.6,0,1.8,10.6,911,841,70,92.32,7.68,115,726,0,70,115,796,13.7,0,12.6,"Less than 25% P.O.C.","$96000 or more"
"42091200310","Census Tract 2003.10, Montgomery County, Pennsylvania",2442,98909,2387,17,0,19,0,19,97.7,0.7,0,0.8,0,0.8,2.3,1038,839,199,80.83,19.17,56,783,0,199,56,982,6.7,0,5.4,"Less than 25% P.O.C.","$96000 or more"
"42091200401","Census Tract 2004.01, Montgomery County, Pennsylvania",3428,71932,2818,197,0,27,0,299,82.2,5.7,0,0.8,0,8.7,17.8,1363,790,573,57.96,42.04,87,703,54,519,141,1222,11,9.4,10.3,"Less than 25% P.O.C.","$51000 - $72000"
"42091200402","Census Tract 2004.02, Montgomery County, Pennsylvania",4021,72115,3365,294,6,38,0,280,83.7,7.3,0.1,0.9,0,7,16.3,1592,833,759,52.32,47.68,133,700,20,739,153,1439,16,2.6,9.6,"Less than 25% P.O.C.","$72000 - $96000"
"42091200501","Census Tract 2005.01, Montgomery County, Pennsylvania",4184,102396,3628,49,0,146,0,199,86.7,1.2,0,3.5,0,4.8,13.3,1346,1295,51,96.21,3.79,175,1120,11,40,186,1160,13.5,21.6,13.8,"Less than 25% P.O.C.","$96000 or more"
"42091200502","Census Tract 2005.02, Montgomery County, Pennsylvania",5088,61556,4051,544,2,320,0,171,79.6,10.7,0,6.3,0,3.4,20.4,2250,890,1360,39.56,60.44,60,830,47,1313,107,2143,6.7,3.5,4.8,"Less than 25% P.O.C.","$51000 - $72000"
"42091200505","Census Tract 2005.05, Montgomery County, Pennsylvania",7425,142600,5798,130,0,764,0,448,78.1,1.8,0,10.3,0,6,21.9,2508,1680,828,66.99,33.01,268,1412,59,769,327,2181,16,7.1,13,"Less than 25% P.O.C.","$96000 or more"
"42091200506","Census Tract 2005.06, Montgomery County, Pennsylvania",4571,117260,3914,15,0,480,0,106,85.6,0.3,0,10.5,0,2.3,14.4,1569,1391,178,88.66,11.34,123,1268,54,124,177,1392,8.8,30.3,11.3,"Less than 25% P.O.C.","$96000 or more"
"42091200507","Census Tract 2005.07, Montgomery County, Pennsylvania",5219,94861,3956,140,0,509,0,555,75.8,2.7,0,9.8,0,10.6,24.2,2176,1845,331,84.79,15.21,133,1712,15,316,148,2028,7.2,4.5,6.8,"Less than 25% P.O.C.","$72000 - $96000"
"42091200602","Census Tract 2006.02, Montgomery County, Pennsylvania",8151,118476,5862,484,0,1358,20,148,71.9,5.9,0,16.7,0.2,1.8,28.1,3124,2674,450,85.6,14.4,322,2352,0,450,322,2802,12,0,10.3,"25% - 50% P.O.C.","$96000 or more"
"42091200603","Census Tract 2006.03, Montgomery County, Pennsylvania",3529,117612,2698,307,0,377,0,124,76.5,8.7,0,10.7,0,3.5,23.5,1269,1150,119,90.62,9.38,45,1105,24,95,69,1200,3.9,20.2,5.4,"Less than 25% P.O.C.","$96000 or more"
"42091200605","Census Tract 2006.05, Montgomery County, Pennsylvania",6787,94609,4352,313,0,2003,0,39,64.1,4.6,0,29.5,0,0.6,35.9,2629,2405,224,91.48,8.52,259,2146,0,224,259,2370,10.8,0,9.9,"25% - 50% P.O.C.","$72000 - $96000"
"42091200606","Census Tract 2006.06, Montgomery County, Pennsylvania",3190,88007,2474,116,0,448,0,113,77.6,3.6,0,14,0,3.5,22.4,1231,986,245,80.1,19.9,95,891,0,245,95,1136,9.6,0,7.7,"Less than 25% P.O.C.","$72000 - $96000"
"42091200607","Census Tract 2006.07, Montgomery County, Pennsylvania",4387,138125,3349,169,0,689,0,68,76.3,3.9,0,15.7,0,1.6,23.7,1600,1576,24,98.5,1.5,98,1478,0,24,98,1502,6.2,0,6.1,"Less than 25% P.O.C.","$96000 or more"
"42091200703","Census Tract 2007.03, Montgomery County, Pennsylvania",4312,89023,3024,363,8,724,0,52,70.1,8.4,0.2,16.8,0,1.2,29.9,1632,1222,410,74.88,25.12,114,1108,24,386,138,1494,9.3,5.9,8.5,"25% - 50% P.O.C.","$72000 - $96000"
"42091200704","Census Tract 2007.04, Montgomery County, Pennsylvania",3303,93125,2614,159,0,104,0,288,79.1,4.8,0,3.1,0,8.7,20.9,1323,809,514,61.15,38.85,35,774,71,443,106,1217,4.3,13.8,8,"Less than 25% P.O.C.","$72000 - $96000"
"42091200707","Census Tract 2007.07, Montgomery County, Pennsylvania",4147,67991,2549,325,0,763,0,443,61.5,7.8,0,18.4,0,10.7,38.5,1753,866,887,49.4,50.6,147,719,18,869,165,1588,17,2,9.4,"25% - 50% P.O.C.","$51000 - $72000"
"42091200708","Census Tract 2007.08, Montgomery County, Pennsylvania",5884,93816,4320,22,0,1025,0,325,73.4,0.4,0,17.4,0,5.5,26.6,2142,1720,422,80.3,19.7,136,1584,33,389,169,1973,7.9,7.8,7.9,"25% - 50% P.O.C.","$72000 - $96000"
"42091200800","Census Tract 2008, Montgomery County, Pennsylvania",3333,58210,1819,417,0,859,0,199,54.6,12.5,0,25.8,0,6,45.4,1279,646,633,50.51,49.49,64,582,79,554,143,1136,9.9,12.5,11.2,"25% - 50% P.O.C.","$51000 - $72000"
"42091200901","Census Tract 2009.01, Montgomery County, Pennsylvania",4217,70769,2897,314,63,752,0,42,68.7,7.4,1.5,17.8,0,1,31.3,1576,890,686,56.47,43.53,169,721,30,656,199,1377,19,4.4,12.6,"25% - 50% P.O.C.","$51000 - $72000"
"42091200902","Census Tract 2009.02, Montgomery County, Pennsylvania",1386,58651,826,45,0,306,0,189,59.6,3.2,0,22.1,0,13.6,40.4,517,270,247,52.22,47.78,62,208,0,247,62,455,23,0,12,"25% - 50% P.O.C.","$51000 - $72000"
"42091200903","Census Tract 2009.03, Montgomery County, Pennsylvania",4595,61350,2990,178,0,744,0,526,65.1,3.9,0,16.2,0,11.4,34.9,1804,764,1040,42.35,57.65,90,674,96,944,186,1618,11.8,9.2,10.3,"25% - 50% P.O.C.","$51000 - $72000"
"42091200906","Census Tract 2009.06, Montgomery County, Pennsylvania",1927,67100,1321,115,0,324,0,96,68.6,6,0,16.8,0,5,31.4,768,409,359,53.26,46.74,26,383,6,353,32,736,6.4,1.7,4.2,"25% - 50% P.O.C.","$51000 - $72000"
"42091200907","Census Tract 2009.07, Montgomery County, Pennsylvania",2479,98472,2242,18,0,168,0,51,90.4,0.7,0,6.8,0,2.1,9.6,979,716,263,73.14,26.86,10,706,0,263,10,969,1.4,0,1,"Less than 25% P.O.C.","$96000 or more"
"42091200908","Census Tract 2009.08, Montgomery County, Pennsylvania",2071,68207,1490,198,4,172,0,148,71.9,9.6,0.2,8.3,0,7.1,28.1,901,509,392,56.49,43.51,26,483,6,386,32,869,5.1,1.5,3.6,"25% - 50% P.O.C.","$51000 - $72000"
"42091201003","Census Tract 2010.03, Montgomery County, Pennsylvania",4848,85129,3577,264,0,858,0,37,73.8,5.4,0,17.7,0,0.8,26.2,2076,1248,828,60.12,39.88,118,1130,0,828,118,1958,9.5,0,5.7,"25% - 50% P.O.C.","$72000 - $96000"
"42091201004","Census Tract 2010.04, Montgomery County, Pennsylvania",5330,83859,3835,162,0,1046,0,247,72,3,0,19.6,0,4.6,28,2205,1335,870,60.54,39.46,123,1212,0,870,123,2082,9.2,0,5.6,"25% - 50% P.O.C.","$72000 - $96000"
"42091201005","Census Tract 2010.05, Montgomery County, Pennsylvania",3465,138072,2997,43,0,313,0,91,86.5,1.2,0,9,0,2.6,13.5,1171,1104,67,94.28,5.72,90,1014,0,67,90,1081,8.2,0,7.7,"Less than 25% P.O.C.","$96000 or more"
"42091201006","Census Tract 2010.06, Montgomery County, Pennsylvania",2188,126429,1964,49,0,64,0,99,89.8,2.2,0,2.9,0,4.5,10.2,904,874,30,96.68,3.32,53,821,5,25,58,846,6.1,16.7,6.4,"Less than 25% P.O.C.","$96000 or more"
"42091201100","Census Tract 2011, Montgomery County, Pennsylvania",3253,94679,2877,151,0,51,0,95,88.4,4.6,0,1.6,0,2.9,11.6,1299,943,356,72.59,27.41,61,882,47,309,108,1191,6.5,13.2,8.3,"Less than 25% P.O.C.","$72000 - $96000"
"42091201201","Census Tract 2012.01, Montgomery County, Pennsylvania",6224,117344,5084,111,10,823,0,43,81.7,1.8,0.2,13.2,0,0.7,18.3,2384,1884,500,79.03,20.97,210,1674,24,476,234,2150,11.1,4.8,9.8,"Less than 25% P.O.C.","$96000 or more"
"42091201203","Census Tract 2012.03, Montgomery County, Pennsylvania",3083,109125,2818,63,0,178,0,7,91.4,2,0,5.8,0,0.2,8.6,1232,817,415,66.31,33.69,124,693,0,415,124,1108,15.2,0,10.1,"Less than 25% P.O.C.","$96000 or more"
"42091201204","Census Tract 2012.04, Montgomery County, Pennsylvania",2213,79750,1538,533,0,58,0,44,69.5,24.1,0,2.6,0,2,30.5,903,786,117,87.04,12.96,36,750,14,103,50,853,4.6,12,5.5,"25% - 50% P.O.C.","$72000 - $96000"
"42091201301","Census Tract 2013.01, Montgomery County, Pennsylvania",3524,81650,2444,307,0,143,0,486,69.4,8.7,0,4.1,0,13.8,30.6,1327,826,501,62.25,37.75,101,725,0,501,101,1226,12.2,0,7.6,"25% - 50% P.O.C.","$72000 - $96000"
"42091201302","Census Tract 2013.02, Montgomery County, Pennsylvania",2965,53944,2080,435,0,98,0,313,70.2,14.7,0,3.3,0,10.6,29.8,1342,600,742,44.71,55.29,16,584,0,742,16,1326,2.7,0,1.2,"25% - 50% P.O.C.","$51000 - $72000"
"42091201404","Census Tract 2014.04, Montgomery County, Pennsylvania",5156,107337,4203,104,0,629,0,191,81.5,2,0,12.2,0,3.7,18.5,2037,1323,714,64.95,35.05,112,1211,0,714,112,1925,8.5,0,5.5,"Less than 25% P.O.C.","$96000 or more"
"42091201406","Census Tract 2014.06, Montgomery County, Pennsylvania",4818,133527,3682,256,0,589,0,242,76.4,5.3,0,12.2,0,5,23.6,1671,1562,109,93.48,6.52,194,1368,0,109,194,1477,12.4,0,11.6,"Less than 25% P.O.C.","$96000 or more"
"42091201407","Census Tract 2014.07, Montgomery County, Pennsylvania",2649,109167,1763,551,0,186,0,120,66.6,20.8,0,7,0,4.5,33.4,858,782,76,91.14,8.86,110,672,0,76,110,748,14.1,0,12.8,"25% - 50% P.O.C.","$96000 or more"
"42091201408","Census Tract 2014.08, Montgomery County, Pennsylvania",4104,167823,3500,29,0,410,0,69,85.3,0.7,0,10,0,1.7,14.7,1434,1355,79,94.49,5.51,93,1262,0,79,93,1341,6.9,0,6.5,"Less than 25% P.O.C.","$96000 or more"
"42091201409","Census Tract 2014.09, Montgomery County, Pennsylvania",4460,163438,3857,34,0,372,0,62,86.5,0.8,0,8.3,0,1.4,13.5,1476,1420,56,96.21,3.79,134,1286,17,39,151,1325,9.4,30.4,10.2,"Less than 25% P.O.C.","$96000 or more"
"42091201410","Census Tract 2014.10, Montgomery County, Pennsylvania",2385,111219,1927,91,0,234,0,28,80.8,3.8,0,9.8,0,1.2,19.2,991,819,172,82.64,17.36,68,751,0,172,68,923,8.3,0,6.9,"Less than 25% P.O.C.","$96000 or more"
"42091201411","Census Tract 2014.11, Montgomery County, Pennsylvania",2755,95833,2546,34,0,17,0,62,92.4,1.2,0,0.6,0,2.3,7.6,1030,825,205,80.1,19.9,152,673,15,190,167,863,18.4,7.3,16.2,"Less than 25% P.O.C.","$72000 - $96000"
"42091201501","Census Tract 2015.01, Montgomery County, Pennsylvania",3503,97031,2827,86,0,348,0,148,80.7,2.5,0,9.9,0,4.2,19.3,1381,845,536,61.19,38.81,85,760,13,523,98,1283,10.1,2.4,7.1,"Less than 25% P.O.C.","$96000 or more"
"42091201502","Census Tract 2015.02, Montgomery County, Pennsylvania",1956,142500,1704,92,0,51,0,86,87.1,4.7,0,2.6,0,4.4,12.9,700,688,12,98.29,1.71,62,626,0,12,62,638,9,0,8.9,"Less than 25% P.O.C.","$96000 or more"
"42091201603","Census Tract 2016.03, Montgomery County, Pennsylvania",4209,80977,2437,1314,0,132,0,127,57.9,31.2,0,3.1,0,3,42.1,1569,1437,132,91.59,8.41,130,1307,13,119,143,1426,9,9.8,9.1,"25% - 50% P.O.C.","$72000 - $96000"
"42091201604","Census Tract 2016.04, Montgomery County, Pennsylvania",3053,88710,1628,880,0,53,0,297,53.3,28.8,0,1.7,0,9.7,46.7,1136,1081,55,95.16,4.84,167,914,0,55,167,969,15.4,0,14.7,"25% - 50% P.O.C.","$72000 - $96000"
"42091201605","Census Tract 2016.05, Montgomery County, Pennsylvania",3089,93913,2385,475,0,151,0,78,77.2,15.4,0,4.9,0,2.5,22.8,1028,994,34,96.69,3.31,116,878,0,34,116,912,11.7,0,11.3,"Less than 25% P.O.C.","$72000 - $96000"
"42091201606","Census Tract 2016.06, Montgomery County, Pennsylvania",2414,64712,1138,767,12,177,0,184,47.1,31.8,0.5,7.3,0,7.6,52.9,830,576,254,69.4,30.6,78,498,47,207,125,705,13.5,18.5,15.1,"50% - 75% P.O.C.","$51000 - $72000"
"42091201607","Census Tract 2016.07, Montgomery County, Pennsylvania",3550,89261,2886,199,0,155,0,121,81.3,5.6,0,4.4,0,3.4,18.7,1305,1065,240,81.61,18.39,95,970,10,230,105,1200,8.9,4.2,8,"Less than 25% P.O.C.","$72000 - $96000"
"42091201608","Census Tract 2016.08, Montgomery County, Pennsylvania",4611,115227,3862,187,0,310,0,122,83.8,4.1,0,6.7,0,2.6,16.2,1762,1419,343,80.53,19.47,158,1261,0,343,158,1604,11.1,0,9,"Less than 25% P.O.C.","$96000 or more"
"42091201703","Census Tract 2017.03, Montgomery County, Pennsylvania",3373,87935,2786,274,0,36,0,165,82.6,8.1,0,1.1,0,4.9,17.4,1186,986,200,83.14,16.86,71,915,27,173,98,1088,7.2,13.5,8.3,"Less than 25% P.O.C.","$72000 - $96000"
"42091201704","Census Tract 2017.04, Montgomery County, Pennsylvania",3323,89679,2757,463,0,31,0,10,83,13.9,0,0.9,0,0.3,17,1239,1075,164,86.76,13.24,65,1010,0,164,65,1174,6,0,5.2,"Less than 25% P.O.C.","$72000 - $96000"
"42091201705","Census Tract 2017.05, Montgomery County, Pennsylvania",4258,90469,3841,96,0,0,0,193,90.2,2.3,0,0,0,4.5,9.8,1648,1289,359,78.22,21.78,214,1075,0,359,214,1434,16.6,0,13,"Less than 25% P.O.C.","$72000 - $96000"
"42091201706","Census Tract 2017.06, Montgomery County, Pennsylvania",4872,99043,3625,661,0,121,0,426,74.4,13.6,0,2.5,0,8.7,25.6,1674,1316,358,78.61,21.39,147,1169,40,318,187,1487,11.2,11.2,11.2,"25% - 50% P.O.C.","$96000 or more"
"42091201800","Census Tract 2018, Montgomery County, Pennsylvania",3163,99875,2523,219,0,105,0,152,79.8,6.9,0,3.3,0,4.8,20.2,1443,842,601,58.35,41.65,65,777,21,580,86,1357,7.7,3.5,6,"Less than 25% P.O.C.","$96000 or more"
"42091201901","Census Tract 2019.01, Montgomery County, Pennsylvania",4822,106585,4247,80,0,279,0,179,88.1,1.7,0,5.8,0,3.7,11.9,1791,1528,263,85.32,14.68,205,1323,0,263,205,1586,13.4,0,11.4,"Less than 25% P.O.C.","$96000 or more"
"42091201902","Census Tract 2019.02, Montgomery County, Pennsylvania",5263,100500,4038,669,0,352,0,129,76.7,12.7,0,6.7,0,2.5,23.3,2238,1521,717,67.96,32.04,94,1427,0,717,94,2144,6.2,0,4.2,"Less than 25% P.O.C.","$96000 or more"
"42091202000","Census Tract 2020, Montgomery County, Pennsylvania",2539,68750,2352,0,0,60,0,94,92.6,0,0,2.4,0,3.7,7.4,1077,690,387,64.07,35.93,60,630,10,377,70,1007,8.7,2.6,6.5,"Less than 25% P.O.C.","$51000 - $72000"
"42091202100","Census Tract 2021, Montgomery County, Pennsylvania",4433,108523,3521,462,0,70,0,319,79.4,10.4,0,1.6,0,7.2,20.6,1793,1142,651,63.69,36.31,171,971,0,651,171,1622,15,0,9.5,"Less than 25% P.O.C.","$96000 or more"
"42091202201","Census Tract 2022.01, Montgomery County, Pennsylvania",4946,93152,3115,1183,0,275,0,269,63,23.9,0,5.6,0,5.4,37,1904,1412,492,74.16,25.84,174,1238,19,473,193,1711,12.3,3.9,10.1,"25% - 50% P.O.C.","$72000 - $96000"
"42091202202","Census Tract 2022.02, Montgomery County, Pennsylvania",3054,99792,779,1371,8,575,0,257,25.5,44.9,0.3,18.8,0,8.4,74.5,975,952,23,97.64,2.36,137,815,17,6,154,821,14.4,73.9,15.8,"50% - 75% P.O.C.","$96000 or more"
"42091202301","Census Tract 2023.01, Montgomery County, Pennsylvania",4535,129531,3149,791,0,159,14,124,69.4,17.4,0,3.5,0.3,2.7,30.6,1870,1496,374,80,20,118,1378,15,359,133,1737,7.9,4,7.1,"25% - 50% P.O.C.","$96000 or more"
"42091202302","Census Tract 2023.02, Montgomery County, Pennsylvania",2161,77542,1138,775,0,117,0,78,52.7,35.9,0,5.4,0,3.6,47.3,1015,730,285,71.92,28.08,24,706,0,285,24,991,3.3,0,2.4,"25% - 50% P.O.C.","$72000 - $96000"
"42091202401","Census Tract 2024.01, Montgomery County, Pennsylvania",3711,46689,531,2506,0,262,0,276,14.3,67.5,0,7.1,0,7.4,85.7,2008,15,1993,0.75,99.25,0,15,43,1950,43,1965,0,2.2,2.1,"75% or more P.O.C.","Less than $51000"
"42091202402","Census Tract 2024.02, Montgomery County, Pennsylvania",4749,93292,1660,2167,103,218,15,284,35,45.6,2.2,4.6,0.3,6,65,1747,1379,368,78.94,21.06,191,1188,24,344,215,1532,13.9,6.5,12.3,"50% - 75% P.O.C.","$72000 - $96000"
"42091202500","Census Tract 2025, Montgomery County, Pennsylvania",5689,76339,1524,2923,57,549,4,300,26.8,51.4,1,9.7,0.1,5.3,73.2,2199,1198,1001,54.48,45.52,171,1027,84,917,255,1944,14.3,8.4,11.6,"50% - 75% P.O.C.","$72000 - $96000"
"42091202602","Census Tract 2026.02, Montgomery County, Pennsylvania",2604,88750,2088,290,0,129,0,33,80.2,11.1,0,5,0,1.3,19.8,1000,645,355,64.5,35.5,73,572,0,355,73,927,11.3,0,7.3,"Less than 25% P.O.C.","$72000 - $96000"
"42091202603","Census Tract 2026.03, Montgomery County, Pennsylvania",3430,93083,2835,237,0,128,0,191,82.7,6.9,0,3.7,0,5.6,17.3,1179,890,289,75.49,24.51,102,788,8,281,110,1069,11.5,2.8,9.3,"Less than 25% P.O.C.","$72000 - $96000"
"42091202604","Census Tract 2026.04, Montgomery County, Pennsylvania",2292,117679,1563,414,0,126,0,135,68.2,18.1,0,5.5,0,5.9,31.8,888,765,123,86.15,13.85,80,685,6,117,86,802,10.5,4.9,9.7,"25% - 50% P.O.C.","$96000 or more"
"42091203000","Census Tract 2030, Montgomery County, Pennsylvania",3028,138750,2535,166,0,166,0,98,83.7,5.5,0,5.5,0,3.2,16.3,1025,807,218,78.73,21.27,87,720,13,205,100,925,10.8,6,9.8,"Less than 25% P.O.C.","$96000 or more"
"42091203103","Census Tract 2031.03, Montgomery County, Pennsylvania",3098,150625,2741,64,0,97,0,80,88.5,2.1,0,3.1,0,2.6,11.5,1096,1052,44,95.99,4.01,78,974,0,44,78,1018,7.4,0,7.1,"Less than 25% P.O.C.","$96000 or more"
"42091203104","Census Tract 2031.04, Montgomery County, Pennsylvania",4282,116667,4089,16,9,37,0,130,95.5,0.4,0.2,0.9,0,3,4.5,1750,1355,395,77.43,22.57,109,1246,0,395,109,1641,8,0,6.2,"Less than 25% P.O.C.","$96000 or more"
"42091203105","Census Tract 2031.05, Montgomery County, Pennsylvania",5283,122222,4606,194,9,332,0,96,87.2,3.7,0.2,6.3,0,1.8,12.8,2052,1626,426,79.24,20.76,182,1444,0,426,182,1870,11.2,0,8.9,"Less than 25% P.O.C.","$96000 or more"
"42091203106","Census Tract 2031.06, Montgomery County, Pennsylvania",2247,97647,1912,58,0,161,0,93,85.1,2.6,0,7.2,0,4.1,14.9,1046,457,589,43.69,56.31,53,404,0,589,53,993,11.6,0,5.1,"Less than 25% P.O.C.","$96000 or more"
"42091203203","Census Tract 2032.03, Montgomery County, Pennsylvania",3983,115966,2974,316,0,566,0,81,74.7,7.9,0,14.2,0,2,25.3,1517,948,569,62.49,37.51,102,846,62,507,164,1353,10.8,10.9,10.8,"25% - 50% P.O.C.","$96000 or more"
"42091203204","Census Tract 2032.04, Montgomery County, Pennsylvania",7001,138333,5123,264,0,1194,0,294,73.2,3.8,0,17.1,0,4.2,26.8,2704,2057,647,76.07,23.93,157,1900,4,643,161,2543,7.6,0.6,6,"25% - 50% P.O.C.","$96000 or more"
"42091203205","Census Tract 2032.05, Montgomery County, Pennsylvania",2174,136902,1685,216,0,193,0,34,77.5,9.9,0,8.9,0,1.6,22.5,799,705,94,88.24,11.76,51,654,5,89,56,743,7.2,5.3,7,"Less than 25% P.O.C.","$96000 or more"
"42091203207","Census Tract 2032.07, Montgomery County, Pennsylvania",3238,156250,2850,72,0,242,0,41,88,2.2,0,7.5,0,1.3,12,1108,984,124,88.81,11.19,110,874,0,124,110,998,11.2,0,9.9,"Less than 25% P.O.C.","$96000 or more"
"42091203208","Census Tract 2032.08, Montgomery County, Pennsylvania",2799,123182,2215,16,0,354,0,146,79.1,0.6,0,12.6,0,5.2,20.9,1238,1055,183,85.22,14.78,37,1018,23,160,60,1178,3.5,12.6,4.8,"Less than 25% P.O.C.","$96000 or more"
"42091203302","Census Tract 2033.02, Montgomery County, Pennsylvania",6381,94654,5222,631,0,229,0,217,81.8,9.9,0,3.6,0,3.4,18.2,2334,2147,187,91.99,8.01,267,1880,0,187,267,2067,12.4,0,11.4,"Less than 25% P.O.C.","$72000 - $96000"
"42091203303","Census Tract 2033.03, Montgomery County, Pennsylvania",4079,73528,2991,444,0,296,0,277,73.3,10.9,0,7.3,0,6.8,26.7,1847,1377,470,74.55,25.45,73,1304,0,470,73,1774,5.3,0,4,"25% - 50% P.O.C.","$72000 - $96000"
"42091203304","Census Tract 2033.04, Montgomery County, Pennsylvania",3555,71745,2611,494,0,171,0,212,73.4,13.9,0,4.8,0,6,26.6,1739,963,776,55.38,44.62,57,906,0,776,57,1682,5.9,0,3.3,"25% - 50% P.O.C.","$51000 - $72000"
"42091203401","Census Tract 2034.01, Montgomery County, Pennsylvania",5932,62994,4138,1058,0,172,0,368,69.8,17.8,0,2.9,0,6.2,30.2,2830,1958,872,69.19,30.81,140,1818,16,856,156,2674,7.2,1.8,5.5,"25% - 50% P.O.C.","$51000 - $72000"
"42091203402","Census Tract 2034.02, Montgomery County, Pennsylvania",6607,91159,4270,743,20,757,0,630,64.6,11.2,0.3,11.5,0,9.5,35.4,2901,1638,1263,56.46,43.54,58,1580,70,1193,128,2773,3.5,5.5,4.4,"25% - 50% P.O.C.","$72000 - $96000"
"42091203403","Census Tract 2034.03, Montgomery County, Pennsylvania",2970,75463,2437,282,0,82,0,130,82.1,9.5,0,2.8,0,4.4,17.9,1550,1236,314,79.74,20.26,54,1182,19,295,73,1477,4.4,6.1,4.7,"Less than 25% P.O.C.","$72000 - $96000"
"42091203500","Census Tract 2035, Montgomery County, Pennsylvania",6640,61000,2222,2621,0,216,51,1045,33.5,39.5,0,3.3,0.8,15.7,66.5,2658,1318,1340,49.59,50.41,126,1192,100,1240,226,2432,9.6,7.5,8.5,"50% - 75% P.O.C.","$51000 - $72000"
"42091203601","Census Tract 2036.01, Montgomery County, Pennsylvania",2598,34128,357,1138,24,47,0,873,13.7,43.8,0.9,1.8,0,33.6,86.3,925,408,517,44.11,55.89,0,408,164,353,164,761,0,31.7,17.7,"75% or more P.O.C.","Less than $51000"
"42091203602","Census Tract 2036.02, Montgomery County, Pennsylvania",4013,80375,1442,1543,0,160,0,671,35.9,38.5,0,4,0,16.7,64.1,1459,985,474,67.51,32.49,102,883,63,411,165,1294,10.4,13.3,11.3,"50% - 75% P.O.C.","$72000 - $96000"
"42091203700","Census Tract 2037, Montgomery County, Pennsylvania",1864,46397,758,542,0,88,0,401,40.7,29.1,0,4.7,0,21.5,59.3,489,181,308,37.01,62.99,11,170,17,291,28,461,6.1,5.5,5.7,"50% - 75% P.O.C.","Less than $51000"
"42091203801","Census Tract 2038.01, Montgomery County, Pennsylvania",3859,50758,1464,1318,0,173,0,626,37.9,34.2,0,4.5,0,16.2,62.1,1360,697,663,51.25,48.75,91,606,87,576,178,1182,13.1,13.1,13.1,"50% - 75% P.O.C.","Less than $51000"
"42091203803","Census Tract 2038.03, Montgomery County, Pennsylvania",5582,39123,1364,1723,0,128,0,2178,24.4,30.9,0,2.3,0,39,75.6,1966,421,1545,21.41,78.59,94,327,256,1289,350,1616,22.3,16.6,17.8,"75% or more P.O.C.","Less than $51000"
"42091203804","Census Tract 2038.04, Montgomery County, Pennsylvania",3143,42309,1012,1006,0,104,0,963,32.2,32,0,3.3,0,30.6,67.8,1086,420,666,38.67,61.33,23,397,165,501,188,898,5.5,24.8,17.3,"50% - 75% P.O.C.","Less than $51000"
"42091203901","Census Tract 2039.01, Montgomery County, Pennsylvania",3325,38589,326,1556,0,13,0,1348,9.8,46.8,0,0.4,0,40.5,90.2,1160,208,952,17.93,82.07,42,166,131,821,173,987,20.2,13.8,14.9,"75% or more P.O.C.","Less than $51000"
"42091203902","Census Tract 2039.02, Montgomery County, Pennsylvania",3569,35614,763,1119,0,283,0,1224,21.4,31.4,0,7.9,0,34.3,78.6,1763,207,1556,11.74,88.26,15,192,124,1432,139,1624,7.2,8,7.9,"75% or more P.O.C.","Less than $51000"
"42091204002","Census Tract 2040.02, Montgomery County, Pennsylvania",3622,76447,2349,478,0,284,0,430,64.9,13.2,0,7.8,0,11.9,35.1,1388,860,528,61.96,38.04,114,746,59,469,173,1215,13.3,11.2,12.5,"25% - 50% P.O.C.","$72000 - $96000"
"42091204007","Census Tract 2040.07, Montgomery County, Pennsylvania",2146,60424,1609,240,0,216,0,38,75,11.2,0,10.1,0,1.8,25,993,427,566,43,57,37,390,20,546,57,936,8.7,3.5,5.7,"25% - 50% P.O.C.","$51000 - $72000"
"42091204008","Census Tract 2040.08, Montgomery County, Pennsylvania",2771,90449,2359,187,20,125,0,37,85.1,6.7,0.7,4.5,0,1.3,14.9,1194,794,400,66.5,33.5,60,734,0,400,60,1134,7.6,0,5,"Less than 25% P.O.C.","$72000 - $96000"
"42091204009","Census Tract 2040.09, Montgomery County, Pennsylvania",2091,110577,1678,123,0,120,0,128,80.2,5.9,0,5.7,0,6.1,19.8,932,607,325,65.13,34.87,33,574,0,325,33,899,5.4,0,3.5,"Less than 25% P.O.C.","$96000 or more"
"42091204010","Census Tract 2040.10, Montgomery County, Pennsylvania",2651,111375,2219,124,0,209,0,23,83.7,4.7,0,7.9,0,0.9,16.3,927,888,39,95.79,4.21,92,796,0,39,92,835,10.4,0,9.9,"Less than 25% P.O.C.","$96000 or more"
"42091204101","Census Tract 2041.01, Montgomery County, Pennsylvania",3768,78186,3641,32,0,16,0,79,96.6,0.8,0,0.4,0,2.1,3.4,1764,1112,652,63.04,36.96,19,1093,0,652,19,1745,1.7,0,1.1,"Less than 25% P.O.C.","$72000 - $96000"
"42091204102","Census Tract 2041.02, Montgomery County, Pennsylvania",4261,89977,3674,131,0,157,0,117,86.2,3.1,0,3.7,0,2.7,13.8,2199,786,1413,35.74,64.26,17,769,56,1357,73,2126,2.2,4,3.3,"Less than 25% P.O.C.","$72000 - $96000"
"42091204200","Census Tract 2042, Montgomery County, Pennsylvania",1384,120179,1178,47,0,80,0,51,85.1,3.4,0,5.8,0,3.7,14.9,645,480,165,74.42,25.58,22,458,2,163,24,621,4.6,1.2,3.7,"Less than 25% P.O.C.","$96000 or more"
"42091204300","Census Tract 2043, Montgomery County, Pennsylvania",2555,85952,2022,135,0,330,0,68,79.1,5.3,0,12.9,0,2.7,20.9,1284,976,308,76.01,23.99,55,921,7,301,62,1222,5.6,2.3,4.8,"Less than 25% P.O.C.","$72000 - $96000"
"42091204400","Census Tract 2044, Montgomery County, Pennsylvania",3353,151607,2771,114,0,246,0,120,82.6,3.4,0,7.3,0,3.6,17.4,1200,890,310,74.17,25.83,104,786,35,275,139,1061,11.7,11.3,11.6,"Less than 25% P.O.C.","$96000 or more"
"42091204500","Census Tract 2045, Montgomery County, Pennsylvania",4610,200368,3960,208,0,214,0,180,85.9,4.5,0,4.6,0,3.9,14.1,1411,1269,142,89.94,10.06,234,1035,8,134,242,1169,18.4,5.6,17.2,"Less than 25% P.O.C.","$96000 or more"
"42091204600","Census Tract 2046, Montgomery County, Pennsylvania",4732,217222,3910,112,0,367,0,201,82.6,2.4,0,7.8,0,4.2,17.4,1554,1487,67,95.69,4.31,213,1274,0,67,213,1341,14.3,0,13.7,"Less than 25% P.O.C.","$96000 or more"
"42091204701","Census Tract 2047.01, Montgomery County, Pennsylvania",2264,105463,2121,33,0,60,0,9,93.7,1.5,0,2.7,0,0.4,6.3,1106,868,238,78.48,21.52,89,779,0,238,89,1017,10.3,0,8,"Less than 25% P.O.C.","$96000 or more"
"42091204702","Census Tract 2047.02, Montgomery County, Pennsylvania",3192,114539,2546,46,0,321,33,61,79.8,1.4,0,10.1,1,1.9,20.2,1271,1023,248,80.49,19.51,34,989,11,237,45,1226,3.3,4.4,3.5,"Less than 25% P.O.C.","$96000 or more"
"42091204800","Census Tract 2048, Montgomery County, Pennsylvania",5147,248646,4607,26,7,235,0,103,89.5,0.5,0.1,4.6,0,2,10.5,2001,1701,300,85.01,14.99,124,1577,0,300,124,1877,7.3,0,6.2,"Less than 25% P.O.C.","$96000 or more"
"42091204900","Census Tract 2049, Montgomery County, Pennsylvania",5375,229861,4649,175,15,296,0,113,86.5,3.3,0.3,5.5,0,2.1,13.5,1738,1557,181,89.59,10.41,161,1396,16,165,177,1561,10.3,8.8,10.2,"Less than 25% P.O.C.","$96000 or more"
"42091205000","Census Tract 2050, Montgomery County, Pennsylvania",2575,92344,1659,349,0,337,7,98,64.4,13.6,0,13.1,0.3,3.8,35.6,837,478,359,57.11,42.89,32,446,3,356,35,802,6.7,0.8,4.2,"25% - 50% P.O.C.","$72000 - $96000"
"42091205100","Census Tract 2051, Montgomery County, Pennsylvania",1658,84038,1271,125,0,166,0,55,76.7,7.5,0,10,0,3.3,23.3,626,248,378,39.62,60.38,18,230,13,365,31,595,7.3,3.4,5,"Less than 25% P.O.C.","$72000 - $96000"
"42091205200","Census Tract 2052, Montgomery County, Pennsylvania",2731,116771,2499,16,0,168,0,25,91.5,0.6,0,6.2,0,0.9,8.5,1299,865,434,66.59,33.41,87,778,10,424,97,1202,10.1,2.3,7.5,"Less than 25% P.O.C.","$96000 or more"
"42091205300","Census Tract 2053, Montgomery County, Pennsylvania",1980,65385,1116,428,26,209,0,126,56.4,21.6,1.3,10.6,0,6.4,43.6,908,365,543,40.2,59.8,29,336,22,521,51,857,7.9,4.1,5.6,"25% - 50% P.O.C.","$51000 - $72000"
"42091205400","Census Tract 2054, Montgomery County, Pennsylvania",6317,131766,5097,106,0,880,0,183,80.7,1.7,0,13.9,0,2.9,19.3,2881,1517,1364,52.66,47.34,100,1417,0,1364,100,2781,6.6,0,3.5,"Less than 25% P.O.C.","$96000 or more"
"42091205501","Census Tract 2055.01, Montgomery County, Pennsylvania",3863,92417,2825,518,5,157,0,208,73.1,13.4,0.1,4.1,0,5.4,26.9,1753,903,850,51.51,48.49,78,825,0,850,78,1675,8.6,0,4.4,"25% - 50% P.O.C.","$72000 - $96000"
"42091205502","Census Tract 2055.02, Montgomery County, Pennsylvania",3624,171250,3037,74,0,357,0,103,83.8,2,0,9.9,0,2.8,16.2,1328,1249,79,94.05,5.95,111,1138,0,79,111,1217,8.9,0,8.4,"Less than 25% P.O.C.","$96000 or more"
"42091205503","Census Tract 2055.03, Montgomery County, Pennsylvania",5061,122813,3559,439,9,628,0,301,70.3,8.7,0.2,12.4,0,5.9,29.7,1991,1701,290,85.43,14.57,134,1567,0,290,134,1857,7.9,0,6.7,"25% - 50% P.O.C.","$96000 or more"
"42091205600","Census Tract 2056, Montgomery County, Pennsylvania",4345,110300,3422,268,0,227,0,206,78.8,6.2,0,5.2,0,4.7,21.2,1878,1182,696,62.94,37.06,82,1100,35,661,117,1761,6.9,5,6.2,"Less than 25% P.O.C.","$96000 or more"
"42091205700","Census Tract 2057, Montgomery County, Pennsylvania",4579,62941,3544,235,0,0,0,681,77.4,5.1,0,0,0,14.9,22.6,2124,851,1273,40.07,59.93,61,790,46,1227,107,2017,7.2,3.6,5,"Less than 25% P.O.C.","$51000 - $72000"
"42091205801","Census Tract 2058.01, Montgomery County, Pennsylvania",3486,79754,1795,77,0,1446,0,110,51.5,2.2,0,41.5,0,3.2,48.5,1994,516,1478,25.88,74.12,0,516,25,1453,25,1969,0,1.7,1.3,"25% - 50% P.O.C.","$72000 - $96000"
"42091205805","Census Tract 2058.05, Montgomery County, Pennsylvania",3090,89452,2311,217,0,477,0,19,74.8,7,0,15.4,0,0.6,25.2,1263,1001,262,79.26,20.74,81,920,50,212,131,1132,8.1,19.1,10.4,"25% - 50% P.O.C.","$72000 - $96000"
"42091205806","Census Tract 2058.06, Montgomery County, Pennsylvania",2081,90091,1271,151,0,338,0,185,61.1,7.3,0,16.2,0,8.9,38.9,867,535,332,61.71,38.29,24,511,0,332,24,843,4.5,0,2.8,"25% - 50% P.O.C.","$72000 - $96000"
"42091205807","Census Tract 2058.07, Montgomery County, Pennsylvania",1843,91806,1161,49,0,517,0,32,63,2.7,0,28.1,0,1.7,37,986,349,637,35.4,64.6,46,303,0,637,46,940,13.2,0,4.7,"25% - 50% P.O.C.","$72000 - $96000"
"42091205808","Census Tract 2058.08, Montgomery County, Pennsylvania",5488,104883,3947,247,0,1013,0,149,71.9,4.5,0,18.5,0,2.7,28.1,2089,1794,295,85.88,14.12,188,1606,18,277,206,1883,10.5,6.1,9.9,"25% - 50% P.O.C.","$96000 or more"
"42091205809","Census Tract 2058.09, Montgomery County, Pennsylvania",3053,106364,2378,134,0,372,0,108,77.9,4.4,0,12.2,0,3.5,22.1,1058,963,95,91.02,8.98,105,858,21,74,126,932,10.9,22.1,11.9,"Less than 25% P.O.C.","$96000 or more"
"42091205903","Census Tract 2059.03, Montgomery County, Pennsylvania",2831,158333,2496,113,0,153,0,38,88.2,4,0,5.4,0,1.3,11.8,1052,996,56,94.68,5.32,66,930,29,27,95,957,6.6,51.8,9,"Less than 25% P.O.C.","$96000 or more"
"42091205904","Census Tract 2059.04, Montgomery County, Pennsylvania",2418,150862,2143,113,0,130,0,11,88.6,4.7,0,5.4,0,0.5,11.4,1000,906,94,90.6,9.4,65,841,0,94,65,935,7.2,0,6.5,"Less than 25% P.O.C.","$96000 or more"
"42091205905","Census Tract 2059.05, Montgomery County, Pennsylvania",3912,78802,1995,563,0,1128,0,105,51,14.4,0,28.8,0,2.7,49,1842,675,1167,36.64,63.36,37,638,5,1162,42,1800,5.5,0.4,2.3,"25% - 50% P.O.C.","$72000 - $96000"
"42091205906","Census Tract 2059.06, Montgomery County, Pennsylvania",2058,83421,1577,168,0,116,0,148,76.6,8.2,0,5.6,0,7.2,23.4,898,668,230,74.39,25.61,30,638,5,225,35,863,4.5,2.2,3.9,"Less than 25% P.O.C.","$72000 - $96000"
"42091206004","Census Tract 2060.04, Montgomery County, Pennsylvania",6806,88456,4509,891,0,775,9,562,66.3,13.1,0,11.4,0.1,8.3,33.7,1693,1097,596,64.8,35.2,97,1000,120,476,217,1476,8.8,20.1,12.8,"25% - 50% P.O.C.","$72000 - $96000"
"42091206005","Census Tract 2060.05, Montgomery County, Pennsylvania",4461,102738,3710,31,0,275,0,371,83.2,0.7,0,6.2,0,8.3,16.8,1578,1410,168,89.35,10.65,125,1285,18,150,143,1435,8.9,10.7,9.1,"Less than 25% P.O.C.","$96000 or more"
"42091206006","Census Tract 2060.06, Montgomery County, Pennsylvania",2920,70875,2591,102,0,90,0,126,88.7,3.5,0,3.1,0,4.3,11.3,1534,875,659,57.04,42.96,63,812,12,647,75,1459,7.2,1.8,4.9,"Less than 25% P.O.C.","$51000 - $72000"
"42091206007","Census Tract 2060.07, Montgomery County, Pennsylvania",6863,95625,4446,243,0,1799,0,274,64.8,3.5,0,26.2,0,4,35.2,2332,1561,771,66.94,33.06,181,1380,0,771,181,2151,11.6,0,7.8,"25% - 50% P.O.C.","$72000 - $96000"
"42091206102","Census Tract 2061.02, Montgomery County, Pennsylvania",9346,120625,7011,348,1,1498,0,385,75,3.7,0,16,0,4.1,25,3660,3176,484,86.78,13.22,220,2956,13,471,233,3427,6.9,2.7,6.4,"25% - 50% P.O.C.","$96000 or more"
"42091206104","Census Tract 2061.04, Montgomery County, Pennsylvania",3374,133519,2590,229,0,329,0,144,76.8,6.8,0,9.8,0,4.3,23.2,1190,1061,129,89.16,10.84,81,980,17,112,98,1092,7.6,13.2,8.2,"Less than 25% P.O.C.","$96000 or more"
"42091206105","Census Tract 2061.05, Montgomery County, Pennsylvania",6529,177656,5573,63,0,753,0,20,85.4,1,0,11.5,0,0.3,14.6,1756,1707,49,97.21,2.79,322,1385,20,29,342,1414,18.9,40.8,19.5,"Less than 25% P.O.C.","$96000 or more"
"42091206106","Census Tract 2061.06, Montgomery County, Pennsylvania",4671,95547,3808,422,0,276,0,84,81.5,9,0,5.9,0,1.8,18.5,1712,1532,180,89.49,10.51,144,1388,39,141,183,1529,9.4,21.7,10.7,"Less than 25% P.O.C.","$72000 - $96000"
"42091206201","Census Tract 2062.01, Montgomery County, Pennsylvania",2448,51442,2259,112,0,16,0,8,92.3,4.6,0,0.7,0,0.3,7.7,1183,613,570,51.82,48.18,14,599,49,521,63,1120,2.3,8.6,5.3,"Less than 25% P.O.C.","$51000 - $72000"
"42091206202","Census Tract 2062.02, Montgomery County, Pennsylvania",2327,67217,1693,361,0,25,0,134,72.8,15.5,0,1.1,0,5.8,27.2,1010,333,677,32.97,67.03,30,303,36,641,66,944,9,5.3,6.5,"25% - 50% P.O.C.","$51000 - $72000"
"42091206300","Census Tract 2063, Montgomery County, Pennsylvania",5152,112500,4164,458,10,287,0,118,80.8,8.9,0.2,5.6,0,2.3,19.2,1326,1018,308,76.77,23.23,106,912,27,281,133,1193,10.4,8.8,10,"Less than 25% P.O.C.","$96000 or more"
"42091206400","Census Tract 2064, Montgomery County, Pennsylvania",3610,91667,2980,93,0,221,0,283,82.5,2.6,0,6.1,0,7.8,17.5,1376,1058,318,76.89,23.11,65,993,0,318,65,1311,6.1,0,4.7,"Less than 25% P.O.C.","$72000 - $96000"
"42091206501","Census Tract 2065.01, Montgomery County, Pennsylvania",4235,127115,3561,92,0,420,0,70,84.1,2.2,0,9.9,0,1.7,15.9,1408,1353,55,96.09,3.91,151,1202,12,43,163,1245,11.2,21.8,11.6,"Less than 25% P.O.C.","$96000 or more"
"42091206502","Census Tract 2065.02, Montgomery County, Pennsylvania",4928,106577,4283,125,0,129,0,243,86.9,2.5,0,2.6,0,4.9,13.1,1763,1582,181,89.73,10.27,140,1442,9,172,149,1614,8.8,5,8.5,"Less than 25% P.O.C.","$96000 or more"
"42091206600","Census Tract 2066, Montgomery County, Pennsylvania",1422,58276,1288,39,0,11,0,56,90.6,2.7,0,0.8,0,3.9,9.4,628,410,218,65.29,34.71,30,380,10,208,40,588,7.3,4.6,6.4,"Less than 25% P.O.C.","$51000 - $72000"
"42091206702","Census Tract 2067.02, Montgomery County, Pennsylvania",3353,NA,819,2076,22,16,0,397,24.4,61.9,0.7,0.5,0,11.8,75.6,0,0,0,NA,NA,0,0,0,0,0,0,NA,NA,NA,"75% or more P.O.C.","N/A"
"42091206703","Census Tract 2067.03, Montgomery County, Pennsylvania",3896,111063,3711,46,0,47,0,64,95.3,1.2,0,1.2,0,1.6,4.7,1516,1393,123,91.89,8.11,135,1258,0,123,135,1381,9.7,0,8.9,"Less than 25% P.O.C.","$96000 or more"
"42091206704","Census Tract 2067.04, Montgomery County, Pennsylvania",7264,140580,6681,115,0,316,0,64,92,1.6,0,4.4,0,0.9,8,2495,2321,174,93.03,6.97,255,2066,0,174,255,2240,11,0,10.2,"Less than 25% P.O.C.","$96000 or more"
"42091206801","Census Tract 2068.01, Montgomery County, Pennsylvania",7664,138686,5800,455,0,1122,21,176,75.7,5.9,0,14.6,0.3,2.3,24.3,2697,2172,525,80.53,19.47,306,1866,13,512,319,2378,14.1,2.5,11.8,"Less than 25% P.O.C.","$96000 or more"
"42091206802","Census Tract 2068.02, Montgomery County, Pennsylvania",2742,111726,2432,8,1,227,0,34,88.7,0.3,0,8.3,0,1.2,11.3,1077,887,190,82.36,17.64,60,827,13,177,73,1004,6.8,6.8,6.8,"Less than 25% P.O.C.","$96000 or more"
"42091206901","Census Tract 2069.01, Montgomery County, Pennsylvania",4638,73245,2908,621,6,903,0,161,62.7,13.4,0.1,19.5,0,3.5,37.3,1902,959,943,50.42,49.58,122,837,60,883,182,1720,12.7,6.4,9.6,"25% - 50% P.O.C.","$72000 - $96000"
"42091206904","Census Tract 2069.04, Montgomery County, Pennsylvania",6117,74646,4928,431,9,452,0,210,80.6,7,0.1,7.4,0,3.4,19.4,2753,1692,1061,61.46,38.54,106,1586,10,1051,116,2637,6.3,0.9,4.2,"Less than 25% P.O.C.","$72000 - $96000"
"42091206905","Census Tract 2069.05, Montgomery County, Pennsylvania",4645,103246,3755,138,0,594,0,60,80.8,3,0,12.8,0,1.3,19.2,1758,1569,189,89.25,10.75,139,1430,41,148,180,1578,8.9,21.7,10.2,"Less than 25% P.O.C.","$96000 or more"
"42091206906","Census Tract 2069.06, Montgomery County, Pennsylvania",2930,91734,2659,63,0,124,0,48,90.8,2.2,0,4.2,0,1.6,9.2,1229,1034,195,84.13,15.87,93,941,0,195,93,1136,9,0,7.6,"Less than 25% P.O.C.","$72000 - $96000"
"42091207001","Census Tract 2070.01, Montgomery County, Pennsylvania",7890,135453,6677,269,0,477,0,410,84.6,3.4,0,6,0,5.2,15.4,2867,2358,509,82.25,17.75,153,2205,30,479,183,2684,6.5,5.9,6.4,"Less than 25% P.O.C.","$96000 or more"
"42091207003","Census Tract 2070.03, Montgomery County, Pennsylvania",3044,112750,2760,134,0,102,0,21,90.7,4.4,0,3.4,0,0.7,9.3,1205,735,470,61,39,102,633,0,470,102,1103,13.9,0,8.5,"Less than 25% P.O.C.","$96000 or more"
"42091207004","Census Tract 2070.04, Montgomery County, Pennsylvania",4430,79593,3641,89,0,376,0,223,82.2,2,0,8.5,0,5,17.8,1728,1268,460,73.38,26.62,126,1142,11,449,137,1591,9.9,2.4,7.9,"Less than 25% P.O.C.","$72000 - $96000"
"42091207101","Census Tract 2071.01, Montgomery County, Pennsylvania",6010,100677,5458,63,0,447,0,42,90.8,1,0,7.4,0,0.7,9.2,2133,1669,464,78.25,21.75,200,1469,17,447,217,1916,12,3.7,10.2,"Less than 25% P.O.C.","$96000 or more"
"42091207103","Census Tract 2071.03, Montgomery County, Pennsylvania",4411,98594,3848,93,9,349,0,31,87.2,2.1,0.2,7.9,0,0.7,12.8,1488,1373,115,92.27,7.73,173,1200,3,112,176,1312,12.6,2.6,11.8,"Less than 25% P.O.C.","$96000 or more"
"42091207104","Census Tract 2071.04, Montgomery County, Pennsylvania",2870,60861,2755,7,0,40,0,7,96,0.2,0,1.4,0,0.2,4,1281,1153,128,90.01,9.99,72,1081,0,128,72,1209,6.2,0,5.6,"Less than 25% P.O.C.","$51000 - $72000"
"42091207201","Census Tract 2072.01, Montgomery County, Pennsylvania",2413,75526,1958,35,0,106,0,314,81.1,1.5,0,4.4,0,13,18.9,978,643,335,65.75,34.25,36,607,32,303,68,910,5.6,9.6,7,"Less than 25% P.O.C.","$72000 - $96000"
"42091207202","Census Tract 2072.02, Montgomery County, Pennsylvania",4549,66345,3266,108,28,262,0,849,71.8,2.4,0.6,5.8,0,18.7,28.2,1721,966,755,56.13,43.87,133,833,108,647,241,1480,13.8,14.3,14,"25% - 50% P.O.C.","$51000 - $72000"
"42091207300","Census Tract 2073, Montgomery County, Pennsylvania",2655,71063,1823,143,7,60,0,582,68.7,5.4,0.3,2.3,0,21.9,31.3,933,605,328,64.84,35.16,89,516,57,271,146,787,14.7,17.4,15.6,"25% - 50% P.O.C.","$51000 - $72000"
"42091207400","Census Tract 2074, Montgomery County, Pennsylvania",2935,103000,2719,76,0,37,0,85,92.6,2.6,0,1.3,0,2.9,7.4,1096,966,130,88.14,11.86,125,841,5,125,130,966,12.9,3.8,11.9,"Less than 25% P.O.C.","$96000 or more"
"42091207500","Census Tract 2075, Montgomery County, Pennsylvania",3353,97428,3304,13,0,0,0,11,98.5,0.4,0,0,0,0.3,1.5,1119,991,128,88.56,11.44,129,862,66,62,195,924,13,51.6,17.4,"Less than 25% P.O.C.","$96000 or more"
"42091207600","Census Tract 2076, Montgomery County, Pennsylvania",3782,85764,3660,15,0,17,0,88,96.8,0.4,0,0.4,0,2.3,3.2,1424,1160,264,81.46,18.54,118,1042,29,235,147,1277,10.2,11,10.3,"Less than 25% P.O.C.","$72000 - $96000"
"42091207800","Census Tract 2078, Montgomery County, Pennsylvania",7673,102849,6868,362,0,91,0,211,89.5,4.7,0,1.2,0,2.7,10.5,2840,2641,199,92.99,7.01,267,2374,0,199,267,2573,10.1,0,9.4,"Less than 25% P.O.C.","$96000 or more"
"42091207900","Census Tract 2079, Montgomery County, Pennsylvania",2484,62500,2189,166,0,0,0,82,88.1,6.7,0,0,0,3.3,11.9,1070,655,415,61.21,38.79,69,586,18,397,87,983,10.5,4.3,8.1,"Less than 25% P.O.C.","$51000 - $72000"
"42091208000","Census Tract 2080, Montgomery County, Pennsylvania",3869,74688,3509,74,0,66,0,100,90.7,1.9,0,1.7,0,2.6,9.3,1333,1045,288,78.39,21.61,77,968,8,280,85,1248,7.4,2.8,6.4,"Less than 25% P.O.C.","$72000 - $96000"
"42091208100","Census Tract 2081, Montgomery County, Pennsylvania",2943,63017,2697,57,17,19,0,92,91.6,1.9,0.6,0.6,0,3.1,8.4,1102,698,404,63.34,36.66,47,651,49,355,96,1006,6.7,12.1,8.7,"Less than 25% P.O.C.","$51000 - $72000"
"42091208201","Census Tract 2082.01, Montgomery County, Pennsylvania",2063,96711,2012,0,0,15,0,17,97.5,0,0,0.7,0,0.8,2.5,758,659,99,86.94,13.06,56,603,0,99,56,702,8.5,0,7.4,"Less than 25% P.O.C.","$96000 or more"
"42091208203","Census Tract 2082.03, Montgomery County, Pennsylvania",5026,94559,4678,109,0,65,14,115,93.1,2.2,0,1.3,0.3,2.3,6.9,1850,1326,524,71.68,28.32,139,1187,38,486,177,1673,10.5,7.3,9.6,"Less than 25% P.O.C.","$72000 - $96000"
"42091208204","Census Tract 2082.04, Montgomery County, Pennsylvania",3417,111935,3243,9,0,73,0,24,94.9,0.3,0,2.1,0,0.7,5.1,1180,1090,90,92.37,7.63,94,996,0,90,94,1086,8.6,0,8,"Less than 25% P.O.C.","$96000 or more"
"42091208301","Census Tract 2083.01, Montgomery County, Pennsylvania",2561,89848,2534,1,0,0,7,19,98.9,0,0,0,0.3,0.7,1.1,906,849,57,93.71,6.29,59,790,0,57,59,847,6.9,0,6.5,"Less than 25% P.O.C.","$72000 - $96000"
"42091208302","Census Tract 2083.02, Montgomery County, Pennsylvania",10280,109861,9462,221,0,183,0,343,92,2.1,0,1.8,0,3.3,8,3517,3474,43,98.78,1.22,379,3095,26,17,405,3112,10.9,60.5,11.5,"Less than 25% P.O.C.","$96000 or more"
"42091208400","Census Tract 2084, Montgomery County, Pennsylvania",3608,81683,3495,0,0,73,0,23,96.9,0,0,2,0,0.6,3.1,1431,1129,302,78.9,21.1,87,1042,0,302,87,1344,7.7,0,6.1,"Less than 25% P.O.C.","$72000 - $96000"
"42091208500","Census Tract 2085, Montgomery County, Pennsylvania",4881,85978,4424,94,8,53,0,279,90.6,1.9,0.2,1.1,0,5.7,9.4,1870,1656,214,88.56,11.44,90,1566,41,173,131,1739,5.4,19.2,7,"Less than 25% P.O.C.","$72000 - $96000"
"42091208601","Census Tract 2086.01, Montgomery County, Pennsylvania",6413,106437,5923,113,0,155,0,136,92.4,1.8,0,2.4,0,2.1,7.6,2290,2110,180,92.14,7.86,269,1841,0,180,269,2021,12.7,0,11.7,"Less than 25% P.O.C.","$96000 or more"
"42091208603","Census Tract 2086.03, Montgomery County, Pennsylvania",6380,96653,5707,141,0,253,0,172,89.5,2.2,0,4,0,2.7,10.5,2488,2085,403,83.8,16.2,166,1919,0,403,166,2322,8,0,6.7,"Less than 25% P.O.C.","$96000 or more"
"42091208604","Census Tract 2086.04, Montgomery County, Pennsylvania",6197,84744,4951,345,0,478,17,101,79.9,5.6,0,7.7,0.3,1.6,20.1,2383,1612,771,67.65,32.35,139,1473,20,751,159,2224,8.6,2.6,6.7,"Less than 25% P.O.C.","$72000 - $96000"
"42091208702","Census Tract 2087.02, Montgomery County, Pennsylvania",3328,110909,2867,172,0,76,0,117,86.1,5.2,0,2.3,0,3.5,13.9,1300,1237,63,95.15,4.85,121,1116,0,63,121,1179,9.8,0,9.3,"Less than 25% P.O.C.","$96000 or more"
"42091208703","Census Tract 2087.03, Montgomery County, Pennsylvania",3968,77283,3400,382,0,55,0,63,85.7,9.6,0,1.4,0,1.6,14.3,1628,1294,334,79.48,20.52,64,1230,28,306,92,1536,4.9,8.4,5.7,"Less than 25% P.O.C.","$72000 - $96000"
"42091208704","Census Tract 2087.04, Montgomery County, Pennsylvania",4823,62917,3426,991,0,141,0,103,71,20.5,0,2.9,0,2.1,29,1716,1133,583,66.03,33.97,106,1027,160,423,266,1450,9.4,27.4,15.5,"25% - 50% P.O.C.","$51000 - $72000"
"42091208801","Census Tract 2088.01, Montgomery County, Pennsylvania",1398,28125,716,480,0,0,0,143,51.2,34.3,0,0,0,10.2,48.8,623,157,466,25.2,74.8,9,148,62,404,71,552,5.7,13.3,11.4,"25% - 50% P.O.C.","Less than $51000"
"42091208802","Census Tract 2088.02, Montgomery County, Pennsylvania",2678,39167,1882,361,0,19,0,149,70.3,13.5,0,0.7,0,5.6,29.7,1226,639,587,52.12,47.88,7,632,65,522,72,1154,1.1,11.1,5.9,"25% - 50% P.O.C.","Less than $51000"
"42091208901","Census Tract 2089.01, Montgomery County, Pennsylvania",3658,52008,2903,333,0,33,0,192,79.4,9.1,0,0.9,0,5.2,20.6,1478,854,624,57.78,42.22,42,812,97,527,139,1339,4.9,15.5,9.4,"Less than 25% P.O.C.","$51000 - $72000"
"42091208903","Census Tract 2089.03, Montgomery County, Pennsylvania",2813,51875,1564,978,0,0,0,216,55.6,34.8,0,0,0,7.7,44.4,1118,654,464,58.5,41.5,34,620,66,398,100,1018,5.2,14.2,8.9,"25% - 50% P.O.C.","$51000 - $72000"
"42091208904","Census Tract 2089.04, Montgomery County, Pennsylvania",3260,34543,1582,1043,7,10,0,439,48.5,32,0.2,0.3,0,13.5,51.5,1358,437,921,32.18,67.82,64,373,77,844,141,1217,14.6,8.4,10.4,"50% - 75% P.O.C.","Less than $51000"
"42091208905","Census Tract 2089.05, Montgomery County, Pennsylvania",3015,67609,2337,266,0,74,0,120,77.5,8.8,0,2.5,0,4,22.5,1160,722,438,62.24,37.76,9,713,65,373,74,1086,1.2,14.8,6.4,"Less than 25% P.O.C.","$51000 - $72000"
"42091208906","Census Tract 2089.06, Montgomery County, Pennsylvania",4496,58407,2441,1401,0,0,0,217,54.3,31.2,0,0,0,4.8,45.7,1597,759,838,47.53,52.47,61,698,149,689,210,1387,8,17.8,13.1,"25% - 50% P.O.C.","$51000 - $72000"
"42091209000","Census Tract 2090, Montgomery County, Pennsylvania",1352,42411,800,332,4,0,0,121,59.2,24.6,0.3,0,0,8.9,40.8,536,259,277,48.32,51.68,27,232,39,238,66,470,10.4,14.1,12.3,"25% - 50% P.O.C.","Less than $51000"
"42091209100","Census Tract 2091, Montgomery County, Pennsylvania",5643,106750,4806,241,0,218,0,174,85.2,4.3,0,3.9,0,3.1,14.8,1908,1784,124,93.5,6.5,217,1567,11,113,228,1680,12.2,8.9,11.9,"Less than 25% P.O.C.","$96000 or more"
"42091209201","Census Tract 2092.01, Montgomery County, Pennsylvania",1573,66250,1315,112,0,40,0,50,83.6,7.1,0,2.5,0,3.2,16.4,637,449,188,70.49,29.51,54,395,0,188,54,583,12,0,8.5,"Less than 25% P.O.C.","$51000 - $72000"
"42091209202","Census Tract 2092.02, Montgomery County, Pennsylvania",2276,58594,1866,192,0,0,0,140,82,8.4,0,0,0,6.2,18,959,546,413,56.93,43.07,75,471,26,387,101,858,13.7,6.3,10.5,"Less than 25% P.O.C.","$51000 - $72000"
"42091210100","Census Tract 2101, Montgomery County, Pennsylvania",3944,93450,3114,231,0,40,0,349,79,5.9,0,1,0,8.8,21,1533,1174,359,76.58,23.42,131,1043,10,349,141,1392,11.2,2.8,9.2,"Less than 25% P.O.C.","$72000 - $96000"
"42091210200","Census Tract 2102, Montgomery County, Pennsylvania",2806,125625,2229,281,0,155,0,106,79.4,10,0,5.5,0,3.8,20.6,978,931,47,95.19,4.81,112,819,0,47,112,866,12,0,11.5,"Less than 25% P.O.C.","$96000 or more"
"42091210300","Census Tract 2103, Montgomery County, Pennsylvania",4367,113867,3774,195,6,50,0,277,86.4,4.5,0.1,1.1,0,6.3,13.6,1541,1046,495,67.88,32.12,175,871,0,495,175,1366,16.7,0,11.4,"Less than 25% P.O.C.","$96000 or more"
"42091210400","Census Tract 2104, Montgomery County, Pennsylvania",4474,80278,3328,645,8,131,0,235,74.4,14.4,0.2,2.9,0,5.3,25.6,1820,1472,348,80.88,19.12,102,1370,16,332,118,1702,6.9,4.6,6.5,"25% - 50% P.O.C.","$72000 - $96000"
"42091210500","Census Tract 2105, Montgomery County, Pennsylvania",4102,111959,3028,687,7,141,0,81,73.8,16.7,0.2,3.4,0,2,26.2,1446,1200,246,82.99,17.01,97,1103,10,236,107,1339,8.1,4.1,7.4,"25% - 50% P.O.C.","$96000 or more"
"42091210600","Census Tract 2106, Montgomery County, Pennsylvania",4301,84091,3281,409,0,484,0,59,76.3,9.5,0,11.3,0,1.4,23.7,1648,1170,478,71,29,81,1089,34,444,115,1533,6.9,7.1,7,"Less than 25% P.O.C.","$72000 - $96000"
"42091210700","Census Tract 2107, Montgomery County, Pennsylvania",5600,127188,4107,320,0,801,0,221,73.3,5.7,0,14.3,0,3.9,26.7,1966,1779,187,90.49,9.51,219,1560,0,187,219,1747,12.3,0,11.1,"25% - 50% P.O.C.","$96000 or more"
"42095010100","Census Tract 101, Northampton County, Pennsylvania",4017,79444,2565,125,16,219,0,886,63.9,3.1,0.4,5.5,0,22.1,36.1,1566,851,715,54.34,45.66,28,823,90,625,118,1448,3.3,12.6,7.5,"25% - 50% P.O.C.","$72000 - $96000"
"42095010200","Census Tract 102, Northampton County, Pennsylvania",3602,97384,3175,137,0,49,0,232,88.1,3.8,0,1.4,0,6.4,11.9,1585,1430,155,90.22,9.78,29,1401,7,148,36,1549,2,4.5,2.3,"Less than 25% P.O.C.","$96000 or more"
"42095010300","Census Tract 103, Northampton County, Pennsylvania",3308,69542,2710,61,0,92,0,382,81.9,1.8,0,2.8,0,11.5,18.1,1415,1070,345,75.62,24.38,90,980,15,330,105,1310,8.4,4.3,7.4,"Less than 25% P.O.C.","$51000 - $72000"
"42095010400","Census Tract 104, Northampton County, Pennsylvania",5594,79318,3403,978,0,17,0,1144,60.8,17.5,0,0.3,0,20.5,39.2,2124,1699,425,79.99,20.01,108,1591,109,316,217,1907,6.4,25.6,10.2,"25% - 50% P.O.C.","$72000 - $96000"
"42095010500","Census Tract 105, Northampton County, Pennsylvania",4242,25000,954,482,0,0,0,2725,22.5,11.4,0,0,0,64.2,77.5,1740,416,1324,23.91,76.09,8,408,139,1185,147,1593,1.9,10.5,8.4,"75% or more P.O.C.","Less than $51000"
"42095010600","Census Tract 106, Northampton County, Pennsylvania",7679,62750,4495,496,0,351,0,2233,58.5,6.5,0,4.6,0,29.1,41.5,3029,1885,1144,62.23,37.77,209,1676,102,1042,311,2718,11.1,8.9,10.3,"25% - 50% P.O.C.","$51000 - $72000"
"42095010700","Census Tract 107, Northampton County, Pennsylvania",4430,56575,2904,134,0,105,0,1241,65.6,3,0,2.4,0,28,34.4,1615,842,773,52.14,47.86,74,768,41,732,115,1500,8.8,5.3,7.1,"25% - 50% P.O.C.","$51000 - $72000"
"42095010800","Census Tract 108, Northampton County, Pennsylvania",2226,33714,1614,79,0,41,0,414,72.5,3.5,0,1.8,0,18.6,27.5,1347,241,1106,17.89,82.11,8,233,11,1095,19,1328,3.3,1,1.4,"25% - 50% P.O.C.","Less than $51000"
"42095010900","Census Tract 109, Northampton County, Pennsylvania",3627,37917,1034,577,0,15,0,1862,28.5,15.9,0,0.4,0,51.3,71.5,1279,535,744,41.83,58.17,21,514,105,639,126,1153,3.9,14.1,9.9,"50% - 75% P.O.C.","Less than $51000"
"42095011000","Census Tract 110, Northampton County, Pennsylvania",3159,35223,1330,422,0,317,0,956,42.1,13.4,0,10,0,30.3,57.9,1131,144,987,12.73,87.27,1,143,132,855,133,998,0.7,13.4,11.8,"50% - 75% P.O.C.","Less than $51000"
"42095011100","Census Tract 111, Northampton County, Pennsylvania",3487,28056,2265,225,0,532,0,371,65,6.5,0,15.3,0,10.6,35,104,29,75,27.88,72.12,0,29,24,51,24,80,0,32,23.1,"25% - 50% P.O.C.","Less than $51000"
"42095011200","Census Tract 112, Northampton County, Pennsylvania",5792,33903,1708,585,24,11,0,3213,29.5,10.1,0.4,0.2,0,55.5,70.5,1917,610,1307,31.82,68.18,63,547,299,1008,362,1555,10.3,22.9,18.9,"50% - 75% P.O.C.","Less than $51000"
"42095011300","Census Tract 113, Northampton County, Pennsylvania",4512,50938,1746,132,0,282,0,2278,38.7,2.9,0,6.2,0,50.5,61.3,1736,429,1307,24.71,75.29,19,410,147,1160,166,1570,4.4,11.2,9.6,"50% - 75% P.O.C.","Less than $51000"
"42095014100","Census Tract 141, Northampton County, Pennsylvania",6065,81000,4569,440,0,406,0,448,75.3,7.3,0,6.7,0,7.4,24.7,1462,844,618,57.73,42.27,72,772,23,595,95,1367,8.5,3.7,6.5,"Less than 25% P.O.C.","$72000 - $96000"
"42095014200","Census Tract 142, Northampton County, Pennsylvania",5657,45625,3060,879,0,46,0,1309,54.1,15.5,0,0.8,0,23.1,45.9,2065,951,1114,46.05,53.95,75,876,128,986,203,1862,7.9,11.5,9.8,"25% - 50% P.O.C.","Less than $51000"
"42095014300","Census Tract 143, Northampton County, Pennsylvania",3750,41913,1777,696,0,89,0,1151,47.4,18.6,0,2.4,0,30.7,52.6,1361,510,851,37.47,62.53,43,467,82,769,125,1236,8.4,9.6,9.2,"50% - 75% P.O.C.","Less than $51000"
"42095014400","Census Tract 144, Northampton County, Pennsylvania",2222,35000,1590,195,0,38,0,272,71.6,8.8,0,1.7,0,12.2,28.4,1156,196,960,16.96,83.04,0,196,0,960,0,1156,0,0,0,"25% - 50% P.O.C.","Less than $51000"
"42095014500","Census Tract 145, Northampton County, Pennsylvania",3088,57355,1563,397,0,5,0,1006,50.6,12.9,0,0.2,0,32.6,49.4,1138,669,469,58.79,41.21,90,579,51,418,141,997,13.5,10.9,12.4,"25% - 50% P.O.C.","$51000 - $72000"
"42095014600","Census Tract 146, Northampton County, Pennsylvania",3398,48064,1159,531,0,161,0,1367,34.1,15.6,0,4.7,0,40.2,65.9,1105,511,594,46.24,53.76,103,408,108,486,211,894,20.2,18.2,19.1,"50% - 75% P.O.C.","Less than $51000"
"42095014700","Census Tract 147, Northampton County, Pennsylvania",2942,60000,1690,441,11,0,0,578,57.4,15,0.4,0,0,19.6,42.6,958,696,262,72.65,27.35,97,599,86,176,183,775,13.9,32.8,19.1,"25% - 50% P.O.C.","$51000 - $72000"
"42095015201","Census Tract 152.01, Northampton County, Pennsylvania",7176,43455,6849,10,0,1,0,279,95.4,0.1,0,0,0,3.9,4.6,2718,1376,1342,50.63,49.37,94,1282,169,1173,263,2455,6.8,12.6,9.7,"Less than 25% P.O.C.","Less than $51000"
"42095015300","Census Tract 153, Northampton County, Pennsylvania",5232,85625,4579,12,8,214,0,352,87.5,0.2,0.2,4.1,0,6.7,12.5,1832,1571,261,85.75,14.25,224,1347,21,240,245,1587,14.3,8,13.4,"Less than 25% P.O.C.","$72000 - $96000"
"42095015400","Census Tract 154, Northampton County, Pennsylvania",3071,66377,2974,55,0,27,0,0,96.8,1.8,0,0.9,0,0,3.2,1330,1127,203,84.74,15.26,30,1097,0,203,30,1300,2.7,0,2.3,"Less than 25% P.O.C.","$51000 - $72000"
"42095015500","Census Tract 155, Northampton County, Pennsylvania",6194,70574,6061,12,0,0,0,115,97.9,0.2,0,0,0,1.9,2.1,2531,2181,350,86.17,13.83,185,1996,0,350,185,2346,8.5,0,7.3,"Less than 25% P.O.C.","$51000 - $72000"
"42095015600","Census Tract 156, Northampton County, Pennsylvania",3543,61250,3194,61,0,5,0,265,90.1,1.7,0,0.1,0,7.5,9.9,1369,854,515,62.38,37.62,52,802,16,499,68,1301,6.1,3.1,5,"Less than 25% P.O.C.","$51000 - $72000"
"42095015700","Census Tract 157, Northampton County, Pennsylvania",2720,51250,2538,10,0,89,0,57,93.3,0.4,0,3.3,0,2.1,6.7,1135,637,498,56.12,43.88,105,532,5,493,110,1025,16.5,1,9.7,"Less than 25% P.O.C.","$51000 - $72000"
"42095015801","Census Tract 158.01, Northampton County, Pennsylvania",5323,97244,5199,0,0,39,4,76,97.7,0,0,0.7,0.1,1.4,2.3,1901,1837,64,96.63,3.37,163,1674,13,51,176,1725,8.9,20.3,9.3,"Less than 25% P.O.C.","$96000 or more"
"42095015802","Census Tract 158.02, Northampton County, Pennsylvania",3143,79485,3012,0,0,0,0,107,95.8,0,0,0,0,3.4,4.2,1181,1089,92,92.21,7.79,92,997,0,92,92,1089,8.4,0,7.8,"Less than 25% P.O.C.","$72000 - $96000"
"42095015901","Census Tract 159.01, Northampton County, Pennsylvania",5543,70685,5448,0,0,0,0,95,98.3,0,0,0,0,1.7,1.7,2197,2015,182,91.72,8.28,172,1843,24,158,196,2001,8.5,13.2,8.9,"Less than 25% P.O.C.","$51000 - $72000"
"42095015902","Census Tract 159.02, Northampton County, Pennsylvania",3951,88289,3812,7,0,0,0,97,96.5,0.2,0,0,0,2.5,3.5,1418,1268,150,89.42,10.58,131,1137,15,135,146,1272,10.3,10,10.3,"Less than 25% P.O.C.","$72000 - $96000"
"42095016001","Census Tract 160.01, Northampton County, Pennsylvania",5803,79196,5746,0,0,10,0,47,99,0,0,0.2,0,0.8,1,2307,2170,137,94.06,5.94,176,1994,0,137,176,2131,8.1,0,7.6,"Less than 25% P.O.C.","$72000 - $96000"
"42095016002","Census Tract 160.02, Northampton County, Pennsylvania",4608,53099,4383,0,0,0,0,149,95.1,0,0,0,0,3.2,4.9,1774,1591,183,89.68,10.32,116,1475,49,134,165,1609,7.3,26.8,9.3,"Less than 25% P.O.C.","$51000 - $72000"
"42095016100","Census Tract 161, Northampton County, Pennsylvania",2038,64375,1926,0,0,7,0,95,94.5,0,0,0.3,0,4.7,5.5,790,645,145,81.65,18.35,53,592,23,122,76,714,8.2,15.9,9.6,"Less than 25% P.O.C.","$51000 - $72000"
"42095016201","Census Tract 162.01, Northampton County, Pennsylvania",5524,55887,4453,149,139,82,0,525,80.6,2.7,2.5,1.5,0,9.5,19.4,2246,1358,888,60.46,39.54,73,1285,136,752,209,2037,5.4,15.3,9.3,"Less than 25% P.O.C.","$51000 - $72000"
"42095016202","Census Tract 162.02, Northampton County, Pennsylvania",4323,69597,3859,83,0,24,0,357,89.3,1.9,0,0.6,0,8.3,10.7,1700,1177,523,69.24,30.76,106,1071,38,485,144,1556,9,7.3,8.5,"Less than 25% P.O.C.","$51000 - $72000"
"42095016300","Census Tract 163, Northampton County, Pennsylvania",2831,69244,2474,48,0,0,0,268,87.4,1.7,0,0,0,9.5,12.6,1068,821,247,76.87,23.13,67,754,37,210,104,964,8.2,15,9.7,"Less than 25% P.O.C.","$51000 - $72000"
"42095016400","Census Tract 164, Northampton County, Pennsylvania",4928,80942,4166,263,22,90,0,268,84.5,5.3,0.4,1.8,0,5.4,15.5,2039,1685,354,82.64,17.36,101,1584,36,318,137,1902,6,10.2,6.7,"Less than 25% P.O.C.","$72000 - $96000"
"42095016500","Census Tract 165, Northampton County, Pennsylvania",4915,71792,4548,55,0,0,0,248,92.5,1.1,0,0,0,5,7.5,1891,1687,204,89.21,10.79,121,1566,22,182,143,1748,7.2,10.8,7.6,"Less than 25% P.O.C.","$51000 - $72000"
"42095016600","Census Tract 166, Northampton County, Pennsylvania",2658,48652,2205,107,0,15,0,263,83,4,0,0.6,0,9.9,17,1013,603,410,59.53,40.47,33,570,54,356,87,926,5.5,13.2,8.6,"Less than 25% P.O.C.","Less than $51000"
"42095016700","Census Tract 167, Northampton County, Pennsylvania",6858,91250,6078,30,0,91,0,641,88.6,0.4,0,1.3,0,9.3,11.4,2078,1702,376,81.91,18.09,193,1509,74,302,267,1811,11.3,19.7,12.8,"Less than 25% P.O.C.","$72000 - $96000"
"42095016800","Census Tract 168, Northampton County, Pennsylvania",5699,56349,5149,0,10,11,0,323,90.3,0,0.2,0.2,0,5.7,9.7,2529,1168,1361,46.18,53.82,53,1115,49,1312,102,2427,4.5,3.6,4,"Less than 25% P.O.C.","$51000 - $72000"
"42095016901","Census Tract 169.01, Northampton County, Pennsylvania",3216,111045,2855,1,0,167,0,154,88.8,0,0,5.2,0,4.8,11.2,1127,1067,60,94.68,5.32,116,951,0,60,116,1011,10.9,0,10.3,"Less than 25% P.O.C.","$96000 or more"
"42095016902","Census Tract 169.02, Northampton County, Pennsylvania",3049,105381,2598,102,0,198,0,140,85.2,3.3,0,6.5,0,4.6,14.8,1082,960,122,88.72,11.28,104,856,0,122,104,978,10.8,0,9.6,"Less than 25% P.O.C.","$96000 or more"
"42095017000","Census Tract 170, Northampton County, Pennsylvania",2077,69770,1848,44,0,30,0,99,89,2.1,0,1.4,0,4.8,11,813,653,160,80.32,19.68,59,594,14,146,73,740,9,8.8,9,"Less than 25% P.O.C.","$51000 - $72000"
"42095017101","Census Tract 171.01, Northampton County, Pennsylvania",6387,97126,4339,987,0,203,0,643,67.9,15.5,0,3.2,0,10.1,32.1,2362,2305,57,97.59,2.41,258,2047,0,57,258,2104,11.2,0,10.9,"25% - 50% P.O.C.","$96000 or more"
"42095017102","Census Tract 171.02, Northampton County, Pennsylvania",9083,100261,7161,721,0,370,0,725,78.8,7.9,0,4.1,0,8,21.2,3386,2956,430,87.3,12.7,318,2638,115,315,433,2953,10.8,26.7,12.8,"Less than 25% P.O.C.","$96000 or more"
"42095017200","Census Tract 172, Northampton County, Pennsylvania",6347,61603,3962,376,0,155,8,1309,62.4,5.9,0,2.4,0.1,20.6,37.6,2354,1369,985,58.16,41.84,118,1251,75,910,193,2161,8.6,7.6,8.2,"25% - 50% P.O.C.","$51000 - $72000"
"42095017300","Census Tract 173, Northampton County, Pennsylvania",2779,67105,1987,165,0,12,0,353,71.5,5.9,0,0.4,0,12.7,28.5,1052,685,367,65.11,34.89,84,601,0,367,84,968,12.3,0,8,"25% - 50% P.O.C.","$51000 - $72000"
"42095017401","Census Tract 174.01, Northampton County, Pennsylvania",7954,99745,6095,611,12,428,0,781,76.6,7.7,0.2,5.4,0,9.8,23.4,3095,2611,484,84.36,15.64,207,2404,13,471,220,2875,7.9,2.7,7.1,"Less than 25% P.O.C.","$96000 or more"
"42095017402","Census Tract 174.02, Northampton County, Pennsylvania",3933,85625,3354,77,8,32,0,429,85.3,2,0.2,0.8,0,10.9,14.7,1499,1441,58,96.13,3.87,131,1310,10,48,141,1358,9.1,17.2,9.4,"Less than 25% P.O.C.","$72000 - $96000"
"42095017501","Census Tract 175.01, Northampton County, Pennsylvania",3987,61696,3004,167,0,330,0,421,75.3,4.2,0,8.3,0,10.6,24.7,1661,1082,579,65.14,34.86,91,991,51,528,142,1519,8.4,8.8,8.5,"Less than 25% P.O.C.","$51000 - $72000"
"42095017502","Census Tract 175.02, Northampton County, Pennsylvania",5471,88399,4362,177,0,154,0,648,79.7,3.2,0,2.8,0,11.8,20.3,2239,1455,784,64.98,35.02,101,1354,45,739,146,2093,6.9,5.7,6.5,"Less than 25% P.O.C.","$72000 - $96000"
"42095017603","Census Tract 176.03, Northampton County, Pennsylvania",3721,61888,2823,172,0,54,102,564,75.9,4.6,0,1.5,2.7,15.2,24.1,1535,1314,221,85.6,14.4,53,1261,14,207,67,1468,4,6.3,4.4,"Less than 25% P.O.C.","$51000 - $72000"
"42095017604","Census Tract 176.04, Northampton County, Pennsylvania",4445,91845,3471,285,0,149,0,440,78.1,6.4,0,3.4,0,9.9,21.9,1841,1618,223,87.89,12.11,58,1560,32,191,90,1751,3.6,14.3,4.9,"Less than 25% P.O.C.","$72000 - $96000"
"42095017605","Census Tract 176.05, Northampton County, Pennsylvania",4415,75859,3146,256,10,485,0,247,71.3,5.8,0.2,11,0,5.6,28.7,1471,992,479,67.44,32.56,120,872,73,406,193,1278,12.1,15.2,13.1,"25% - 50% P.O.C.","$72000 - $96000"
"42095017606","Census Tract 176.06, Northampton County, Pennsylvania",4725,105634,3602,330,0,165,0,591,76.2,7,0,3.5,0,12.5,23.8,1672,1595,77,95.39,4.61,139,1456,10,67,149,1523,8.7,13,8.9,"Less than 25% P.O.C.","$96000 or more"
"42095017607","Census Tract 176.07, Northampton County, Pennsylvania",6615,103451,5286,328,19,360,0,391,79.9,5,0.3,5.4,0,5.9,20.1,2321,2212,109,95.3,4.7,162,2050,0,109,162,2159,7.3,0,7,"Less than 25% P.O.C.","$96000 or more"
"42095017702","Census Tract 177.02, Northampton County, Pennsylvania",2378,103558,1923,24,0,42,0,227,80.9,1,0,1.8,0,9.5,19.1,877,835,42,95.21,4.79,79,756,0,42,79,798,9.5,0,9,"Less than 25% P.O.C.","$96000 or more"
"42095017703","Census Tract 177.03, Northampton County, Pennsylvania",2928,91397,2298,139,0,203,0,202,78.5,4.7,0,6.9,0,6.9,21.5,1242,1017,225,81.88,18.12,96,921,26,199,122,1120,9.4,11.6,9.8,"Less than 25% P.O.C.","$72000 - $96000"
"42095017704","Census Tract 177.04, Northampton County, Pennsylvania",6193,91161,5220,312,0,474,0,148,84.3,5,0,7.7,0,2.4,15.7,2484,1924,560,77.46,22.54,363,1561,0,560,363,2121,18.9,0,14.6,"Less than 25% P.O.C.","$72000 - $96000"
"42095017800","Census Tract 178, Northampton County, Pennsylvania",2622,56944,1586,310,0,43,0,634,60.5,11.8,0,1.6,0,24.2,39.5,992,678,314,68.35,31.65,65,613,42,272,107,885,9.6,13.4,10.8,"25% - 50% P.O.C.","$51000 - $72000"
"42095017901","Census Tract 179.01, Northampton County, Pennsylvania",3530,66839,2979,65,0,145,0,339,84.4,1.8,0,4.1,0,9.6,15.6,1491,836,655,56.07,43.93,78,758,0,655,78,1413,9.3,0,5.2,"Less than 25% P.O.C.","$51000 - $72000"
"42095017902","Census Tract 179.02, Northampton County, Pennsylvania",2301,73802,2036,31,14,77,0,98,88.5,1.3,0.6,3.3,0,4.3,11.5,871,689,182,79.1,20.9,64,625,38,144,102,769,9.3,20.9,11.7,"Less than 25% P.O.C.","$72000 - $96000"
"42095018001","Census Tract 180.01, Northampton County, Pennsylvania",4073,87396,3688,0,0,18,0,270,90.5,0,0,0.4,0,6.6,9.5,1500,1392,108,92.8,7.2,173,1219,0,108,173,1327,12.4,0,11.5,"Less than 25% P.O.C.","$72000 - $96000"
"42095018002","Census Tract 180.02, Northampton County, Pennsylvania",6719,93424,5753,148,0,194,0,526,85.6,2.2,0,2.9,0,7.8,14.4,2555,2230,325,87.28,12.72,132,2098,70,255,202,2353,5.9,21.5,7.9,"Less than 25% P.O.C.","$72000 - $96000"
"42095018100","Census Tract 181, Northampton County, Pennsylvania",6539,83125,5522,468,0,249,0,121,84.4,7.2,0,3.8,0,1.9,15.6,2546,1953,593,76.71,23.29,223,1730,39,554,262,2284,11.4,6.6,10.3,"Less than 25% P.O.C.","$72000 - $96000"
"42095018200","Census Tract 182, Northampton County, Pennsylvania",3659,67016,3114,49,0,60,0,418,85.1,1.3,0,1.6,0,11.4,14.9,1406,1135,271,80.73,19.27,100,1035,26,245,126,1280,8.8,9.6,9,"Less than 25% P.O.C.","$51000 - $72000"
"42095018300","Census Tract 183, Northampton County, Pennsylvania",4785,72413,4147,28,0,71,0,475,86.7,0.6,0,1.5,0,9.9,13.3,1831,1379,452,75.31,24.69,88,1291,20,432,108,1723,6.4,4.4,5.9,"Less than 25% P.O.C.","$72000 - $96000"
"42101000100","Census Tract 1, Philadelphia County, Pennsylvania",4118,103585,3237,274,0,234,0,288,78.6,6.7,0,5.7,0,7,21.4,2489,901,1588,36.2,63.8,0,901,0,1588,0,2489,0,0,0,"Less than 25% P.O.C.","$96000 or more"
"42101000200","Census Tract 2, Philadelphia County, Pennsylvania",2860,49871,595,123,8,1865,0,197,20.8,4.3,0.3,65.2,0,6.9,79.2,1082,523,559,48.34,51.66,62,461,23,536,85,997,11.9,4.1,7.9,"75% or more P.O.C.","Less than $51000"
"42101000300","Census Tract 3, Philadelphia County, Pennsylvania",3385,86296,2167,222,0,553,19,180,64,6.6,0,16.3,0.6,5.3,36,1828,441,1387,24.12,75.88,10,431,0,1387,10,1818,2.3,0,0.5,"25% - 50% P.O.C.","$72000 - $96000"
"42101000401","Census Tract 4.01, Philadelphia County, Pennsylvania",2516,62986,1594,286,0,473,0,96,63.4,11.4,0,18.8,0,3.8,36.6,1618,491,1127,30.35,69.65,0,491,0,1127,0,1618,0,0,0,"25% - 50% P.O.C.","$51000 - $72000"
"42101000402","Census Tract 4.02, Philadelphia County, Pennsylvania",4097,78947,3251,214,0,434,0,105,79.4,5.2,0,10.6,0,2.6,20.6,2918,1679,1239,57.54,42.46,0,1679,0,1239,0,2918,0,0,0,"Less than 25% P.O.C.","$72000 - $96000"
"42101000500","Census Tract 5, Philadelphia County, Pennsylvania",2543,45438,794,802,57,364,0,280,31.2,31.5,2.2,14.3,0,11,68.8,927,48,879,5.18,94.82,0,48,0,879,0,927,0,0,0,"50% - 75% P.O.C.","Less than $51000"
"42101000600","Census Tract 6, Philadelphia County, Pennsylvania",1222,84632,903,108,0,120,0,86,73.9,8.8,0,9.8,0,7,26.1,787,39,748,4.96,95.04,0,39,0,748,0,787,0,0,0,"25% - 50% P.O.C.","$72000 - $96000"
"42101000700","Census Tract 7, Philadelphia County, Pennsylvania",3736,66923,2328,429,0,672,9,188,62.3,11.5,0,18,0.2,5,37.7,2666,662,2004,24.83,75.17,0,662,0,2004,0,2666,0,0,0,"25% - 50% P.O.C.","$51000 - $72000"
"42101000801","Census Tract 8.01, Philadelphia County, Pennsylvania",1514,127849,1245,11,0,128,0,92,82.2,0.7,0,8.5,0,6.1,17.8,794,277,517,34.89,65.11,21,256,9,508,30,764,7.6,1.7,3.8,"Less than 25% P.O.C.","$96000 or more"
"42101000803","Census Tract 8.03, Philadelphia County, Pennsylvania",2774,63974,2155,81,0,275,0,138,77.7,2.9,0,9.9,0,5,22.3,1733,591,1142,34.1,65.9,17,574,0,1142,17,1716,2.9,0,1,"Less than 25% P.O.C.","$51000 - $72000"
"42101000804","Census Tract 8.04, Philadelphia County, Pennsylvania",4899,108293,3797,111,0,599,0,218,77.5,2.3,0,12.2,0,4.4,22.5,3095,921,2174,29.76,70.24,0,921,0,2174,0,3095,0,0,0,"Less than 25% P.O.C.","$96000 or more"
"42101000901","Census Tract 9.01, Philadelphia County, Pennsylvania",2056,48929,1522,92,0,330,0,60,74,4.5,0,16.1,0,2.9,26,1524,117,1407,7.68,92.32,0,117,0,1407,0,1524,0,0,0,"25% - 50% P.O.C.","Less than $51000"
"42101000902","Census Tract 9.02, Philadelphia County, Pennsylvania",2818,60268,1978,176,36,438,0,121,70.2,6.2,1.3,15.5,0,4.3,29.8,1436,246,1190,17.13,82.87,0,246,0,1190,0,1436,0,0,0,"25% - 50% P.O.C.","$51000 - $72000"
"42101001001","Census Tract 10.01, Philadelphia County, Pennsylvania",2670,106667,2410,67,0,83,10,56,90.3,2.5,0,3.1,0.4,2.1,9.7,1498,1071,427,71.5,28.5,12,1059,0,427,12,1486,1.1,0,0.8,"Less than 25% P.O.C.","$96000 or more"
"42101001002","Census Tract 10.02, Philadelphia County, Pennsylvania",3444,113431,2967,98,30,163,0,135,86.1,2.8,0.9,4.7,0,3.9,13.9,1815,1077,738,59.34,40.66,0,1077,0,738,0,1815,0,0,0,"Less than 25% P.O.C.","$96000 or more"
"42101001101","Census Tract 11.01, Philadelphia County, Pennsylvania",3750,65924,2607,372,0,373,0,263,69.5,9.9,0,9.9,0,7,30.5,1940,712,1228,36.7,63.3,3,709,16,1212,19,1921,0.4,1.3,1,"25% - 50% P.O.C.","$51000 - $72000"
"42101001102","Census Tract 11.02, Philadelphia County, Pennsylvania",2687,82107,1925,257,0,366,0,42,71.6,9.6,0,13.6,0,1.6,28.4,1547,515,1032,33.29,66.71,9,506,0,1032,9,1538,1.7,0,0.6,"25% - 50% P.O.C.","$72000 - $96000"
"42101001201","Census Tract 12.01, Philadelphia County, Pennsylvania",4038,122417,2943,241,13,311,0,246,72.9,6,0.3,7.7,0,6.1,27.1,2091,1112,979,53.18,46.82,0,1112,0,979,0,2091,0,0,0,"25% - 50% P.O.C.","$96000 or more"
"42101001202","Census Tract 12.02, Philadelphia County, Pennsylvania",5215,86667,3988,233,7,448,12,431,76.5,4.5,0.1,8.6,0.2,8.3,23.5,2924,874,2050,29.89,70.11,13,861,0,2050,13,2911,1.5,0,0.4,"Less than 25% P.O.C.","$72000 - $96000"
"42101001300","Census Tract 13, Philadelphia County, Pennsylvania",6911,118351,4255,1555,0,379,0,431,61.6,22.5,0,5.5,0,6.2,38.4,2946,1713,1233,58.15,41.85,59,1654,24,1209,83,2863,3.4,1.9,2.8,"25% - 50% P.O.C.","$96000 or more"
"42101001400","Census Tract 14, Philadelphia County, Pennsylvania",4199,83317,2715,974,0,303,0,88,64.7,23.2,0,7.2,0,2.1,35.3,2245,1068,1177,47.57,52.43,20,1048,10,1167,30,2215,1.9,0.8,1.3,"25% - 50% P.O.C.","$72000 - $96000"
"42101001500","Census Tract 15, Philadelphia County, Pennsylvania",3227,71174,2199,449,0,306,0,223,68.1,13.9,0,9.5,0,6.9,31.9,1591,820,771,51.54,48.46,21,799,0,771,21,1570,2.6,0,1.3,"25% - 50% P.O.C.","$51000 - $72000"
"42101001600","Census Tract 16, Philadelphia County, Pennsylvania",2371,102778,1937,76,0,117,0,159,81.7,3.2,0,4.9,0,6.7,18.3,1162,536,626,46.13,53.87,37,499,0,626,37,1125,6.9,0,3.2,"Less than 25% P.O.C.","$96000 or more"
"42101001700","Census Tract 17, Philadelphia County, Pennsylvania",3114,108750,2520,240,0,18,0,153,80.9,7.7,0,0.6,0,4.9,19.1,1428,814,614,57,43,32,782,10,604,42,1386,3.9,1.6,2.9,"Less than 25% P.O.C.","$96000 or more"
"42101001800","Census Tract 18, Philadelphia County, Pennsylvania",3138,104821,2316,547,0,156,0,63,73.8,17.4,0,5,0,2,26.2,1433,769,664,53.66,46.34,12,757,0,664,12,1421,1.6,0,0.8,"25% - 50% P.O.C.","$96000 or more"
"42101001900","Census Tract 19, Philadelphia County, Pennsylvania",4039,117927,2322,1252,0,183,0,251,57.5,31,0,4.5,0,6.2,42.5,1610,900,710,55.9,44.1,0,900,20,690,20,1590,0,2.8,1.2,"25% - 50% P.O.C.","$96000 or more"
"42101002000","Census Tract 20, Philadelphia County, Pennsylvania",1828,49572,579,1044,11,63,0,32,31.7,57.1,0.6,3.4,0,1.8,68.3,839,548,291,65.32,34.68,13,535,8,283,21,818,2.4,2.7,2.5,"50% - 75% P.O.C.","Less than $51000"
"42101002100","Census Tract 21, Philadelphia County, Pennsylvania",2221,56625,780,1219,0,68,0,95,35.1,54.9,0,3.1,0,4.3,64.9,958,648,310,67.64,32.36,22,626,17,293,39,919,3.4,5.5,4.1,"50% - 75% P.O.C.","$51000 - $72000"
"42101002200","Census Tract 22, Philadelphia County, Pennsylvania",2263,65368,1025,851,0,182,0,136,45.3,37.6,0,8,0,6,54.7,1053,469,584,44.54,55.46,0,469,15,569,15,1038,0,2.6,1.4,"50% - 75% P.O.C.","$51000 - $72000"
"42101002300","Census Tract 23, Philadelphia County, Pennsylvania",2918,70926,2013,85,0,551,0,223,69,2.9,0,18.9,0,7.6,31,1272,727,545,57.15,42.85,56,671,0,545,56,1216,7.7,0,4.4,"25% - 50% P.O.C.","$51000 - $72000"
"42101002400","Census Tract 24, Philadelphia County, Pennsylvania",4647,90682,3158,345,0,598,0,433,68,7.4,0,12.9,0,9.3,32,2136,1028,1108,48.13,51.87,37,991,0,1108,37,2099,3.6,0,1.7,"25% - 50% P.O.C.","$72000 - $96000"
"42101002500","Census Tract 25, Philadelphia County, Pennsylvania",4243,60000,2231,764,0,681,0,347,52.6,18,0,16,0,8.2,47.4,1838,1034,804,56.26,43.74,99,935,24,780,123,1715,9.6,3,6.7,"25% - 50% P.O.C.","$51000 - $72000"
"42101002701","Census Tract 27.01, Philadelphia County, Pennsylvania",4234,55585,1634,727,0,773,0,1020,38.6,17.2,0,18.3,0,24.1,61.4,1422,624,798,43.88,56.12,77,547,113,685,190,1232,12.3,14.2,13.4,"50% - 75% P.O.C.","$51000 - $72000"
"42101002702","Census Tract 27.02, Philadelphia County, Pennsylvania",4419,69493,3662,121,0,175,0,358,82.9,2.7,0,4,0,8.1,17.1,1877,1270,607,67.66,32.34,86,1184,9,598,95,1782,6.8,1.5,5.1,"Less than 25% P.O.C.","$51000 - $72000"
"42101002801","Census Tract 28.01, Philadelphia County, Pennsylvania",4595,54340,1306,270,27,1416,0,1478,28.4,5.9,0.6,30.8,0,32.2,71.6,1556,910,646,58.48,41.52,139,771,183,463,322,1234,15.3,28.3,20.7,"50% - 75% P.O.C.","$51000 - $72000"
"42101002802","Census Tract 28.02, Philadelphia County, Pennsylvania",5596,61075,3679,156,0,856,0,859,65.7,2.8,0,15.3,0,15.4,34.3,2209,1305,904,59.08,40.92,28,1277,67,837,95,2114,2.1,7.4,4.3,"25% - 50% P.O.C.","$51000 - $72000"
"42101002900","Census Tract 29, Philadelphia County, Pennsylvania",3945,60288,2823,47,0,351,0,635,71.6,1.2,0,8.9,0,16.1,28.4,1875,1234,641,65.81,34.19,73,1161,0,641,73,1802,5.9,0,3.9,"25% - 50% P.O.C.","$51000 - $72000"
"42101003001","Census Tract 30.01, Philadelphia County, Pennsylvania",3959,50054,1432,764,0,1298,0,351,36.2,19.3,0,32.8,0,8.9,63.8,1503,834,669,55.49,44.51,54,780,58,611,112,1391,6.5,8.7,7.5,"50% - 75% P.O.C.","Less than $51000"
"42101003002","Census Tract 30.02, Philadelphia County, Pennsylvania",2820,45060,987,1600,13,67,0,53,35,56.7,0.5,2.4,0,1.9,65,1230,674,556,54.8,45.2,32,642,32,524,64,1166,4.7,5.8,5.2,"50% - 75% P.O.C.","Less than $51000"
"42101003100","Census Tract 31, Philadelphia County, Pennsylvania",4426,39153,943,2619,65,149,0,457,21.3,59.2,1.5,3.4,0,10.3,78.7,2003,987,1016,49.28,50.72,51,936,23,993,74,1929,5.2,2.3,3.7,"75% or more P.O.C.","Less than $51000"
"42101003200","Census Tract 32, Philadelphia County, Pennsylvania",4180,32115,381,3031,0,109,16,459,9.1,72.5,0,2.6,0.4,11,90.9,1630,902,728,55.34,44.66,17,885,127,601,144,1486,1.9,17.4,8.8,"75% or more P.O.C.","Less than $51000"
"42101003300","Census Tract 33, Philadelphia County, Pennsylvania",6203,35521,2287,2420,0,430,0,977,36.9,39,0,6.9,0,15.8,63.1,2369,1057,1312,44.62,55.38,12,1045,102,1210,114,2255,1.1,7.8,4.8,"50% - 75% P.O.C.","Less than $51000"
"42101003600","Census Tract 36, Philadelphia County, Pennsylvania",7142,21836,1199,4334,92,1195,0,237,16.8,60.7,1.3,16.7,0,3.3,83.2,2624,1240,1384,47.26,52.74,103,1137,97,1287,200,2424,8.3,7,7.6,"75% or more P.O.C.","Less than $51000"
"42101003701","Census Tract 37.01, Philadelphia County, Pennsylvania",5859,38632,984,3795,86,431,0,510,16.8,64.8,1.5,7.4,0,8.7,83.2,2237,1278,959,57.13,42.87,36,1242,17,942,53,2184,2.8,1.8,2.4,"75% or more P.O.C.","Less than $51000"
"42101003702","Census Tract 37.02, Philadelphia County, Pennsylvania",4221,32188,871,1667,73,1179,0,290,20.6,39.5,1.7,27.9,0,6.9,79.4,1440,847,593,58.82,41.18,130,717,143,450,273,1167,15.3,24.1,19,"75% or more P.O.C.","Less than $51000"
"42101003800","Census Tract 38, Philadelphia County, Pennsylvania",4015,62071,3298,20,0,369,0,314,82.1,0.5,0,9.2,0,7.8,17.9,1600,1321,279,82.56,17.44,130,1191,0,279,130,1470,9.8,0,8.1,"Less than 25% P.O.C.","$51000 - $72000"
"42101003901","Census Tract 39.01, Philadelphia County, Pennsylvania",6186,42161,4179,483,0,1144,0,353,67.6,7.8,0,18.5,0,5.7,32.4,2617,1437,1180,54.91,45.09,120,1317,0,1180,120,2497,8.4,0,4.6,"25% - 50% P.O.C.","Less than $51000"
"42101003902","Census Tract 39.02, Philadelphia County, Pennsylvania",5800,63966,5511,17,24,99,0,78,95,0.3,0.4,1.7,0,1.3,5,2351,1858,493,79.03,20.97,102,1756,68,425,170,2181,5.5,13.8,7.2,"Less than 25% P.O.C.","$51000 - $72000"
"42101004001","Census Tract 40.01, Philadelphia County, Pennsylvania",4165,55227,2935,138,0,224,0,851,70.5,3.3,0,5.4,0,20.4,29.5,1902,964,938,50.68,49.32,19,945,0,938,19,1883,2,0,1,"25% - 50% P.O.C.","$51000 - $72000"
"42101004002","Census Tract 40.02, Philadelphia County, Pennsylvania",4757,56058,3944,194,0,357,0,137,82.9,4.1,0,7.5,0,2.9,17.1,2140,1606,534,75.05,24.95,137,1469,0,534,137,2003,8.5,0,6.4,"Less than 25% P.O.C.","$51000 - $72000"
"42101004101","Census Tract 41.01, Philadelphia County, Pennsylvania",5637,34507,1376,847,0,2118,0,1223,24.4,15,0,37.6,0,21.7,75.6,2115,1337,778,63.22,36.78,150,1187,97,681,247,1868,11.2,12.5,11.7,"75% or more P.O.C.","Less than $51000"
"42101004102","Census Tract 41.02, Philadelphia County, Pennsylvania",8671,40958,2137,568,0,3875,13,1667,24.6,6.6,0,44.7,0.1,19.2,75.4,2475,1314,1161,53.09,46.91,143,1171,276,885,419,2056,10.9,23.8,16.9,"75% or more P.O.C.","Less than $51000"
"42101004201","Census Tract 42.01, Philadelphia County, Pennsylvania",5326,50709,4263,47,0,785,0,207,80,0.9,0,14.7,0,3.9,20,2034,1472,562,72.37,27.63,70,1402,63,499,133,1901,4.8,11.2,6.5,"Less than 25% P.O.C.","Less than $51000"
"42101004202","Census Tract 42.02, Philadelphia County, Pennsylvania",5651,47935,3694,195,5,1042,0,518,65.4,3.5,0.1,18.4,0,9.2,34.6,1742,1380,362,79.22,20.78,188,1192,135,227,323,1419,13.6,37.3,18.5,"25% - 50% P.O.C.","Less than $51000"
"42101005000","Census Tract 50, Philadelphia County, Pennsylvania",0,NA,0,0,0,0,0,0,NA,NA,NA,NA,NA,NA,NA,0,0,0,NA,NA,0,0,0,0,0,0,NA,NA,NA,"N/A","N/A"
"42101005400","Census Tract 54, Philadelphia County, Pennsylvania",1577,54336,184,1109,0,129,0,121,11.7,70.3,0,8.2,0,7.7,88.3,645,223,422,34.57,65.43,39,184,0,422,39,606,17.5,0,6,"75% or more P.O.C.","$51000 - $72000"
"42101005500","Census Tract 55, Philadelphia County, Pennsylvania",6321,59519,880,4475,23,161,0,714,13.9,70.8,0.4,2.5,0,11.3,86.1,2505,1655,850,66.07,33.93,141,1514,0,850,141,2364,8.5,0,5.6,"75% or more P.O.C.","$51000 - $72000"
"42101005600","Census Tract 56, Philadelphia County, Pennsylvania",1158,28802,31,1021,0,4,0,35,2.7,88.2,0,0.3,0,3,97.3,569,99,470,17.4,82.6,0,99,0,470,0,569,0,0,0,"75% or more P.O.C.","Less than $51000"
"42101006000","Census Tract 60, Philadelphia County, Pennsylvania",6467,42143,658,4757,0,553,0,76,10.2,73.6,0,8.6,0,1.2,89.8,2368,1598,770,67.48,32.52,195,1403,49,721,244,2124,12.2,6.4,10.3,"75% or more P.O.C.","Less than $51000"
"42101006100","Census Tract 61, Philadelphia County, Pennsylvania",2759,33533,281,2256,0,212,0,10,10.2,81.8,0,7.7,0,0.4,89.8,1118,780,338,69.77,30.23,75,705,0,338,75,1043,9.6,0,6.7,"75% or more P.O.C.","Less than $51000"
"42101006200","Census Tract 62, Philadelphia County, Pennsylvania",4994,31098,210,4388,0,235,0,161,4.2,87.9,0,4.7,0,3.2,95.8,1477,745,732,50.44,49.56,225,520,146,586,371,1106,30.2,19.9,25.1,"75% or more P.O.C.","Less than $51000"
"42101006300","Census Tract 63, Philadelphia County, Pennsylvania",4512,28140,139,3540,4,517,0,270,3.1,78.5,0.1,11.5,0,6,96.9,1326,462,864,34.84,65.16,28,434,85,779,113,1213,6.1,9.8,8.5,"75% or more P.O.C.","Less than $51000"
"42101006400","Census Tract 64, Philadelphia County, Pennsylvania",4430,28342,312,3729,0,240,0,93,7,84.2,0,5.4,0,2.1,93,1461,838,623,57.36,42.64,47,791,111,512,158,1303,5.6,17.8,10.8,"75% or more P.O.C.","Less than $51000"
"42101006500","Census Tract 65, Philadelphia County, Pennsylvania",4426,29760,54,4305,0,0,8,16,1.2,97.3,0,0,0.2,0.4,98.8,1754,890,864,50.74,49.26,116,774,72,792,188,1566,13,8.3,10.7,"75% or more P.O.C.","Less than $51000"
"42101006600","Census Tract 66, Philadelphia County, Pennsylvania",3471,22637,145,2785,0,343,0,170,4.2,80.2,0,9.9,0,4.9,95.8,1302,504,798,38.71,61.29,102,402,48,750,150,1152,20.2,6,11.5,"75% or more P.O.C.","Less than $51000"
"42101006700","Census Tract 67, Philadelphia County, Pennsylvania",7082,36905,469,5737,257,490,0,36,6.6,81,3.6,6.9,0,0.5,93.4,2679,1371,1308,51.18,48.82,177,1194,131,1177,308,2371,12.9,10,11.5,"75% or more P.O.C.","Less than $51000"
"42101006900","Census Tract 69, Philadelphia County, Pennsylvania",3479,19451,99,3272,0,26,0,82,2.8,94.1,0,0.7,0,2.4,97.2,1092,190,902,17.4,82.6,0,190,130,772,130,962,0,14.4,11.9,"75% or more P.O.C.","Less than $51000"
"42101007000","Census Tract 70, Philadelphia County, Pennsylvania",3529,33520,63,3403,0,43,12,0,1.8,96.4,0,1.2,0.3,0,98.2,1492,836,656,56.03,43.97,25,811,63,593,88,1404,3,9.6,5.9,"75% or more P.O.C.","Less than $51000"
"42101007101","Census Tract 71.01, Philadelphia County, Pennsylvania",2595,24875,93,2413,0,26,0,63,3.6,93,0,1,0,2.4,96.4,805,339,466,42.11,57.89,38,301,44,422,82,723,11.2,9.4,10.2,"75% or more P.O.C.","Less than $51000"
"42101007102","Census Tract 71.02, Philadelphia County, Pennsylvania",4570,28321,115,4033,76,0,0,319,2.5,88.2,1.7,0,0,7,97.5,1728,1094,634,63.31,36.69,67,1027,144,490,211,1517,6.1,22.7,12.2,"75% or more P.O.C.","Less than $51000"
"42101007200","Census Tract 72, Philadelphia County, Pennsylvania",4466,33393,120,3905,0,207,0,66,2.7,87.4,0,4.6,0,1.5,97.3,1673,824,849,49.25,50.75,67,757,121,728,188,1485,8.1,14.3,11.2,"75% or more P.O.C.","Less than $51000"
"42101007300","Census Tract 73, Philadelphia County, Pennsylvania",2959,32165,354,2444,0,56,0,54,12,82.6,0,1.9,0,1.8,88,1101,649,452,58.95,41.05,96,553,74,378,170,931,14.8,16.4,15.4,"75% or more P.O.C.","Less than $51000"
"42101007400","Census Tract 74, Philadelphia County, Pennsylvania",4720,38264,438,3793,0,60,0,88,9.3,80.4,0,1.3,0,1.9,90.7,1643,716,927,43.58,56.42,13,703,134,793,147,1496,1.8,14.5,8.9,"75% or more P.O.C.","Less than $51000"
"42101007700","Census Tract 77, Philadelphia County, Pennsylvania",1872,40938,816,498,0,327,0,131,43.6,26.6,0,17.5,0,7,56.4,627,104,523,16.59,83.41,0,104,35,488,35,592,0,6.7,5.6,"50% - 75% P.O.C.","Less than $51000"
"42101007800","Census Tract 78, Philadelphia County, Pennsylvania",4163,46907,2440,988,0,300,42,258,58.6,23.7,0,7.2,1,6.2,41.4,2016,598,1418,29.66,70.34,48,550,8,1410,56,1960,8,0.6,2.8,"25% - 50% P.O.C.","Less than $51000"
"42101007900","Census Tract 79, Philadelphia County, Pennsylvania",4463,63642,2303,1209,0,424,44,311,51.6,27.1,0,9.5,1,7,48.4,2046,740,1306,36.17,63.83,71,669,20,1286,91,1955,9.6,1.5,4.4,"25% - 50% P.O.C.","$51000 - $72000"
"42101008000","Census Tract 80, Philadelphia County, Pennsylvania",3807,51875,888,2507,0,93,0,186,23.3,65.9,0,2.4,0,4.9,76.7,1442,788,654,54.65,45.35,29,759,86,568,115,1327,3.7,13.1,8,"75% or more P.O.C.","$51000 - $72000"
"42101008101","Census Tract 81.01, Philadelphia County, Pennsylvania",3179,27440,115,2983,0,0,0,6,3.6,93.8,0,0,0,0.2,96.4,986,469,517,47.57,52.43,19,450,128,389,147,839,4.1,24.8,14.9,"75% or more P.O.C.","Less than $51000"
"42101008102","Census Tract 81.02, Philadelphia County, Pennsylvania",5354,26080,360,4781,0,0,0,197,6.7,89.3,0,0,0,3.7,93.3,1835,1147,688,62.51,37.49,108,1039,148,540,256,1579,9.4,21.5,14,"75% or more P.O.C.","Less than $51000"
"42101008200","Census Tract 82, Philadelphia County, Pennsylvania",5882,34056,61,5455,0,75,0,220,1,92.7,0,1.3,0,3.7,99,2448,1418,1030,57.92,42.08,25,1393,189,841,214,2234,1.8,18.3,8.7,"75% or more P.O.C.","Less than $51000"
"42101008301","Census Tract 83.01, Philadelphia County, Pennsylvania",4628,34486,91,4329,8,53,0,71,2,93.5,0.2,1.1,0,1.5,98,1637,763,874,46.61,53.39,74,689,82,792,156,1481,9.7,9.4,9.5,"75% or more P.O.C.","Less than $51000"
"42101008302","Census Tract 83.02, Philadelphia County, Pennsylvania",5133,26214,19,4778,29,120,0,119,0.4,93.1,0.6,2.3,0,2.3,99.6,2004,836,1168,41.72,58.28,68,768,36,1132,104,1900,8.1,3.1,5.2,"75% or more P.O.C.","Less than $51000"
"42101008400","Census Tract 84, Philadelphia County, Pennsylvania",5050,38590,100,4655,11,61,0,89,2,92.2,0.2,1.2,0,1.8,98,1739,728,1011,41.86,58.14,24,704,112,899,136,1603,3.3,11.1,7.8,"75% or more P.O.C.","Less than $51000"
"42101008500","Census Tract 85, Philadelphia County, Pennsylvania",6803,33429,462,5669,164,196,0,260,6.8,83.3,2.4,2.9,0,3.8,93.2,2694,1152,1542,42.76,57.24,99,1053,37,1505,136,2558,8.6,2.4,5,"75% or more P.O.C.","Less than $51000"
"42101008601","Census Tract 86.01, Philadelphia County, Pennsylvania",3312,52426,1545,788,0,469,0,362,46.6,23.8,0,14.2,0,10.9,53.4,1418,282,1136,19.89,80.11,19,263,36,1100,55,1363,6.7,3.2,3.9,"50% - 75% P.O.C.","$51000 - $72000"
"42101008602","Census Tract 86.02, Philadelphia County, Pennsylvania",2940,39394,614,1900,0,248,0,114,20.9,64.6,0,8.4,0,3.9,79.1,1332,243,1089,18.24,81.76,3,240,84,1005,87,1245,1.2,7.7,6.5,"75% or more P.O.C.","Less than $51000"
"42101008701","Census Tract 87.01, Philadelphia County, Pennsylvania",3667,43929,1864,669,56,731,0,222,50.8,18.2,1.5,19.9,0,6.1,49.2,1688,229,1459,13.57,86.43,0,229,70,1389,70,1618,0,4.8,4.1,"25% - 50% P.O.C.","Less than $51000"
"42101008702","Census Tract 87.02, Philadelphia County, Pennsylvania",2622,35643,1312,247,0,669,0,238,50,9.4,0,25.5,0,9.1,50,1252,175,1077,13.98,86.02,55,120,0,1077,55,1197,31.4,0,4.4,"50% - 75% P.O.C.","Less than $51000"
"42101008801","Census Tract 88.01, Philadelphia County, Pennsylvania",2289,31250,1082,272,9,537,9,251,47.3,11.9,0.4,23.5,0.4,11,52.7,257,0,257,0,100,0,0,20,237,20,237,NA,7.8,7.8,"50% - 75% P.O.C.","Less than $51000"
"42101008802","Census Tract 88.02, Philadelphia County, Pennsylvania",6303,22104,2820,1370,0,1408,0,579,44.7,21.7,0,22.3,0,9.2,55.3,1297,49,1248,3.78,96.22,0,49,142,1106,142,1155,0,11.4,10.9,"50% - 75% P.O.C.","Less than $51000"
"42101009000","Census Tract 90, Philadelphia County, Pennsylvania",6201,25515,3847,470,0,1216,0,472,62,7.6,0,19.6,0,7.6,38,1082,92,990,8.5,91.5,0,92,11,979,11,1071,0,1.1,1,"25% - 50% P.O.C.","Less than $51000"
"42101009100","Census Tract 91, Philadelphia County, Pennsylvania",2958,17813,967,1072,27,664,0,110,32.7,36.2,0.9,22.4,0,3.7,67.3,1617,268,1349,16.57,83.43,14,254,36,1313,50,1567,5.2,2.7,3.1,"50% - 75% P.O.C.","Less than $51000"
"42101009200","Census Tract 92, Philadelphia County, Pennsylvania",3345,23333,545,2182,0,304,0,131,16.3,65.2,0,9.1,0,3.9,83.7,1376,411,965,29.87,70.13,50,361,59,906,109,1267,12.2,6.1,7.9,"75% or more P.O.C.","Less than $51000"
"42101009300","Census Tract 93, Philadelphia County, Pennsylvania",4721,26650,278,4136,0,155,0,140,5.9,87.6,0,3.3,0,3,94.1,1775,931,844,52.45,47.55,104,827,110,734,214,1561,11.2,13,12.1,"75% or more P.O.C.","Less than $51000"
"42101009400","Census Tract 94, Philadelphia County, Pennsylvania",4252,19787,55,4049,0,0,0,98,1.3,95.2,0,0,0,2.3,98.7,1767,632,1135,35.77,64.23,0,632,123,1012,123,1644,0,10.8,7,"75% or more P.O.C.","Less than $51000"
"42101009500","Census Tract 95, Philadelphia County, Pennsylvania",3261,28636,57,3049,0,0,0,124,1.7,93.5,0,0,0,3.8,98.3,1392,395,997,28.38,71.62,23,372,69,928,92,1300,5.8,6.9,6.6,"75% or more P.O.C.","Less than $51000"
"42101009600","Census Tract 96, Philadelphia County, Pennsylvania",4477,33713,13,3932,22,8,0,474,0.3,87.8,0.5,0.2,0,10.6,99.7,1661,800,861,48.16,51.84,0,800,120,741,120,1541,0,13.9,7.2,"75% or more P.O.C.","Less than $51000"
"42101009801","Census Tract 98.01, Philadelphia County, Pennsylvania",2318,57852,221,1920,0,40,0,126,9.5,82.8,0,1.7,0,5.4,90.5,935,626,309,66.95,33.05,20,606,0,309,20,915,3.2,0,2.1,"75% or more P.O.C.","$51000 - $72000"
"42101009802","Census Tract 98.02, Philadelphia County, Pennsylvania",6190,57017,580,5341,0,35,0,149,9.4,86.3,0,0.6,0,2.4,90.6,2129,1593,536,74.82,25.18,199,1394,42,494,241,1888,12.5,7.8,11.3,"75% or more P.O.C.","$51000 - $72000"
"42101010000","Census Tract 100, Philadelphia County, Pennsylvania",4863,44748,258,4315,0,112,0,92,5.3,88.7,0,2.3,0,1.9,94.7,1565,927,638,59.23,40.77,143,784,106,532,249,1316,15.4,16.6,15.9,"75% or more P.O.C.","Less than $51000"
"42101010100","Census Tract 101, Philadelphia County, Pennsylvania",6925,45540,122,6671,0,0,0,21,1.8,96.3,0,0,0,0.3,98.2,2137,1388,749,64.95,35.05,158,1230,131,618,289,1848,11.4,17.5,13.5,"75% or more P.O.C.","Less than $51000"
"42101010200","Census Tract 102, Philadelphia County, Pennsylvania",3344,25455,16,3111,0,0,0,178,0.5,93,0,0,0,5.3,99.5,1280,540,740,42.19,57.81,25,515,80,660,105,1175,4.6,10.8,8.2,"75% or more P.O.C.","Less than $51000"
"42101010300","Census Tract 103, Philadelphia County, Pennsylvania",2816,27004,36,2706,0,42,0,32,1.3,96.1,0,1.5,0,1.1,98.7,887,348,539,39.23,60.77,75,273,70,469,145,742,21.6,13,16.3,"75% or more P.O.C.","Less than $51000"
"42101010400","Census Tract 104, Philadelphia County, Pennsylvania",3827,26875,181,3452,0,0,0,60,4.7,90.2,0,0,0,1.6,95.3,1308,670,638,51.22,48.78,45,625,122,516,167,1141,6.7,19.1,12.8,"75% or more P.O.C.","Less than $51000"
"42101010500","Census Tract 105, Philadelphia County, Pennsylvania",4544,22420,270,3963,30,62,0,128,5.9,87.2,0.7,1.4,0,2.8,94.1,1437,463,974,32.22,67.78,46,417,84,890,130,1307,9.9,8.6,9,"75% or more P.O.C.","Less than $51000"
"42101010600","Census Tract 106, Philadelphia County, Pennsylvania",1704,21579,79,1478,0,54,0,51,4.6,86.7,0,3.2,0,3,95.4,586,187,399,31.91,68.09,38,149,50,349,88,498,20.3,12.5,15,"75% or more P.O.C.","Less than $51000"
"42101010700","Census Tract 107, Philadelphia County, Pennsylvania",3612,18476,176,3301,0,6,0,70,4.9,91.4,0,0.2,0,1.9,95.1,1238,484,754,39.1,60.9,44,440,96,658,140,1098,9.1,12.7,11.3,"75% or more P.O.C.","Less than $51000"
"42101010800","Census Tract 108, Philadelphia County, Pennsylvania",4258,23680,326,3570,48,160,0,80,7.7,83.8,1.1,3.8,0,1.9,92.3,1592,594,998,37.31,62.69,13,581,100,898,113,1479,2.2,10,7.1,"75% or more P.O.C.","Less than $51000"
"42101010900","Census Tract 109, Philadelphia County, Pennsylvania",2790,27039,441,2018,14,144,0,144,15.8,72.3,0.5,5.2,0,5.2,84.2,1015,277,738,27.29,72.71,20,257,62,676,82,933,7.2,8.4,8.1,"75% or more P.O.C.","Less than $51000"
"42101011000","Census Tract 110, Philadelphia County, Pennsylvania",3549,16461,169,2878,8,78,0,103,4.8,81.1,0.2,2.2,0,2.9,95.2,1386,551,835,39.75,60.25,67,484,40,795,107,1279,12.2,4.8,7.7,"75% or more P.O.C.","Less than $51000"
"42101011100","Census Tract 111, Philadelphia County, Pennsylvania",3704,37375,166,3349,0,2,0,39,4.5,90.4,0,0.1,0,1.1,95.5,1219,722,497,59.23,40.77,79,643,54,443,133,1086,10.9,10.9,10.9,"75% or more P.O.C.","Less than $51000"
"42101011200","Census Tract 112, Philadelphia County, Pennsylvania",5939,33570,14,5530,0,0,0,387,0.2,93.1,0,0,0,6.5,99.8,2055,1374,681,66.86,33.14,144,1230,86,595,230,1825,10.5,12.6,11.2,"75% or more P.O.C.","Less than $51000"
"42101011300","Census Tract 113, Philadelphia County, Pennsylvania",3344,28636,62,3229,0,0,0,53,1.9,96.6,0,0,0,1.6,98.1,1102,621,481,56.35,43.65,41,580,33,448,74,1028,6.6,6.9,6.7,"75% or more P.O.C.","Less than $51000"
"42101011400","Census Tract 114, Philadelphia County, Pennsylvania",6864,33908,81,6645,0,16,0,79,1.2,96.8,0,0.2,0,1.2,98.8,2771,1453,1318,52.44,47.56,143,1310,37,1281,180,2591,9.8,2.8,6.5,"75% or more P.O.C.","Less than $51000"
"42101011500","Census Tract 115, Philadelphia County, Pennsylvania",4472,58447,93,4227,30,0,0,66,2.1,94.5,0.7,0,0,1.5,97.9,1609,1265,344,78.62,21.38,51,1214,21,323,72,1537,4,6.1,4.5,"75% or more P.O.C.","$51000 - $72000"
"42101011700","Census Tract 117, Philadelphia County, Pennsylvania",1957,57500,834,756,0,293,0,54,42.6,38.6,0,15,0,2.8,57.4,336,268,68,79.76,20.24,22,246,6,62,28,308,8.2,8.8,8.3,"50% - 75% P.O.C.","$51000 - $72000"
"42101011800","Census Tract 118, Philadelphia County, Pennsylvania",5618,41607,89,5202,0,65,0,174,1.6,92.6,0,1.2,0,3.1,98.4,2170,1727,443,79.59,20.41,77,1650,0,443,77,2093,4.5,0,3.5,"75% or more P.O.C.","Less than $51000"
"42101011900","Census Tract 119, Philadelphia County, Pennsylvania",5161,35091,124,4834,0,0,0,38,2.4,93.7,0,0,0,0.7,97.6,2127,1287,840,60.51,39.49,130,1157,13,827,143,1984,10.1,1.5,6.7,"75% or more P.O.C.","Less than $51000"
"42101012000","Census Tract 120, Philadelphia County, Pennsylvania",1890,58875,525,1099,0,162,0,81,27.8,58.1,0,8.6,0,4.3,72.2,657,322,335,49.01,50.99,13,309,0,335,13,644,4,0,2,"50% - 75% P.O.C.","$51000 - $72000"
"42101012100","Census Tract 121, Philadelphia County, Pennsylvania",3189,45087,610,2278,0,112,0,120,19.1,71.4,0,3.5,0,3.8,80.9,1422,468,954,32.91,67.09,7,461,0,954,7,1415,1.5,0,0.5,"75% or more P.O.C.","Less than $51000"
"42101012201","Census Tract 122.01, Philadelphia County, Pennsylvania",2776,27721,844,1263,110,376,0,96,30.4,45.5,4,13.5,0,3.5,69.6,1908,14,1894,0.73,99.27,0,14,16,1878,16,1892,0,0.8,0.8,"50% - 75% P.O.C.","Less than $51000"
"42101012203","Census Tract 122.03, Philadelphia County, Pennsylvania",633,51500,142,153,0,244,29,62,22.4,24.2,0,38.5,4.6,9.8,77.6,370,0,370,0,100,0,0,26,344,26,344,NA,7,7,"75% or more P.O.C.","$51000 - $72000"
"42101012204","Census Tract 122.04, Philadelphia County, Pennsylvania",4265,54868,666,3187,47,191,0,112,15.6,74.7,1.1,4.5,0,2.6,84.4,1949,1021,928,52.39,47.61,60,961,0,928,60,1889,5.9,0,3.1,"75% or more P.O.C.","$51000 - $72000"
"42101012500","Census Tract 125, Philadelphia County, Pennsylvania",5375,77086,3337,569,0,1159,0,182,62.1,10.6,0,21.6,0,3.4,37.9,3210,504,2706,15.7,84.3,0,504,0,2706,0,3210,0,0,0,"25% - 50% P.O.C.","$72000 - $96000"
"42101013100","Census Tract 131, Philadelphia County, Pennsylvania",1765,37946,396,1072,0,133,0,79,22.4,60.7,0,7.5,0,4.5,77.6,725,163,562,22.48,77.52,0,163,30,532,30,695,0,5.3,4.1,"75% or more P.O.C.","Less than $51000"
"42101013200","Census Tract 132, Philadelphia County, Pennsylvania",2778,26629,604,1613,46,205,0,274,21.7,58.1,1.7,7.4,0,9.9,78.3,1153,187,966,16.22,83.78,11,176,62,904,73,1080,5.9,6.4,6.3,"75% or more P.O.C.","Less than $51000"
"42101013300","Census Tract 133, Philadelphia County, Pennsylvania",3100,86140,1695,831,0,337,0,115,54.7,26.8,0,10.9,0,3.7,45.3,1612,396,1216,24.57,75.43,0,396,0,1216,0,1612,0,0,0,"25% - 50% P.O.C.","$72000 - $96000"
"42101013401","Census Tract 134.01, Philadelphia County, Pennsylvania",2504,87917,2217,150,0,106,0,0,88.5,6,0,4.2,0,0,11.5,1497,977,520,65.26,34.74,9,968,0,520,9,1488,0.9,0,0.6,"Less than 25% P.O.C.","$72000 - $96000"
"42101013402","Census Tract 134.02, Philadelphia County, Pennsylvania",3088,84875,2263,200,22,149,0,369,73.3,6.5,0.7,4.8,0,11.9,26.7,1715,495,1220,28.86,71.14,10,485,0,1220,10,1705,2,0,0.6,"25% - 50% P.O.C.","$72000 - $96000"
"42101013500","Census Tract 135, Philadelphia County, Pennsylvania",3987,89821,2534,1009,0,151,0,271,63.6,25.3,0,3.8,0,6.8,36.4,1508,869,639,57.63,42.37,23,846,75,564,98,1410,2.6,11.7,6.5,"25% - 50% P.O.C.","$72000 - $96000"
"42101013601","Census Tract 136.01, Philadelphia County, Pennsylvania",2832,105455,2294,104,0,288,0,76,81,3.7,0,10.2,0,2.7,19,1416,915,501,64.62,35.38,0,915,0,501,0,1416,0,0,0,"Less than 25% P.O.C.","$96000 or more"
"42101013602","Census Tract 136.02, Philadelphia County, Pennsylvania",3827,87134,2960,229,0,256,0,34,77.3,6,0,6.7,0,0.9,22.7,1780,921,859,51.74,48.26,16,905,21,838,37,1743,1.7,2.4,2.1,"Less than 25% P.O.C.","$72000 - $96000"
"42101013700","Census Tract 137, Philadelphia County, Pennsylvania",5155,55694,1418,3208,0,118,39,281,27.5,62.2,0,2.3,0.8,5.5,72.5,2304,1047,1257,45.44,54.56,52,995,54,1203,106,2198,5,4.3,4.6,"50% - 75% P.O.C.","$51000 - $72000"
"42101013800","Census Tract 138, Philadelphia County, Pennsylvania",1972,40536,284,1345,0,36,30,165,14.4,68.2,0,1.8,1.5,8.4,85.6,815,450,365,55.21,44.79,41,409,0,365,41,774,9.1,0,5,"75% or more P.O.C.","Less than $51000"
"42101013900","Census Tract 139, Philadelphia County, Pennsylvania",1757,26354,429,1097,0,9,0,135,24.4,62.4,0,0.5,0,7.7,75.6,808,196,612,24.26,75.74,2,194,0,612,2,806,1,0,0.2,"75% or more P.O.C.","Less than $51000"
"42101014000","Census Tract 140, Philadelphia County, Pennsylvania",3888,40975,880,2371,0,300,0,232,22.6,61,0,7.7,0,6,77.4,1497,412,1085,27.52,72.48,9,403,40,1045,49,1448,2.2,3.7,3.3,"75% or more P.O.C.","Less than $51000"
"42101014100","Census Tract 141, Philadelphia County, Pennsylvania",2659,27621,472,1769,13,195,0,144,17.8,66.5,0.5,7.3,0,5.4,82.2,1131,365,766,32.27,67.73,24,341,27,739,51,1080,6.6,3.5,4.5,"75% or more P.O.C.","Less than $51000"
"42101014200","Census Tract 142, Philadelphia County, Pennsylvania",5198,113143,3502,570,18,422,0,548,67.4,11,0.3,8.1,0,10.5,32.6,2399,953,1446,39.72,60.28,11,942,0,1446,11,2388,1.2,0,0.5,"25% - 50% P.O.C.","$96000 or more"
"42101014300","Census Tract 143, Philadelphia County, Pennsylvania",1935,90772,1613,70,0,119,0,104,83.4,3.6,0,6.1,0,5.4,16.6,855,464,391,54.27,45.73,6,458,0,391,6,849,1.3,0,0.7,"Less than 25% P.O.C.","$72000 - $96000"
"42101014400","Census Tract 144, Philadelphia County, Pennsylvania",4470,77284,2260,501,0,223,0,1377,50.6,11.2,0,5,0,30.8,49.4,1797,922,875,51.31,48.69,42,880,56,819,98,1699,4.6,6.4,5.5,"25% - 50% P.O.C.","$72000 - $96000"
"42101014500","Census Tract 145, Philadelphia County, Pennsylvania",1868,17991,72,1339,0,27,0,420,3.9,71.7,0,1.4,0,22.5,96.1,637,241,396,37.83,62.17,41,200,55,341,96,541,17,13.9,15.1,"75% or more P.O.C.","Less than $51000"
"42101014600","Census Tract 146, Philadelphia County, Pennsylvania",4305,33787,1333,1991,0,477,0,254,31,46.2,0,11.1,0,5.9,69,1037,426,611,41.08,58.92,6,420,82,529,88,949,1.4,13.4,8.5,"50% - 75% P.O.C.","Less than $51000"
"42101014700","Census Tract 147, Philadelphia County, Pennsylvania",2686,10793,877,1316,0,187,0,233,32.7,49,0,7,0,8.7,67.3,1049,81,968,7.72,92.28,17,64,7,961,24,1025,21,0.7,2.3,"50% - 75% P.O.C.","Less than $51000"
"42101014800","Census Tract 148, Philadelphia County, Pennsylvania",804,12500,15,662,0,102,0,10,1.9,82.3,0,12.7,0,1.2,98.1,396,79,317,19.95,80.05,8,71,0,317,8,388,10.1,0,2,"75% or more P.O.C.","Less than $51000"
"42101014900","Census Tract 149, Philadelphia County, Pennsylvania",3891,16955,218,3026,0,30,0,495,5.6,77.8,0,0.8,0,12.7,94.4,1521,564,957,37.08,62.92,99,465,71,886,170,1351,17.6,7.4,11.2,"75% or more P.O.C.","Less than $51000"
"42101015101","Census Tract 151.01, Philadelphia County, Pennsylvania",2279,29350,100,1973,0,8,0,176,4.4,86.6,0,0.4,0,7.7,95.6,787,253,534,32.15,67.85,26,227,41,493,67,720,10.3,7.7,8.5,"75% or more P.O.C.","Less than $51000"
"42101015102","Census Tract 151.02, Philadelphia County, Pennsylvania",4242,17467,3,3916,4,80,0,180,0.1,92.3,0.1,1.9,0,4.2,99.9,1744,577,1167,33.08,66.92,13,564,136,1031,149,1595,2.3,11.7,8.5,"75% or more P.O.C.","Less than $51000"
"42101015200","Census Tract 152, Philadelphia County, Pennsylvania",5347,25156,148,4840,14,90,0,255,2.8,90.5,0.3,1.7,0,4.8,97.2,1854,691,1163,37.27,62.73,24,667,193,970,217,1637,3.5,16.6,11.7,"75% or more P.O.C.","Less than $51000"
"42101015300","Census Tract 153, Philadelphia County, Pennsylvania",4086,17202,1939,1367,59,436,0,231,47.5,33.5,1.4,10.7,0,5.7,52.5,1190,213,977,17.9,82.1,44,169,41,936,85,1105,20.7,4.2,7.1,"50% - 75% P.O.C.","Less than $51000"
"42101015600","Census Tract 156, Philadelphia County, Pennsylvania",1596,28472,217,248,0,50,0,1070,13.6,15.5,0,3.1,0,67,86.4,547,252,295,46.07,53.93,48,204,22,273,70,477,19,7.5,12.8,"75% or more P.O.C.","Less than $51000"
"42101015700","Census Tract 157, Philadelphia County, Pennsylvania",2587,46667,1265,279,0,39,0,885,48.9,10.8,0,1.5,0,34.2,51.1,950,586,364,61.68,38.32,97,489,21,343,118,832,16.6,5.8,12.4,"50% - 75% P.O.C.","Less than $51000"
"42101015800","Census Tract 158, Philadelphia County, Pennsylvania",6969,77198,6196,157,0,214,0,319,88.9,2.3,0,3.1,0,4.6,11.1,3022,2018,1004,66.78,33.22,172,1846,20,984,192,2830,8.5,2,6.4,"Less than 25% P.O.C.","$72000 - $96000"
"42101016000","Census Tract 160, Philadelphia County, Pennsylvania",6996,70739,6008,249,0,167,0,509,85.9,3.6,0,2.4,0,7.3,14.1,2929,2070,859,70.67,29.33,208,1862,0,859,208,2721,10,0,7.1,"Less than 25% P.O.C.","$51000 - $72000"
"42101016100","Census Tract 161, Philadelphia County, Pennsylvania",6203,79932,3524,156,0,743,0,1484,56.8,2.5,0,12,0,23.9,43.2,2219,1302,917,58.68,41.32,153,1149,61,856,214,2005,11.8,6.7,9.6,"25% - 50% P.O.C.","$72000 - $96000"
"42101016200","Census Tract 162, Philadelphia County, Pennsylvania",2098,27198,144,328,0,160,0,1462,6.9,15.6,0,7.6,0,69.7,93.1,787,356,431,45.24,54.76,48,308,72,359,120,667,13.5,16.7,15.2,"75% or more P.O.C.","Less than $51000"
"42101016300","Census Tract 163, Philadelphia County, Pennsylvania",3005,18158,242,351,0,170,0,2241,8.1,11.7,0,5.7,0,74.6,91.9,1012,376,636,37.15,62.85,70,306,98,538,168,844,18.6,15.4,16.6,"75% or more P.O.C.","Less than $51000"
"42101016400","Census Tract 164, Philadelphia County, Pennsylvania",4633,18067,137,1436,54,0,0,2697,3,31,1.2,0,0,58.2,97,1597,539,1058,33.75,66.25,118,421,81,977,199,1398,21.9,7.7,12.5,"75% or more P.O.C.","Less than $51000"
"42101016500","Census Tract 165, Philadelphia County, Pennsylvania",3180,13235,11,2773,5,49,0,337,0.3,87.2,0.2,1.5,0,10.6,99.7,1020,176,844,17.25,82.75,0,176,150,694,150,870,0,17.8,14.7,"75% or more P.O.C.","Less than $51000"
"42101016600","Census Tract 166, Philadelphia County, Pennsylvania",2241,31458,250,1678,0,30,0,218,11.2,74.9,0,1.3,0,9.7,88.8,745,151,594,20.27,79.73,32,119,38,556,70,675,21.2,6.4,9.4,"75% or more P.O.C.","Less than $51000"
"42101016701","Census Tract 167.01, Philadelphia County, Pennsylvania",2809,32561,45,2616,0,0,0,52,1.6,93.1,0,0,0,1.9,98.4,1155,609,546,52.73,47.27,32,577,70,476,102,1053,5.3,12.8,8.8,"75% or more P.O.C.","Less than $51000"
"42101016702","Census Tract 167.02, Philadelphia County, Pennsylvania",2704,21131,201,2415,0,8,0,80,7.4,89.3,0,0.3,0,3,92.6,1099,428,671,38.94,61.06,25,403,71,600,96,1003,5.8,10.6,8.7,"75% or more P.O.C.","Less than $51000"
"42101016800","Census Tract 168, Philadelphia County, Pennsylvania",2965,12547,34,2856,0,0,0,13,1.1,96.3,0,0,0,0.4,98.9,1533,812,721,52.97,47.03,10,802,0,721,10,1523,1.2,0,0.7,"75% or more P.O.C.","Less than $51000"
"42101016901","Census Tract 169.01, Philadelphia County, Pennsylvania",3092,30426,9,3045,0,0,0,38,0.3,98.5,0,0,0,1.2,99.7,1246,680,566,54.57,45.43,32,648,44,522,76,1170,4.7,7.8,6.1,"75% or more P.O.C.","Less than $51000"
"42101016902","Census Tract 169.02, Philadelphia County, Pennsylvania",4412,19678,32,4320,0,0,0,39,0.7,97.9,0,0,0,0.9,99.3,2042,828,1214,40.55,59.45,0,828,73,1141,73,1969,0,6,3.6,"75% or more P.O.C.","Less than $51000"
"42101017000","Census Tract 170, Philadelphia County, Pennsylvania",2884,46269,655,1966,15,48,0,110,22.7,68.2,0.5,1.7,0,3.8,77.3,1270,289,981,22.76,77.24,0,289,0,981,0,1270,0,0,0,"75% or more P.O.C.","Less than $51000"
"42101017100","Census Tract 171, Philadelphia County, Pennsylvania",3565,26710,42,3142,0,0,0,250,1.2,88.1,0,0,0,7,98.8,1483,998,485,67.3,32.7,46,952,0,485,46,1437,4.6,0,3.1,"75% or more P.O.C.","Less than $51000"
"42101017201","Census Tract 172.01, Philadelphia County, Pennsylvania",2835,31987,61,2146,0,202,0,66,2.2,75.7,0,7.1,0,2.3,97.8,1294,625,669,48.3,51.7,50,575,0,669,50,1244,8,0,3.9,"75% or more P.O.C.","Less than $51000"
"42101017202","Census Tract 172.02, Philadelphia County, Pennsylvania",3842,22934,9,3687,31,115,0,0,0.2,96,0.8,3,0,0,99.8,1679,1125,554,67,33,0,1125,55,499,55,1624,0,9.9,3.3,"75% or more P.O.C.","Less than $51000"
"42101017300","Census Tract 173, Philadelphia County, Pennsylvania",2538,16607,124,2231,19,1,0,139,4.9,87.9,0.7,0,0,5.5,95.1,1227,511,716,41.65,58.35,21,490,0,716,21,1206,4.1,0,1.7,"75% or more P.O.C.","Less than $51000"
"42101017400","Census Tract 174, Philadelphia County, Pennsylvania",2392,28642,48,1858,0,13,0,355,2,77.7,0,0.5,0,14.8,98,893,420,473,47.03,52.97,17,403,0,473,17,876,4,0,1.9,"75% or more P.O.C.","Less than $51000"
"42101017500","Census Tract 175, Philadelphia County, Pennsylvania",6943,17910,124,1233,0,71,0,5398,1.8,17.8,0,1,0,77.7,98.2,2394,1138,1256,47.54,52.46,52,1086,265,991,317,2077,4.6,21.1,13.2,"75% or more P.O.C.","Less than $51000"
"42101017601","Census Tract 176.01, Philadelphia County, Pennsylvania",4972,16361,140,342,16,4,0,4418,2.8,6.9,0.3,0.1,0,88.9,97.2,1840,1074,766,58.37,41.63,69,1005,88,678,157,1683,6.4,11.5,8.5,"75% or more P.O.C.","Less than $51000"
"42101017602","Census Tract 176.02, Philadelphia County, Pennsylvania",4603,23630,195,536,0,26,0,3846,4.2,11.6,0,0.6,0,83.6,95.8,1349,549,800,40.7,59.3,35,514,96,704,131,1218,6.4,12,9.7,"75% or more P.O.C.","Less than $51000"
"42101017701","Census Tract 177.01, Philadelphia County, Pennsylvania",3203,20266,355,979,20,10,0,1789,11.1,30.6,0.6,0.3,0,55.9,88.9,1117,325,792,29.1,70.9,34,291,56,736,90,1027,10.5,7.1,8.1,"75% or more P.O.C.","Less than $51000"
"42101017702","Census Tract 177.02, Philadelphia County, Pennsylvania",5188,23336,231,873,0,0,0,4072,4.5,16.8,0,0,0,78.5,95.5,1499,726,773,48.43,51.57,88,638,155,618,243,1256,12.1,20.1,16.2,"75% or more P.O.C.","Less than $51000"
"42101017800","Census Tract 178, Philadelphia County, Pennsylvania",5862,26052,1526,1490,7,42,0,2616,26,25.4,0.1,0.7,0,44.6,74,1988,871,1117,43.81,56.19,79,792,200,917,279,1709,9.1,17.9,14,"50% - 75% P.O.C.","Less than $51000"
"42101017900","Census Tract 179, Philadelphia County, Pennsylvania",6279,35787,1517,1145,0,22,0,3556,24.2,18.2,0,0.4,0,56.6,75.8,2149,887,1262,41.28,58.72,14,873,211,1051,225,1924,1.6,16.7,10.5,"75% or more P.O.C.","Less than $51000"
"42101018001","Census Tract 180.01, Philadelphia County, Pennsylvania",3253,61917,2629,51,0,0,0,383,80.8,1.6,0,0,0,11.8,19.2,1168,749,419,64.13,35.87,44,705,95,324,139,1029,5.9,22.7,11.9,"Less than 25% P.O.C.","$51000 - $72000"
"42101018002","Census Tract 180.02, Philadelphia County, Pennsylvania",6038,44201,5084,1,0,267,0,515,84.2,0,0,4.4,0,8.5,15.8,2339,1698,641,72.6,27.4,243,1455,26,615,269,2070,14.3,4.1,11.5,"Less than 25% P.O.C.","Less than $51000"
"42101018300","Census Tract 183, Philadelphia County, Pennsylvania",4005,69188,3884,3,0,0,0,77,97,0.1,0,0,0,1.9,3,1539,1344,195,87.33,12.67,130,1214,12,183,142,1397,9.7,6.2,9.2,"Less than 25% P.O.C.","$51000 - $72000"
"42101018400","Census Tract 184, Philadelphia County, Pennsylvania",2242,54474,2079,1,5,21,0,130,92.7,0,0.2,0.9,0,5.8,7.3,840,698,142,83.1,16.9,94,604,0,142,94,746,13.5,0,11.2,"Less than 25% P.O.C.","$51000 - $72000"
"42101018800","Census Tract 188, Philadelphia County, Pennsylvania",8705,26008,1373,1988,0,184,0,5131,15.8,22.8,0,2.1,0,58.9,84.2,2382,1139,1243,47.82,52.18,165,974,348,895,513,1869,14.5,28,21.5,"75% or more P.O.C.","Less than $51000"
"42101019000","Census Tract 190, Philadelphia County, Pennsylvania",7750,33685,1032,1091,0,219,0,5365,13.3,14.1,0,2.8,0,69.2,86.7,2619,1425,1194,54.41,45.59,268,1157,104,1090,372,2247,18.8,8.7,14.2,"75% or more P.O.C.","Less than $51000"
"42101019100","Census Tract 191, Philadelphia County, Pennsylvania",8194,41224,1095,843,0,1071,0,5185,13.4,10.3,0,13.1,0,63.3,86.6,2749,1977,772,71.92,28.08,329,1648,228,544,557,2192,16.6,29.5,20.3,"75% or more P.O.C.","Less than $51000"
"42101019200","Census Tract 192, Philadelphia County, Pennsylvania",8721,28783,1202,1488,0,350,0,5681,13.8,17.1,0,4,0,65.1,86.2,2345,1215,1130,51.81,48.19,274,941,276,854,550,1795,22.6,24.4,23.5,"75% or more P.O.C.","Less than $51000"
"42101019501","Census Tract 195.01, Philadelphia County, Pennsylvania",4432,17825,342,186,1,0,0,3903,7.7,4.2,0,0,0,88.1,92.3,1703,839,864,49.27,50.73,5,834,77,787,82,1621,0.6,8.9,4.8,"75% or more P.O.C.","Less than $51000"
"42101019502","Census Tract 195.02, Philadelphia County, Pennsylvania",3732,20372,408,174,0,0,0,3004,10.9,4.7,0,0,0,80.5,89.1,1162,651,511,56.02,43.98,53,598,164,347,217,945,8.1,32.1,18.7,"75% or more P.O.C.","Less than $51000"
"42101019700","Census Tract 197, Philadelphia County, Pennsylvania",7064,32621,225,2694,0,0,0,4145,3.2,38.1,0,0,0,58.7,96.8,2252,1139,1113,50.58,49.42,131,1008,175,938,306,1946,11.5,15.7,13.6,"75% or more P.O.C.","Less than $51000"
"42101019800","Census Tract 198, Philadelphia County, Pennsylvania",6878,28319,201,1985,0,367,0,4220,2.9,28.9,0,5.3,0,61.4,97.1,1934,1108,826,57.29,42.71,77,1031,208,618,285,1649,6.9,25.2,14.7,"75% or more P.O.C.","Less than $51000"
"42101019900","Census Tract 199, Philadelphia County, Pennsylvania",4498,20577,142,1447,0,0,0,2890,3.2,32.2,0,0,0,64.3,96.8,1472,554,918,37.64,62.36,37,517,158,760,195,1277,6.7,17.2,13.2,"75% or more P.O.C.","Less than $51000"
"42101020000","Census Tract 200, Philadelphia County, Pennsylvania",1320,21792,64,962,0,18,0,259,4.8,72.9,0,1.4,0,19.6,95.2,548,177,371,32.3,67.7,1,176,0,371,1,547,0.6,0,0.2,"75% or more P.O.C.","Less than $51000"
"42101020101","Census Tract 201.01, Philadelphia County, Pennsylvania",3552,14164,157,3047,0,73,0,203,4.4,85.8,0,2.1,0,5.7,95.6,1517,421,1096,27.75,72.25,71,350,37,1059,108,1409,16.9,3.4,7.1,"75% or more P.O.C.","Less than $51000"
"42101020102","Census Tract 201.02, Philadelphia County, Pennsylvania",3415,36729,21,3228,13,0,8,145,0.6,94.5,0.4,0,0.2,4.2,99.4,1431,846,585,59.12,40.88,10,836,32,553,42,1389,1.2,5.5,2.9,"75% or more P.O.C.","Less than $51000"
"42101020200","Census Tract 202, Philadelphia County, Pennsylvania",4804,20067,211,4105,0,8,0,287,4.4,85.4,0,0.2,0,6,95.6,2108,1085,1023,51.47,48.53,61,1024,0,1023,61,2047,5.6,0,2.9,"75% or more P.O.C.","Less than $51000"
"42101020300","Census Tract 203, Philadelphia County, Pennsylvania",2842,23244,62,2295,0,10,0,400,2.2,80.8,0,0.4,0,14.1,97.8,1051,487,564,46.34,53.66,33,454,57,507,90,961,6.8,10.1,8.6,"75% or more P.O.C.","Less than $51000"
"42101020400","Census Tract 204, Philadelphia County, Pennsylvania",2744,26589,45,2534,0,0,0,89,1.6,92.3,0,0,0,3.2,98.4,1113,605,508,54.36,45.64,34,571,10,498,44,1069,5.6,2,4,"75% or more P.O.C.","Less than $51000"
"42101020500","Census Tract 205, Philadelphia County, Pennsylvania",2578,13456,78,2303,0,124,0,61,3,89.3,0,4.8,0,2.4,97,1380,653,727,47.32,52.68,13,640,35,692,48,1332,2,4.8,3.5,"75% or more P.O.C.","Less than $51000"
"42101020600","Census Tract 206, Philadelphia County, Pennsylvania",1695,52167,1041,323,0,116,0,171,61.4,19.1,0,6.8,0,10.1,38.6,754,216,538,28.65,71.35,30,186,17,521,47,707,13.9,3.2,6.2,"25% - 50% P.O.C.","$51000 - $72000"
"42101020700","Census Tract 207, Philadelphia County, Pennsylvania",5942,100813,4516,563,0,358,0,193,76,9.5,0,6,0,3.2,24,2497,1392,1105,55.75,44.25,19,1373,14,1091,33,2464,1.4,1.3,1.3,"Less than 25% P.O.C.","$96000 or more"
"42101020800","Census Tract 208, Philadelphia County, Pennsylvania",2289,60938,1081,783,0,290,0,88,47.2,34.2,0,12.7,0,3.8,52.8,1156,336,820,29.07,70.93,0,336,0,820,0,1156,0,0,0,"50% - 75% P.O.C.","$51000 - $72000"
"42101020900","Census Tract 209, Philadelphia County, Pennsylvania",3085,74554,2471,348,37,64,0,145,80.1,11.3,1.2,2.1,0,4.7,19.9,1387,667,720,48.09,51.91,13,654,20,700,33,1354,1.9,2.8,2.4,"Less than 25% P.O.C.","$72000 - $96000"
"42101021000","Census Tract 210, Philadelphia County, Pennsylvania",5342,70765,4343,549,27,105,0,236,81.3,10.3,0.5,2,0,4.4,18.7,2358,1213,1145,51.44,48.56,12,1201,23,1122,35,2323,1,2,1.5,"Less than 25% P.O.C.","$51000 - $72000"
"42101021100","Census Tract 211, Philadelphia County, Pennsylvania",2481,75871,2084,195,0,57,0,94,84,7.9,0,2.3,0,3.8,16,1129,669,460,59.26,40.74,40,629,0,460,40,1089,6,0,3.5,"Less than 25% P.O.C.","$72000 - $96000"
"42101021200","Census Tract 212, Philadelphia County, Pennsylvania",2419,66179,1701,463,0,62,0,184,70.3,19.1,0,2.6,0,7.6,29.7,1071,594,477,55.46,44.54,35,559,7,470,42,1029,5.9,1.5,3.9,"25% - 50% P.O.C.","$51000 - $72000"
"42101021300","Census Tract 213, Philadelphia County, Pennsylvania",3485,75174,2824,263,0,75,0,198,81,7.5,0,2.2,0,5.7,19,1443,777,666,53.85,46.15,9,768,51,615,60,1383,1.2,7.7,4.2,"Less than 25% P.O.C.","$72000 - $96000"
"42101021400","Census Tract 214, Philadelphia County, Pennsylvania",3980,77257,3161,413,0,43,0,207,79.4,10.4,0,1.1,0,5.2,20.6,1623,721,902,44.42,55.58,38,683,35,867,73,1550,5.3,3.9,4.5,"Less than 25% P.O.C.","$72000 - $96000"
"42101021500","Census Tract 215, Philadelphia County, Pennsylvania",3879,70094,3075,418,0,125,0,112,79.3,10.8,0,3.2,0,2.9,20.7,1767,1031,736,58.35,41.65,19,1012,52,684,71,1696,1.8,7.1,4,"Less than 25% P.O.C.","$51000 - $72000"
"42101021600","Census Tract 216, Philadelphia County, Pennsylvania",2372,77214,1632,420,0,125,0,82,68.8,17.7,0,5.3,0,3.5,31.2,1072,403,669,37.59,62.41,37,366,0,669,37,1035,9.2,0,3.5,"25% - 50% P.O.C.","$72000 - $96000"
"42101021700","Census Tract 217, Philadelphia County, Pennsylvania",5727,88304,4302,661,0,193,0,200,75.1,11.5,0,3.4,0,3.5,24.9,2516,2083,433,82.79,17.21,99,1984,0,433,99,2417,4.8,0,3.9,"Less than 25% P.O.C.","$72000 - $96000"
"42101021800","Census Tract 218, Philadelphia County, Pennsylvania",5141,56206,2822,1497,0,247,0,178,54.9,29.1,0,4.8,0,3.5,45.1,2242,597,1645,26.63,73.37,52,545,0,1645,52,2190,8.7,0,2.3,"25% - 50% P.O.C.","$51000 - $72000"
"42101021900","Census Tract 219, Philadelphia County, Pennsylvania",1434,63214,1307,50,0,24,0,41,91.1,3.5,0,1.7,0,2.9,8.9,654,551,103,84.25,15.75,34,517,0,103,34,620,6.2,0,5.2,"Less than 25% P.O.C.","$51000 - $72000"
"42101022000","Census Tract 220, Philadelphia County, Pennsylvania",1534,107500,1301,131,0,42,0,60,84.8,8.5,0,2.7,0,3.9,15.2,706,518,188,73.37,26.63,17,501,0,188,17,689,3.3,0,2.4,"Less than 25% P.O.C.","$96000 or more"
"42101023100","Census Tract 231, Philadelphia County, Pennsylvania",1275,125455,1154,11,0,9,0,62,90.5,0.9,0,0.7,0,4.9,9.5,518,294,224,56.76,43.24,24,270,0,224,24,494,8.2,0,4.6,"Less than 25% P.O.C.","$96000 or more"
"42101023500","Census Tract 235, Philadelphia County, Pennsylvania",1300,68438,864,361,0,21,0,2,66.5,27.8,0,1.6,0,0.2,33.5,539,399,140,74.03,25.97,31,368,0,140,31,508,7.8,0,5.8,"25% - 50% P.O.C.","$51000 - $72000"
"42101023600","Census Tract 236, Philadelphia County, Pennsylvania",2391,88472,1408,782,0,35,0,49,58.9,32.7,0,1.5,0,2,41.1,1033,578,455,55.95,44.05,18,560,37,418,55,978,3.1,8.1,5.3,"25% - 50% P.O.C.","$72000 - $96000"
"42101023700","Census Tract 237, Philadelphia County, Pennsylvania",4463,61695,1256,2597,0,67,0,186,28.1,58.2,0,1.5,0,4.2,71.9,2050,979,1071,47.76,52.24,99,880,0,1071,99,1951,10.1,0,4.8,"50% - 75% P.O.C.","$51000 - $72000"
"42101023800","Census Tract 238, Philadelphia County, Pennsylvania",4633,78421,1201,2858,0,39,0,265,25.9,61.7,0,0.8,0,5.7,74.1,2076,880,1196,42.39,57.61,52,828,0,1196,52,2024,5.9,0,2.5,"50% - 75% P.O.C.","$72000 - $96000"
"42101023900","Census Tract 239, Philadelphia County, Pennsylvania",1634,26213,438,845,0,209,0,109,26.8,51.7,0,12.8,0,6.7,73.2,1143,180,963,15.75,84.25,0,180,0,963,0,1143,0,0,0,"50% - 75% P.O.C.","Less than $51000"
"42101024000","Census Tract 240, Philadelphia County, Pennsylvania",3659,47852,1262,1998,0,117,0,196,34.5,54.6,0,3.2,0,5.4,65.5,1700,671,1029,39.47,60.53,45,626,19,1010,64,1636,6.7,1.8,3.8,"50% - 75% P.O.C.","Less than $51000"
"42101024100","Census Tract 241, Philadelphia County, Pennsylvania",1445,12863,285,1033,0,9,0,52,19.7,71.5,0,0.6,0,3.6,80.3,674,138,536,20.47,79.53,8,130,0,536,8,666,5.8,0,1.2,"75% or more P.O.C.","Less than $51000"
"42101024200","Census Tract 242, Philadelphia County, Pennsylvania",3807,25833,463,3138,0,51,0,108,12.2,82.4,0,1.3,0,2.8,87.8,1754,698,1056,39.79,60.21,64,634,26,1030,90,1664,9.2,2.5,5.1,"75% or more P.O.C.","Less than $51000"
"42101024300","Census Tract 243, Philadelphia County, Pennsylvania",3895,36364,509,3141,22,76,0,32,13.1,80.6,0.6,2,0,0.8,86.9,1584,810,774,51.14,48.86,61,749,34,740,95,1489,7.5,4.4,6,"75% or more P.O.C.","Less than $51000"
"42101024400","Census Tract 244, Philadelphia County, Pennsylvania",3230,30250,340,2458,59,0,0,373,10.5,76.1,1.8,0,0,11.5,89.5,1011,460,551,45.5,54.5,68,392,82,469,150,861,14.8,14.9,14.8,"75% or more P.O.C.","Less than $51000"
"42101024500","Census Tract 245, Philadelphia County, Pennsylvania",3823,16478,318,3441,0,28,0,24,8.3,90,0,0.7,0,0.6,91.7,1605,611,994,38.07,61.93,49,562,42,952,91,1514,8,4.2,5.7,"75% or more P.O.C.","Less than $51000"
"42101024600","Census Tract 246, Philadelphia County, Pennsylvania",2684,14394,250,2231,0,33,0,82,9.3,83.1,0,1.2,0,3.1,90.7,1099,380,719,34.58,65.42,28,352,38,681,66,1033,7.4,5.3,6,"75% or more P.O.C.","Less than $51000"
"42101024700","Census Tract 247, Philadelphia County, Pennsylvania",4293,30755,212,3889,9,14,0,78,4.9,90.6,0.2,0.3,0,1.8,95.1,1631,882,749,54.08,45.92,113,769,36,713,149,1482,12.8,4.8,9.1,"75% or more P.O.C.","Less than $51000"
"42101024800","Census Tract 248, Philadelphia County, Pennsylvania",2232,47056,57,1993,0,0,13,67,2.6,89.3,0,0,0.6,3,97.4,719,550,169,76.5,23.5,63,487,39,130,102,617,11.5,23.1,14.2,"75% or more P.O.C.","Less than $51000"
"42101024900","Census Tract 249, Philadelphia County, Pennsylvania",2737,22971,38,2654,2,0,0,5,1.4,97,0.1,0,0,0.2,98.6,1209,851,358,70.39,29.61,59,792,0,358,59,1150,6.9,0,4.9,"75% or more P.O.C.","Less than $51000"
"42101025200","Census Tract 252, Philadelphia County, Pennsylvania",7793,40061,446,6798,90,63,0,334,5.7,87.2,1.2,0.8,0,4.3,94.3,2706,1261,1445,46.6,53.4,57,1204,197,1248,254,2452,4.5,13.6,9.4,"75% or more P.O.C.","Less than $51000"
"42101025300","Census Tract 253, Philadelphia County, Pennsylvania",4636,41545,532,3901,0,129,0,2,11.5,84.1,0,2.8,0,0,88.5,1688,1038,650,61.49,38.51,44,994,108,542,152,1536,4.2,16.6,9,"75% or more P.O.C.","Less than $51000"
"42101025400","Census Tract 254, Philadelphia County, Pennsylvania",4222,56042,446,3343,0,34,0,113,10.6,79.2,0,0.8,0,2.7,89.4,1899,1381,518,72.72,27.28,109,1272,0,518,109,1790,7.9,0,5.7,"75% or more P.O.C.","$51000 - $72000"
"42101025500","Census Tract 255, Philadelphia County, Pennsylvania",2764,66190,1061,1334,0,94,0,76,38.4,48.3,0,3.4,0,2.7,61.6,1164,791,373,67.96,32.04,62,729,12,361,74,1090,7.8,3.2,6.4,"50% - 75% P.O.C.","$51000 - $72000"
"42101025600","Census Tract 256, Philadelphia County, Pennsylvania",2795,84659,1429,1024,0,27,0,90,51.1,36.6,0,1,0,3.2,48.9,1164,809,355,69.5,30.5,52,757,0,355,52,1112,6.4,0,4.5,"25% - 50% P.O.C.","$72000 - $96000"
"42101025700","Census Tract 257, Philadelphia County, Pennsylvania",3874,66676,1788,1379,0,252,0,350,46.2,35.6,0,6.5,0,9,53.8,1960,409,1551,20.87,79.13,7,402,60,1491,67,1893,1.7,3.9,3.4,"50% - 75% P.O.C.","$51000 - $72000"
"42101025800","Census Tract 258, Philadelphia County, Pennsylvania",1778,57545,102,1632,0,25,0,0,5.7,91.8,0,1.4,0,0,94.3,733,559,174,76.26,23.74,29,530,21,153,50,683,5.2,12.1,6.8,"75% or more P.O.C.","$51000 - $72000"
"42101025900","Census Tract 259, Philadelphia County, Pennsylvania",4409,46548,63,4192,0,12,0,23,1.4,95.1,0,0.3,0,0.5,98.6,2084,1382,702,66.31,33.69,58,1324,0,702,58,2026,4.2,0,2.8,"75% or more P.O.C.","Less than $51000"
"42101026000","Census Tract 260, Philadelphia County, Pennsylvania",3055,52706,93,2717,16,10,0,76,3,88.9,0.5,0.3,0,2.5,97,1245,834,411,66.99,33.01,34,800,9,402,43,1202,4.1,2.2,3.5,"75% or more P.O.C.","$51000 - $72000"
"42101026100","Census Tract 261, Philadelphia County, Pennsylvania",3192,35708,103,3045,0,0,4,30,3.2,95.4,0,0,0.1,0.9,96.8,1378,944,434,68.51,31.49,86,858,32,402,118,1260,9.1,7.4,8.6,"75% or more P.O.C.","Less than $51000"
"42101026200","Census Tract 262, Philadelphia County, Pennsylvania",3791,49918,132,3577,8,7,0,67,3.5,94.4,0.2,0.2,0,1.8,96.5,1690,1359,331,80.41,19.59,69,1290,0,331,69,1621,5.1,0,4.1,"75% or more P.O.C.","Less than $51000"
"42101026301","Census Tract 263.01, Philadelphia County, Pennsylvania",3488,38510,49,3297,0,1,0,59,1.4,94.5,0,0,0,1.7,98.6,1499,1168,331,77.92,22.08,83,1085,9,322,92,1407,7.1,2.7,6.1,"75% or more P.O.C.","Less than $51000"
"42101026302","Census Tract 263.02, Philadelphia County, Pennsylvania",4927,46166,130,4704,0,50,0,43,2.6,95.5,0,1,0,0.9,97.4,1997,1675,322,83.88,16.12,79,1596,0,322,79,1918,4.7,0,4,"75% or more P.O.C.","Less than $51000"
"42101026400","Census Tract 264, Philadelphia County, Pennsylvania",5660,52895,36,5576,0,0,0,26,0.6,98.5,0,0,0,0.5,99.4,2166,1798,368,83.01,16.99,39,1759,67,301,106,2060,2.2,18.2,4.9,"75% or more P.O.C.","$51000 - $72000"
"42101026500","Census Tract 265, Philadelphia County, Pennsylvania",5065,47708,86,4721,0,0,0,78,1.7,93.2,0,0,0,1.5,98.3,1674,1105,569,66.01,33.99,201,904,76,493,277,1397,18.2,13.4,16.5,"75% or more P.O.C.","Less than $51000"
"42101026600","Census Tract 266, Philadelphia County, Pennsylvania",6528,46859,14,6129,0,0,0,164,0.2,93.9,0,0,0,2.5,99.8,2237,1770,467,79.12,20.88,106,1664,48,419,154,2083,6,10.3,6.9,"75% or more P.O.C.","Less than $51000"
"42101026700","Census Tract 267, Philadelphia County, Pennsylvania",6987,37871,27,6696,0,0,0,46,0.4,95.8,0,0,0,0.7,99.6,2573,1636,937,63.58,36.42,60,1576,29,908,89,2484,3.7,3.1,3.5,"75% or more P.O.C.","Less than $51000"
"42101026800","Census Tract 268, Philadelphia County, Pennsylvania",4189,39057,301,2968,0,133,0,466,7.2,70.9,0,3.2,0,11.1,92.8,1864,622,1242,33.37,66.63,12,610,12,1230,24,1840,1.9,1,1.3,"75% or more P.O.C.","Less than $51000"
"42101026900","Census Tract 269, Philadelphia County, Pennsylvania",2147,59844,379,1398,0,7,0,247,17.7,65.1,0,0.3,0,11.5,82.3,680,363,317,53.38,46.62,52,311,23,294,75,605,14.3,7.3,11,"75% or more P.O.C.","$51000 - $72000"
"42101027000","Census Tract 270, Philadelphia County, Pennsylvania",2635,58875,273,2089,0,174,4,17,10.4,79.3,0,6.6,0.2,0.6,89.6,955,552,403,57.8,42.2,68,484,13,390,81,874,12.3,3.2,8.5,"75% or more P.O.C.","$51000 - $72000"
"42101027100","Census Tract 271, Philadelphia County, Pennsylvania",2806,51500,155,1741,0,571,0,258,5.5,62,0,20.3,0,9.2,94.5,910,680,230,74.73,25.27,70,610,42,188,112,798,10.3,18.3,12.3,"75% or more P.O.C.","$51000 - $72000"
"42101027200","Census Tract 272, Philadelphia County, Pennsylvania",4647,48250,307,3519,0,300,0,392,6.6,75.7,0,6.5,0,8.4,93.4,1763,1046,717,59.33,40.67,160,886,0,717,160,1603,15.3,0,9.1,"75% or more P.O.C.","Less than $51000"
"42101027300","Census Tract 273, Philadelphia County, Pennsylvania",6019,47551,332,4021,27,1061,0,295,5.5,66.8,0.4,17.6,0,4.9,94.5,2047,1525,522,74.5,25.5,160,1365,72,450,232,1815,10.5,13.8,11.3,"75% or more P.O.C.","Less than $51000"
"42101027401","Census Tract 274.01, Philadelphia County, Pennsylvania",2975,40738,137,1675,0,617,0,519,4.6,56.3,0,20.7,0,17.4,95.4,1089,689,400,63.27,36.73,49,640,46,354,95,994,7.1,11.5,8.7,"75% or more P.O.C.","Less than $51000"
"42101027402","Census Tract 274.02, Philadelphia County, Pennsylvania",6825,37960,313,3758,0,329,0,2346,4.6,55.1,0,4.8,0,34.4,95.4,2366,1703,663,71.98,28.02,114,1589,128,535,242,2124,6.7,19.3,10.2,"75% or more P.O.C.","Less than $51000"
"42101027500","Census Tract 275, Philadelphia County, Pennsylvania",5133,45714,202,3740,0,396,0,773,3.9,72.9,0,7.7,0,15.1,96.1,1678,1157,521,68.95,31.05,102,1055,123,398,225,1453,8.8,23.6,13.4,"75% or more P.O.C.","Less than $51000"
"42101027600","Census Tract 276, Philadelphia County, Pennsylvania",4163,38337,31,3926,0,7,0,105,0.7,94.3,0,0.2,0,2.5,99.3,1601,759,842,47.41,52.59,28,731,108,734,136,1465,3.7,12.8,8.5,"75% or more P.O.C.","Less than $51000"
"42101027700","Census Tract 277, Philadelphia County, Pennsylvania",4960,29650,76,4364,0,147,0,24,1.5,88,0,3,0,0.5,98.5,1956,1217,739,62.22,37.78,122,1095,42,697,164,1792,10,5.7,8.4,"75% or more P.O.C.","Less than $51000"
"42101027800","Census Tract 278, Philadelphia County, Pennsylvania",4564,31273,92,4300,0,38,0,94,2,94.2,0,0.8,0,2.1,98,1791,956,835,53.38,46.62,160,796,60,775,220,1571,16.7,7.2,12.3,"75% or more P.O.C.","Less than $51000"
"42101027901","Census Tract 279.01, Philadelphia County, Pennsylvania",4201,43182,55,3867,0,21,0,60,1.3,92,0,0.5,0,1.4,98.7,1434,867,567,60.46,39.54,24,843,81,486,105,1329,2.8,14.3,7.3,"75% or more P.O.C.","Less than $51000"
"42101027902","Census Tract 279.02, Philadelphia County, Pennsylvania",4075,29783,1470,2136,0,192,0,149,36.1,52.4,0,4.7,0,3.7,63.9,908,367,541,40.42,59.58,28,339,28,513,56,852,7.6,5.2,6.2,"50% - 75% P.O.C.","Less than $51000"
"42101028000","Census Tract 280, Philadelphia County, Pennsylvania",4111,32328,48,3918,0,74,0,36,1.2,95.3,0,1.8,0,0.9,98.8,1650,1043,607,63.21,36.79,55,988,29,578,84,1566,5.3,4.8,5.1,"75% or more P.O.C.","Less than $51000"
"42101028100","Census Tract 281, Philadelphia County, Pennsylvania",4498,35591,85,3864,0,39,0,418,1.9,85.9,0,0.9,0,9.3,98.1,1450,864,586,59.59,40.41,105,759,159,427,264,1186,12.2,27.1,18.2,"75% or more P.O.C.","Less than $51000"
"42101028200","Census Tract 282, Philadelphia County, Pennsylvania",5184,32284,209,3507,0,582,0,886,4,67.7,0,11.2,0,17.1,96,2044,1069,975,52.3,47.7,63,1006,0,975,63,1981,5.9,0,3.1,"75% or more P.O.C.","Less than $51000"
"42101028300","Census Tract 283, Philadelphia County, Pennsylvania",6738,29509,7,5202,0,917,0,71,0.1,77.2,0,13.6,0,1.1,99.9,2379,1116,1263,46.91,53.09,196,920,136,1127,332,2047,17.6,10.8,14,"75% or more P.O.C.","Less than $51000"
"42101028400","Census Tract 284, Philadelphia County, Pennsylvania",3873,29950,80,3092,21,228,0,408,2.1,79.8,0.5,5.9,0,10.5,97.9,1273,887,386,69.68,30.32,103,784,27,359,130,1143,11.6,7,10.2,"75% or more P.O.C.","Less than $51000"
"42101028500","Census Tract 285, Philadelphia County, Pennsylvania",2480,26810,44,1213,0,357,3,834,1.8,48.9,0,14.4,0.1,33.6,98.2,802,313,489,39.03,60.97,68,245,67,422,135,667,21.7,13.7,16.8,"75% or more P.O.C.","Less than $51000"
"42101028600","Census Tract 286, Philadelphia County, Pennsylvania",6583,28981,215,4427,0,462,0,1401,3.3,67.2,0,7,0,21.3,96.7,2257,1111,1146,49.22,50.78,157,954,83,1063,240,2017,14.1,7.2,10.6,"75% or more P.O.C.","Less than $51000"
"42101028700","Census Tract 287, Philadelphia County, Pennsylvania",2577,27097,49,854,0,70,0,1584,1.9,33.1,0,2.7,0,61.5,98.1,812,343,469,42.24,57.76,54,289,107,362,161,651,15.7,22.8,19.8,"75% or more P.O.C.","Less than $51000"
"42101028800","Census Tract 288, Philadelphia County, Pennsylvania",4619,26408,320,678,0,657,0,2871,6.9,14.7,0,14.2,0,62.2,93.1,1414,800,614,56.58,43.42,77,723,166,448,243,1171,9.6,27,17.2,"75% or more P.O.C.","Less than $51000"
"42101028901","Census Tract 289.01, Philadelphia County, Pennsylvania",4056,37522,157,602,57,410,0,2817,3.9,14.8,1.4,10.1,0,69.5,96.1,1269,791,478,62.33,37.67,149,642,16,462,165,1104,18.8,3.3,13,"75% or more P.O.C.","Less than $51000"
"42101028902","Census Tract 289.02, Philadelphia County, Pennsylvania",7043,30066,490,1839,0,658,0,3792,7,26.1,0,9.3,0,53.8,93,2024,1096,928,54.15,45.85,230,866,163,765,393,1631,21,17.6,19.4,"75% or more P.O.C.","Less than $51000"
"42101029000","Census Tract 290, Philadelphia County, Pennsylvania",8124,37977,383,3005,0,745,0,3751,4.7,37,0,9.2,0,46.2,95.3,2055,1127,928,54.84,45.16,218,909,301,627,519,1536,19.3,32.4,25.3,"75% or more P.O.C.","Less than $51000"
"42101029100","Census Tract 291, Philadelphia County, Pennsylvania",5158,28571,192,1703,0,1336,0,1870,3.7,33,0,25.9,0,36.3,96.3,1618,560,1058,34.61,65.39,87,473,149,909,236,1382,15.5,14.1,14.6,"75% or more P.O.C.","Less than $51000"
"42101029200","Census Tract 292, Philadelphia County, Pennsylvania",4917,51359,536,1699,147,119,0,2318,10.9,34.6,3,2.4,0,47.1,89.1,1304,881,423,67.56,32.44,177,704,128,295,305,999,20.1,30.3,23.4,"75% or more P.O.C.","$51000 - $72000"
"42101029300","Census Tract 293, Philadelphia County, Pennsylvania",3170,25982,728,560,41,0,0,1826,23,17.7,1.3,0,0,57.6,77,962,432,530,44.91,55.09,85,347,71,459,156,806,19.7,13.4,16.2,"75% or more P.O.C.","Less than $51000"
"42101029400","Census Tract 294, Philadelphia County, Pennsylvania",3874,23107,419,1907,0,348,0,1200,10.8,49.2,0,9,0,31,89.2,1127,496,631,44.01,55.99,85,411,141,490,226,901,17.1,22.3,20.1,"75% or more P.O.C.","Less than $51000"
"42101029800","Census Tract 298, Philadelphia County, Pennsylvania",4830,29805,892,2002,0,138,0,1770,18.5,41.4,0,2.9,0,36.6,81.5,1924,966,958,50.21,49.79,139,827,64,894,203,1721,14.4,6.7,10.6,"75% or more P.O.C.","Less than $51000"
"42101029900","Census Tract 299, Philadelphia County, Pennsylvania",4324,24111,654,2078,0,86,4,1365,15.1,48.1,0,2,0.1,31.6,84.9,1490,623,867,41.81,58.19,102,521,89,778,191,1299,16.4,10.3,12.8,"75% or more P.O.C.","Less than $51000"
"42101030000","Census Tract 300, Philadelphia County, Pennsylvania",7629,29669,849,4413,19,243,0,1785,11.1,57.8,0.2,3.2,0,23.4,88.9,2500,1021,1479,40.84,59.16,224,797,147,1332,371,2129,21.9,9.9,14.8,"75% or more P.O.C.","Less than $51000"
"42101030100","Census Tract 301, Philadelphia County, Pennsylvania",5984,26610,1238,2648,5,83,0,1775,20.7,44.3,0.1,1.4,0,29.7,79.3,2164,796,1368,36.78,63.22,134,662,74,1294,208,1956,16.8,5.4,9.6,"75% or more P.O.C.","Less than $51000"
"42101030200","Census Tract 302, Philadelphia County, Pennsylvania",8912,63518,702,4863,68,192,0,2701,7.9,54.6,0.8,2.2,0,30.3,92.1,2590,1608,982,62.08,37.92,373,1235,120,862,493,2097,23.2,12.2,19,"75% or more P.O.C.","$51000 - $72000"
"42101030501","Census Tract 305.01, Philadelphia County, Pennsylvania",6079,37045,688,3422,55,311,0,1451,11.3,56.3,0.9,5.1,0,23.9,88.7,1860,1131,729,60.81,39.19,132,999,168,561,300,1560,11.7,23,16.1,"75% or more P.O.C.","Less than $51000"
"42101030502","Census Tract 305.02, Philadelphia County, Pennsylvania",7254,49115,774,3886,0,467,0,1889,10.7,53.6,0,6.4,0,26,89.3,2049,1440,609,70.28,29.72,120,1320,176,433,296,1753,8.3,28.9,14.4,"75% or more P.O.C.","Less than $51000"
"42101030600","Census Tract 306, Philadelphia County, Pennsylvania",6988,51705,2097,2464,0,668,0,1641,30,35.3,0,9.6,0,23.5,70,2652,1744,908,65.76,34.24,278,1466,0,908,278,2374,15.9,0,10.5,"50% - 75% P.O.C.","$51000 - $72000"
"42101030700","Census Tract 307, Philadelphia County, Pennsylvania",4238,49906,1461,1591,0,289,0,738,34.5,37.5,0,6.8,0,17.4,65.5,1481,546,935,36.87,63.13,65,481,81,854,146,1335,11.9,8.7,9.9,"50% - 75% P.O.C.","Less than $51000"
"42101030800","Census Tract 308, Philadelphia County, Pennsylvania",5570,55313,2090,1454,0,839,0,861,37.5,26.1,0,15.1,0,15.5,62.5,1692,1192,500,70.45,29.55,206,986,88,412,294,1398,17.3,17.6,17.4,"50% - 75% P.O.C.","$51000 - $72000"
"42101030900","Census Tract 309, Philadelphia County, Pennsylvania",4553,50694,934,1791,0,539,0,1072,20.5,39.3,0,11.8,0,23.5,79.5,1377,666,711,48.37,51.63,49,617,195,516,244,1133,7.4,27.4,17.7,"75% or more P.O.C.","Less than $51000"
"42101031000","Census Tract 310, Philadelphia County, Pennsylvania",7694,41540,2187,1767,341,1402,0,1764,28.4,23,4.4,18.2,0,22.9,71.6,2176,1442,734,66.27,33.73,164,1278,230,504,394,1782,11.4,31.3,18.1,"50% - 75% P.O.C.","Less than $51000"
"42101031101","Census Tract 311.01, Philadelphia County, Pennsylvania",5274,38292,910,2349,0,509,0,1329,17.3,44.5,0,9.7,0,25.2,82.7,1595,890,705,55.8,44.2,128,762,144,561,272,1323,14.4,20.4,17.1,"75% or more P.O.C.","Less than $51000"
"42101031102","Census Tract 311.02, Philadelphia County, Pennsylvania",4346,39201,420,1882,0,438,0,1499,9.7,43.3,0,10.1,0,34.5,90.3,1385,1010,375,72.92,27.08,139,871,112,263,251,1134,13.8,29.9,18.1,"75% or more P.O.C.","Less than $51000"
"42101031200","Census Tract 312, Philadelphia County, Pennsylvania",5032,42404,735,2438,12,452,0,1229,14.6,48.4,0.2,9,0,24.4,85.4,1614,912,702,56.51,43.49,135,777,107,595,242,1372,14.8,15.2,15,"75% or more P.O.C.","Less than $51000"
"42101031300","Census Tract 313, Philadelphia County, Pennsylvania",7632,40317,2462,1413,49,1581,0,1947,32.3,18.5,0.6,20.7,0,25.5,67.7,2363,909,1454,38.47,61.53,112,797,183,1271,295,2068,12.3,12.6,12.5,"50% - 75% P.O.C.","Less than $51000"
"42101031401","Census Tract 314.01, Philadelphia County, Pennsylvania",7061,41724,1784,1218,0,1522,0,1679,25.3,17.2,0,21.6,0,23.8,74.7,2076,947,1129,45.62,54.38,71,876,254,875,325,1751,7.5,22.5,15.7,"50% - 75% P.O.C.","Less than $51000"
"42101031402","Census Tract 314.02, Philadelphia County, Pennsylvania",5921,37341,1476,659,17,2017,0,1730,24.9,11.1,0.3,34.1,0,29.2,75.1,1803,1191,612,66.06,33.94,154,1037,208,404,362,1441,12.9,34,20.1,"75% or more P.O.C.","Less than $51000"
"42101031501","Census Tract 315.01, Philadelphia County, Pennsylvania",6643,48775,4110,200,0,1526,0,783,61.9,3,0,23,0,11.8,38.1,2196,1672,524,76.14,23.86,248,1424,97,427,345,1851,14.8,18.5,15.7,"25% - 50% P.O.C.","Less than $51000"
"42101031502","Census Tract 315.02, Philadelphia County, Pennsylvania",4337,45069,1983,889,0,761,0,557,45.7,20.5,0,17.5,0,12.8,54.3,1447,886,561,61.23,38.77,110,776,48,513,158,1289,12.4,8.6,10.9,"50% - 75% P.O.C.","Less than $51000"
"42101031600","Census Tract 316, Philadelphia County, Pennsylvania",5998,54198,3376,761,0,610,0,1138,56.3,12.7,0,10.2,0,19,43.7,2103,1395,708,66.33,33.67,146,1249,107,601,253,1850,10.5,15.1,12,"25% - 50% P.O.C.","$51000 - $72000"
"42101031700","Census Tract 317, Philadelphia County, Pennsylvania",5175,43750,2077,1231,0,303,0,1263,40.1,23.8,0,5.9,0,24.4,59.9,2127,1458,669,68.55,31.45,112,1346,0,669,112,2015,7.7,0,5.3,"50% - 75% P.O.C.","Less than $51000"
"42101031800","Census Tract 318, Philadelphia County, Pennsylvania",4056,43576,864,1666,0,149,0,1226,21.3,41.1,0,3.7,0,30.2,78.7,1445,903,542,62.49,37.51,87,816,26,516,113,1332,9.6,4.8,7.8,"75% or more P.O.C.","Less than $51000"
"42101031900","Census Tract 319, Philadelphia County, Pennsylvania",5641,43925,1784,1716,0,239,0,1745,31.6,30.4,0,4.2,0,30.9,68.4,1745,1057,688,60.57,39.43,140,917,95,593,235,1510,13.2,13.8,13.5,"50% - 75% P.O.C.","Less than $51000"
"42101032000","Census Tract 320, Philadelphia County, Pennsylvania",7382,50031,3720,1146,0,271,0,2041,50.4,15.5,0,3.7,0,27.6,49.6,2490,1863,627,74.82,25.18,277,1586,99,528,376,2114,14.9,15.8,15.1,"25% - 50% P.O.C.","Less than $51000"
"42101032100","Census Tract 321, Philadelphia County, Pennsylvania",4070,40175,1789,619,0,157,0,1386,44,15.2,0,3.9,0,34.1,56,1401,720,681,51.39,48.61,129,591,34,647,163,1238,17.9,5,11.6,"50% - 75% P.O.C.","Less than $51000"
"42101032300","Census Tract 323, Philadelphia County, Pennsylvania",3619,38906,1409,1214,0,0,0,929,38.9,33.5,0,0,0,25.7,61.1,1419,787,632,55.46,44.54,85,702,55,577,140,1279,10.8,8.7,9.9,"50% - 75% P.O.C.","Less than $51000"
"42101032500","Census Tract 325, Philadelphia County, Pennsylvania",6143,51450,2858,1200,0,661,0,1118,46.5,19.5,0,10.8,0,18.2,53.5,2075,1332,743,64.19,35.81,91,1241,160,583,251,1824,6.8,21.5,12.1,"50% - 75% P.O.C.","$51000 - $72000"
"42101032600","Census Tract 326, Philadelphia County, Pennsylvania",7611,44718,4760,646,0,798,0,1221,62.5,8.5,0,10.5,0,16,37.5,2591,1861,730,71.83,28.17,218,1643,19,711,237,2354,11.7,2.6,9.1,"25% - 50% P.O.C.","Less than $51000"
"42101032900","Census Tract 329, Philadelphia County, Pennsylvania",3701,32568,1874,584,0,135,0,884,50.6,15.8,0,3.6,0,23.9,49.4,1586,751,835,47.35,52.65,55,696,18,817,73,1513,7.3,2.2,4.6,"25% - 50% P.O.C.","Less than $51000"
"42101033000","Census Tract 330, Philadelphia County, Pennsylvania",8394,44233,3706,1692,0,347,0,2376,44.2,20.2,0,4.1,0,28.3,55.8,2681,1578,1103,58.86,41.14,211,1367,139,964,350,2331,13.4,12.6,13.1,"50% - 75% P.O.C.","Less than $51000"
"42101033101","Census Tract 331.01, Philadelphia County, Pennsylvania",5064,65188,3859,382,0,126,0,569,76.2,7.5,0,2.5,0,11.2,23.8,1695,1293,402,76.28,23.72,166,1127,79,323,245,1450,12.8,19.7,14.5,"Less than 25% P.O.C.","$51000 - $72000"
"42101033102","Census Tract 331.02, Philadelphia County, Pennsylvania",4048,42692,3107,299,0,31,0,438,76.8,7.4,0,0.8,0,10.8,23.2,1556,935,621,60.09,39.91,112,823,0,621,112,1444,12,0,7.2,"Less than 25% P.O.C.","Less than $51000"
"42101033200","Census Tract 332, Philadelphia County, Pennsylvania",2960,66339,1626,146,0,554,0,555,54.9,4.9,0,18.7,0,18.8,45.1,994,794,200,79.88,20.12,109,685,27,173,136,858,13.7,13.5,13.7,"25% - 50% P.O.C.","$51000 - $72000"
"42101033300","Census Tract 333, Philadelphia County, Pennsylvania",4147,44167,2740,550,0,245,0,475,66.1,13.3,0,5.9,0,11.5,33.9,1752,1066,686,60.84,39.16,90,976,0,686,90,1662,8.4,0,5.1,"25% - 50% P.O.C.","Less than $51000"
"42101033400","Census Tract 334, Philadelphia County, Pennsylvania",5619,52959,2571,1220,0,1395,0,340,45.8,21.7,0,24.8,0,6.1,54.2,1896,1147,749,60.5,39.5,200,947,72,677,272,1624,17.4,9.6,14.3,"50% - 75% P.O.C.","$51000 - $72000"
"42101033500","Census Tract 335, Philadelphia County, Pennsylvania",3975,48426,1657,589,0,812,0,755,41.7,14.8,0,20.4,0,19,58.3,1390,803,587,57.77,42.23,50,753,70,517,120,1270,6.2,11.9,8.6,"50% - 75% P.O.C.","Less than $51000"
"42101033600","Census Tract 336, Philadelphia County, Pennsylvania",7288,43198,4110,1518,0,516,0,1005,56.4,20.8,0,7.1,0,13.8,43.6,2813,1218,1595,43.3,56.7,109,1109,212,1383,321,2492,8.9,13.3,11.4,"25% - 50% P.O.C.","Less than $51000"
"42101033701","Census Tract 337.01, Philadelphia County, Pennsylvania",6589,41429,3086,1259,0,478,0,1427,46.8,19.1,0,7.3,0,21.7,53.2,2248,987,1261,43.91,56.09,300,687,70,1191,370,1878,30.4,5.6,16.5,"50% - 75% P.O.C.","Less than $51000"
"42101033702","Census Tract 337.02, Philadelphia County, Pennsylvania",4860,59680,2670,421,0,1231,0,286,54.9,8.7,0,25.3,0,5.9,45.1,1877,1495,382,79.65,20.35,147,1348,0,382,147,1730,9.8,0,7.8,"25% - 50% P.O.C.","$51000 - $72000"
"42101033800","Census Tract 338, Philadelphia County, Pennsylvania",6380,49021,3742,624,21,169,0,1260,58.7,9.8,0.3,2.6,0,19.7,41.3,2518,1298,1220,51.55,48.45,135,1163,26,1194,161,2357,10.4,2.1,6.4,"25% - 50% P.O.C.","Less than $51000"
"42101033900","Census Tract 339, Philadelphia County, Pennsylvania",3133,52418,1713,518,0,369,0,477,54.7,16.5,0,11.8,0,15.2,45.3,1261,750,511,59.48,40.52,78,672,30,481,108,1153,10.4,5.9,8.6,"25% - 50% P.O.C.","$51000 - $72000"
"42101034000","Census Tract 340, Philadelphia County, Pennsylvania",3082,85575,1958,329,0,273,0,517,63.5,10.7,0,8.9,0,16.8,36.5,1115,947,168,84.93,15.07,115,832,11,157,126,989,12.1,6.5,11.3,"25% - 50% P.O.C.","$72000 - $96000"
"42101034100","Census Tract 341, Philadelphia County, Pennsylvania",5729,73309,3597,521,0,569,0,950,62.8,9.1,0,9.9,0,16.6,37.2,2401,1355,1046,56.43,43.57,66,1289,36,1010,102,2299,4.9,3.4,4.2,"25% - 50% P.O.C.","$72000 - $96000"
"42101034200","Census Tract 342, Philadelphia County, Pennsylvania",3354,67917,2434,598,0,107,0,175,72.6,17.8,0,3.2,0,5.2,27.4,1465,772,693,52.7,47.3,13,759,0,693,13,1452,1.7,0,0.9,"25% - 50% P.O.C.","$51000 - $72000"
"42101034400","Census Tract 344, Philadelphia County, Pennsylvania",8044,77132,5510,503,7,1563,0,433,68.5,6.3,0.1,19.4,0,5.4,31.5,2686,2401,285,89.39,10.61,321,2080,0,285,321,2365,13.4,0,12,"25% - 50% P.O.C.","$72000 - $96000"
"42101034501","Census Tract 345.01, Philadelphia County, Pennsylvania",4243,35665,2095,639,0,676,0,730,49.4,15.1,0,15.9,0,17.2,50.6,1885,285,1600,15.12,84.88,63,222,64,1536,127,1758,22.1,4,6.7,"50% - 75% P.O.C.","Less than $51000"
"42101034502","Census Tract 345.02, Philadelphia County, Pennsylvania",5672,45164,3129,1218,0,471,26,716,55.2,21.5,0,8.3,0.5,12.6,44.8,2496,762,1734,30.53,69.47,48,714,80,1654,128,2368,6.3,4.6,5.1,"25% - 50% P.O.C.","Less than $51000"
"42101034600","Census Tract 346, Philadelphia County, Pennsylvania",2496,43654,947,645,0,335,0,501,37.9,25.8,0,13.4,0,20.1,62.1,1162,206,956,17.73,82.27,4,202,25,931,29,1133,1.9,2.6,2.5,"50% - 75% P.O.C.","Less than $51000"
"42101034701","Census Tract 347.01, Philadelphia County, Pennsylvania",6879,55244,3598,1463,3,747,0,628,52.3,21.3,0,10.9,0,9.1,47.7,2618,1876,742,71.66,28.34,115,1761,46,696,161,2457,6.1,6.2,6.1,"25% - 50% P.O.C.","$51000 - $72000"
"42101034702","Census Tract 347.02, Philadelphia County, Pennsylvania",3835,68636,2613,325,0,398,0,478,68.1,8.5,0,10.4,0,12.5,31.9,1428,1174,254,82.21,17.79,133,1041,14,240,147,1281,11.3,5.5,10.3,"25% - 50% P.O.C.","$51000 - $72000"
"42101034801","Census Tract 348.01, Philadelphia County, Pennsylvania",4600,57463,3812,220,0,201,0,342,82.9,4.8,0,4.4,0,7.4,17.1,1969,922,1047,46.83,53.17,81,841,61,986,142,1827,8.8,5.8,7.2,"Less than 25% P.O.C.","$51000 - $72000"
"42101034802","Census Tract 348.02, Philadelphia County, Pennsylvania",5485,44074,3019,1607,0,0,21,614,55,29.3,0,0,0.4,11.2,45,2127,989,1138,46.5,53.5,86,903,55,1083,141,1986,8.7,4.8,6.6,"25% - 50% P.O.C.","Less than $51000"
"42101034803","Census Tract 348.03, Philadelphia County, Pennsylvania",4309,68594,3311,136,12,194,0,633,76.8,3.2,0.3,4.5,0,14.7,23.2,1602,1331,271,83.08,16.92,105,1226,0,271,105,1497,7.9,0,6.6,"Less than 25% P.O.C.","$51000 - $72000"
"42101034900","Census Tract 349, Philadelphia County, Pennsylvania",5316,52017,2488,1074,0,256,0,1265,46.8,20.2,0,4.8,0,23.8,53.2,2064,1195,869,57.9,42.1,86,1109,26,843,112,1952,7.2,3,5.4,"50% - 75% P.O.C.","$51000 - $72000"
"42101035100","Census Tract 351, Philadelphia County, Pennsylvania",4187,55081,3411,368,0,220,0,167,81.5,8.8,0,5.3,0,4,18.5,2245,1354,891,60.31,39.69,19,1335,19,872,38,2207,1.4,2.1,1.7,"Less than 25% P.O.C.","$51000 - $72000"
"42101035200","Census Tract 352, Philadelphia County, Pennsylvania",4686,82419,4247,88,0,147,0,200,90.6,1.9,0,3.1,0,4.3,9.4,1786,1373,413,76.88,23.12,79,1294,35,378,114,1672,5.8,8.5,6.4,"Less than 25% P.O.C.","$72000 - $96000"
"42101035301","Census Tract 353.01, Philadelphia County, Pennsylvania",5550,79434,4579,76,0,134,0,701,82.5,1.4,0,2.4,0,12.6,17.5,1943,1524,419,78.44,21.56,179,1345,24,395,203,1740,11.7,5.7,10.4,"Less than 25% P.O.C.","$72000 - $96000"
"42101035302","Census Tract 353.02, Philadelphia County, Pennsylvania",4516,54739,3586,424,0,95,0,300,79.4,9.4,0,2.1,0,6.6,20.6,1915,1191,724,62.19,37.81,119,1072,0,724,119,1796,10,0,6.2,"Less than 25% P.O.C.","$51000 - $72000"
"42101035500","Census Tract 355, Philadelphia County, Pennsylvania",7948,56042,5562,519,0,964,12,458,70,6.5,0,12.1,0.2,5.8,30,2780,1858,922,66.83,33.17,438,1420,121,801,559,2221,23.6,13.1,20.1,"25% - 50% P.O.C.","$51000 - $72000"
"42101035601","Census Tract 356.01, Philadelphia County, Pennsylvania",5272,52673,4069,140,9,887,0,127,77.2,2.7,0.2,16.8,0,2.4,22.8,2155,1398,757,64.87,35.13,232,1166,0,757,232,1923,16.6,0,10.8,"Less than 25% P.O.C.","$51000 - $72000"
"42101035602","Census Tract 356.02, Philadelphia County, Pennsylvania",3661,81912,2518,73,0,707,8,307,68.8,2,0,19.3,0.2,8.4,31.2,1252,1022,230,81.63,18.37,171,851,11,219,182,1070,16.7,4.8,14.5,"25% - 50% P.O.C.","$72000 - $96000"
"42101035701","Census Tract 357.01, Philadelphia County, Pennsylvania",4931,35246,2695,301,0,1374,0,272,54.7,6.1,0,27.9,0,5.5,45.3,1896,608,1288,32.07,67.93,45,563,152,1136,197,1699,7.4,11.8,10.4,"25% - 50% P.O.C.","Less than $51000"
"42101035702","Census Tract 357.02, Philadelphia County, Pennsylvania",4158,43047,2864,43,0,774,0,209,68.9,1,0,18.6,0,5,31.1,1575,598,977,37.97,62.03,66,532,46,931,112,1463,11,4.7,7.1,"25% - 50% P.O.C.","Less than $51000"
"42101035800","Census Tract 358, Philadelphia County, Pennsylvania",6806,61389,5182,153,35,862,0,148,76.1,2.2,0.5,12.7,0,2.2,23.9,2242,1881,361,83.9,16.1,331,1550,0,361,331,1911,17.6,0,14.8,"Less than 25% P.O.C.","$51000 - $72000"
"42101035900","Census Tract 359, Philadelphia County, Pennsylvania",5548,63426,3641,101,43,930,0,589,65.6,1.8,0.8,16.8,0,10.6,34.4,2146,1422,724,66.26,33.74,101,1321,13,711,114,2032,7.1,1.8,5.3,"25% - 50% P.O.C.","$51000 - $72000"
"42101036000","Census Tract 360, Philadelphia County, Pennsylvania",3472,59219,1881,388,8,948,0,129,54.2,11.2,0.2,27.3,0,3.7,45.8,1136,707,429,62.24,37.76,108,599,0,429,108,1028,15.3,0,9.5,"25% - 50% P.O.C.","$51000 - $72000"
"42101036100","Census Tract 361, Philadelphia County, Pennsylvania",4049,59010,2516,791,0,95,0,615,62.1,19.5,0,2.3,0,15.2,37.9,1426,819,607,57.43,42.57,63,756,57,550,120,1306,7.7,9.4,8.4,"25% - 50% P.O.C.","$51000 - $72000"
"42101036201","Census Tract 362.01, Philadelphia County, Pennsylvania",5153,74360,4195,308,0,0,0,419,81.4,6,0,0,0,8.1,18.6,1981,1327,654,66.99,33.01,179,1148,32,622,211,1770,13.5,4.9,10.7,"Less than 25% P.O.C.","$72000 - $96000"
"42101036202","Census Tract 362.02, Philadelphia County, Pennsylvania",6239,65049,4854,425,0,245,0,691,77.8,6.8,0,3.9,0,11.1,22.2,2283,1957,326,85.72,14.28,276,1681,0,326,276,2007,14.1,0,12.1,"Less than 25% P.O.C.","$51000 - $72000"
"42101036203","Census Tract 362.03, Philadelphia County, Pennsylvania",5111,76807,4365,141,84,95,0,411,85.4,2.8,1.6,1.9,0,8,14.6,1855,1676,179,90.35,9.65,226,1450,14,165,240,1615,13.5,7.8,12.9,"Less than 25% P.O.C.","$72000 - $96000"
"42101036301","Census Tract 363.01, Philadelphia County, Pennsylvania",3969,63909,3050,13,13,550,0,244,76.8,0.3,0.3,13.9,0,6.1,23.2,1295,1022,273,78.92,21.08,236,786,22,251,258,1037,23.1,8.1,19.9,"Less than 25% P.O.C.","$51000 - $72000"
"42101036302","Census Tract 363.02, Philadelphia County, Pennsylvania",3705,55313,2439,836,0,0,0,351,65.8,22.6,0,0,0,9.5,34.2,1321,844,477,63.89,36.11,86,758,70,407,156,1165,10.2,14.7,11.8,"25% - 50% P.O.C.","$51000 - $72000"
"42101036303","Census Tract 363.03, Philadelphia County, Pennsylvania",6592,78250,5927,446,0,95,0,124,89.9,6.8,0,1.4,0,1.9,10.1,2251,2060,191,91.51,8.49,166,1894,53,138,219,2032,8.1,27.7,9.7,"Less than 25% P.O.C.","$72000 - $96000"
"42101036400","Census Tract 364, Philadelphia County, Pennsylvania",1037,66375,751,120,6,15,0,117,72.4,11.6,0.6,1.4,0,11.3,27.6,253,209,44,82.61,17.39,0,209,0,44,0,253,0,0,0,"25% - 50% P.O.C.","$51000 - $72000"
"42101036501","Census Tract 365.01, Philadelphia County, Pennsylvania",5331,54920,4023,594,0,292,0,298,75.5,11.1,0,5.5,0,5.6,24.5,2199,1094,1105,49.75,50.25,159,935,0,1105,159,2040,14.5,0,7.2,"Less than 25% P.O.C.","$51000 - $72000"
"42101036502","Census Tract 365.02, Philadelphia County, Pennsylvania",4213,101875,3607,7,0,227,0,319,85.6,0.2,0,5.4,0,7.6,14.4,1450,1213,237,83.66,16.34,198,1015,19,218,217,1233,16.3,8,15,"Less than 25% P.O.C.","$96000 or more"
"42101036600","Census Tract 366, Philadelphia County, Pennsylvania",2604,125921,1687,137,0,300,0,317,64.8,5.3,0,11.5,0,12.2,35.2,1340,650,690,48.51,51.49,10,640,15,675,25,1315,1.5,2.2,1.9,"25% - 50% P.O.C.","$96000 or more"
"42101036700","Census Tract 367, Philadelphia County, Pennsylvania",3612,132545,2751,276,0,180,0,315,76.2,7.6,0,5,0,8.7,23.8,1783,884,899,49.58,50.42,49,835,22,877,71,1712,5.5,2.4,4,"Less than 25% P.O.C.","$96000 or more"
"42101036900","Census Tract 369, Philadelphia County, Pennsylvania",5889,28099,3062,834,41,1278,0,381,52,14.2,0.7,21.7,0,6.5,48,701,4,697,0.57,99.43,0,4,0,697,0,701,0,0,0,"25% - 50% P.O.C.","Less than $51000"
"42101037200","Census Tract 372, Philadelphia County, Pennsylvania",4702,56656,2638,483,0,1265,0,159,56.1,10.3,0,26.9,0,3.4,43.9,1843,1447,396,78.51,21.49,101,1346,65,331,166,1677,7,16.4,9,"25% - 50% P.O.C.","$51000 - $72000"
"42101037300","Census Tract 373, Philadelphia County, Pennsylvania",5759,82230,4236,345,0,422,0,746,73.6,6,0,7.3,0,13,26.4,2550,1502,1048,58.9,41.1,68,1434,0,1048,68,2482,4.5,0,2.7,"25% - 50% P.O.C.","$72000 - $96000"
"42101037500","Census Tract 375, Philadelphia County, Pennsylvania",3736,75566,1672,1467,0,165,0,298,44.8,39.3,0,4.4,0,8,55.2,1224,722,502,58.99,41.01,38,684,52,450,90,1134,5.3,10.4,7.4,"50% - 75% P.O.C.","$72000 - $96000"
"42101037600","Census Tract 376, Philadelphia County, Pennsylvania",3287,75098,1389,613,20,839,0,359,42.3,18.6,0.6,25.5,0,10.9,57.7,1408,371,1037,26.35,73.65,23,348,17,1020,40,1368,6.2,1.6,2.8,"50% - 75% P.O.C.","$72000 - $96000"
"42101037700","Census Tract 377, Philadelphia County, Pennsylvania",5313,22689,1539,2210,0,450,0,1043,29,41.6,0,8.5,0,19.6,71,1266,270,996,21.33,78.67,49,221,43,953,92,1174,18.1,4.3,7.3,"50% - 75% P.O.C.","Less than $51000"
"42101037800","Census Tract 378, Philadelphia County, Pennsylvania",2474,59958,2079,142,12,36,0,169,84,5.7,0.5,1.5,0,6.8,16,1101,740,361,67.21,32.79,57,683,0,361,57,1044,7.7,0,5.2,"Less than 25% P.O.C.","$51000 - $72000"
"42101037900","Census Tract 379, Philadelphia County, Pennsylvania",5006,60136,4657,6,10,64,0,269,93,0.1,0.2,1.3,0,5.4,7,2140,1558,582,72.8,27.2,87,1471,42,540,129,2011,5.6,7.2,6,"Less than 25% P.O.C.","$51000 - $72000"
"42101038000","Census Tract 380, Philadelphia County, Pennsylvania",2431,40792,1231,230,0,30,0,940,50.6,9.5,0,1.2,0,38.7,49.4,781,488,293,62.48,37.52,68,420,65,228,133,648,13.9,22.2,17,"25% - 50% P.O.C.","Less than $51000"
"42101038100","Census Tract 381, Philadelphia County, Pennsylvania",845,32120,456,178,0,3,0,189,54,21.1,0,0.4,0,22.4,46,293,164,129,55.97,44.03,16,148,9,120,25,268,9.8,7,8.5,"25% - 50% P.O.C.","Less than $51000"
"42101038200","Census Tract 382, Philadelphia County, Pennsylvania",3067,29308,1404,734,0,65,0,806,45.8,23.9,0,2.1,0,26.3,54.2,957,442,515,46.19,53.81,55,387,95,420,150,807,12.4,18.4,15.7,"50% - 75% P.O.C.","Less than $51000"
"42101038300","Census Tract 383, Philadelphia County, Pennsylvania",3352,20972,167,1107,5,5,0,2019,5,33,0.1,0.1,0,60.2,95,943,479,464,50.8,49.2,10,469,59,405,69,874,2.1,12.7,7.3,"75% or more P.O.C.","Less than $51000"
"42101038400","Census Tract 384, Philadelphia County, Pennsylvania",2484,82315,2099,241,0,71,0,45,84.5,9.7,0,2.9,0,1.8,15.5,1000,826,174,82.6,17.4,52,774,30,144,82,918,6.3,17.2,8.2,"Less than 25% P.O.C.","$72000 - $96000"
"42101038500","Census Tract 385, Philadelphia County, Pennsylvania",1830,90188,1509,95,0,112,0,14,82.5,5.2,0,6.1,0,0.8,17.5,881,501,380,56.87,43.13,14,487,0,380,14,867,2.8,0,1.6,"Less than 25% P.O.C.","$72000 - $96000"
"42101038600","Census Tract 386, Philadelphia County, Pennsylvania",1395,133036,1098,177,0,57,0,41,78.7,12.7,0,4.1,0,2.9,21.3,597,428,169,71.69,28.31,30,398,0,169,30,567,7,0,5,"Less than 25% P.O.C.","$96000 or more"
"42101038700","Census Tract 387, Philadelphia County, Pennsylvania",2816,143646,2071,432,0,143,0,79,73.5,15.3,0,5.1,0,2.8,26.5,683,526,157,77.01,22.99,26,500,22,135,48,635,4.9,14,7,"25% - 50% P.O.C.","$96000 or more"
"42101038800","Census Tract 388, Philadelphia County, Pennsylvania",3636,78036,2233,986,0,54,0,128,61.4,27.1,0,1.5,0,3.5,38.6,1642,1058,584,64.43,35.57,36,1022,7,577,43,1599,3.4,1.2,2.6,"25% - 50% P.O.C.","$72000 - $96000"
"42101038900","Census Tract 389, Philadelphia County, Pennsylvania",3251,33777,165,2852,0,0,0,121,5.1,87.7,0,0,0,3.7,94.9,1299,797,502,61.35,38.65,50,747,0,502,50,1249,6.3,0,3.8,"75% or more P.O.C.","Less than $51000"
"42101039000","Census Tract 390, Philadelphia County, Pennsylvania",8641,29613,1057,5003,0,96,0,2266,12.2,57.9,0,1.1,0,26.2,87.8,2558,1618,940,63.25,36.75,258,1360,139,801,397,2161,15.9,14.8,15.5,"75% or more P.O.C.","Less than $51000"
"42101980000","Census Tract 9800, Philadelphia County, Pennsylvania",416,70833,250,91,0,21,0,39,60.1,21.9,0,5,0,9.4,39.9,44,20,24,45.45,54.55,0,20,0,24,0,44,0,0,0,"25% - 50% P.O.C.","$51000 - $72000"
"42101980100","Census Tract 9801, Philadelphia County, Pennsylvania",40,NA,25,0,3,0,0,0,62.5,0,7.5,0,0,0,37.5,12,8,4,66.67,33.33,0,8,0,4,0,12,0,0,0,"25% - 50% P.O.C.","N/A"
"42101980200","Census Tract 9802, Philadelphia County, Pennsylvania",554,99375,464,47,0,11,0,32,83.8,8.5,0,2,0,5.8,16.2,68,67,1,98.53,1.47,12,55,0,1,12,56,17.9,0,17.6,"Less than 25% P.O.C.","$96000 or more"
"42101980300","Census Tract 9803, Philadelphia County, Pennsylvania",0,NA,0,0,0,0,0,0,NA,NA,NA,NA,NA,NA,NA,0,0,0,NA,NA,0,0,0,0,0,0,NA,NA,NA,"N/A","N/A"
"42101980400","Census Tract 9804, Philadelphia County, Pennsylvania",0,NA,0,0,0,0,0,0,NA,NA,NA,NA,NA,NA,NA,0,0,0,NA,NA,0,0,0,0,0,0,NA,NA,NA,"N/A","N/A"
"42101980500","Census Tract 9805, Philadelphia County, Pennsylvania",0,NA,0,0,0,0,0,0,NA,NA,NA,NA,NA,NA,NA,0,0,0,NA,NA,0,0,0,0,0,0,NA,NA,NA,"N/A","N/A"
"42101980600","Census Tract 9806, Philadelphia County, Pennsylvania",0,NA,0,0,0,0,0,0,NA,NA,NA,NA,NA,NA,NA,0,0,0,NA,NA,0,0,0,0,0,0,NA,NA,NA,"N/A","N/A"
"42101980700","Census Tract 9807, Philadelphia County, Pennsylvania",0,NA,0,0,0,0,0,0,NA,NA,NA,NA,NA,NA,NA,0,0,0,NA,NA,0,0,0,0,0,0,NA,NA,NA,"N/A","N/A"
"42101980800","Census Tract 9808, Philadelphia County, Pennsylvania",0,NA,0,0,0,0,0,0,NA,NA,NA,NA,NA,NA,NA,0,0,0,NA,NA,0,0,0,0,0,0,NA,NA,NA,"N/A","N/A"
"42101980900","Census Tract 9809, Philadelphia County, Pennsylvania",0,NA,0,0,0,0,0,0,NA,NA,NA,NA,NA,NA,NA,0,0,0,NA,NA,0,0,0,0,0,0,NA,NA,NA,"N/A","N/A"
"42101989100","Census Tract 9891, Philadelphia County, Pennsylvania",1811,NA,196,1246,0,10,0,350,10.8,68.8,0,0.6,0,19.3,89.2,0,0,0,NA,NA,0,0,0,0,0,0,NA,NA,NA,"75% or more P.O.C.","N/A"
