"GEOID","NAME","total_pop","median_hh_income","white","black","ai_an","asian","hi_pi","hisp_lat","pct_white","pct_black","pct_ai_an","pct_asian","pct_hi_pi","pct_hisp_lat","pct_poc","total_hh","total_hh_owner","total_hh_renter","pct_owners","pct_renters","total_owner_more_than_4","total_owner_less_than_4","total_renter_more_than_4","total_renter_less_than_4","total_hh_more_than_4","total_hh_less_than_4","pct_owner_more_than_4","pct_renter_more_than_4","pct_total_hh_more_than_4","poc_bin","income_bin"
"37037020103","Census Tract 201.03, Chatham County, North Carolina",4616,115729,2875,493,0,121,0,1012,62.3,10.7,0,2.6,0,21.9,37.7,1988,1672,316,84.1,15.9,82,1590,37,279,119,1869,4.9,11.7,6,"25% - 50% P.O.C.","$78000 or more"
"37037020104","Census Tract 201.04, Chatham County, North Carolina",5370,99811,4726,133,63,81,0,241,88,2.5,1.2,1.5,0,4.5,12,2587,2088,499,80.71,19.29,67,2021,8,491,75,2512,3.2,1.6,2.9,"Less than 25% P.O.C.","$78000 or more"
"37037020105","Census Tract 201.05, Chatham County, North Carolina",5516,103618,4345,122,0,293,21,495,78.8,2.2,0,5.3,0.4,9,21.2,2300,1907,393,82.91,17.09,76,1831,0,393,76,2224,4,0,3.3,"Less than 25% P.O.C.","$78000 or more"
"37037020106","Census Tract 201.06, Chatham County, North Carolina",4593,84853,3765,531,0,85,27,121,82,11.6,0,1.9,0.6,2.6,18,1796,1453,343,80.9,19.1,66,1387,38,305,104,1692,4.5,11.1,5.8,"Less than 25% P.O.C.","$78000 or more"
"37037020200","Census Tract 202, Chatham County, North Carolina",8788,75697,7129,855,0,8,0,283,81.1,9.7,0,0.1,0,3.2,18.9,3321,2542,779,76.54,23.46,219,2323,118,661,337,2984,8.6,15.1,10.1,"Less than 25% P.O.C.","$56000 - $78000"
"37037020300","Census Tract 203, Chatham County, North Carolina",2790,44563,1807,380,0,0,0,343,64.8,13.6,0,0,0,12.3,35.2,1046,750,296,71.7,28.3,48,702,7,289,55,991,6.4,2.4,5.3,"25% - 50% P.O.C.","$42000 - $56000"
"37037020401","Census Tract 204.01, Chatham County, North Carolina",6099,39375,2006,897,0,104,0,2831,32.9,14.7,0,1.7,0,46.4,67.1,2034,1365,669,67.11,32.89,291,1074,112,557,403,1631,21.3,16.7,19.8,"50% - 75% P.O.C.","Less than $42000"
"37037020402","Census Tract 204.02, Chatham County, North Carolina",4499,44470,1050,1107,0,0,0,1978,23.3,24.6,0,0,0,44,76.7,1590,670,920,42.14,57.86,59,611,112,808,171,1419,8.8,12.2,10.8,"75% or more P.O.C.","$42000 - $56000"
"37037020500","Census Tract 205, Chatham County, North Carolina",3626,49438,3088,369,0,0,0,169,85.2,10.2,0,0,0,4.7,14.8,1381,1086,295,78.64,21.36,48,1038,42,253,90,1291,4.4,14.2,6.5,"Less than 25% P.O.C.","$42000 - $56000"
"37037020600","Census Tract 206, Chatham County, North Carolina",5187,52431,3881,812,0,134,0,303,74.8,15.7,0,2.6,0,5.8,25.2,2092,1672,420,79.92,20.08,43,1629,50,370,93,1999,2.6,11.9,4.4,"25% - 50% P.O.C.","$42000 - $56000"
"37037020701","Census Tract 207.01, Chatham County, North Carolina",6970,87190,6215,294,0,91,0,135,89.2,4.2,0,1.3,0,1.9,10.8,3256,2558,698,78.56,21.44,58,2500,20,678,78,3178,2.3,2.9,2.4,"Less than 25% P.O.C.","$78000 or more"
"37037020702","Census Tract 207.02, Chatham County, North Carolina",3996,65486,3223,350,0,42,0,357,80.7,8.8,0,1.1,0,8.9,19.3,1573,1292,281,82.14,17.86,122,1170,0,281,122,1451,9.4,0,7.8,"Less than 25% P.O.C.","$56000 - $78000"
"37037020800","Census Tract 208, Chatham County, North Carolina",9288,65282,7036,1555,0,109,0,439,75.8,16.7,0,1.2,0,4.7,24.2,4069,3112,957,76.48,23.52,127,2985,12,945,139,3930,4.1,1.3,3.4,"Less than 25% P.O.C.","$56000 - $78000"
"37051000200","Census Tract 2, Cumberland County, North Carolina",2202,16000,190,1738,10,35,0,191,8.6,78.9,0.5,1.6,0,8.7,91.4,992,213,779,21.47,78.53,14,199,23,756,37,955,6.6,3,3.7,"75% or more P.O.C.","Less than $42000"
"37051000500","Census Tract 5, Cumberland County, North Carolina",2288,24657,830,964,92,28,0,277,36.3,42.1,4,1.2,0,12.1,63.7,918,338,580,36.82,63.18,30,308,60,520,90,828,8.9,10.3,9.8,"50% - 75% P.O.C.","Less than $42000"
"37051000600","Census Tract 6, Cumberland County, North Carolina",5566,48699,3092,1697,98,137,0,467,55.6,30.5,1.8,2.5,0,8.4,44.4,2388,1074,1314,44.97,55.03,48,1026,49,1265,97,2291,4.5,3.7,4.1,"25% - 50% P.O.C.","$42000 - $56000"
"37051000701","Census Tract 7.01, Cumberland County, North Carolina",5446,74050,3931,508,0,352,0,432,72.2,9.3,0,6.5,0,7.9,27.8,2263,1482,781,65.49,34.51,107,1375,48,733,155,2108,7.2,6.1,6.8,"25% - 50% P.O.C.","$56000 - $78000"
"37051000702","Census Tract 7.02, Cumberland County, North Carolina",2279,66875,1559,510,0,27,0,154,68.4,22.4,0,1.2,0,6.8,31.6,979,625,354,63.84,36.16,56,569,19,335,75,904,9,5.4,7.7,"25% - 50% P.O.C.","$56000 - $78000"
"37051000800","Census Tract 8, Cumberland County, North Carolina",2684,50982,1750,733,22,20,0,138,65.2,27.3,0.8,0.7,0,5.1,34.8,1326,686,640,51.73,48.27,28,658,43,597,71,1255,4.1,6.7,5.4,"25% - 50% P.O.C.","$42000 - $56000"
"37051000900","Census Tract 9, Cumberland County, North Carolina",4848,41142,2896,1068,44,113,0,266,59.7,22,0.9,2.3,0,5.5,40.3,2261,1012,1249,44.76,55.24,75,937,52,1197,127,2134,7.4,4.2,5.6,"25% - 50% P.O.C.","Less than $42000"
"37051001000","Census Tract 10, Cumberland County, North Carolina",2556,28629,477,1759,33,44,0,148,18.7,68.8,1.3,1.7,0,5.8,81.3,1088,243,845,22.33,77.67,14,229,46,799,60,1028,5.8,5.4,5.5,"75% or more P.O.C.","Less than $42000"
"37051001100","Census Tract 11, Cumberland County, North Carolina",3912,32289,334,3350,11,25,0,44,8.5,85.6,0.3,0.6,0,1.1,91.5,1302,780,522,59.91,40.09,23,757,38,484,61,1241,2.9,7.3,4.7,"75% or more P.O.C.","Less than $42000"
"37051001200","Census Tract 12, Cumberland County, North Carolina",5156,24706,1044,3472,65,59,0,312,20.2,67.3,1.3,1.1,0,6.1,79.8,2344,998,1346,42.58,57.42,0,998,103,1243,103,2241,0,7.7,4.4,"75% or more P.O.C.","Less than $42000"
"37051001400","Census Tract 14, Cumberland County, North Carolina",6257,28579,2847,2414,174,77,0,526,45.5,38.6,2.8,1.2,0,8.4,54.5,2438,1118,1320,45.86,54.14,95,1023,191,1129,286,2152,8.5,14.5,11.7,"50% - 75% P.O.C.","Less than $42000"
"37051001500","Census Tract 15, Cumberland County, North Carolina",2954,42147,1401,1071,85,0,0,291,47.4,36.3,2.9,0,0,9.9,52.6,1105,637,468,57.65,42.35,72,565,49,419,121,984,11.3,10.5,11,"50% - 75% P.O.C.","$42000 - $56000"
"37051001601","Census Tract 16.01, Cumberland County, North Carolina",7461,48634,3679,2321,59,223,38,642,49.3,31.1,0.8,3,0.5,8.6,50.7,2812,1631,1181,58,42,203,1428,67,1114,270,2542,12.4,5.7,9.6,"50% - 75% P.O.C.","$42000 - $56000"
"37051001603","Census Tract 16.03, Cumberland County, North Carolina",3887,38142,1762,1294,82,0,15,497,45.3,33.3,2.1,0,0.4,12.8,54.7,1363,715,648,52.46,47.54,113,602,84,564,197,1166,15.8,13,14.5,"50% - 75% P.O.C.","Less than $42000"
"37051001604","Census Tract 16.04, Cumberland County, North Carolina",8113,53064,2863,3400,214,194,22,1043,35.3,41.9,2.6,2.4,0.3,12.9,64.7,2929,1592,1337,54.35,45.65,200,1392,176,1161,376,2553,12.6,13.2,12.8,"50% - 75% P.O.C.","$42000 - $56000"
"37051001700","Census Tract 17, Cumberland County, North Carolina",9127,42260,3523,3236,293,152,20,1291,38.6,35.5,3.2,1.7,0.2,14.1,61.4,3360,1941,1419,57.77,42.23,173,1768,140,1279,313,3047,8.9,9.9,9.3,"50% - 75% P.O.C.","$42000 - $56000"
"37051001800","Census Tract 18, Cumberland County, North Carolina",2353,41424,1215,722,61,83,0,150,51.6,30.7,2.6,3.5,0,6.4,48.4,1009,542,467,53.72,46.28,28,514,23,444,51,958,5.2,4.9,5.1,"25% - 50% P.O.C.","Less than $42000"
"37051001901","Census Tract 19.01, Cumberland County, North Carolina",1976,42938,907,706,50,12,0,222,45.9,35.7,2.5,0.6,0,11.2,54.1,820,463,357,56.46,43.54,23,440,29,328,52,768,5,8.1,6.3,"50% - 75% P.O.C.","$42000 - $56000"
"37051001902","Census Tract 19.02, Cumberland County, North Carolina",4516,45784,1784,1752,72,80,44,589,39.5,38.8,1.6,1.8,1,13,60.5,1744,1094,650,62.73,37.27,69,1025,71,579,140,1604,6.3,10.9,8,"50% - 75% P.O.C.","$42000 - $56000"
"37051001903","Census Tract 19.03, Cumberland County, North Carolina",4105,35990,1699,1307,157,43,0,660,41.4,31.8,3.8,1,0,16.1,58.6,1683,757,926,44.98,55.02,35,722,81,845,116,1567,4.6,8.7,6.9,"50% - 75% P.O.C.","Less than $42000"
"37051002001","Census Tract 20.01, Cumberland County, North Carolina",3074,48878,1156,1197,8,54,46,433,37.6,38.9,0.3,1.8,1.5,14.1,62.4,1469,409,1060,27.84,72.16,0,409,34,1026,34,1435,0,3.2,2.3,"50% - 75% P.O.C.","$42000 - $56000"
"37051002002","Census Tract 20.02, Cumberland County, North Carolina",4882,41468,1944,1721,22,30,0,796,39.8,35.3,0.5,0.6,0,16.3,60.2,2046,834,1212,40.76,59.24,30,804,64,1148,94,1952,3.6,5.3,4.6,"50% - 75% P.O.C.","Less than $42000"
"37051002100","Census Tract 21, Cumberland County, North Carolina",3839,43191,1842,1068,6,386,43,383,48,27.8,0.2,10.1,1.1,10,52,1798,755,1043,41.99,58.01,50,705,45,998,95,1703,6.6,4.3,5.3,"50% - 75% P.O.C.","$42000 - $56000"
"37051002200","Census Tract 22, Cumberland County, North Carolina",2296,40817,916,791,13,51,9,323,39.9,34.5,0.6,2.2,0.4,14.1,60.1,1148,158,990,13.76,86.24,3,155,45,945,48,1100,1.9,4.5,4.2,"50% - 75% P.O.C.","Less than $42000"
"37051002300","Census Tract 23, Cumberland County, North Carolina",4360,32396,1163,2317,29,68,0,532,26.7,53.1,0.7,1.6,0,12.2,73.3,2077,809,1268,38.95,61.05,36,773,48,1220,84,1993,4.4,3.8,4,"50% - 75% P.O.C.","Less than $42000"
"37051002401","Census Tract 24.01, Cumberland County, North Carolina",1439,21723,184,1104,7,0,0,68,12.8,76.7,0.5,0,0,4.7,87.2,625,148,477,23.68,76.32,15,133,33,444,48,577,10.1,6.9,7.7,"75% or more P.O.C.","Less than $42000"
"37051002402","Census Tract 24.02, Cumberland County, North Carolina",3021,30688,675,1973,35,18,0,219,22.3,65.3,1.2,0.6,0,7.2,77.7,1614,357,1257,22.12,77.88,9,348,24,1233,33,1581,2.5,1.9,2,"75% or more P.O.C.","Less than $42000"
"37051002501","Census Tract 25.01, Cumberland County, North Carolina",7613,51378,2463,3827,51,86,0,484,32.4,50.3,0.7,1.1,0,6.4,67.6,3119,1737,1382,55.69,44.31,72,1665,38,1344,110,3009,4.1,2.7,3.5,"50% - 75% P.O.C.","$42000 - $56000"
"37051002502","Census Tract 25.02, Cumberland County, North Carolina",7852,43337,3053,3044,15,63,0,1123,38.9,38.8,0.2,0.8,0,14.3,61.1,3051,935,2116,30.65,69.35,70,865,58,2058,128,2923,7.5,2.7,4.2,"50% - 75% P.O.C.","$42000 - $56000"
"37051002503","Census Tract 25.03, Cumberland County, North Carolina",4488,50938,2155,1512,0,47,143,464,48,33.7,0,1,3.2,10.3,52,2130,1006,1124,47.23,52.77,35,971,84,1040,119,2011,3.5,7.5,5.6,"50% - 75% P.O.C.","$42000 - $56000"
"37051002504","Census Tract 25.04, Cumberland County, North Carolina",7315,48469,3307,2510,84,271,0,805,45.2,34.3,1.1,3.7,0,11,54.8,2803,1572,1231,56.08,43.92,227,1345,116,1115,343,2460,14.4,9.4,12.2,"50% - 75% P.O.C.","$42000 - $56000"
"37051002600","Census Tract 26, Cumberland County, North Carolina",5241,49823,3384,1137,53,23,0,454,64.6,21.7,1,0.4,0,8.7,35.4,1938,1343,595,69.3,30.7,71,1272,18,577,89,1849,5.3,3,4.6,"25% - 50% P.O.C.","$42000 - $56000"
"37051002700","Census Tract 27, Cumberland County, North Carolina",8289,54006,5113,1892,63,102,3,686,61.7,22.8,0.8,1.2,0,8.3,38.3,3021,2331,690,77.16,22.84,252,2079,24,666,276,2745,10.8,3.5,9.1,"25% - 50% P.O.C.","$42000 - $56000"
"37051002800","Census Tract 28, Cumberland County, North Carolina",6426,62837,4886,755,93,66,0,471,76,11.7,1.4,1,0,7.3,24,2444,1843,601,75.41,24.59,141,1702,33,568,174,2270,7.7,5.5,7.1,"Less than 25% P.O.C.","$56000 - $78000"
"37051002900","Census Tract 29, Cumberland County, North Carolina",4075,49191,2985,755,29,0,0,142,73.3,18.5,0.7,0,0,3.5,26.7,1578,1103,475,69.9,30.1,118,985,55,420,173,1405,10.7,11.6,11,"25% - 50% P.O.C.","$42000 - $56000"
"37051003001","Census Tract 30.01, Cumberland County, North Carolina",13267,78548,7895,2708,774,201,0,1214,59.5,20.4,5.8,1.5,0,9.2,40.5,4394,3480,914,79.2,20.8,510,2970,69,845,579,3815,14.7,7.5,13.2,"25% - 50% P.O.C.","$78000 or more"
"37051003002","Census Tract 30.02, Cumberland County, North Carolina",2697,42500,1865,526,87,0,0,184,69.2,19.5,3.2,0,0,6.8,30.8,1040,808,232,77.69,22.31,73,735,18,214,91,949,9,7.8,8.8,"25% - 50% P.O.C.","$42000 - $56000"
"37051003102","Census Tract 31.02, Cumberland County, North Carolina",5452,85265,3088,1003,99,209,0,675,56.6,18.4,1.8,3.8,0,12.4,43.4,1742,1304,438,74.86,25.14,210,1094,71,367,281,1461,16.1,16.2,16.1,"25% - 50% P.O.C.","$78000 or more"
"37051003103","Census Tract 31.03, Cumberland County, North Carolina",5579,49833,3006,1535,126,39,0,541,53.9,27.5,2.3,0.7,0,9.7,46.1,2078,1437,641,69.15,30.85,115,1322,37,604,152,1926,8,5.8,7.3,"25% - 50% P.O.C.","$42000 - $56000"
"37051003104","Census Tract 31.04, Cumberland County, North Carolina",6916,49616,3889,1743,249,110,0,586,56.2,25.2,3.6,1.6,0,8.5,43.8,2219,1515,704,68.27,31.73,210,1305,157,547,367,1852,13.9,22.3,16.5,"25% - 50% P.O.C.","$42000 - $56000"
"37051003201","Census Tract 32.01, Cumberland County, North Carolina",12694,87123,6825,2892,190,786,0,1551,53.8,22.8,1.5,6.2,0,12.2,46.2,4126,3407,719,82.57,17.43,473,2934,56,663,529,3597,13.9,7.8,12.8,"25% - 50% P.O.C.","$78000 or more"
"37051003203","Census Tract 32.03, Cumberland County, North Carolina",5472,47463,2044,2473,18,131,13,656,37.4,45.2,0.3,2.4,0.2,12,62.6,2292,1097,1195,47.86,52.14,30,1067,106,1089,136,2156,2.7,8.9,5.9,"50% - 75% P.O.C.","$42000 - $56000"
"37051003204","Census Tract 32.04, Cumberland County, North Carolina",8374,49658,3006,3468,0,385,0,1166,35.9,41.4,0,4.6,0,13.9,64.1,3102,1476,1626,47.58,52.42,163,1313,115,1511,278,2824,11,7.1,9,"50% - 75% P.O.C.","$42000 - $56000"
"37051003205","Census Tract 32.05, Cumberland County, North Carolina",5123,59783,1600,2397,5,253,20,591,31.2,46.8,0.1,4.9,0.4,11.5,68.8,1926,1191,735,61.84,38.16,78,1113,98,637,176,1750,6.5,13.3,9.1,"50% - 75% P.O.C.","$56000 - $78000"
"37051003302","Census Tract 33.02, Cumberland County, North Carolina",6131,36396,1257,3707,50,74,0,796,20.5,60.5,0.8,1.2,0,13,79.5,2737,774,1963,28.28,71.72,62,712,94,1869,156,2581,8,4.8,5.7,"75% or more P.O.C.","Less than $42000"
"37051003304","Census Tract 33.04, Cumberland County, North Carolina",7038,48975,1961,3364,0,322,50,1018,27.9,47.8,0,4.6,0.7,14.5,72.1,3125,1522,1603,48.7,51.3,78,1444,76,1527,154,2971,5.1,4.7,4.9,"50% - 75% P.O.C.","$42000 - $56000"
"37051003305","Census Tract 33.05, Cumberland County, North Carolina",6161,34060,1663,2864,58,273,92,769,27,46.5,0.9,4.4,1.5,12.5,73,2886,979,1907,33.92,66.08,77,902,176,1731,253,2633,7.9,9.2,8.8,"50% - 75% P.O.C.","Less than $42000"
"37051003307","Census Tract 33.07, Cumberland County, North Carolina",4235,46667,843,2503,49,152,23,498,19.9,59.1,1.2,3.6,0.5,11.8,80.1,1588,775,813,48.8,51.2,69,706,69,744,138,1450,8.9,8.5,8.7,"75% or more P.O.C.","$42000 - $56000"
"37051003309","Census Tract 33.09, Cumberland County, North Carolina",6546,56304,2747,2070,51,363,0,818,42,31.6,0.8,5.5,0,12.5,58,2670,1310,1360,49.06,50.94,89,1221,125,1235,214,2456,6.8,9.2,8,"50% - 75% P.O.C.","$56000 - $78000"
"37051003310","Census Tract 33.10, Cumberland County, North Carolina",5162,41935,1091,2639,81,207,0,745,21.1,51.1,1.6,4,0,14.4,78.9,1962,780,1182,39.76,60.24,50,730,112,1070,162,1800,6.4,9.5,8.3,"75% or more P.O.C.","Less than $42000"
"37051003311","Census Tract 33.11, Cumberland County, North Carolina",2885,38140,768,1429,40,37,0,464,26.6,49.5,1.4,1.3,0,16.1,73.4,1508,117,1391,7.76,92.24,0,117,50,1341,50,1458,0,3.6,3.3,"50% - 75% P.O.C.","Less than $42000"
"37051003312","Census Tract 33.12, Cumberland County, North Carolina",6671,54692,2065,2938,20,334,81,976,31,44,0.3,5,1.2,14.6,69,2527,1628,899,64.42,35.58,135,1493,12,887,147,2380,8.3,1.3,5.8,"50% - 75% P.O.C.","$42000 - $56000"
"37051003313","Census Tract 33.13, Cumberland County, North Carolina",8160,68264,1816,4228,0,163,21,1530,22.3,51.8,0,2,0.3,18.8,77.7,2494,1523,971,61.07,38.93,258,1265,161,810,419,2075,16.9,16.6,16.8,"75% or more P.O.C.","$56000 - $78000"
"37051003314","Census Tract 33.14, Cumberland County, North Carolina",7618,52836,1811,4032,0,106,0,1250,23.8,52.9,0,1.4,0,16.4,76.2,2792,1458,1334,52.22,47.78,164,1294,138,1196,302,2490,11.2,10.3,10.8,"75% or more P.O.C.","$42000 - $56000"
"37051003401","Census Tract 34.01, Cumberland County, North Carolina",3317,41591,1694,568,20,42,10,781,51.1,17.1,0.6,1.3,0.3,23.5,48.9,860,16,844,1.86,98.14,0,16,180,664,180,680,0,21.3,20.9,"25% - 50% P.O.C.","Less than $42000"
"37051003402","Census Tract 34.02, Cumberland County, North Carolina",3801,NA,2219,515,62,71,17,554,58.4,13.5,1.6,1.9,0.4,14.6,41.6,0,0,0,NA,NA,0,0,0,0,0,0,NA,NA,NA,"25% - 50% P.O.C.","N/A"
"37051003403","Census Tract 34.03, Cumberland County, North Carolina",4337,36958,2056,765,13,47,29,1155,47.4,17.6,0.3,1.1,0.7,26.6,52.6,981,14,967,1.43,98.57,0,14,93,874,93,888,0,9.6,9.5,"50% - 75% P.O.C.","Less than $42000"
"37051003404","Census Tract 34.04, Cumberland County, North Carolina",2697,NA,1772,385,0,43,13,383,65.7,14.3,0,1.6,0.5,14.2,34.3,0,0,0,NA,NA,0,0,0,0,0,0,NA,NA,NA,"25% - 50% P.O.C.","N/A"
"37051003405","Census Tract 34.05, Cumberland County, North Carolina",1923,36148,1144,193,25,104,0,380,59.5,10,1.3,5.4,0,19.8,40.5,644,14,630,2.17,97.83,0,14,97,533,97,547,0,15.4,15.1,"25% - 50% P.O.C.","Less than $42000"
"37051003406","Census Tract 34.06, Cumberland County, North Carolina",1642,70893,1139,138,2,27,0,234,69.4,8.4,0.1,1.6,0,14.3,30.6,340,0,340,0,100,0,0,44,296,44,296,NA,12.9,12.9,"25% - 50% P.O.C.","$56000 - $78000"
"37051003407","Census Tract 34.07, Cumberland County, North Carolina",1763,NA,809,428,14,31,11,400,45.9,24.3,0.8,1.8,0.6,22.7,54.1,25,0,25,0,100,0,0,0,25,0,25,NA,0,0,"50% - 75% P.O.C.","N/A"
"37051003408","Census Tract 34.08, Cumberland County, North Carolina",4918,41458,2674,865,51,68,17,1016,54.4,17.6,1,1.4,0.3,20.7,45.6,1712,0,1712,0,100,0,0,19,1693,19,1693,NA,1.1,1.1,"25% - 50% P.O.C.","Less than $42000"
"37051003500","Census Tract 35, Cumberland County, North Carolina",4621,39293,1509,1987,12,168,25,680,32.7,43,0.3,3.6,0.5,14.7,67.3,2053,462,1591,22.5,77.5,42,420,21,1570,63,1990,9.1,1.3,3.1,"50% - 75% P.O.C.","Less than $42000"
"37051003600","Census Tract 36, Cumberland County, North Carolina",5426,36120,2026,2132,31,132,0,589,37.3,39.3,0.6,2.4,0,10.9,62.7,2168,797,1371,36.76,63.24,53,744,166,1205,219,1949,6.6,12.1,10.1,"50% - 75% P.O.C.","Less than $42000"
"37051003700","Census Tract 37, Cumberland County, North Carolina",7144,73404,4736,1452,8,111,48,505,66.3,20.3,0.1,1.6,0.7,7.1,33.7,2588,2205,383,85.2,14.8,180,2025,38,345,218,2370,8.2,9.9,8.4,"25% - 50% P.O.C.","$56000 - $78000"
"37051003800","Census Tract 38, Cumberland County, North Carolina",2754,25241,348,2085,97,7,0,97,12.6,75.7,3.5,0.3,0,3.5,87.4,863,254,609,29.43,70.57,23,231,26,583,49,814,9.1,4.3,5.7,"75% or more P.O.C.","Less than $42000"
"37051980100","Census Tract 9801, Cumberland County, North Carolina",0,NA,0,0,0,0,0,0,NA,NA,NA,NA,NA,NA,NA,0,0,0,NA,NA,0,0,0,0,0,0,NA,NA,NA,"N/A","N/A"
"37051980200","Census Tract 9802, Cumberland County, North Carolina",441,NA,286,61,12,0,21,30,64.9,13.8,2.7,0,4.8,6.8,35.1,0,0,0,NA,NA,0,0,0,0,0,0,NA,NA,NA,"25% - 50% P.O.C.","N/A"
"37063000101","Census Tract 1.01, Durham County, North Carolina",3150,55667,1051,1625,16,0,0,426,33.4,51.6,0.5,0,0,13.5,66.6,1304,894,410,68.56,31.44,11,883,46,364,57,1247,1.2,11.2,4.4,"50% - 75% P.O.C.","$42000 - $56000"
"37063000102","Census Tract 1.02, Durham County, North Carolina",4430,43561,1695,1065,1,139,0,1230,38.3,24,0,3.1,0,27.8,61.7,1818,615,1203,33.83,66.17,8,607,94,1109,102,1716,1.3,7.8,5.6,"50% - 75% P.O.C.","$42000 - $56000"
"37063000200","Census Tract 2, Durham County, North Carolina",3343,60000,1696,645,23,7,0,910,50.7,19.3,0.7,0.2,0,27.2,49.3,1206,535,671,44.36,55.64,50,485,50,621,100,1106,9.3,7.5,8.3,"25% - 50% P.O.C.","$56000 - $78000"
"37063000301","Census Tract 3.01, Durham County, North Carolina",2381,41588,1080,826,0,85,0,328,45.4,34.7,0,3.6,0,13.8,54.6,1133,373,760,32.92,67.08,0,373,34,726,34,1099,0,4.5,3,"50% - 75% P.O.C.","Less than $42000"
"37063000302","Census Tract 3.02, Durham County, North Carolina",3819,84826,2448,348,0,121,0,694,64.1,9.1,0,3.2,0,18.2,35.9,1573,782,791,49.71,50.29,79,703,20,771,99,1474,10.1,2.5,6.3,"25% - 50% P.O.C.","$78000 or more"
"37063000401","Census Tract 4.01, Durham County, North Carolina",2900,95375,2419,136,0,59,5,200,83.4,4.7,0,2,0.2,6.9,16.6,1225,886,339,72.33,27.67,83,803,6,333,89,1136,9.4,1.8,7.3,"Less than 25% P.O.C.","$78000 or more"
"37063000402","Census Tract 4.02, Durham County, North Carolina",2337,47000,1841,84,0,134,0,183,78.8,3.6,0,5.7,0,7.8,21.2,1374,283,1091,20.6,79.4,4,279,20,1071,24,1350,1.4,1.8,1.7,"Less than 25% P.O.C.","$42000 - $56000"
"37063000500","Census Tract 5, Durham County, North Carolina",4532,31892,1316,2290,6,349,0,489,29,50.5,0.1,7.7,0,10.8,71,1567,427,1140,27.25,72.75,66,361,74,1066,140,1427,15.5,6.5,8.9,"50% - 75% P.O.C.","Less than $42000"
"37063000600","Census Tract 6, Durham County, North Carolina",5504,47500,2917,991,17,122,0,1038,53,18,0.3,2.2,0,18.9,47,2254,1032,1222,45.79,54.21,60,972,22,1200,82,2172,5.8,1.8,3.6,"25% - 50% P.O.C.","$42000 - $56000"
"37063000700","Census Tract 7, Durham County, North Carolina",3682,61729,2526,617,0,146,0,247,68.6,16.8,0,4,0,6.7,31.4,1873,903,970,48.21,51.79,0,903,0,970,0,1873,0,0,0,"25% - 50% P.O.C.","$56000 - $78000"
"37063000900","Census Tract 9, Durham County, North Carolina",1710,32500,234,920,0,16,17,500,13.7,53.8,0,0.9,1,29.2,86.3,642,181,461,28.19,71.81,7,174,64,397,71,571,3.9,13.9,11.1,"75% or more P.O.C.","Less than $42000"
"37063001001","Census Tract 10.01, Durham County, North Carolina",3706,30595,466,2167,29,21,0,972,12.6,58.5,0.8,0.6,0,26.2,87.4,1360,355,1005,26.1,73.9,12,343,172,833,184,1176,3.4,17.1,13.5,"75% or more P.O.C.","Less than $42000"
"37063001002","Census Tract 10.02, Durham County, North Carolina",5931,21107,467,2194,46,176,0,2892,7.9,37,0.8,3,0,48.8,92.1,2242,533,1709,23.77,76.23,131,402,179,1530,310,1932,24.6,10.5,13.8,"75% or more P.O.C.","Less than $42000"
"37063001100","Census Tract 11, Durham County, North Carolina",3183,24209,554,1982,20,0,0,621,17.4,62.3,0.6,0,0,19.5,82.6,1346,212,1134,15.75,84.25,35,177,93,1041,128,1218,16.5,8.2,9.5,"75% or more P.O.C.","Less than $42000"
"37063001301","Census Tract 13.01, Durham County, North Carolina",1382,31683,46,1139,0,5,0,177,3.3,82.4,0,0.4,0,12.8,96.7,543,111,432,20.44,79.56,0,111,44,388,44,499,0,10.2,8.1,"75% or more P.O.C.","Less than $42000"
"37063001303","Census Tract 13.03, Durham County, North Carolina",3985,37540,509,3095,14,87,0,147,12.8,77.7,0.4,2.2,0,3.7,87.2,711,268,443,37.69,62.31,31,237,25,418,56,655,11.6,5.6,7.9,"75% or more P.O.C.","Less than $42000"
"37063001304","Census Tract 13.04, Durham County, North Carolina",3411,30332,72,2330,0,0,0,640,2.1,68.3,0,0,0,18.8,97.9,1188,255,933,21.46,78.54,11,244,181,752,192,996,4.3,19.4,16.2,"75% or more P.O.C.","Less than $42000"
"37063001400","Census Tract 14, Durham County, North Carolina",2397,27628,37,1945,0,0,0,387,1.5,81.1,0,0,0,16.1,98.5,827,163,664,19.71,80.29,0,163,146,518,146,681,0,22,17.7,"75% or more P.O.C.","Less than $42000"
"37063001501","Census Tract 15.01, Durham County, North Carolina",3387,NA,1572,874,0,585,13,290,46.4,25.8,0,17.3,0.4,8.6,53.6,17,0,17,0,100,0,0,0,17,0,17,NA,0,0,"50% - 75% P.O.C.","N/A"
"37063001502","Census Tract 15.02, Durham County, North Carolina",5928,27097,1395,1616,63,1420,0,1104,23.5,27.3,1.1,24,0,18.6,76.5,2990,40,2950,1.34,98.66,0,40,125,2825,125,2865,0,4.2,4.2,"75% or more P.O.C.","Less than $42000"
"37063001503","Census Tract 15.03, Durham County, North Carolina",1727,NA,819,412,6,342,0,130,47.4,23.9,0.3,19.8,0,7.5,52.6,0,0,0,NA,NA,0,0,0,0,0,0,NA,NA,NA,"50% - 75% P.O.C.","N/A"
"37063001601","Census Tract 16.01, Durham County, North Carolina",6435,69556,3360,2051,0,99,0,681,52.2,31.9,0,1.5,0,10.6,47.8,2359,2098,261,88.94,11.06,226,1872,19,242,245,2114,10.8,7.3,10.4,"25% - 50% P.O.C.","$56000 - $78000"
"37063001603","Census Tract 16.03, Durham County, North Carolina",6829,86638,4613,1317,0,151,0,514,67.6,19.3,0,2.2,0,7.5,32.4,2712,2521,191,92.96,7.04,126,2395,29,162,155,2557,5,15.2,5.7,"25% - 50% P.O.C.","$78000 or more"
"37063001604","Census Tract 16.04, Durham County, North Carolina",6381,104314,4933,792,17,211,0,195,77.3,12.4,0.3,3.3,0,3.1,22.7,2656,2501,155,94.16,5.84,100,2401,0,155,100,2556,4,0,3.8,"Less than 25% P.O.C.","$78000 or more"
"37063001705","Census Tract 17.05, Durham County, North Carolina",5050,65612,3149,475,23,205,0,1140,62.4,9.4,0.5,4.1,0,22.6,37.6,2275,1443,832,63.43,36.57,19,1424,160,672,179,2096,1.3,19.2,7.9,"25% - 50% P.O.C.","$56000 - $78000"
"37063001706","Census Tract 17.06, Durham County, North Carolina",5321,56468,2880,1324,0,540,0,373,54.1,24.9,0,10.1,0,7,45.9,2451,1124,1327,45.86,54.14,46,1078,39,1288,85,2366,4.1,2.9,3.5,"25% - 50% P.O.C.","$56000 - $78000"
"37063001707","Census Tract 17.07, Durham County, North Carolina",7085,94893,5812,672,0,306,0,210,82,9.5,0,4.3,0,3,18,3045,2334,711,76.65,23.35,144,2190,0,711,144,2901,6.2,0,4.7,"Less than 25% P.O.C.","$78000 or more"
"37063001708","Census Tract 17.08, Durham County, North Carolina",5245,55094,889,3399,0,38,0,822,16.9,64.8,0,0.7,0,15.7,83.1,1791,1231,560,68.73,31.27,99,1132,179,381,278,1513,8,32,15.5,"75% or more P.O.C.","$42000 - $56000"
"37063001709","Census Tract 17.09, Durham County, North Carolina",6964,34662,745,4998,0,61,0,1007,10.7,71.8,0,0.9,0,14.5,89.3,2986,745,2241,24.95,75.05,93,652,260,1981,353,2633,12.5,11.6,11.8,"75% or more P.O.C.","Less than $42000"
"37063001710","Census Tract 17.10, Durham County, North Carolina",4894,48238,1350,2436,29,171,0,819,27.6,49.8,0.6,3.5,0,16.7,72.4,1786,1002,784,56.1,43.9,166,836,65,719,231,1555,16.6,8.3,12.9,"50% - 75% P.O.C.","$42000 - $56000"
"37063001711","Census Tract 17.11, Durham County, North Carolina",4465,40278,1086,2188,0,96,0,995,24.3,49,0,2.2,0,22.3,75.7,2258,560,1698,24.8,75.2,0,560,31,1667,31,2227,0,1.8,1.4,"75% or more P.O.C.","Less than $42000"
"37063001801","Census Tract 18.01, Durham County, North Carolina",8618,55434,2291,3635,0,1,0,2657,26.6,42.2,0,0,0,30.8,73.4,2840,2302,538,81.06,18.94,492,1810,21,517,513,2327,21.4,3.9,18.1,"50% - 75% P.O.C.","$42000 - $56000"
"37063001802","Census Tract 18.02, Durham County, North Carolina",8121,38741,591,4249,41,74,0,2933,7.3,52.3,0.5,0.9,0,36.1,92.7,2647,1213,1434,45.83,54.17,202,1011,239,1195,441,2206,16.7,16.7,16.7,"75% or more P.O.C.","Less than $42000"
"37063001806","Census Tract 18.06, Durham County, North Carolina",7416,59601,2625,3741,15,0,0,738,35.4,50.4,0.2,0,0,10,64.6,2479,2137,342,86.2,13.8,160,1977,139,203,299,2180,7.5,40.6,12.1,"50% - 75% P.O.C.","$56000 - $78000"
"37063001807","Census Tract 18.07, Durham County, North Carolina",10155,76318,2149,5631,20,20,0,2197,21.2,55.5,0.2,0.2,0,21.6,78.8,3578,2781,797,77.72,22.28,267,2514,71,726,338,3240,9.6,8.9,9.4,"75% or more P.O.C.","$56000 - $78000"
"37063001808","Census Tract 18.08, Durham County, North Carolina",10407,101791,4171,4695,0,693,0,684,40.1,45.1,0,6.7,0,6.6,59.9,3976,3562,414,89.59,10.41,288,3274,45,369,333,3643,8.1,10.9,8.4,"50% - 75% P.O.C.","$78000 or more"
"37063001809","Census Tract 18.09, Durham County, North Carolina",6217,53658,2524,2771,20,27,0,742,40.6,44.6,0.3,0.4,0,11.9,59.4,2757,1014,1743,36.78,63.22,41,973,118,1625,159,2598,4,6.8,5.8,"50% - 75% P.O.C.","$42000 - $56000"
"37063001900","Census Tract 19, Durham County, North Carolina",4418,82946,3349,552,0,272,0,166,75.8,12.5,0,6.2,0,3.8,24.2,2203,1992,211,90.42,9.58,53,1939,0,211,53,2150,2.7,0,2.4,"Less than 25% P.O.C.","$78000 or more"
"37063002007","Census Tract 20.07, Durham County, North Carolina",4855,82039,3096,1366,0,57,64,229,63.8,28.1,0,1.2,1.3,4.7,36.2,2303,1737,566,75.42,24.58,62,1675,0,566,62,2241,3.6,0,2.7,"25% - 50% P.O.C.","$78000 or more"
"37063002008","Census Tract 20.08, Durham County, North Carolina",3069,135403,2565,223,12,60,0,71,83.6,7.3,0.4,2,0,2.3,16.4,1194,1165,29,97.57,2.43,91,1074,0,29,91,1103,7.8,0,7.6,"Less than 25% P.O.C.","$78000 or more"
"37063002009","Census Tract 20.09, Durham County, North Carolina",5052,35247,120,3678,23,0,0,994,2.4,72.8,0.5,0,0,19.7,97.6,1960,1240,720,63.27,36.73,100,1140,146,574,246,1714,8.1,20.3,12.6,"75% or more P.O.C.","Less than $42000"
"37063002013","Census Tract 20.13, Durham County, North Carolina",4679,95773,2491,1463,11,86,0,433,53.2,31.3,0.2,1.8,0,9.3,46.8,1898,1554,344,81.88,18.12,63,1491,44,300,107,1791,4.1,12.8,5.6,"25% - 50% P.O.C.","$78000 or more"
"37063002015","Census Tract 20.15, Durham County, North Carolina",5801,43180,2284,1573,0,207,0,1545,39.4,27.1,0,3.6,0,26.6,60.6,2471,468,2003,18.94,81.06,43,425,148,1855,191,2280,9.2,7.4,7.7,"50% - 75% P.O.C.","$42000 - $56000"
"37063002016","Census Tract 20.16, Durham County, North Carolina",5304,44159,1614,1359,0,517,0,1683,30.4,25.6,0,9.7,0,31.7,69.6,2307,275,2032,11.92,88.08,0,275,140,1892,140,2167,0,6.9,6.1,"50% - 75% P.O.C.","$42000 - $56000"
"37063002017","Census Tract 20.17, Durham County, North Carolina",7660,81396,5749,510,24,928,0,92,75.1,6.7,0.3,12.1,0,1.2,24.9,3404,2114,1290,62.1,37.9,198,1916,0,1290,198,3206,9.4,0,5.8,"Less than 25% P.O.C.","$78000 or more"
"37063002018","Census Tract 20.18, Durham County, North Carolina",9587,86444,5589,2043,61,463,0,1065,58.3,21.3,0.6,4.8,0,11.1,41.7,4690,2674,2016,57.01,42.99,77,2597,225,1791,302,4388,2.9,11.2,6.4,"25% - 50% P.O.C.","$78000 or more"
"37063002019","Census Tract 20.19, Durham County, North Carolina",5064,75931,3848,731,0,381,0,57,76,14.4,0,7.5,0,1.1,24,2694,1505,1189,55.86,44.14,111,1394,0,1189,111,2583,7.4,0,4.1,"Less than 25% P.O.C.","$56000 - $78000"
"37063002020","Census Tract 20.20, Durham County, North Carolina",7445,145179,4646,1611,68,710,0,126,62.4,21.6,0.9,9.5,0,1.7,37.6,2634,2499,135,94.87,5.13,290,2209,13,122,303,2331,11.6,9.6,11.5,"25% - 50% P.O.C.","$78000 or more"
"37063002021","Census Tract 20.21, Durham County, North Carolina",4285,69375,2017,1370,0,439,0,400,47.1,32,0,10.2,0,9.3,52.9,2123,713,1410,33.58,66.42,37,676,37,1373,74,2049,5.2,2.6,3.5,"50% - 75% P.O.C.","$56000 - $78000"
"37063002022","Census Tract 20.22, Durham County, North Carolina",4819,57679,2154,1810,0,340,0,115,44.7,37.6,0,7.1,0,2.4,55.3,2452,842,1610,34.34,65.66,0,842,41,1569,41,2411,0,2.5,1.7,"50% - 75% P.O.C.","$56000 - $78000"
"37063002023","Census Tract 20.23, Durham County, North Carolina",3287,74545,1899,775,0,328,0,185,57.8,23.6,0,10,0,5.6,42.2,1378,557,821,40.42,59.58,74,483,17,804,91,1287,13.3,2.1,6.6,"25% - 50% P.O.C.","$56000 - $78000"
"37063002024","Census Tract 20.24, Durham County, North Carolina",6361,83742,4403,1096,0,367,0,252,69.2,17.2,0,5.8,0,4,30.8,3067,2434,633,79.36,20.64,31,2403,0,633,31,3036,1.3,0,1,"25% - 50% P.O.C.","$78000 or more"
"37063002025","Census Tract 20.25, Durham County, North Carolina",6746,81292,2194,3214,0,657,0,635,32.5,47.6,0,9.7,0,9.4,67.5,2518,1840,678,73.07,26.93,97,1743,13,665,110,2408,5.3,1.9,4.4,"50% - 75% P.O.C.","$78000 or more"
"37063002026","Census Tract 20.26, Durham County, North Carolina",7296,51049,966,4659,0,142,0,1092,13.2,63.9,0,1.9,0,15,86.8,2835,1043,1792,36.79,63.21,50,993,165,1627,215,2620,4.8,9.2,7.6,"75% or more P.O.C.","$42000 - $56000"
"37063002027","Census Tract 20.27, Durham County, North Carolina",10567,66140,3832,4488,0,1250,0,912,36.3,42.5,0,11.8,0,8.6,63.7,4768,1735,3033,36.39,63.61,129,1606,50,2983,179,4589,7.4,1.6,3.8,"50% - 75% P.O.C.","$56000 - $78000"
"37063002028","Census Tract 20.28, Durham County, North Carolina",10201,80789,4125,3561,0,1293,12,710,40.4,34.9,0,12.7,0.1,7,59.6,5171,1900,3271,36.74,63.26,34,1866,76,3195,110,5061,1.8,2.3,2.1,"50% - 75% P.O.C.","$78000 or more"
"37063002100","Census Tract 21, Durham County, North Carolina",9200,87867,5683,2656,56,56,18,480,61.8,28.9,0.6,0.6,0.2,5.2,38.2,2574,2366,208,91.92,8.08,179,2187,22,186,201,2373,7.6,10.6,7.8,"25% - 50% P.O.C.","$78000 or more"
"37063002200","Census Tract 22, Durham County, North Carolina",2091,70043,1218,584,0,80,0,149,58.2,27.9,0,3.8,0,7.1,41.8,1079,264,815,24.47,75.53,8,256,21,794,29,1050,3,2.6,2.7,"25% - 50% P.O.C.","$56000 - $78000"
"37063002300","Census Tract 23, Durham County, North Carolina",1633,48194,279,906,0,52,0,376,17.1,55.5,0,3.2,0,23,82.9,441,127,314,28.8,71.2,8,119,47,267,55,386,6.3,15,12.5,"75% or more P.O.C.","$42000 - $56000"
"37063980100","Census Tract 9801, Durham County, North Carolina",0,NA,0,0,0,0,0,0,NA,NA,NA,NA,NA,NA,NA,0,0,0,NA,NA,0,0,0,0,0,0,NA,NA,NA,"N/A","N/A"
"37065020200","Census Tract 202, Edgecombe County, North Carolina",6214,31925,1050,4844,20,22,0,122,16.9,78,0.3,0.4,0,2,83.1,2374,845,1529,35.59,64.41,57,788,288,1241,345,2029,6.7,18.8,14.5,"75% or more P.O.C.","Less than $42000"
"37065020300","Census Tract 203, Edgecombe County, North Carolina",4821,35547,474,4168,0,33,0,52,9.8,86.5,0,0.7,0,1.1,90.2,2007,980,1027,48.83,51.17,91,889,111,916,202,1805,9.3,10.8,10.1,"75% or more P.O.C.","Less than $42000"
"37065020400","Census Tract 204, Edgecombe County, North Carolina",4724,29892,176,4439,0,0,54,54,3.7,94,0,0,1.1,1.1,96.3,1912,735,1177,38.44,61.56,31,704,63,1114,94,1818,4.2,5.4,4.9,"75% or more P.O.C.","Less than $42000"
"37065020600","Census Tract 206, Edgecombe County, North Carolina",2364,35398,561,1424,0,0,0,324,23.7,60.2,0,0,0,13.7,76.3,910,725,185,79.67,20.33,130,595,14,171,144,766,17.9,7.6,15.8,"75% or more P.O.C.","Less than $42000"
"37065020700","Census Tract 207, Edgecombe County, North Carolina",1918,46818,603,1237,0,0,0,21,31.4,64.5,0,0,0,1.1,68.6,746,563,183,75.47,24.53,31,532,22,161,53,693,5.5,12,7.1,"50% - 75% P.O.C.","$42000 - $56000"
"37065020800","Census Tract 208, Edgecombe County, North Carolina",3324,38088,1783,1463,0,0,0,59,53.6,44,0,0,0,1.8,46.4,1388,1051,337,75.72,24.28,58,993,43,294,101,1287,5.5,12.8,7.3,"25% - 50% P.O.C.","Less than $42000"
"37065020900","Census Tract 209, Edgecombe County, North Carolina",2582,33910,336,2142,0,0,0,81,13,83,0,0,0,3.1,87,984,657,327,66.77,33.23,45,612,91,236,136,848,6.8,27.8,13.8,"75% or more P.O.C.","Less than $42000"
"37065021000","Census Tract 210, Edgecombe County, North Carolina",3006,27383,867,1863,13,18,0,221,28.8,62,0.4,0.6,0,7.4,71.2,1329,649,680,48.83,51.17,48,601,22,658,70,1259,7.4,3.2,5.3,"50% - 75% P.O.C.","Less than $42000"
"37065021100","Census Tract 211, Edgecombe County, North Carolina",4110,43786,1727,1745,7,0,0,575,42,42.5,0.2,0,0,14,58,1548,984,564,63.57,36.43,46,938,109,455,155,1393,4.7,19.3,10,"50% - 75% P.O.C.","$42000 - $56000"
"37065021200","Census Tract 212, Edgecombe County, North Carolina",4806,27446,2260,2417,12,0,0,70,47,50.3,0.2,0,0,1.5,53,2142,1036,1106,48.37,51.63,58,978,0,1106,58,2084,5.6,0,2.7,"50% - 75% P.O.C.","Less than $42000"
"37065021300","Census Tract 213, Edgecombe County, North Carolina",4942,52909,2653,1675,0,0,0,530,53.7,33.9,0,0,0,10.7,46.3,1872,1394,478,74.47,25.53,153,1241,83,395,236,1636,11,17.4,12.6,"25% - 50% P.O.C.","$42000 - $56000"
"37065021400","Census Tract 214, Edgecombe County, North Carolina",3548,41801,2869,661,18,0,0,0,80.9,18.6,0.5,0,0,0,19.1,1369,1039,330,75.89,24.11,136,903,7,323,143,1226,13.1,2.1,10.4,"Less than 25% P.O.C.","Less than $42000"
"37065021500","Census Tract 215, Edgecombe County, North Carolina",3305,39731,1731,1363,0,0,8,179,52.4,41.2,0,0,0.2,5.4,47.6,1432,930,502,64.94,35.06,31,899,21,481,52,1380,3.3,4.2,3.6,"25% - 50% P.O.C.","Less than $42000"
"37065021600","Census Tract 216, Edgecombe County, North Carolina",2984,42283,1975,810,0,40,0,127,66.2,27.1,0,1.3,0,4.3,33.8,1138,848,290,74.52,25.48,75,773,20,270,95,1043,8.8,6.9,8.3,"25% - 50% P.O.C.","$42000 - $56000"
"37069060100","Census Tract 601, Franklin County, North Carolina",4744,42775,2297,1788,24,0,0,470,48.4,37.7,0.5,0,0,9.9,51.6,1841,1458,383,79.2,20.8,80,1378,101,282,181,1660,5.5,26.4,9.8,"50% - 75% P.O.C.","$42000 - $56000"
"37069060200","Census Tract 602, Franklin County, North Carolina",3704,53843,2921,467,6,58,0,229,78.9,12.6,0.2,1.6,0,6.2,21.1,1523,1130,393,74.2,25.8,69,1061,13,380,82,1441,6.1,3.3,5.4,"Less than 25% P.O.C.","$42000 - $56000"
"37069060301","Census Tract 603.01, Franklin County, North Carolina",6123,56448,3149,2655,0,10,0,269,51.4,43.4,0,0.2,0,4.4,48.6,2133,1504,629,70.51,29.49,69,1435,94,535,163,1970,4.6,14.9,7.6,"25% - 50% P.O.C.","$56000 - $78000"
"37069060302","Census Tract 603.02, Franklin County, North Carolina",2702,25544,602,1835,16,0,0,166,22.3,67.9,0.6,0,0,6.1,77.7,1125,423,702,37.6,62.4,13,410,43,659,56,1069,3.1,6.1,5,"75% or more P.O.C.","Less than $42000"
"37069060401","Census Tract 604.01, Franklin County, North Carolina",2774,49531,1711,601,14,0,0,367,61.7,21.7,0.5,0,0,13.2,38.3,1129,877,252,77.68,22.32,59,818,18,234,77,1052,6.7,7.1,6.8,"25% - 50% P.O.C.","$42000 - $56000"
"37069060402","Census Tract 604.02, Franklin County, North Carolina",4984,34860,1904,2222,51,0,0,534,38.2,44.6,1,0,0,10.7,61.8,2144,1367,777,63.76,36.24,71,1296,149,628,220,1924,5.2,19.2,10.3,"50% - 75% P.O.C.","Less than $42000"
"37069060501","Census Tract 605.01, Franklin County, North Carolina",7599,74068,5140,1450,15,114,0,584,67.6,19.1,0.2,1.5,0,7.7,32.4,2860,2205,655,77.1,22.9,218,1987,72,583,290,2570,9.9,11,10.1,"25% - 50% P.O.C.","$56000 - $78000"
"37069060502","Census Tract 605.02, Franklin County, North Carolina",8934,84401,6939,1146,19,100,0,554,77.7,12.8,0.2,1.1,0,6.2,22.3,3341,2797,544,83.72,16.28,275,2522,42,502,317,3024,9.8,7.7,9.5,"Less than 25% P.O.C.","$78000 or more"
"37069060600","Census Tract 606, Franklin County, North Carolina",9200,60802,6844,1379,29,0,0,643,74.4,15,0.3,0,0,7,25.6,3478,2640,838,75.91,24.09,225,2415,96,742,321,3157,8.5,11.5,9.2,"25% - 50% P.O.C.","$56000 - $78000"
"37069060700","Census Tract 607, Franklin County, North Carolina",6391,55222,4180,1530,23,44,0,591,65.4,23.9,0.4,0.7,0,9.2,34.6,2427,1888,539,77.79,22.21,166,1722,80,459,246,2181,8.8,14.8,10.1,"25% - 50% P.O.C.","$42000 - $56000"
"37069060801","Census Tract 608.01, Franklin County, North Carolina",4102,51736,2675,770,34,0,2,510,65.2,18.8,0.8,0,0,12.4,34.8,1407,1057,350,75.12,24.88,62,995,22,328,84,1323,5.9,6.3,6,"25% - 50% P.O.C.","$42000 - $56000"
"37069060802","Census Tract 608.02, Franklin County, North Carolina",5105,48708,3758,613,27,0,0,670,73.6,12,0.5,0,0,13.1,26.4,1973,1383,590,70.1,29.9,58,1325,82,508,140,1833,4.2,13.9,7.1,"25% - 50% P.O.C.","$42000 - $56000"
"37077970101","Census Tract 9701.01, Granville County, North Carolina",4876,55640,3150,1549,15,0,0,88,64.6,31.8,0.3,0,0,1.8,35.4,1894,1402,492,74.02,25.98,65,1337,29,463,94,1800,4.6,5.9,5,"25% - 50% P.O.C.","$42000 - $56000"
"37077970102","Census Tract 9701.02, Granville County, North Carolina",3580,46045,1919,1168,0,19,0,249,53.6,32.6,0,0.5,0,7,46.4,1388,1045,343,75.29,24.71,44,1001,54,289,98,1290,4.2,15.7,7.1,"25% - 50% P.O.C.","$42000 - $56000"
"37077970200","Census Tract 9702, Granville County, North Carolina",4820,54127,1967,2517,11,11,0,267,40.8,52.2,0.2,0.2,0,5.5,59.2,1514,954,560,63.01,36.99,101,853,77,483,178,1336,10.6,13.8,11.8,"50% - 75% P.O.C.","$42000 - $56000"
"37077970300","Census Tract 9703, Granville County, North Carolina",3529,38681,1683,1315,18,38,0,288,47.7,37.3,0.5,1.1,0,8.2,52.3,1501,881,620,58.69,41.31,27,854,22,598,49,1452,3.1,3.5,3.3,"50% - 75% P.O.C.","Less than $42000"
"37077970400","Census Tract 9704, Granville County, North Carolina",3753,40205,973,2533,20,13,0,137,25.9,67.5,0.5,0.3,0,3.7,74.1,1633,642,991,39.31,60.69,48,594,74,917,122,1511,7.5,7.5,7.5,"50% - 75% P.O.C.","Less than $42000"
"37077970500","Census Tract 9705, Granville County, North Carolina",4265,55458,1890,1463,76,0,0,709,44.3,34.3,1.8,0,0,16.6,55.7,1618,1330,288,82.2,17.8,176,1154,11,277,187,1431,13.2,3.8,11.6,"50% - 75% P.O.C.","$42000 - $56000"
"37077970601","Census Tract 9706.01, Granville County, North Carolina",5433,69565,4359,785,0,0,0,157,80.2,14.4,0,0,0,2.9,19.8,2068,1693,375,81.87,18.13,194,1499,0,375,194,1874,11.5,0,9.4,"Less than 25% P.O.C.","$56000 - $78000"
"37077970602","Census Tract 9706.02, Granville County, North Carolina",8553,76051,6169,1130,0,92,0,864,72.1,13.2,0,1.1,0,10.1,27.9,3201,2723,478,85.07,14.93,325,2398,0,478,325,2876,11.9,0,10.2,"25% - 50% P.O.C.","$56000 - $78000"
"37077970603","Census Tract 9706.03, Granville County, North Carolina",6810,67548,4443,1417,18,111,0,537,65.2,20.8,0.3,1.6,0,7.9,34.8,2639,1918,721,72.68,27.32,123,1795,72,649,195,2444,6.4,10,7.4,"25% - 50% P.O.C.","$56000 - $78000"
"37077970701","Census Tract 9707.01, Granville County, North Carolina",5466,70574,4115,798,0,0,0,352,75.3,14.6,0,0,0,6.4,24.7,1959,1685,274,86.01,13.99,130,1555,0,274,130,1829,7.7,0,6.6,"Less than 25% P.O.C.","$56000 - $78000"
"37077970702","Census Tract 9707.02, Granville County, North Carolina",2615,39901,1135,932,29,8,0,511,43.4,35.6,1.1,0.3,0,19.5,56.6,829,479,350,57.78,42.22,26,453,17,333,43,786,5.4,4.9,5.2,"50% - 75% P.O.C.","Less than $42000"
"37077970703","Census Tract 9707.03, Granville County, North Carolina",4389,38716,2002,1663,19,20,42,426,45.6,37.9,0.4,0.5,1,9.7,54.4,1156,688,468,59.52,40.48,70,618,10,458,80,1076,10.2,2.1,6.9,"50% - 75% P.O.C.","Less than $42000"
"37077970704","Census Tract 9707.04, Granville County, North Carolina",1239,NA,603,397,14,0,0,130,48.7,32,1.1,0,0,10.5,51.3,0,0,0,NA,NA,0,0,0,0,0,0,NA,NA,NA,"50% - 75% P.O.C.","N/A"
"37083930100","Census Tract 9301, Halifax County, North Carolina",3246,30969,743,2474,0,0,0,12,22.9,76.2,0,0,0,0.4,77.1,1328,678,650,51.05,48.95,26,652,152,498,178,1150,3.8,23.4,13.4,"75% or more P.O.C.","Less than $42000"
"37083930200","Census Tract 9302, Halifax County, North Carolina",4617,48094,3109,1111,33,127,0,174,67.3,24.1,0.7,2.8,0,3.8,32.7,2182,1214,968,55.64,44.36,110,1104,60,908,170,2012,9.1,6.2,7.8,"25% - 50% P.O.C.","$42000 - $56000"
"37083930300","Census Tract 9303, Halifax County, North Carolina",4300,40227,2827,1049,114,46,43,158,65.7,24.4,2.7,1.1,1,3.7,34.3,1668,763,905,45.74,54.26,31,732,106,799,137,1531,4.1,11.7,8.2,"25% - 50% P.O.C.","Less than $42000"
"37083930400","Census Tract 9304, Halifax County, North Carolina",4005,32162,1781,1567,1,106,0,531,44.5,39.1,0,2.6,0,13.3,55.5,1382,582,800,42.11,57.89,53,529,139,661,192,1190,9.1,17.4,13.9,"50% - 75% P.O.C.","Less than $42000"
"37083930501","Census Tract 9305.01, Halifax County, North Carolina",3675,34756,1674,1916,28,0,0,0,45.6,52.1,0.8,0,0,0,54.4,1614,988,626,61.21,38.79,79,909,14,612,93,1521,8,2.2,5.8,"50% - 75% P.O.C.","Less than $42000"
"37083930502","Census Tract 9305.02, Halifax County, North Carolina",5170,34750,2260,2709,0,18,0,143,43.7,52.4,0,0.3,0,2.8,56.3,2225,1512,713,67.96,32.04,102,1410,0,713,102,2123,6.7,0,4.6,"50% - 75% P.O.C.","Less than $42000"
"37083930600","Census Tract 9306, Halifax County, North Carolina",4333,37900,1479,2818,36,0,0,0,34.1,65,0.8,0,0,0,65.9,1748,1193,555,68.25,31.75,168,1025,33,522,201,1547,14.1,5.9,11.5,"50% - 75% P.O.C.","Less than $42000"
"37083930700","Census Tract 9307, Halifax County, North Carolina",4059,45600,2151,1685,31,0,0,159,53,41.5,0.8,0,0,3.9,47,1804,1472,332,81.6,18.4,26,1446,2,330,28,1776,1.8,0.6,1.6,"25% - 50% P.O.C.","$42000 - $56000"
"37083930800","Census Tract 9308, Halifax County, North Carolina",5047,31139,569,2439,1456,60,6,146,11.3,48.3,28.8,1.2,0.1,2.9,88.7,2043,1459,584,71.41,28.59,93,1366,57,527,150,1893,6.4,9.8,7.3,"75% or more P.O.C.","Less than $42000"
"37083930900","Census Tract 9309, Halifax County, North Carolina",5051,29375,720,4255,38,0,9,0,14.3,84.2,0.8,0,0.2,0,85.7,2073,1162,911,56.05,43.95,77,1085,129,782,206,1867,6.6,14.2,9.9,"75% or more P.O.C.","Less than $42000"
"37083931000","Census Tract 9310, Halifax County, North Carolina",3168,29854,824,2065,31,9,16,87,26,65.2,1,0.3,0.5,2.7,74,1027,762,265,74.2,25.8,36,726,26,239,62,965,4.7,9.8,6,"50% - 75% P.O.C.","Less than $42000"
"37083931100","Census Tract 9311, Halifax County, North Carolina",4519,34375,1520,2843,32,8,0,65,33.6,62.9,0.7,0.2,0,1.4,66.4,1923,1377,546,71.61,28.39,54,1323,47,499,101,1822,3.9,8.6,5.3,"50% - 75% P.O.C.","Less than $42000"
"37085070100","Census Tract 701, Harnett County, North Carolina",4642,32139,2767,1411,60,5,0,247,59.6,30.4,1.3,0.1,0,5.3,40.4,1797,1011,786,56.26,43.74,51,960,62,724,113,1684,5,7.9,6.3,"25% - 50% P.O.C.","Less than $42000"
"37085070200","Census Tract 702, Harnett County, North Carolina",3053,28583,1339,1459,34,0,0,216,43.9,47.8,1.1,0,0,7.1,56.1,1343,753,590,56.07,43.93,31,722,50,540,81,1262,4.1,8.5,6,"50% - 75% P.O.C.","Less than $42000"
"37085070300","Census Tract 703, Harnett County, North Carolina",5062,35634,2984,1523,42,25,0,445,58.9,30.1,0.8,0.5,0,8.8,41.1,2112,1154,958,54.64,45.36,26,1128,96,862,122,1990,2.3,10,5.8,"25% - 50% P.O.C.","Less than $42000"
"37085070401","Census Tract 704.01, Harnett County, North Carolina",3904,47868,2838,450,5,3,0,444,72.7,11.5,0.1,0.1,0,11.4,27.3,1546,1149,397,74.32,25.68,90,1059,36,361,126,1420,7.8,9.1,8.2,"25% - 50% P.O.C.","$42000 - $56000"
"37085070402","Census Tract 704.02, Harnett County, North Carolina",6773,43117,4531,980,62,0,0,1088,66.9,14.5,0.9,0,0,16.1,33.1,2526,1401,1125,55.46,44.54,55,1346,199,926,254,2272,3.9,17.7,10.1,"25% - 50% P.O.C.","$42000 - $56000"
"37085070500","Census Tract 705, Harnett County, North Carolina",6224,41190,4237,1234,30,18,0,542,68.1,19.8,0.5,0.3,0,8.7,31.9,2429,1625,804,66.9,33.1,132,1493,82,722,214,2215,8.1,10.2,8.8,"25% - 50% P.O.C.","Less than $42000"
"37085070600","Census Tract 706, Harnett County, North Carolina",4520,43153,1991,2212,65,0,0,135,44,48.9,1.4,0,0,3,56,1766,1271,495,71.97,28.03,131,1140,39,456,170,1596,10.3,7.9,9.6,"50% - 75% P.O.C.","$42000 - $56000"
"37085070700","Census Tract 707, Harnett County, North Carolina",5321,43229,2783,1801,73,19,0,409,52.3,33.8,1.4,0.4,0,7.7,47.7,1615,987,628,61.11,38.89,107,880,30,598,137,1478,10.8,4.8,8.5,"25% - 50% P.O.C.","$42000 - $56000"
"37085070801","Census Tract 708.01, Harnett County, North Carolina",2430,51753,1652,140,13,42,0,560,68,5.8,0.5,1.7,0,23,32,899,665,234,73.97,26.03,85,580,24,210,109,790,12.8,10.3,12.1,"25% - 50% P.O.C.","$42000 - $56000"
"37085070802","Census Tract 708.02, Harnett County, North Carolina",4924,45993,3532,604,14,227,0,526,71.7,12.3,0.3,4.6,0,10.7,28.3,1259,649,610,51.55,48.45,26,623,39,571,65,1194,4,6.4,5.2,"25% - 50% P.O.C.","$42000 - $56000"
"37085070901","Census Tract 709.01, Harnett County, North Carolina",3103,52618,1710,446,21,25,0,751,55.1,14.4,0.7,0.8,0,24.2,44.9,1149,937,212,81.55,18.45,168,769,8,204,176,973,17.9,3.8,15.3,"25% - 50% P.O.C.","$42000 - $56000"
"37085070902","Census Tract 709.02, Harnett County, North Carolina",2779,44741,1735,98,14,0,0,854,62.4,3.5,0.5,0,0,30.7,37.6,1043,742,301,71.14,28.86,61,681,24,277,85,958,8.2,8,8.1,"25% - 50% P.O.C.","$42000 - $56000"
"37085070903","Census Tract 709.03, Harnett County, North Carolina",2186,54679,1620,231,0,0,0,309,74.1,10.6,0,0,0,14.1,25.9,850,568,282,66.82,33.18,31,537,30,252,61,789,5.5,10.6,7.2,"25% - 50% P.O.C.","$42000 - $56000"
"37085070904","Census Tract 709.04, Harnett County, North Carolina",3785,54315,2097,829,25,0,0,796,55.4,21.9,0.7,0,0,21,44.6,1358,899,459,66.2,33.8,75,824,54,405,129,1229,8.3,11.8,9.5,"25% - 50% P.O.C.","$42000 - $56000"
"37085071001","Census Tract 710.01, Harnett County, North Carolina",5517,73348,4296,349,19,44,0,563,77.9,6.3,0.3,0.8,0,10.2,22.1,1960,1597,363,81.48,18.52,203,1394,0,363,203,1757,12.7,0,10.4,"Less than 25% P.O.C.","$56000 - $78000"
"37085071002","Census Tract 710.02, Harnett County, North Carolina",3524,66810,2732,273,46,0,0,401,77.5,7.7,1.3,0,0,11.4,22.5,1264,1123,141,88.84,11.16,147,976,0,141,147,1117,13.1,0,11.6,"Less than 25% P.O.C.","$56000 - $78000"
"37085071101","Census Tract 711.01, Harnett County, North Carolina",3677,46118,2534,427,0,9,0,667,68.9,11.6,0,0.2,0,18.1,31.1,1327,979,348,73.78,26.22,108,871,71,277,179,1148,11,20.4,13.5,"25% - 50% P.O.C.","$42000 - $56000"
"37085071102","Census Tract 711.02, Harnett County, North Carolina",5228,52267,3040,1489,0,0,0,683,58.1,28.5,0,0,0,13.1,41.9,1751,1319,432,75.33,24.67,74,1245,83,349,157,1594,5.6,19.2,9,"25% - 50% P.O.C.","$42000 - $56000"
"37085071201","Census Tract 712.01, Harnett County, North Carolina",2962,50000,1849,489,10,24,0,476,62.4,16.5,0.3,0.8,0,16.1,37.6,1010,658,352,65.15,34.85,102,556,36,316,138,872,15.5,10.2,13.7,"25% - 50% P.O.C.","$42000 - $56000"
"37085071202","Census Tract 712.02, Harnett County, North Carolina",5265,53409,2299,1414,64,24,88,1142,43.7,26.9,1.2,0.5,1.7,21.7,56.3,1626,906,720,55.72,44.28,158,748,117,603,275,1351,17.4,16.2,16.9,"50% - 75% P.O.C.","$42000 - $56000"
"37085071203","Census Tract 712.03, Harnett County, North Carolina",2654,56875,1030,907,31,22,0,528,38.8,34.2,1.2,0.8,0,19.9,61.2,784,447,337,57.02,42.98,113,334,45,292,158,626,25.3,13.4,20.2,"50% - 75% P.O.C.","$56000 - $78000"
"37085071204","Census Tract 712.04, Harnett County, North Carolina",7288,79466,4354,1381,117,160,22,767,59.7,18.9,1.6,2.2,0.3,10.5,40.3,2328,1782,546,76.55,23.45,206,1576,100,446,306,2022,11.6,18.3,13.1,"25% - 50% P.O.C.","$78000 or more"
"37085071301","Census Tract 713.01, Harnett County, North Carolina",3995,60865,2371,848,87,0,0,480,59.3,21.2,2.2,0,0,12,40.7,1401,1072,329,76.52,23.48,113,959,108,221,221,1180,10.5,32.8,15.8,"25% - 50% P.O.C.","$56000 - $78000"
"37085071302","Census Tract 713.02, Harnett County, North Carolina",5926,61708,3781,1265,130,81,43,466,63.8,21.3,2.2,1.4,0.7,7.9,36.2,2029,1237,792,60.97,39.03,147,1090,143,649,290,1739,11.9,18.1,14.3,"25% - 50% P.O.C.","$56000 - $78000"
"37085071303","Census Tract 713.03, Harnett County, North Carolina",11556,85964,6931,2465,14,484,0,815,60,21.3,0.1,4.2,0,7.1,40,3646,2569,1077,70.46,29.54,315,2254,100,977,415,3231,12.3,9.3,11.4,"25% - 50% P.O.C.","$78000 or more"
"37085071401","Census Tract 714.01, Harnett County, North Carolina",4383,48321,2594,735,0,0,0,977,59.2,16.8,0,0,0,22.3,40.8,1509,1054,455,69.85,30.15,80,974,103,352,183,1326,7.6,22.6,12.1,"25% - 50% P.O.C.","$42000 - $56000"
"37085071402","Census Tract 714.02, Harnett County, North Carolina",11602,62842,7511,1544,59,170,45,1602,64.7,13.3,0.5,1.5,0.4,13.8,35.3,3089,1134,1955,36.71,63.29,97,1037,544,1411,641,2448,8.6,27.8,20.8,"25% - 50% P.O.C.","$56000 - $78000"
"37093970101","Census Tract 9701.01, Hoke County, North Carolina",10537,50911,3772,4186,150,150,27,1730,35.8,39.7,1.4,1.4,0.3,16.4,64.2,3356,2086,1270,62.16,37.84,352,1734,102,1168,454,2902,16.9,8,13.5,"50% - 75% P.O.C.","$42000 - $56000"
"37093970102","Census Tract 9701.02, Hoke County, North Carolina",13195,62932,6191,4450,17,330,0,1726,46.9,33.7,0.1,2.5,0,13.1,53.1,4263,2720,1543,63.8,36.2,378,2342,243,1300,621,3642,13.9,15.7,14.6,"50% - 75% P.O.C.","$56000 - $78000"
"37093970103","Census Tract 9701.03, Hoke County, North Carolina",8644,60601,4466,2050,298,163,17,1365,51.7,23.7,3.4,1.9,0.2,15.8,48.3,2965,2194,771,74,26,179,2015,95,676,274,2691,8.2,12.3,9.2,"25% - 50% P.O.C.","$56000 - $78000"
"37093970201","Census Tract 9702.01, Hoke County, North Carolina",5193,39178,2636,1593,370,46,0,204,50.8,30.7,7.1,0.9,0,3.9,49.2,1557,1193,364,76.62,23.38,61,1132,42,322,103,1454,5.1,11.5,6.6,"25% - 50% P.O.C.","Less than $42000"
"37093970202","Census Tract 9702.02, Hoke County, North Carolina",4224,41684,1566,1449,609,33,0,420,37.1,34.3,14.4,0.8,0,9.9,62.9,1370,893,477,65.18,34.82,58,835,27,450,85,1285,6.5,5.7,6.2,"50% - 75% P.O.C.","Less than $42000"
"37093970300","Census Tract 9703, Hoke County, North Carolina",5237,32097,1325,2623,308,0,0,668,25.3,50.1,5.9,0,0,12.8,74.7,2054,1283,771,62.46,37.54,43,1240,45,726,88,1966,3.4,5.8,4.3,"50% - 75% P.O.C.","Less than $42000"
"37093970401","Census Tract 9704.01, Hoke County, North Carolina",3682,37049,1329,563,1297,5,0,266,36.1,15.3,35.2,0.1,0,7.2,63.9,1223,839,384,68.6,31.4,48,791,81,303,129,1094,5.7,21.1,10.5,"50% - 75% P.O.C.","Less than $42000"
"37093970402","Census Tract 9704.02, Hoke County, North Carolina",3245,27007,234,920,1170,89,0,819,7.2,28.4,36.1,2.7,0,25.2,92.8,1011,728,283,72.01,27.99,111,617,39,244,150,861,15.2,13.8,14.8,"75% or more P.O.C.","Less than $42000"
"37093980100","Census Tract 9801, Hoke County, North Carolina",0,NA,0,0,0,0,0,0,NA,NA,NA,NA,NA,NA,NA,0,0,0,NA,NA,0,0,0,0,0,0,NA,NA,NA,"N/A","N/A"
"37101040100","Census Tract 401, Johnston County, North Carolina",7209,40755,4883,1144,11,8,0,974,67.7,15.9,0.2,0.1,0,13.5,32.3,2743,1673,1070,60.99,39.01,241,1432,61,1009,302,2441,14.4,5.7,11,"25% - 50% P.O.C.","Less than $42000"
"37101040201","Census Tract 402.01, Johnston County, North Carolina",6361,52814,3759,1332,0,38,11,1187,59.1,20.9,0,0.6,0.2,18.7,40.9,2203,1787,416,81.12,18.88,179,1608,162,254,341,1862,10,38.9,15.5,"25% - 50% P.O.C.","$42000 - $56000"
"37101040202","Census Tract 402.02, Johnston County, North Carolina",7060,61164,5055,506,34,51,0,1221,71.6,7.2,0.5,0.7,0,17.3,28.4,2552,2095,457,82.09,17.91,248,1847,48,409,296,2256,11.8,10.5,11.6,"25% - 50% P.O.C.","$56000 - $78000"
"37101040203","Census Tract 402.03, Johnston County, North Carolina",19761,85166,15025,1958,181,137,58,1719,76,9.9,0.9,0.7,0.3,8.7,24,6789,5668,1121,83.49,16.51,594,5074,157,964,751,6038,10.5,14,11.1,"Less than 25% P.O.C.","$78000 or more"
"37101040301","Census Tract 403.01, Johnston County, North Carolina",4899,30435,1858,1644,0,20,0,1354,37.9,33.6,0,0.4,0,27.6,62.1,1730,855,875,49.42,50.58,30,825,178,697,208,1522,3.5,20.3,12,"50% - 75% P.O.C.","Less than $42000"
"37101040302","Census Tract 403.02, Johnston County, North Carolina",5573,39837,2206,1875,19,0,0,1407,39.6,33.6,0.3,0,0,25.2,60.4,1901,939,962,49.4,50.6,124,815,136,826,260,1641,13.2,14.1,13.7,"50% - 75% P.O.C.","Less than $42000"
"37101040400","Census Tract 404, Johnston County, North Carolina",4422,51830,3217,498,0,0,0,641,72.7,11.3,0,0,0,14.5,27.3,1677,1226,451,73.11,26.89,88,1138,18,433,106,1571,7.2,4,6.3,"25% - 50% P.O.C.","$42000 - $56000"
"37101040500","Census Tract 405, Johnston County, North Carolina",6673,43573,5412,402,15,12,0,709,81.1,6,0.2,0.2,0,10.6,18.9,2577,1656,921,64.26,35.74,184,1472,77,844,261,2316,11.1,8.4,10.1,"Less than 25% P.O.C.","$42000 - $56000"
"37101040600","Census Tract 406, Johnston County, North Carolina",3821,31111,1698,1128,0,0,0,815,44.4,29.5,0,0,0,21.3,55.6,1380,743,637,53.84,46.16,98,645,96,541,194,1186,13.2,15.1,14.1,"50% - 75% P.O.C.","Less than $42000"
"37101040700","Census Tract 407, Johnston County, North Carolina",3901,40594,2126,1058,0,31,0,656,54.5,27.1,0,0.8,0,16.8,45.5,1547,781,766,50.48,49.52,62,719,21,745,83,1464,7.9,2.7,5.4,"25% - 50% P.O.C.","Less than $42000"
"37101040800","Census Tract 408, Johnston County, North Carolina",3807,41375,2403,784,20,0,0,545,63.1,20.6,0.5,0,0,14.3,36.9,1633,875,758,53.58,46.42,36,839,80,678,116,1517,4.1,10.6,7.1,"25% - 50% P.O.C.","Less than $42000"
"37101040901","Census Tract 409.01, Johnston County, North Carolina",11817,72658,7652,1930,38,65,0,1863,64.8,16.3,0.3,0.6,0,15.8,35.2,3753,3188,565,84.95,15.05,368,2820,76,489,444,3309,11.5,13.5,11.8,"25% - 50% P.O.C.","$56000 - $78000"
"37101040902","Census Tract 409.02, Johnston County, North Carolina",7895,60513,5475,1033,18,55,0,746,69.3,13.1,0.2,0.7,0,9.4,30.7,2438,1688,750,69.24,30.76,376,1312,72,678,448,1990,22.3,9.6,18.4,"25% - 50% P.O.C.","$56000 - $78000"
"37101041001","Census Tract 410.01, Johnston County, North Carolina",9273,55435,4428,2921,19,70,0,1547,47.8,31.5,0.2,0.8,0,16.7,52.2,3168,1988,1180,62.75,37.25,285,1703,190,990,475,2693,14.3,16.1,15,"50% - 75% P.O.C.","$42000 - $56000"
"37101041002","Census Tract 410.02, Johnston County, North Carolina",8918,60474,5576,1866,29,75,0,1302,62.5,20.9,0.3,0.8,0,14.6,37.5,3492,2150,1342,61.57,38.43,215,1935,149,1193,364,3128,10,11.1,10.4,"25% - 50% P.O.C.","$56000 - $78000"
"37101041101","Census Tract 411.01, Johnston County, North Carolina",8118,72034,5985,1143,1,0,0,805,73.7,14.1,0,0,0,9.9,26.3,3041,2520,521,82.87,17.13,314,2206,26,495,340,2701,12.5,5,11.2,"25% - 50% P.O.C.","$56000 - $78000"
"37101041102","Census Tract 411.02, Johnston County, North Carolina",14095,86393,10425,2066,284,157,0,997,74,14.7,2,1.1,0,7.1,26,4779,3927,852,82.17,17.83,403,3524,19,833,422,4357,10.3,2.2,8.8,"25% - 50% P.O.C.","$78000 or more"
"37101041103","Census Tract 411.03, Johnston County, North Carolina",15881,83536,12118,2137,20,244,0,1115,76.3,13.5,0.1,1.5,0,7,23.7,5316,4449,867,83.69,16.31,381,4068,142,725,523,4793,8.6,16.4,9.8,"Less than 25% P.O.C.","$78000 or more"
"37101041201","Census Tract 412.01, Johnston County, North Carolina",4153,53413,2656,516,0,20,0,961,64,12.4,0,0.5,0,23.1,36,1546,969,577,62.68,37.32,88,881,63,514,151,1395,9.1,10.9,9.8,"25% - 50% P.O.C.","$42000 - $56000"
"37101041202","Census Tract 412.02, Johnston County, North Carolina",5241,45064,3233,590,42,32,0,1278,61.7,11.3,0.8,0.6,0,24.4,38.3,1694,958,736,56.55,43.45,84,874,101,635,185,1509,8.8,13.7,10.9,"25% - 50% P.O.C.","$42000 - $56000"
"37101041300","Census Tract 413, Johnston County, North Carolina",6502,43295,5378,96,0,0,0,988,82.7,1.5,0,0,0,15.2,17.3,2189,1743,446,79.63,20.37,154,1589,59,387,213,1976,8.8,13.2,9.7,"Less than 25% P.O.C.","$42000 - $56000"
"37101041400","Census Tract 414, Johnston County, North Carolina",7159,37397,4137,1609,0,16,0,1336,57.8,22.5,0,0.2,0,18.7,42.2,2520,1644,876,65.24,34.76,200,1444,63,813,263,2257,12.2,7.2,10.4,"25% - 50% P.O.C.","Less than $42000"
"37101041501","Census Tract 415.01, Johnston County, North Carolina",7603,62560,6192,571,0,44,0,624,81.4,7.5,0,0.6,0,8.2,18.6,2710,2136,574,78.82,21.18,252,1884,70,504,322,2388,11.8,12.2,11.9,"Less than 25% P.O.C.","$56000 - $78000"
"37101041502","Census Tract 415.02, Johnston County, North Carolina",8365,75406,6269,1206,28,74,0,697,74.9,14.4,0.3,0.9,0,8.3,25.1,2905,2495,410,85.89,14.11,255,2240,117,293,372,2533,10.2,28.5,12.8,"25% - 50% P.O.C.","$56000 - $78000"
"37101041503","Census Tract 415.03, Johnston County, North Carolina",8363,62132,6312,408,140,93,0,1294,75.5,4.9,1.7,1.1,0,15.5,24.5,2685,2183,502,81.3,18.7,246,1937,89,413,335,2350,11.3,17.7,12.5,"Less than 25% P.O.C.","$56000 - $78000"
"37105030101","Census Tract 301.01, Lee County, North Carolina",5490,46154,2932,1027,0,65,0,1426,53.4,18.7,0,1.2,0,26,46.6,1928,823,1105,42.69,57.31,203,620,43,1062,246,1682,24.7,3.9,12.8,"25% - 50% P.O.C.","$42000 - $56000"
"37105030102","Census Tract 301.02, Lee County, North Carolina",5486,62578,4353,508,0,36,0,547,79.3,9.3,0,0.7,0,10,20.7,2319,1890,429,81.5,18.5,58,1832,36,393,94,2225,3.1,8.4,4.1,"Less than 25% P.O.C.","$56000 - $78000"
"37105030200","Census Tract 302, Lee County, North Carolina",3304,23438,699,1103,6,0,0,1374,21.2,33.4,0.2,0,0,41.6,78.8,1090,299,791,27.43,72.57,43,256,100,691,143,947,14.4,12.6,13.1,"75% or more P.O.C.","Less than $42000"
"37105030300","Census Tract 303, Lee County, North Carolina",3015,22917,329,1647,0,0,0,1004,10.9,54.6,0,0,0,33.3,89.1,914,367,547,40.15,59.85,34,333,31,516,65,849,9.3,5.7,7.1,"75% or more P.O.C.","Less than $42000"
"37105030401","Census Tract 304.01, Lee County, North Carolina",4011,41296,1021,1409,0,0,0,1453,25.5,35.1,0,0,0,36.2,74.5,1332,817,515,61.34,38.66,107,710,69,446,176,1156,13.1,13.4,13.2,"50% - 75% P.O.C.","Less than $42000"
"37105030402","Census Tract 304.02, Lee County, North Carolina",7509,38191,2209,2445,0,382,0,2456,29.4,32.6,0,5.1,0,32.7,70.6,2554,1530,1024,59.91,40.09,243,1287,138,886,381,2173,15.9,13.5,14.9,"50% - 75% P.O.C.","Less than $42000"
"37105030501","Census Tract 305.01, Lee County, North Carolina",4736,56765,3585,408,25,113,0,536,75.7,8.6,0.5,2.4,0,11.3,24.3,1936,1484,452,76.65,23.35,95,1389,31,421,126,1810,6.4,6.9,6.5,"Less than 25% P.O.C.","$56000 - $78000"
"37105030502","Census Tract 305.02, Lee County, North Carolina",2038,44464,1127,290,0,0,0,609,55.3,14.2,0,0,0,29.9,44.7,725,524,201,72.28,27.72,57,467,22,179,79,646,10.9,10.9,10.9,"25% - 50% P.O.C.","$42000 - $56000"
"37105030503","Census Tract 305.03, Lee County, North Carolina",7292,45519,5073,810,349,17,0,1026,69.6,11.1,4.8,0.2,0,14.1,30.4,2547,1885,662,74.01,25.99,65,1820,104,558,169,2378,3.4,15.7,6.6,"25% - 50% P.O.C.","$42000 - $56000"
"37105030601","Census Tract 306.01, Lee County, North Carolina",3141,92521,2646,303,22,11,0,118,84.2,9.6,0.7,0.4,0,3.8,15.8,1161,1063,98,91.56,8.44,68,995,6,92,74,1087,6.4,6.1,6.4,"Less than 25% P.O.C.","$78000 or more"
"37105030602","Census Tract 306.02, Lee County, North Carolina",5058,73345,4154,476,29,27,31,252,82.1,9.4,0.6,0.5,0.6,5,17.9,1846,1442,404,78.11,21.89,110,1332,8,396,118,1728,7.6,2,6.4,"Less than 25% P.O.C.","$56000 - $78000"
"37105030701","Census Tract 307.01, Lee County, North Carolina",5007,57750,3641,898,9,6,0,420,72.7,17.9,0.2,0.1,0,8.4,27.3,1852,1193,659,64.42,35.58,158,1035,9,650,167,1685,13.2,1.4,9,"25% - 50% P.O.C.","$56000 - $78000"
"37105030702","Census Tract 307.02, Lee County, North Carolina",4394,50227,3387,468,2,69,0,363,77.1,10.7,0,1.6,0,8.3,22.9,1690,1284,406,75.98,24.02,52,1232,53,353,105,1585,4,13.1,6.2,"Less than 25% P.O.C.","$42000 - $56000"
"37125950100","Census Tract 9501, Moore County, North Carolina",3042,46518,2537,217,0,0,0,288,83.4,7.1,0,0,0,9.5,16.6,1223,1098,125,89.78,10.22,88,1010,0,125,88,1135,8,0,7.2,"Less than 25% P.O.C.","$42000 - $56000"
"37125950200","Census Tract 9502, Moore County, North Carolina",8237,40000,5413,562,0,64,0,2066,65.7,6.8,0,0.8,0,25.1,34.3,3030,2327,703,76.8,23.2,238,2089,86,617,324,2706,10.2,12.2,10.7,"25% - 50% P.O.C.","Less than $42000"
"37125950301","Census Tract 9503.01, Moore County, North Carolina",6555,62113,5194,774,0,144,0,347,79.2,11.8,0,2.2,0,5.3,20.8,2639,2239,400,84.84,15.16,61,2178,21,379,82,2557,2.7,5.2,3.1,"Less than 25% P.O.C.","$56000 - $78000"
"37125950302","Census Tract 9503.02, Moore County, North Carolina",5014,82434,4073,647,69,26,0,67,81.2,12.9,1.4,0.5,0,1.3,18.8,2061,1814,247,88.02,11.98,130,1684,0,247,130,1931,7.2,0,6.3,"Less than 25% P.O.C.","$78000 or more"
"37125950401","Census Tract 9504.01, Moore County, North Carolina",3578,43333,3352,106,0,23,0,39,93.7,3,0,0.6,0,1.1,6.3,1620,1360,260,83.95,16.05,64,1296,0,260,64,1556,4.7,0,4,"Less than 25% P.O.C.","$42000 - $56000"
"37125950402","Census Tract 9504.02, Moore County, North Carolina",5016,54676,3716,695,18,0,0,435,74.1,13.9,0.4,0,0,8.7,25.9,1862,1527,335,82.01,17.99,164,1363,67,268,231,1631,10.7,20,12.4,"25% - 50% P.O.C.","$42000 - $56000"
"37125950501","Census Tract 9505.01, Moore County, North Carolina",6988,70579,5212,971,276,69,0,252,74.6,13.9,3.9,1,0,3.6,25.4,2725,2040,685,74.86,25.14,124,1916,11,674,135,2590,6.1,1.6,5,"25% - 50% P.O.C.","$56000 - $78000"
"37125950502","Census Tract 9505.02, Moore County, North Carolina",9026,67863,7635,311,26,161,0,738,84.6,3.4,0.3,1.8,0,8.2,15.4,3361,2887,474,85.9,14.1,346,2541,33,441,379,2982,12,7,11.3,"Less than 25% P.O.C.","$56000 - $78000"
"37125950601","Census Tract 9506.01, Moore County, North Carolina",3831,99917,3627,35,5,88,0,37,94.7,0.9,0.1,2.3,0,1,5.3,1665,1493,172,89.67,10.33,21,1472,0,172,21,1644,1.4,0,1.3,"Less than 25% P.O.C.","$78000 or more"
"37125950602","Census Tract 9506.02, Moore County, North Carolina",6956,66165,5427,861,0,183,0,376,78,12.4,0,2.6,0,5.4,22,3013,2455,558,81.48,18.52,159,2296,58,500,217,2796,6.5,10.4,7.2,"Less than 25% P.O.C.","$56000 - $78000"
"37125950701","Census Tract 9507.01, Moore County, North Carolina",5019,68295,4240,402,0,102,15,194,84.5,8,0,2,0.3,3.9,15.5,2441,1900,541,77.84,22.16,12,1888,17,524,29,2412,0.6,3.1,1.2,"Less than 25% P.O.C.","$56000 - $78000"
"37125950702","Census Tract 9507.02, Moore County, North Carolina",2773,82407,2406,230,51,0,19,33,86.8,8.3,1.8,0,0.7,1.2,13.2,1234,1015,219,82.25,17.75,70,945,33,186,103,1131,6.9,15.1,8.3,"Less than 25% P.O.C.","$78000 or more"
"37125950801","Census Tract 9508.01, Moore County, North Carolina",5440,41815,2734,2236,12,175,0,259,50.3,41.1,0.2,3.2,0,4.8,49.7,2110,1131,979,53.6,46.4,70,1061,66,913,136,1974,6.2,6.7,6.4,"25% - 50% P.O.C.","Less than $42000"
"37125950802","Census Tract 9508.02, Moore County, North Carolina",3717,57891,3480,132,4,20,0,52,93.6,3.6,0.1,0.5,0,1.4,6.4,1899,1151,748,60.61,39.39,10,1141,0,748,10,1889,0.9,0,0.5,"Less than 25% P.O.C.","$56000 - $78000"
"37125950900","Census Tract 9509, Moore County, North Carolina",2528,47371,2079,274,6,30,34,77,82.2,10.8,0.2,1.2,1.3,3,17.8,1376,607,769,44.11,55.89,25,582,10,759,35,1341,4.1,1.3,2.5,"Less than 25% P.O.C.","$42000 - $56000"
"37125951000","Census Tract 9510, Moore County, North Carolina",5453,81591,4797,258,0,0,0,286,88,4.7,0,0,0,5.2,12,2194,1489,705,67.87,32.13,141,1348,48,657,189,2005,9.5,6.8,8.6,"Less than 25% P.O.C.","$78000 or more"
"37125951100","Census Tract 9511, Moore County, North Carolina",8854,57839,5885,1967,80,154,0,558,66.5,22.2,0.9,1.7,0,6.3,33.5,3488,2276,1212,65.25,34.75,250,2026,51,1161,301,3187,11,4.2,8.6,"25% - 50% P.O.C.","$56000 - $78000"
"37125951200","Census Tract 9512, Moore County, North Carolina",5267,51420,3187,1292,248,0,0,440,60.5,24.5,4.7,0,0,8.4,39.5,1880,1334,546,70.96,29.04,61,1273,142,404,203,1677,4.6,26,10.8,"25% - 50% P.O.C.","$42000 - $56000"
"37127010200","Census Tract 102, Nash County, North Carolina",4146,26157,791,3245,10,0,0,100,19.1,78.3,0.2,0,0,2.4,80.9,1775,719,1056,40.51,59.49,50,669,50,1006,100,1675,7,4.7,5.6,"75% or more P.O.C.","Less than $42000"
"37127010300","Census Tract 103, Nash County, North Carolina",5843,38068,2222,3380,0,107,18,0,38,57.8,0,1.8,0.3,0,62,2629,1573,1056,59.83,40.17,172,1401,10,1046,182,2447,10.9,0.9,6.9,"50% - 75% P.O.C.","Less than $42000"
"37127010400","Census Tract 104, Nash County, North Carolina",2784,33058,399,2245,5,0,0,14,14.3,80.6,0.2,0,0,0.5,85.7,1203,356,847,29.59,70.41,0,356,83,764,83,1120,0,9.8,6.9,"75% or more P.O.C.","Less than $42000"
"37127010502","Census Tract 105.02, Nash County, North Carolina",7005,45605,2284,3825,51,158,0,556,32.6,54.6,0.7,2.3,0,7.9,67.4,3344,1460,1884,43.66,56.34,197,1263,0,1884,197,3147,13.5,0,5.9,"50% - 75% P.O.C.","$42000 - $56000"
"37127010503","Census Tract 105.03, Nash County, North Carolina",2557,60250,1481,986,14,27,0,39,57.9,38.6,0.5,1.1,0,1.5,42.1,1008,816,192,80.95,19.05,64,752,7,185,71,937,7.8,3.6,7,"25% - 50% P.O.C.","$56000 - $78000"
"37127010504","Census Tract 105.04, Nash County, North Carolina",5530,64112,3089,1985,12,1,0,413,55.9,35.9,0.2,0,0,7.5,44.1,2117,1568,549,74.07,25.93,220,1348,93,456,313,1804,14,16.9,14.8,"25% - 50% P.O.C.","$56000 - $78000"
"37127010601","Census Tract 106.01, Nash County, North Carolina",2682,54659,1332,666,20,0,0,269,49.7,24.8,0.7,0,0,10,50.3,1005,656,349,65.27,34.73,52,604,24,325,76,929,7.9,6.9,7.6,"50% - 75% P.O.C.","$42000 - $56000"
"37127010602","Census Tract 106.02, Nash County, North Carolina",6209,46250,2204,3367,29,131,0,108,35.5,54.2,0.5,2.1,0,1.7,64.5,2363,1106,1257,46.8,53.2,93,1013,126,1131,219,2144,8.4,10,9.3,"50% - 75% P.O.C.","$42000 - $56000"
"37127010700","Census Tract 107, Nash County, North Carolina",2948,49896,1029,1512,0,194,0,108,34.9,51.3,0,6.6,0,3.7,65.1,1120,790,330,70.54,29.46,104,686,0,330,104,1016,13.2,0,9.3,"50% - 75% P.O.C.","$42000 - $56000"
"37127010800","Census Tract 108, Nash County, North Carolina",7411,60767,5608,1717,47,1,0,25,75.7,23.2,0.6,0,0,0.3,24.3,2870,2581,289,89.93,10.07,185,2396,0,289,185,2685,7.2,0,6.4,"Less than 25% P.O.C.","$56000 - $78000"
"37127010900","Census Tract 109, Nash County, North Carolina",5511,44457,2758,2375,103,64,0,96,50,43.1,1.9,1.2,0,1.7,50,2138,1497,641,70.02,29.98,153,1344,19,622,172,1966,10.2,3,8,"50% - 75% P.O.C.","$42000 - $56000"
"37127011000","Census Tract 110, Nash County, North Carolina",4902,43990,2262,1868,85,15,11,506,46.1,38.1,1.7,0.3,0.2,10.3,53.9,1887,1246,641,66.03,33.97,90,1156,95,546,185,1702,7.2,14.8,9.8,"50% - 75% P.O.C.","$42000 - $56000"
"37127011101","Census Tract 111.01, Nash County, North Carolina",6501,62134,3896,2276,67,0,0,24,59.9,35,1,0,0,0.4,40.1,2394,2074,320,86.63,13.37,245,1829,0,320,245,2149,11.8,0,10.2,"25% - 50% P.O.C.","$56000 - $78000"
"37127011102","Census Tract 111.02, Nash County, North Carolina",7448,59530,3777,3313,45,3,0,117,50.7,44.5,0.6,0,0,1.6,49.3,2681,1728,953,64.45,35.55,205,1523,58,895,263,2418,11.9,6.1,9.8,"25% - 50% P.O.C.","$56000 - $78000"
"37127011200","Census Tract 112, Nash County, North Carolina",6502,65766,4380,1608,72,0,0,367,67.4,24.7,1.1,0,0,5.6,32.6,2636,2093,543,79.4,20.6,211,1882,46,497,257,2379,10.1,8.5,9.7,"25% - 50% P.O.C.","$56000 - $78000"
"37127011300","Census Tract 113, Nash County, North Carolina",5170,52165,2895,651,8,32,0,1532,56,12.6,0.2,0.6,0,29.6,44,1847,1268,579,68.65,31.35,176,1092,75,504,251,1596,13.9,13,13.6,"25% - 50% P.O.C.","$42000 - $56000"
"37127011400","Census Tract 114, Nash County, North Carolina",3880,52149,2435,540,0,0,0,778,62.8,13.9,0,0,0,20.1,37.2,1532,1056,476,68.93,31.07,122,934,47,429,169,1363,11.6,9.9,11,"25% - 50% P.O.C.","$42000 - $56000"
"37127011500","Census Tract 115, Nash County, North Carolina",7001,38776,4064,1307,2,39,0,1517,58,18.7,0,0.6,0,21.7,42,2462,1594,868,64.74,35.26,181,1413,89,779,270,2192,11.4,10.3,11,"25% - 50% P.O.C.","Less than $42000"
"37135010701","Census Tract 107.01, Orange County, North Carolina",2274,109485,1521,466,24,16,0,217,66.9,20.5,1.1,0.7,0,9.5,33.1,802,698,104,87.03,12.97,65,633,0,104,65,737,9.3,0,8.1,"25% - 50% P.O.C.","$78000 or more"
"37135010703","Census Tract 107.03, Orange County, North Carolina",5935,37154,3466,909,0,845,0,439,58.4,15.3,0,14.2,0,7.4,41.6,2878,389,2489,13.52,86.48,75,314,74,2415,149,2729,19.3,3,5.2,"25% - 50% P.O.C.","Less than $42000"
"37135010704","Census Tract 107.04, Orange County, North Carolina",5415,59217,3790,679,0,350,0,413,70,12.5,0,6.5,0,7.6,30,2467,1125,1342,45.6,54.4,12,1113,67,1275,79,2388,1.1,5,3.2,"25% - 50% P.O.C.","$56000 - $78000"
"37135010705","Census Tract 107.05, Orange County, North Carolina",5090,63000,3570,609,53,158,0,512,70.1,12,1,3.1,0,10.1,29.9,2232,1007,1225,45.12,54.88,49,958,0,1225,49,2183,4.9,0,2.2,"25% - 50% P.O.C.","$56000 - $78000"
"37135010706","Census Tract 107.06, Orange County, North Carolina",3503,127500,2878,88,0,289,0,195,82.2,2.5,0,8.3,0,5.6,17.8,1286,1115,171,86.7,13.3,101,1014,12,159,113,1173,9.1,7,8.8,"Less than 25% P.O.C.","$78000 or more"
"37135010801","Census Tract 108.01, Orange County, North Carolina",5268,65772,3654,1021,8,9,1,347,69.4,19.4,0.2,0.2,0,6.6,30.6,2037,1651,386,81.05,18.95,108,1543,14,372,122,1915,6.5,3.6,6,"25% - 50% P.O.C.","$56000 - $78000"
"37135010802","Census Tract 108.02, Orange County, North Carolina",4880,77188,4255,297,0,33,0,227,87.2,6.1,0,0.7,0,4.7,12.8,2015,1744,271,86.55,13.45,83,1661,0,271,83,1932,4.8,0,4.1,"Less than 25% P.O.C.","$56000 - $78000"
"37135010901","Census Tract 109.01, Orange County, North Carolina",5773,72691,4092,398,0,82,0,1060,70.9,6.9,0,1.4,0,18.4,29.1,2257,1938,319,85.87,14.13,56,1882,43,276,99,2158,2.9,13.5,4.4,"25% - 50% P.O.C.","$56000 - $78000"
"37135010902","Census Tract 109.02, Orange County, North Carolina",6039,66369,3547,789,38,162,0,1362,58.7,13.1,0.6,2.7,0,22.6,41.3,2171,1506,665,69.37,30.63,124,1382,24,641,148,2023,8.2,3.6,6.8,"25% - 50% P.O.C.","$56000 - $78000"
"37135011000","Census Tract 110, Orange County, North Carolina",7931,81554,6298,610,298,262,0,240,79.4,7.7,3.8,3.3,0,3,20.6,3147,2449,698,77.82,22.18,199,2250,0,698,199,2948,8.1,0,6.3,"Less than 25% P.O.C.","$78000 or more"
"37135011101","Census Tract 111.01, Orange County, North Carolina",8057,56979,4668,1888,56,70,0,1326,57.9,23.4,0.7,0.9,0,16.5,42.1,3101,2289,812,73.81,26.19,214,2075,133,679,347,2754,9.3,16.4,11.2,"25% - 50% P.O.C.","$56000 - $78000"
"37135011102","Census Tract 111.02, Orange County, North Carolina",6543,64330,4507,775,84,49,0,818,68.9,11.8,1.3,0.7,0,12.5,31.1,2438,1709,729,70.1,29.9,175,1534,47,682,222,2216,10.2,6.4,9.1,"25% - 50% P.O.C.","$56000 - $78000"
"37135011202","Census Tract 112.02, Orange County, North Carolina",8178,105308,5905,835,0,713,0,504,72.2,10.2,0,8.7,0,6.2,27.8,3141,2634,507,83.86,16.14,170,2464,9,498,179,2962,6.5,1.8,5.7,"25% - 50% P.O.C.","$78000 or more"
"37135011203","Census Tract 112.03, Orange County, North Carolina",6469,72917,5442,332,0,247,0,381,84.1,5.1,0,3.8,0,5.9,15.9,2509,2013,496,80.23,19.77,164,1849,3,493,167,2342,8.1,0.6,6.7,"Less than 25% P.O.C.","$56000 - $78000"
"37135011204","Census Tract 112.04, Orange County, North Carolina",3204,136917,2545,84,0,249,0,326,79.4,2.6,0,7.8,0,10.2,20.6,1263,1158,105,91.69,8.31,82,1076,0,105,82,1181,7.1,0,6.5,"Less than 25% P.O.C.","$78000 or more"
"37135011205","Census Tract 112.05, Orange County, North Carolina",8483,92996,4230,1128,96,2228,8,354,49.9,13.3,1.1,26.3,0.1,4.2,50.1,3243,1725,1518,53.19,46.81,202,1523,175,1343,377,2866,11.7,11.5,11.6,"50% - 75% P.O.C.","$78000 or more"
"37135011300","Census Tract 113, Orange County, North Carolina",3146,20278,2094,624,0,249,0,108,66.6,19.8,0,7.9,0,3.4,33.4,1112,154,958,13.85,86.15,0,154,62,896,62,1050,0,6.5,5.6,"25% - 50% P.O.C.","Less than $42000"
"37135011400","Census Tract 114, Orange County, North Carolina",3818,41394,2929,184,0,386,0,203,76.7,4.8,0,10.1,0,5.3,23.3,1367,508,859,37.16,62.84,27,481,9,850,36,1331,5.3,1,2.6,"Less than 25% P.O.C.","Less than $42000"
"37135011500","Census Tract 115, Orange County, North Carolina",1957,125208,1493,111,6,134,0,153,76.3,5.7,0.3,6.8,0,7.8,23.7,780,496,284,63.59,36.41,36,460,16,268,52,728,7.3,5.6,6.7,"Less than 25% P.O.C.","$78000 or more"
"37135011601","Census Tract 116.01, Orange County, North Carolina",2423,NA,1709,189,10,207,0,232,70.5,7.8,0.4,8.5,0,9.6,29.5,19,16,3,84.21,15.79,0,16,0,3,0,19,0,0,0,"25% - 50% P.O.C.","N/A"
"37135011602","Census Tract 116.02, Orange County, North Carolina",6722,25972,4309,624,15,926,0,588,64.1,9.3,0.2,13.8,0,8.7,35.9,287,10,277,3.48,96.52,0,10,14,263,14,273,0,5.1,4.9,"25% - 50% P.O.C.","Less than $42000"
"37135011700","Census Tract 117, Orange County, North Carolina",5337,50114,4057,466,11,337,0,289,76,8.7,0.2,6.3,0,5.4,24,1261,375,886,29.74,70.26,0,375,97,789,97,1164,0,10.9,7.7,"Less than 25% P.O.C.","$42000 - $56000"
"37135011800","Census Tract 118, Orange County, North Carolina",3169,52500,2337,381,0,275,0,144,73.7,12,0,8.7,0,4.5,26.3,1296,703,593,54.24,45.76,16,687,32,561,48,1248,2.3,5.4,3.7,"25% - 50% P.O.C.","$42000 - $56000"
"37135011901","Census Tract 119.01, Orange County, North Carolina",5034,83194,2882,446,0,897,0,715,57.3,8.9,0,17.8,0,14.2,42.7,2102,1061,1041,50.48,49.52,29,1032,104,937,133,1969,2.7,10,6.3,"25% - 50% P.O.C.","$78000 or more"
"37135011902","Census Tract 119.02, Orange County, North Carolina",3965,105430,2810,396,0,472,0,231,70.9,10,0,11.9,0,5.8,29.1,1677,1076,601,64.16,35.84,27,1049,31,570,58,1619,2.5,5.2,3.5,"25% - 50% P.O.C.","$78000 or more"
"37135012100","Census Tract 121, Orange County, North Carolina",8055,64453,5234,1331,0,923,0,295,65,16.5,0,11.5,0,3.7,35,3304,1748,1556,52.91,47.09,234,1514,67,1489,301,3003,13.4,4.3,9.1,"25% - 50% P.O.C.","$56000 - $78000"
"37135012201","Census Tract 122.01, Orange County, North Carolina",2814,129323,2254,256,10,179,0,82,80.1,9.1,0.4,6.4,0,2.9,19.9,1085,844,241,77.79,22.21,44,800,47,194,91,994,5.2,19.5,8.4,"Less than 25% P.O.C.","$78000 or more"
"37135012202","Census Tract 122.02, Orange County, North Carolina",5354,98050,4014,270,14,476,0,475,75,5,0.3,8.9,0,8.9,25,2099,1295,804,61.7,38.3,155,1140,43,761,198,1901,12,5.3,9.4,"25% - 50% P.O.C.","$78000 or more"
"37145920100","Census Tract 9201, Person County, North Carolina",6712,51423,4685,1796,99,9,4,55,69.8,26.8,1.5,0.1,0.1,0.8,30.2,2656,2185,471,82.27,17.73,193,1992,58,413,251,2405,8.8,12.3,9.5,"25% - 50% P.O.C.","$42000 - $56000"
"37145920200","Census Tract 9202, Person County, North Carolina",6554,64276,5149,1049,35,0,0,200,78.6,16,0.5,0,0,3.1,21.4,2665,2197,468,82.44,17.56,64,2133,109,359,173,2492,2.9,23.3,6.5,"Less than 25% P.O.C.","$56000 - $78000"
"37145920300","Census Tract 9203, Person County, North Carolina",5487,31326,2190,2738,21,14,17,507,39.9,49.9,0.4,0.3,0.3,9.2,60.1,2421,1160,1261,47.91,52.09,0,1160,34,1227,34,2387,0,2.7,1.4,"50% - 75% P.O.C.","Less than $42000"
"37145920400","Census Tract 9204, Person County, North Carolina",2875,36122,1003,1486,0,0,0,250,34.9,51.7,0,0,0,8.7,65.1,1206,670,536,55.56,44.44,47,623,8,528,55,1151,7,1.5,4.6,"50% - 75% P.O.C.","Less than $42000"
"37145920500","Census Tract 9205, Person County, North Carolina",6946,59181,5609,1011,0,0,0,104,80.8,14.6,0,0,0,1.5,19.2,2791,2672,119,95.74,4.26,203,2469,0,119,203,2588,7.6,0,7.3,"Less than 25% P.O.C.","$56000 - $78000"
"37145920601","Census Tract 9206.01, Person County, North Carolina",5789,51766,3709,1197,1,63,0,545,64.1,20.7,0,1.1,0,9.4,35.9,2148,1538,610,71.6,28.4,211,1327,71,539,282,1866,13.7,11.6,13.1,"25% - 50% P.O.C.","$42000 - $56000"
"37145920602","Census Tract 9206.02, Person County, North Carolina",4982,62823,3779,975,0,43,0,30,75.9,19.6,0,0.9,0,0.6,24.1,2009,1730,279,86.11,13.89,65,1665,25,254,90,1919,3.8,9,4.5,"Less than 25% P.O.C.","$56000 - $78000"
"37163970100","Census Tract 9701, Sampson County, North Carolina",7110,40978,2703,1803,1,14,0,2497,38,25.4,0,0.2,0,35.1,62,2380,1693,687,71.13,28.87,359,1334,132,555,491,1889,21.2,19.2,20.6,"50% - 75% P.O.C.","Less than $42000"
"37163970200","Census Tract 9702, Sampson County, North Carolina",6796,45568,4099,1120,126,140,0,1059,60.3,16.5,1.9,2.1,0,15.6,39.7,2532,1796,736,70.93,29.07,189,1607,44,692,233,2299,10.5,6,9.2,"25% - 50% P.O.C.","$42000 - $56000"
"37163970301","Census Tract 9703.01, Sampson County, North Carolina",6071,42188,4427,1029,0,17,0,353,72.9,16.9,0,0.3,0,5.8,27.1,2267,1853,414,81.74,18.26,208,1645,0,414,208,2059,11.2,0,9.2,"25% - 50% P.O.C.","$42000 - $56000"
"37163970302","Census Tract 9703.02, Sampson County, North Carolina",5350,58521,3528,642,70,30,0,1006,65.9,12,1.3,0.6,0,18.8,34.1,1847,1494,353,80.89,19.11,124,1370,37,316,161,1686,8.3,10.5,8.7,"25% - 50% P.O.C.","$56000 - $78000"
"37163970400","Census Tract 9704, Sampson County, North Carolina",4570,43027,3265,672,106,0,0,400,71.4,14.7,2.3,0,0,8.8,28.6,2057,1527,530,74.23,25.77,104,1423,22,508,126,1931,6.8,4.2,6.1,"25% - 50% P.O.C.","$42000 - $56000"
"37163970500","Census Tract 9705, Sampson County, North Carolina",5949,49054,3350,1387,225,15,0,786,56.3,23.3,3.8,0.3,0,13.2,43.7,2171,1462,709,67.34,32.66,118,1344,26,683,144,2027,8.1,3.7,6.6,"25% - 50% P.O.C.","$42000 - $56000"
"37163970600","Census Tract 9706, Sampson County, North Carolina",4681,32857,2060,1732,98,57,0,610,44,37,2.1,1.2,0,13,56,1778,955,823,53.71,46.29,82,873,24,799,106,1672,8.6,2.9,6,"50% - 75% P.O.C.","Less than $42000"
"37163970700","Census Tract 9707, Sampson County, North Carolina",7316,42045,3787,1982,58,35,0,1403,51.8,27.1,0.8,0.5,0,19.2,48.2,2652,1777,875,67.01,32.99,178,1599,134,741,312,2340,10,15.3,11.8,"25% - 50% P.O.C.","$42000 - $56000"
"37163970800","Census Tract 9708, Sampson County, North Carolina",6944,34882,2158,2074,316,48,0,2173,31.1,29.9,4.6,0.7,0,31.3,68.9,2523,1326,1197,52.56,47.44,113,1213,175,1022,288,2235,8.5,14.6,11.4,"50% - 75% P.O.C.","Less than $42000"
"37163970900","Census Tract 9709, Sampson County, North Carolina",3538,29231,1509,1135,1,0,0,877,42.7,32.1,0,0,0,24.8,57.3,1338,889,449,66.44,33.56,82,807,107,342,189,1149,9.2,23.8,14.1,"50% - 75% P.O.C.","Less than $42000"
"37163971000","Census Tract 9710, Sampson County, North Carolina",5060,41813,1433,2322,7,0,0,1281,28.3,45.9,0.1,0,0,25.3,71.7,1871,1456,415,77.82,22.18,146,1310,48,367,194,1677,10,11.6,10.4,"50% - 75% P.O.C.","Less than $42000"
"37181960100","Census Tract 9601, Vance County, North Carolina",4051,41250,1895,1762,0,0,0,292,46.8,43.5,0,0,0,7.2,53.2,1624,1192,432,73.4,26.6,88,1104,42,390,130,1494,7.4,9.7,8,"50% - 75% P.O.C.","Less than $42000"
"37181960200","Census Tract 9602, Vance County, North Carolina",4015,47455,1783,2061,12,33,0,39,44.4,51.3,0.3,0.8,0,1,55.6,1643,1188,455,72.31,27.69,61,1127,21,434,82,1561,5.1,4.6,5,"50% - 75% P.O.C.","$42000 - $56000"
"37181960300","Census Tract 9603, Vance County, North Carolina",5127,47040,3247,1522,5,0,0,159,63.3,29.7,0.1,0,0,3.1,36.7,1970,1423,547,72.23,27.77,169,1254,67,480,236,1734,11.9,12.2,12,"25% - 50% P.O.C.","$42000 - $56000"
"37181960400","Census Tract 9604, Vance County, North Carolina",4240,49792,2035,1905,0,212,0,61,48,44.9,0,5,0,1.4,52,1658,910,748,54.89,45.11,89,821,42,706,131,1527,9.8,5.6,7.9,"50% - 75% P.O.C.","$42000 - $56000"
"37181960500","Census Tract 9605, Vance County, North Carolina",4379,33503,945,3329,0,0,0,69,21.6,76,0,0,0,1.6,78.4,1833,515,1318,28.1,71.9,17,498,73,1245,90,1743,3.3,5.5,4.9,"75% or more P.O.C.","Less than $42000"
"37181960600","Census Tract 9606, Vance County, North Carolina",1545,29444,205,977,0,0,0,351,13.3,63.2,0,0,0,22.7,86.7,546,151,395,27.66,72.34,16,135,37,358,53,493,10.6,9.4,9.7,"75% or more P.O.C.","Less than $42000"
"37181960700","Census Tract 9607, Vance County, North Carolina",4206,25300,312,3595,41,0,25,166,7.4,85.5,1,0,0.6,3.9,92.6,1500,439,1061,29.27,70.73,55,384,138,923,193,1307,12.5,13,12.9,"75% or more P.O.C.","Less than $42000"
"37181960800","Census Tract 9608, Vance County, North Carolina",2338,25142,425,1291,14,0,0,579,18.2,55.2,0.6,0,0,24.8,81.8,816,379,437,46.45,53.55,56,323,86,351,142,674,14.8,19.7,17.4,"75% or more P.O.C.","Less than $42000"
"37181960900","Census Tract 9609, Vance County, North Carolina",8840,47623,3837,3556,60,74,0,1122,43.4,40.2,0.7,0.8,0,12.7,56.6,3039,1961,1078,64.53,35.47,206,1755,127,951,333,2706,10.5,11.8,11,"50% - 75% P.O.C.","$42000 - $56000"
"37181961000","Census Tract 9610, Vance County, North Carolina",5738,40625,2936,2105,0,0,0,628,51.2,36.7,0,0,0,10.9,48.8,2246,1371,875,61.04,38.96,15,1356,57,818,72,2174,1.1,6.5,3.2,"25% - 50% P.O.C.","Less than $42000"
"37183050100","Census Tract 501, Wake County, North Carolina",4251,105133,2716,974,16,92,0,331,63.9,22.9,0.4,2.2,0,7.8,36.1,2041,544,1497,26.65,73.35,15,529,0,1497,15,2026,2.8,0,0.7,"25% - 50% P.O.C.","$78000 or more"
"37183050300","Census Tract 503, Wake County, North Carolina",3350,59817,2868,287,0,75,0,56,85.6,8.6,0,2.2,0,1.7,14.4,2290,792,1498,34.59,65.41,0,792,0,1498,0,2290,0,0,0,"Less than 25% P.O.C.","$56000 - $78000"
"37183050400","Census Tract 504, Wake County, North Carolina",2045,85139,1505,333,0,138,0,34,73.6,16.3,0,6.7,0,1.7,26.4,833,401,432,48.14,51.86,12,389,0,432,12,821,3,0,1.4,"25% - 50% P.O.C.","$78000 or more"
"37183050500","Census Tract 505, Wake County, North Carolina",3690,65921,2580,551,11,92,48,384,69.9,14.9,0.3,2.5,1.3,10.4,30.1,1778,1142,636,64.23,35.77,56,1086,36,600,92,1686,4.9,5.7,5.2,"25% - 50% P.O.C.","$56000 - $78000"
"37183050600","Census Tract 506, Wake County, North Carolina",3645,43750,1358,1919,10,85,0,204,37.3,52.6,0.3,2.3,0,5.6,62.7,1040,479,561,46.06,53.94,39,440,52,509,91,949,8.1,9.3,8.8,"50% - 75% P.O.C.","$42000 - $56000"
"37183050700","Census Tract 507, Wake County, North Carolina",3142,35878,695,2149,0,5,0,210,22.1,68.4,0,0.2,0,6.7,77.9,1484,608,876,40.97,59.03,38,570,26,850,64,1420,6.2,3,4.3,"75% or more P.O.C.","Less than $42000"
"37183050800","Census Tract 508, Wake County, North Carolina",4090,28963,886,2441,85,7,0,491,21.7,59.7,2.1,0.2,0,12,78.3,922,189,733,20.5,79.5,10,179,76,657,86,836,5.3,10.4,9.3,"75% or more P.O.C.","Less than $42000"
"37183050900","Census Tract 509, Wake County, North Carolina",3193,36629,739,2161,0,58,0,206,23.1,67.7,0,1.8,0,6.5,76.9,909,172,737,18.92,81.08,8,164,73,664,81,828,4.7,9.9,8.9,"75% or more P.O.C.","Less than $42000"
"37183051000","Census Tract 510, Wake County, North Carolina",2576,60000,1948,283,0,83,0,221,75.6,11,0,3.2,0,8.6,24.4,1530,323,1207,21.11,78.89,0,323,0,1207,0,1530,0,0,0,"Less than 25% P.O.C.","$56000 - $78000"
"37183051101","Census Tract 511.01, Wake County, North Carolina",5363,35873,3756,972,11,367,0,214,70,18.1,0.2,6.8,0,4,30,492,53,439,10.77,89.23,0,53,5,434,5,487,0,1.1,1,"25% - 50% P.O.C.","Less than $42000"
"37183051102","Census Tract 511.02, Wake County, North Carolina",4977,22000,3624,821,33,274,0,172,72.8,16.5,0.7,5.5,0,3.5,27.2,80,4,76,5,95,0,4,0,76,0,80,0,0,0,"25% - 50% P.O.C.","Less than $42000"
"37183051200","Census Tract 512, Wake County, North Carolina",4805,61300,4168,203,0,182,0,178,86.7,4.2,0,3.8,0,3.7,13.3,2397,638,1759,26.62,73.38,0,638,0,1759,0,2397,0,0,0,"Less than 25% P.O.C.","$56000 - $78000"
"37183051400","Census Tract 514, Wake County, North Carolina",4937,70000,4247,372,0,80,47,104,86,7.5,0,1.6,1,2.1,14,2032,1000,1032,49.21,50.79,45,955,17,1015,62,1970,4.5,1.6,3.1,"Less than 25% P.O.C.","$56000 - $78000"
"37183051501","Census Tract 515.01, Wake County, North Carolina",3498,132031,3317,94,0,55,0,15,94.8,2.7,0,1.6,0,0.4,5.2,1491,1167,324,78.27,21.73,67,1100,15,309,82,1409,5.7,4.6,5.5,"Less than 25% P.O.C.","$78000 or more"
"37183051502","Census Tract 515.02, Wake County, North Carolina",2101,108684,1963,0,6,92,0,33,93.4,0,0.3,4.4,0,1.6,6.6,896,620,276,69.2,30.8,62,558,0,276,62,834,10,0,6.9,"Less than 25% P.O.C.","$78000 or more"
"37183051600","Census Tract 516, Wake County, North Carolina",4909,140170,4738,69,0,23,0,41,96.5,1.4,0,0.5,0,0.8,3.5,2032,1559,473,76.72,23.28,108,1451,19,454,127,1905,6.9,4,6.2,"Less than 25% P.O.C.","$78000 or more"
"37183051700","Census Tract 517, Wake County, North Carolina",3360,212115,3191,37,0,30,0,77,95,1.1,0,0.9,0,2.3,5,1246,1162,84,93.26,6.74,117,1045,0,84,117,1129,10.1,0,9.4,"Less than 25% P.O.C.","$78000 or more"
"37183051800","Census Tract 518, Wake County, North Carolina",4563,94333,4233,132,16,0,0,157,92.8,2.9,0.4,0,0,3.4,7.2,2152,1401,751,65.1,34.9,103,1298,18,733,121,2031,7.4,2.4,5.6,"Less than 25% P.O.C.","$78000 or more"
"37183051900","Census Tract 519, Wake County, North Carolina",5216,54896,1730,2957,0,49,0,458,33.2,56.7,0,0.9,0,8.8,66.8,1941,1042,899,53.68,46.32,104,938,88,811,192,1749,10,9.8,9.9,"50% - 75% P.O.C.","$42000 - $56000"
"37183052001","Census Tract 520.01, Wake County, North Carolina",4323,31341,429,2815,6,57,0,968,9.9,65.1,0.1,1.3,0,22.4,90.1,1567,104,1463,6.64,93.36,7,97,84,1379,91,1476,6.7,5.7,5.8,"75% or more P.O.C.","Less than $42000"
"37183052002","Census Tract 520.02, Wake County, North Carolina",5931,38974,506,4229,21,50,0,1067,8.5,71.3,0.4,0.8,0,18,91.5,1848,927,921,50.16,49.84,109,818,204,717,313,1535,11.8,22.1,16.9,"75% or more P.O.C.","Less than $42000"
"37183052101","Census Tract 521.01, Wake County, North Carolina",9240,40768,1077,6334,0,101,0,1458,11.7,68.5,0,1.1,0,15.8,88.3,3131,1822,1309,58.19,41.81,214,1608,234,1075,448,2683,11.7,17.9,14.3,"75% or more P.O.C.","Less than $42000"
"37183052102","Census Tract 521.02, Wake County, North Carolina",6960,47431,271,5038,9,112,0,1350,3.9,72.4,0.1,1.6,0,19.4,96.1,2138,1065,1073,49.81,50.19,74,991,280,793,354,1784,6.9,26.1,16.6,"75% or more P.O.C.","$42000 - $56000"
"37183052301","Census Tract 523.01, Wake County, North Carolina",6438,42761,3697,1571,0,988,0,50,57.4,24.4,0,15.3,0,0.8,42.6,2911,564,2347,19.37,80.63,0,564,51,2296,51,2860,0,2.2,1.8,"25% - 50% P.O.C.","$42000 - $56000"
"37183052302","Census Tract 523.02, Wake County, North Carolina",9657,50956,5820,2282,41,797,0,335,60.3,23.6,0.4,8.3,0,3.5,39.7,3379,890,2489,26.34,73.66,81,809,76,2413,157,3222,9.1,3.1,4.6,"25% - 50% P.O.C.","$42000 - $56000"
"37183052401","Census Tract 524.01, Wake County, North Carolina",5892,67087,4447,868,17,238,0,214,75.5,14.7,0.3,4,0,3.6,24.5,2414,648,1766,26.84,73.16,0,648,53,1713,53,2361,0,3,2.2,"Less than 25% P.O.C.","$56000 - $78000"
"37183052404","Census Tract 524.04, Wake County, North Carolina",4736,64063,3065,183,26,934,0,438,64.7,3.9,0.5,19.7,0,9.2,35.3,1631,870,761,53.34,46.66,28,842,70,691,98,1533,3.2,9.2,6,"25% - 50% P.O.C.","$56000 - $78000"
"37183052406","Census Tract 524.06, Wake County, North Carolina",7507,51535,3492,1536,110,565,0,1688,46.5,20.5,1.5,7.5,0,22.5,53.5,3198,702,2496,21.95,78.05,81,621,177,2319,258,2940,11.5,7.1,8.1,"50% - 75% P.O.C.","$42000 - $56000"
"37183052407","Census Tract 524.07, Wake County, North Carolina",4291,52483,2283,1244,0,245,0,435,53.2,29,0,5.7,0,10.1,46.8,1904,729,1175,38.29,61.71,29,700,48,1127,77,1827,4,4.1,4,"25% - 50% P.O.C.","$42000 - $56000"
"37183052408","Census Tract 524.08, Wake County, North Carolina",3586,37543,1415,1088,72,256,0,689,39.5,30.3,2,7.1,0,19.2,60.5,1156,171,985,14.79,85.21,14,157,178,807,192,964,8.2,18.1,16.6,"50% - 75% P.O.C.","Less than $42000"
"37183052409","Census Tract 524.09, Wake County, North Carolina",4286,25993,1910,492,40,1092,0,681,44.6,11.5,0.9,25.5,0,15.9,55.4,1201,9,1192,0.75,99.25,0,9,60,1132,60,1141,0,5,5,"50% - 75% P.O.C.","Less than $42000"
"37183052503","Census Tract 525.03, Wake County, North Carolina",7085,79350,5266,892,57,205,0,437,74.3,12.6,0.8,2.9,0,6.2,25.7,3279,1309,1970,39.92,60.08,100,1209,14,1956,114,3165,7.6,0.7,3.5,"25% - 50% P.O.C.","$78000 or more"
"37183052504","Census Tract 525.04, Wake County, North Carolina",6774,78902,5103,496,3,336,0,733,75.3,7.3,0,5,0,10.8,24.7,3160,1535,1625,48.58,51.42,42,1493,88,1537,130,3030,2.7,5.4,4.1,"Less than 25% P.O.C.","$78000 or more"
"37183052505","Census Tract 525.05, Wake County, North Carolina",5296,75119,3590,361,18,301,0,979,67.8,6.8,0.3,5.7,0,18.5,32.2,2288,1076,1212,47.03,52.97,115,961,87,1125,202,2086,10.7,7.2,8.8,"25% - 50% P.O.C.","$56000 - $78000"
"37183052506","Census Tract 525.06, Wake County, North Carolina",2677,83861,2197,244,0,78,0,142,82.1,9.1,0,2.9,0,5.3,17.9,1295,584,711,45.1,54.9,22,562,18,693,40,1255,3.8,2.5,3.1,"Less than 25% P.O.C.","$78000 or more"
"37183052507","Census Tract 525.07, Wake County, North Carolina",3223,68198,2346,520,0,48,0,258,72.8,16.1,0,1.5,0,8,27.2,1276,727,549,56.97,43.03,138,589,28,521,166,1110,19,5.1,13,"25% - 50% P.O.C.","$56000 - $78000"
"37183052601","Census Tract 526.01, Wake County, North Carolina",3410,123682,3070,125,7,69,0,20,90,3.7,0.2,2,0,0.6,10,1235,1006,229,81.46,18.54,107,899,31,198,138,1097,10.6,13.5,11.2,"Less than 25% P.O.C.","$78000 or more"
"37183052602","Census Tract 526.02, Wake County, North Carolina",4699,79665,3905,309,0,156,0,268,83.1,6.6,0,3.3,0,5.7,16.9,2263,1242,1021,54.88,45.12,160,1082,10,1011,170,2093,12.9,1,7.5,"Less than 25% P.O.C.","$78000 or more"
"37183052603","Census Tract 526.03, Wake County, North Carolina",2865,89708,2563,88,0,68,0,77,89.5,3.1,0,2.4,0,2.7,10.5,1343,729,614,54.28,45.72,86,643,0,614,86,1257,11.8,0,6.4,"Less than 25% P.O.C.","$78000 or more"
"37183052701","Census Tract 527.01, Wake County, North Carolina",6389,58006,3070,889,0,225,0,2113,48.1,13.9,0,3.5,0,33.1,51.9,2508,1114,1394,44.42,55.58,0,1114,148,1246,148,2360,0,10.6,5.9,"50% - 75% P.O.C.","$56000 - $78000"
"37183052704","Census Tract 527.04, Wake County, North Carolina",6420,38209,1320,2435,22,110,0,2490,20.6,37.9,0.3,1.7,0,38.8,79.4,2452,659,1793,26.88,73.12,88,571,130,1663,218,2234,13.4,7.3,8.9,"75% or more P.O.C.","Less than $42000"
"37183052705","Census Tract 527.05, Wake County, North Carolina",4960,56494,2021,1423,0,305,0,1023,40.7,28.7,0,6.1,0,20.6,59.3,2061,1002,1059,48.62,51.38,51,951,93,966,144,1917,5.1,8.8,7,"50% - 75% P.O.C.","$56000 - $78000"
"37183052706","Census Tract 527.06, Wake County, North Carolina",4751,60625,1102,1865,0,231,0,1485,23.2,39.3,0,4.9,0,31.3,76.8,1744,919,825,52.69,47.31,73,846,125,700,198,1546,7.9,15.2,11.4,"75% or more P.O.C.","$56000 - $78000"
"37183052707","Census Tract 527.07, Wake County, North Carolina",7239,60701,2414,2666,12,466,0,1584,33.3,36.8,0.2,6.4,0,21.9,66.7,2652,1586,1066,59.8,40.2,139,1447,117,949,256,2396,8.8,11,9.7,"50% - 75% P.O.C.","$56000 - $78000"
"37183052801","Census Tract 528.01, Wake County, North Carolina",6512,74161,4193,1893,0,128,0,171,64.4,29.1,0,2,0,2.6,35.6,2491,1984,507,79.65,20.35,181,1803,0,507,181,2310,9.1,0,7.3,"25% - 50% P.O.C.","$56000 - $78000"
"37183052802","Census Tract 528.02, Wake County, North Carolina",6538,51222,3168,1920,43,56,0,1319,48.5,29.4,0.7,0.9,0,20.2,51.5,2516,1618,898,64.31,35.69,106,1512,114,784,220,2296,6.6,12.7,8.7,"50% - 75% P.O.C.","$42000 - $56000"
"37183052803","Census Tract 528.03, Wake County, North Carolina",12074,51974,1935,7928,4,90,0,1770,16,65.7,0,0.7,0,14.7,84,3906,2594,1312,66.41,33.59,419,2175,313,999,732,3174,16.2,23.9,18.7,"75% or more P.O.C.","$42000 - $56000"
"37183052806","Census Tract 528.06, Wake County, North Carolina",18085,58900,2224,11033,0,383,0,3889,12.3,61,0,2.1,0,21.5,87.7,5835,4152,1683,71.16,28.84,713,3439,245,1438,958,4877,17.2,14.6,16.4,"75% or more P.O.C.","$56000 - $78000"
"37183052807","Census Tract 528.07, Wake County, North Carolina",6558,62120,1738,3242,142,10,0,1198,26.5,49.4,2.2,0.2,0,18.3,73.5,2119,1564,555,73.81,26.19,270,1294,101,454,371,1748,17.3,18.2,17.5,"50% - 75% P.O.C.","$56000 - $78000"
"37183052808","Census Tract 528.08, Wake County, North Carolina",11485,64922,6684,2706,0,233,0,1489,58.2,23.6,0,2,0,13,41.8,4420,2474,1946,55.97,44.03,192,2282,169,1777,361,4059,7.8,8.7,8.2,"25% - 50% P.O.C.","$56000 - $78000"
"37183052809","Census Tract 528.09, Wake County, North Carolina",3068,63981,1673,719,7,5,0,576,54.5,23.4,0.2,0.2,0,18.8,45.5,986,762,224,77.28,22.72,123,639,53,171,176,810,16.1,23.7,17.8,"25% - 50% P.O.C.","$56000 - $78000"
"37183052901","Census Tract 529.01, Wake County, North Carolina",2796,92625,2437,80,0,0,0,276,87.2,2.9,0,0,0,9.9,12.8,944,858,86,90.89,9.11,115,743,6,80,121,823,13.4,7,12.8,"Less than 25% P.O.C.","$78000 or more"
"37183052902","Census Tract 529.02, Wake County, North Carolina",5999,77402,3963,611,12,33,0,1260,66.1,10.2,0.2,0.6,0,21,33.9,2196,1895,301,86.29,13.71,179,1716,0,301,179,2017,9.4,0,8.2,"25% - 50% P.O.C.","$56000 - $78000"
"37183052903","Census Tract 529.03, Wake County, North Carolina",2930,94091,2001,508,0,92,0,292,68.3,17.3,0,3.1,0,10,31.7,1106,1007,99,91.05,8.95,95,912,23,76,118,988,9.4,23.2,10.7,"25% - 50% P.O.C.","$78000 or more"
"37183052904","Census Tract 529.04, Wake County, North Carolina",7801,85000,5489,1083,12,154,0,741,70.4,13.9,0.2,2,0,9.5,29.6,2896,2633,263,90.92,9.08,206,2427,50,213,256,2640,7.8,19,8.8,"25% - 50% P.O.C.","$78000 or more"
"37183053003","Census Tract 530.03, Wake County, North Carolina",5763,75231,3969,913,0,614,0,158,68.9,15.8,0,10.7,0,2.7,31.1,2719,878,1841,32.29,67.71,38,840,29,1812,67,2652,4.3,1.6,2.5,"25% - 50% P.O.C.","$56000 - $78000"
"37183053004","Census Tract 530.04, Wake County, North Carolina",2937,108583,2386,108,0,323,0,60,81.2,3.7,0,11,0,2,18.8,1275,903,372,70.82,29.18,43,860,13,359,56,1219,4.8,3.5,4.4,"Less than 25% P.O.C.","$78000 or more"
"37183053005","Census Tract 530.05, Wake County, North Carolina",4773,160263,4258,60,3,259,0,32,89.2,1.3,0.1,5.4,0,0.7,10.8,1744,1683,61,96.5,3.5,119,1564,0,61,119,1625,7.1,0,6.8,"Less than 25% P.O.C.","$78000 or more"
"37183053006","Census Tract 530.06, Wake County, North Carolina",3123,144432,2718,76,0,19,0,268,87,2.4,0,0.6,0,8.6,13,1073,1061,12,98.88,1.12,73,988,0,12,73,1000,6.9,0,6.8,"Less than 25% P.O.C.","$78000 or more"
"37183053007","Census Tract 530.07, Wake County, North Carolina",3018,122303,2674,54,0,216,21,53,88.6,1.8,0,7.2,0.7,1.8,11.4,1101,1039,62,94.37,5.63,89,950,0,62,89,1012,8.6,0,8.1,"Less than 25% P.O.C.","$78000 or more"
"37183053008","Census Tract 530.08, Wake County, North Carolina",8492,78661,5339,1477,195,531,0,606,62.9,17.4,2.3,6.3,0,7.1,37.1,3679,1881,1798,51.13,48.87,204,1677,15,1783,219,3460,10.8,0.8,6,"25% - 50% P.O.C.","$78000 or more"
"37183053009","Census Tract 530.09, Wake County, North Carolina",7775,73426,4490,1032,139,367,0,1530,57.7,13.3,1.8,4.7,0,19.7,42.3,2888,2110,778,73.06,26.94,186,1924,0,778,186,2702,8.8,0,6.4,"25% - 50% P.O.C.","$56000 - $78000"
"37183053105","Census Tract 531.05, Wake County, North Carolina",4346,75038,3187,329,0,27,0,744,73.3,7.6,0,0.6,0,17.1,26.7,1597,1253,344,78.46,21.54,142,1111,61,283,203,1394,11.3,17.7,12.7,"25% - 50% P.O.C.","$56000 - $78000"
"37183053106","Census Tract 531.06, Wake County, North Carolina",3323,60952,2225,870,20,7,0,117,67,26.2,0.6,0.2,0,3.5,33,1352,776,576,57.4,42.6,103,673,14,562,117,1235,13.3,2.4,8.7,"25% - 50% P.O.C.","$56000 - $78000"
"37183053107","Census Tract 531.07, Wake County, North Carolina",10561,69863,7060,2107,0,269,0,872,66.8,20,0,2.5,0,8.3,33.2,3706,2409,1297,65,35,226,2183,168,1129,394,3312,9.4,13,10.6,"25% - 50% P.O.C.","$56000 - $78000"
"37183053108","Census Tract 531.08, Wake County, North Carolina",8550,77405,6654,812,86,129,0,713,77.8,9.5,1,1.5,0,8.3,22.2,2877,2556,321,88.84,11.16,248,2308,57,264,305,2572,9.7,17.8,10.6,"Less than 25% P.O.C.","$56000 - $78000"
"37183053109","Census Tract 531.09, Wake County, North Carolina",9478,92529,7540,422,0,178,0,1153,79.6,4.5,0,1.9,0,12.2,20.4,3131,2362,769,75.44,24.56,211,2151,203,566,414,2717,8.9,26.4,13.2,"Less than 25% P.O.C.","$78000 or more"
"37183053110","Census Tract 531.10, Wake County, North Carolina",6071,94375,4030,774,0,40,0,1152,66.4,12.7,0,0.7,0,19,33.6,1941,1694,247,87.27,12.73,189,1505,155,92,344,1597,11.2,62.8,17.7,"25% - 50% P.O.C.","$78000 or more"
"37183053111","Census Tract 531.11, Wake County, North Carolina",5977,97449,3804,988,72,0,0,1046,63.6,16.5,1.2,0,0,17.5,36.4,2280,1880,400,82.46,17.54,225,1655,0,400,225,2055,12,0,9.9,"25% - 50% P.O.C.","$78000 or more"
"37183053201","Census Tract 532.01, Wake County, North Carolina",12450,129379,10508,801,0,220,0,643,84.4,6.4,0,1.8,0,5.2,15.6,3922,3625,297,92.43,7.57,620,3005,63,234,683,3239,17.1,21.2,17.4,"Less than 25% P.O.C.","$78000 or more"
"37183053202","Census Tract 532.02, Wake County, North Carolina",4315,148365,3708,307,17,40,0,182,85.9,7.1,0.4,0.9,0,4.2,14.1,1394,1285,109,92.18,7.82,185,1100,6,103,191,1203,14.4,5.5,13.7,"Less than 25% P.O.C.","$78000 or more"
"37183053203","Census Tract 532.03, Wake County, North Carolina",9166,119866,6590,1162,18,333,23,402,71.9,12.7,0.2,3.6,0.3,4.4,28.1,2879,2558,321,88.85,11.15,223,2335,52,269,275,2604,8.7,16.2,9.6,"25% - 50% P.O.C.","$78000 or more"
"37183053204","Census Tract 532.04, Wake County, North Carolina",5093,72212,3227,897,0,70,0,602,63.4,17.6,0,1.4,0,11.8,36.6,1855,1233,622,66.47,33.53,172,1061,38,584,210,1645,13.9,6.1,11.3,"25% - 50% P.O.C.","$56000 - $78000"
"37183053205","Census Tract 532.05, Wake County, North Carolina",4450,106053,3529,566,4,65,0,177,79.3,12.7,0.1,1.5,0,4,20.7,1600,1145,455,71.56,28.44,132,1013,52,403,184,1416,11.5,11.4,11.5,"Less than 25% P.O.C.","$78000 or more"
"37183053206","Census Tract 532.06, Wake County, North Carolina",5130,95236,3246,903,25,380,0,281,63.3,17.6,0.5,7.4,0,5.5,36.7,1657,1491,166,89.98,10.02,160,1331,21,145,181,1476,10.7,12.7,10.9,"25% - 50% P.O.C.","$78000 or more"
"37183053207","Census Tract 532.07, Wake County, North Carolina",10934,126132,8551,698,24,170,0,1049,78.2,6.4,0.2,1.6,0,9.6,21.8,3373,2938,435,87.1,12.9,406,2532,172,263,578,2795,13.8,39.5,17.1,"Less than 25% P.O.C.","$78000 or more"
"37183053405","Census Tract 534.05, Wake County, North Carolina",4724,117405,4005,94,15,359,0,197,84.8,2,0.3,7.6,0,4.2,15.2,1975,1409,566,71.34,28.66,54,1355,7,559,61,1914,3.8,1.2,3.1,"Less than 25% P.O.C.","$78000 or more"
"37183053408","Census Tract 534.08, Wake County, North Carolina",4163,135994,2769,70,0,1199,0,50,66.5,1.7,0,28.8,0,1.2,33.5,1381,1160,221,84,16,104,1056,23,198,127,1254,9,10.4,9.2,"25% - 50% P.O.C.","$78000 or more"
"37183053409","Census Tract 534.09, Wake County, North Carolina",6701,138044,4496,317,0,1389,0,344,67.1,4.7,0,20.7,0,5.1,32.9,2183,1998,185,91.53,8.47,146,1852,16,169,162,2021,7.3,8.6,7.4,"25% - 50% P.O.C.","$78000 or more"
"37183053410","Census Tract 534.10, Wake County, North Carolina",6250,157632,3092,313,7,2335,0,81,49.5,5,0.1,37.4,0,1.3,50.5,2028,1796,232,88.56,11.44,161,1635,54,178,215,1813,9,23.3,10.6,"50% - 75% P.O.C.","$78000 or more"
"37183053411","Census Tract 534.11, Wake County, North Carolina",11913,155938,6099,856,16,3990,0,576,51.2,7.2,0.1,33.5,0,4.8,48.8,3745,2910,835,77.7,22.3,432,2478,32,803,464,3281,14.8,3.8,12.4,"25% - 50% P.O.C.","$78000 or more"
"37183053412","Census Tract 534.12, Wake County, North Carolina",7685,128948,5110,271,7,1682,0,532,66.5,3.5,0.1,21.9,0,6.9,33.5,2479,1979,500,79.83,20.17,342,1637,65,435,407,2072,17.3,13,16.4,"25% - 50% P.O.C.","$78000 or more"
"37183053413","Census Tract 534.13, Wake County, North Carolina",8189,128676,6310,487,11,932,0,303,77.1,5.9,0.1,11.4,0,3.7,22.9,2671,2358,313,88.28,11.72,387,1971,0,313,387,2284,16.4,0,14.5,"Less than 25% P.O.C.","$78000 or more"
"37183053414","Census Tract 534.14, Wake County, North Carolina",9996,113151,7824,746,36,403,0,754,78.3,7.5,0.4,4,0,7.5,21.7,3283,2905,378,88.49,11.51,320,2585,0,378,320,2963,11,0,9.7,"Less than 25% P.O.C.","$78000 or more"
"37183053415","Census Tract 534.15, Wake County, North Carolina",4002,129605,2655,61,12,501,0,696,66.3,1.5,0.3,12.5,0,17.4,33.7,1310,1103,207,84.2,15.8,80,1023,40,167,120,1190,7.3,19.3,9.2,"25% - 50% P.O.C.","$78000 or more"
"37183053416","Census Tract 534.16, Wake County, North Carolina",7311,95461,5676,478,0,492,0,355,77.6,6.5,0,6.7,0,4.9,22.4,2786,1746,1040,62.67,37.33,187,1559,51,989,238,2548,10.7,4.9,8.5,"Less than 25% P.O.C.","$78000 or more"
"37183053417","Census Tract 534.17, Wake County, North Carolina",4316,82889,2943,641,0,349,0,304,68.2,14.9,0,8.1,0,7,31.8,1808,1135,673,62.78,37.22,59,1076,47,626,106,1702,5.2,7,5.9,"25% - 50% P.O.C.","$78000 or more"
"37183053418","Census Tract 534.18, Wake County, North Carolina",7389,89761,5053,268,0,516,0,1054,68.4,3.6,0,7,0,14.3,31.6,2737,1773,964,64.78,35.22,90,1683,66,898,156,2581,5.1,6.8,5.7,"25% - 50% P.O.C.","$78000 or more"
"37183053419","Census Tract 534.19, Wake County, North Carolina",3142,127321,2744,173,0,68,14,88,87.3,5.5,0,2.2,0.4,2.8,12.7,1103,1068,35,96.83,3.17,77,991,9,26,86,1017,7.2,25.7,7.8,"Less than 25% P.O.C.","$78000 or more"
"37183053420","Census Tract 534.20, Wake County, North Carolina",7863,91199,4470,1249,0,517,0,1355,56.8,15.9,0,6.6,0,17.2,43.2,2707,2001,706,73.92,26.08,314,1687,45,661,359,2348,15.7,6.4,13.3,"25% - 50% P.O.C.","$78000 or more"
"37183053421","Census Tract 534.21, Wake County, North Carolina",5737,116667,4123,530,0,542,0,376,71.9,9.2,0,9.4,0,6.6,28.1,1900,1507,393,79.32,20.68,219,1288,9,384,228,1672,14.5,2.3,12,"25% - 50% P.O.C.","$78000 or more"
"37183053422","Census Tract 534.22, Wake County, North Carolina",2497,135658,2089,59,0,241,0,62,83.7,2.4,0,9.7,0,2.5,16.3,882,843,39,95.58,4.42,90,753,5,34,95,787,10.7,12.8,10.8,"Less than 25% P.O.C.","$78000 or more"
"37183053423","Census Tract 534.23, Wake County, North Carolina",2039,88667,1641,115,8,143,0,86,80.5,5.6,0.4,7,0,4.2,19.5,898,607,291,67.59,32.41,51,556,6,285,57,841,8.4,2.1,6.3,"Less than 25% P.O.C.","$78000 or more"
"37183053424","Census Tract 534.24, Wake County, North Carolina",4613,129688,2970,276,79,828,0,252,64.4,6,1.7,17.9,0,5.5,35.6,1567,1378,189,87.94,12.06,98,1280,34,155,132,1435,7.1,18,8.4,"25% - 50% P.O.C.","$78000 or more"
"37183053425","Census Tract 534.25, Wake County, North Carolina",3103,140350,2000,114,3,656,0,284,64.5,3.7,0.1,21.1,0,9.2,35.5,1127,772,355,68.5,31.5,72,700,7,348,79,1048,9.3,2,7,"25% - 50% P.O.C.","$78000 or more"
"37183053505","Census Tract 535.05, Wake County, North Carolina",3577,100486,2933,76,4,382,0,126,82,2.1,0.1,10.7,0,3.5,18,1475,1325,150,89.83,10.17,92,1233,0,150,92,1383,6.9,0,6.2,"Less than 25% P.O.C.","$78000 or more"
"37183053506","Census Tract 535.06, Wake County, North Carolina",5504,96719,4656,219,22,230,0,349,84.6,4,0.4,4.2,0,6.3,15.4,2444,1751,693,71.64,28.36,61,1690,31,662,92,2352,3.5,4.5,3.8,"Less than 25% P.O.C.","$78000 or more"
"37183053507","Census Tract 535.07, Wake County, North Carolina",4143,60921,2635,670,24,136,20,599,63.6,16.2,0.6,3.3,0.5,14.5,36.4,1800,898,902,49.89,50.11,26,872,25,877,51,1749,2.9,2.8,2.8,"25% - 50% P.O.C.","$56000 - $78000"
"37183053509","Census Tract 535.09, Wake County, North Carolina",5375,137500,4609,192,40,256,0,146,85.7,3.6,0.7,4.8,0,2.7,14.3,1918,1783,135,92.96,7.04,112,1671,9,126,121,1797,6.3,6.7,6.3,"Less than 25% P.O.C.","$78000 or more"
"37183053512","Census Tract 535.12, Wake County, North Carolina",6672,93293,4816,480,32,657,0,302,72.2,7.2,0.5,9.8,0,4.5,27.8,2975,1509,1466,50.72,49.28,57,1452,13,1453,70,2905,3.8,0.9,2.4,"25% - 50% P.O.C.","$78000 or more"
"37183053513","Census Tract 535.13, Wake County, North Carolina",4564,69688,2219,637,9,528,0,1121,48.6,14,0.2,11.6,0,24.6,51.4,1690,757,933,44.79,55.21,11,746,80,853,91,1599,1.5,8.6,5.4,"50% - 75% P.O.C.","$56000 - $78000"
"37183053516","Census Tract 535.16, Wake County, North Carolina",3448,59063,1883,686,0,177,0,637,54.6,19.9,0,5.1,0,18.5,45.4,1345,573,772,42.6,57.4,51,522,100,672,151,1194,8.9,13,11.2,"25% - 50% P.O.C.","$56000 - $78000"
"37183053517","Census Tract 535.17, Wake County, North Carolina",5097,52250,2253,517,27,253,0,2004,44.2,10.1,0.5,5,0,39.3,55.8,1722,1085,637,63.01,36.99,178,907,114,523,292,1430,16.4,17.9,17,"50% - 75% P.O.C.","$42000 - $56000"
"37183053518","Census Tract 535.18, Wake County, North Carolina",3700,85000,3216,167,0,124,0,90,86.9,4.5,0,3.4,0,2.4,13.1,1624,1430,194,88.05,11.95,81,1349,0,194,81,1543,5.7,0,5,"Less than 25% P.O.C.","$78000 or more"
"37183053519","Census Tract 535.19, Wake County, North Carolina",4895,63517,2348,1339,0,217,0,838,48,27.4,0,4.4,0,17.1,52,1971,912,1059,46.27,53.73,7,905,128,931,135,1836,0.8,12.1,6.8,"50% - 75% P.O.C.","$56000 - $78000"
"37183053520","Census Tract 535.20, Wake County, North Carolina",6206,58479,3753,938,30,810,0,565,60.5,15.1,0.5,13.1,0,9.1,39.5,2601,905,1696,34.79,65.21,89,816,19,1677,108,2493,9.8,1.1,4.2,"25% - 50% P.O.C.","$56000 - $78000"
"37183053521","Census Tract 535.21, Wake County, North Carolina",3694,108281,2945,123,0,511,0,5,79.7,3.3,0,13.8,0,0.1,20.3,1304,1119,185,85.81,14.19,57,1062,57,128,114,1190,5.1,30.8,8.7,"Less than 25% P.O.C.","$78000 or more"
"37183053522","Census Tract 535.22, Wake County, North Carolina",6983,94776,3185,895,0,2448,0,344,45.6,12.8,0,35.1,0,4.9,54.4,2773,1115,1658,40.21,59.79,82,1033,66,1592,148,2625,7.4,4,5.3,"50% - 75% P.O.C.","$78000 or more"
"37183053523","Census Tract 535.23, Wake County, North Carolina",5646,106632,3453,596,0,1140,90,262,61.2,10.6,0,20.2,1.6,4.6,38.8,2181,1246,935,57.13,42.87,174,1072,0,935,174,2007,14,0,8,"25% - 50% P.O.C.","$78000 or more"
"37183053524","Census Tract 535.24, Wake County, North Carolina",3728,77125,2419,243,20,696,0,307,64.9,6.5,0.5,18.7,0,8.2,35.1,1713,1111,602,64.86,35.14,47,1064,25,577,72,1641,4.2,4.2,4.2,"25% - 50% P.O.C.","$56000 - $78000"
"37183053525","Census Tract 535.25, Wake County, North Carolina",2947,94399,2131,166,0,314,0,240,72.3,5.6,0,10.7,0,8.1,27.7,1112,787,325,70.77,29.23,57,730,23,302,80,1032,7.2,7.1,7.2,"25% - 50% P.O.C.","$78000 or more"
"37183053601","Census Tract 536.01, Wake County, North Carolina",13565,113944,5184,1951,81,4758,31,1123,38.2,14.4,0.6,35.1,0.2,8.3,61.8,4818,2340,2478,48.57,51.43,156,2184,189,2289,345,4473,6.7,7.6,7.2,"50% - 75% P.O.C.","$78000 or more"
"37183053602","Census Tract 536.02, Wake County, North Carolina",6510,123056,2480,590,56,2875,0,172,38.1,9.1,0.9,44.2,0,2.6,61.9,1966,1184,782,60.22,39.78,146,1038,159,623,305,1661,12.3,20.3,15.5,"50% - 75% P.O.C.","$78000 or more"
"37183053603","Census Tract 536.03, Wake County, North Carolina",4194,113447,2517,203,6,1248,0,147,60,4.8,0.1,29.8,0,3.5,40,1623,1204,419,74.18,25.82,99,1105,27,392,126,1497,8.2,6.4,7.8,"25% - 50% P.O.C.","$78000 or more"
"37183053604","Census Tract 536.04, Wake County, North Carolina",4341,180938,2485,172,13,1542,0,83,57.2,4,0.3,35.5,0,1.9,42.8,1495,1267,228,84.75,15.25,161,1106,9,219,170,1325,12.7,3.9,11.4,"25% - 50% P.O.C.","$78000 or more"
"37183053605","Census Tract 536.05, Wake County, North Carolina",2524,131875,1809,59,31,361,0,143,71.7,2.3,1.2,14.3,0,5.7,28.3,989,674,315,68.15,31.85,52,622,27,288,79,910,7.7,8.6,8,"25% - 50% P.O.C.","$78000 or more"
"37183053606","Census Tract 536.06, Wake County, North Carolina",2568,91667,1282,329,22,651,0,256,49.9,12.8,0.9,25.4,0,10,50.1,1186,385,801,32.46,67.54,9,376,38,763,47,1139,2.3,4.7,4,"50% - 75% P.O.C.","$78000 or more"
"37183053607","Census Tract 536.07, Wake County, North Carolina",9873,114355,3032,1145,159,4838,0,195,30.7,11.6,1.6,49,0,2,69.3,3463,2237,1226,64.6,35.4,196,2041,162,1064,358,3105,8.8,13.2,10.3,"50% - 75% P.O.C.","$78000 or more"
"37183053608","Census Tract 536.08, Wake County, North Carolina",6477,123125,2188,965,24,2841,0,237,33.8,14.9,0.4,43.9,0,3.7,66.2,2271,1583,688,69.7,30.3,83,1500,116,572,199,2072,5.2,16.9,8.8,"50% - 75% P.O.C.","$78000 or more"
"37183053609","Census Tract 536.09, Wake County, North Carolina",1006,61926,402,173,0,315,0,116,40,17.2,0,31.3,0,11.5,60,463,94,369,20.3,79.7,0,94,30,339,30,433,0,8.1,6.5,"50% - 75% P.O.C.","$56000 - $78000"
"37183053610","Census Tract 536.10, Wake County, North Carolina",12071,91721,6864,2495,0,967,30,1318,56.9,20.7,0,8,0.2,10.9,43.1,5745,1954,3791,34.01,65.99,100,1854,146,3645,246,5499,5.1,3.9,4.3,"25% - 50% P.O.C.","$78000 or more"
"37183053707","Census Tract 537.07, Wake County, North Carolina",7089,72642,4936,1491,30,240,0,288,69.6,21,0.4,3.4,0,4.1,30.4,3287,1777,1510,54.06,45.94,124,1653,93,1417,217,3070,7,6.2,6.6,"25% - 50% P.O.C.","$56000 - $78000"
"37183053709","Census Tract 537.09, Wake County, North Carolina",6892,68370,4458,1271,51,337,0,622,64.7,18.4,0.7,4.9,0,9,35.3,3772,1887,1885,50.03,49.97,37,1850,0,1885,37,3735,2,0,1,"25% - 50% P.O.C.","$56000 - $78000"
"37183053711","Census Tract 537.11, Wake County, North Carolina",4975,128854,3936,596,0,260,0,183,79.1,12,0,5.2,0,3.7,20.9,1965,1441,524,73.33,26.67,94,1347,13,511,107,1858,6.5,2.5,5.4,"Less than 25% P.O.C.","$78000 or more"
"37183053712","Census Tract 537.12, Wake County, North Carolina",2625,103984,2421,34,6,51,0,79,92.2,1.3,0.2,1.9,0,3,7.8,1089,905,184,83.1,16.9,54,851,0,184,54,1035,6,0,5,"Less than 25% P.O.C.","$78000 or more"
"37183053713","Census Tract 537.13, Wake County, North Carolina",3519,49041,2136,742,0,32,0,381,60.7,21.1,0,0.9,0,10.8,39.3,1851,268,1583,14.48,85.52,0,268,27,1556,27,1824,0,1.7,1.5,"25% - 50% P.O.C.","$42000 - $56000"
"37183053714","Census Tract 537.14, Wake County, North Carolina",4347,87174,3608,499,0,101,0,139,83,11.5,0,2.3,0,3.2,17,2016,1302,714,64.58,35.42,22,1280,0,714,22,1994,1.7,0,1.1,"Less than 25% P.O.C.","$78000 or more"
"37183053715","Census Tract 537.15, Wake County, North Carolina",3483,93889,2836,310,0,74,0,251,81.4,8.9,0,2.1,0,7.2,18.6,1450,1175,275,81.03,18.97,33,1142,22,253,55,1395,2.8,8,3.8,"Less than 25% P.O.C.","$78000 or more"
"37183053716","Census Tract 537.16, Wake County, North Carolina",4216,57798,2670,1354,0,0,0,93,63.3,32.1,0,0,0,2.2,36.7,2104,1079,1025,51.28,48.72,26,1053,55,970,81,2023,2.4,5.4,3.8,"25% - 50% P.O.C.","$56000 - $78000"
"37183053717","Census Tract 537.17, Wake County, North Carolina",3994,69885,2469,967,0,412,0,69,61.8,24.2,0,10.3,0,1.7,38.2,2021,875,1146,43.3,56.7,37,838,19,1127,56,1965,4.2,1.7,2.8,"25% - 50% P.O.C.","$56000 - $78000"
"37183053718","Census Tract 537.18, Wake County, North Carolina",3628,107188,2808,387,0,140,0,154,77.4,10.7,0,3.9,0,4.2,22.6,1214,1115,99,91.85,8.15,115,1000,31,68,146,1068,10.3,31.3,12,"Less than 25% P.O.C.","$78000 or more"
"37183053719","Census Tract 537.19, Wake County, North Carolina",4278,125179,3684,98,7,97,0,255,86.1,2.3,0.2,2.3,0,6,13.9,1409,1278,131,90.7,9.3,53,1225,25,106,78,1331,4.1,19.1,5.5,"Less than 25% P.O.C.","$78000 or more"
"37183053720","Census Tract 537.20, Wake County, North Carolina",3973,151033,3598,104,27,54,0,104,90.6,2.6,0.7,1.4,0,2.6,9.4,1329,1321,8,99.4,0.6,123,1198,0,8,123,1206,9.3,0,9.3,"Less than 25% P.O.C.","$78000 or more"
"37183053721","Census Tract 537.21, Wake County, North Carolina",3757,157240,3364,118,40,66,18,71,89.5,3.1,1.1,1.8,0.5,1.9,10.5,1377,1335,42,96.95,3.05,96,1239,10,32,106,1271,7.2,23.8,7.7,"Less than 25% P.O.C.","$78000 or more"
"37183053722","Census Tract 537.22, Wake County, North Carolina",4837,71012,4407,148,15,57,0,93,91.1,3.1,0.3,1.2,0,1.9,8.9,2459,1509,950,61.37,38.63,34,1475,0,950,34,2425,2.3,0,1.4,"Less than 25% P.O.C.","$56000 - $78000"
"37183053723","Census Tract 537.23, Wake County, North Carolina",3401,71065,2525,304,15,133,0,332,74.2,8.9,0.4,3.9,0,9.8,25.8,1637,1188,449,72.57,27.43,6,1182,19,430,25,1612,0.5,4.2,1.5,"25% - 50% P.O.C.","$56000 - $78000"
"37183053724","Census Tract 537.24, Wake County, North Carolina",6541,107813,4144,622,60,769,0,652,63.4,9.5,0.9,11.8,0,10,36.6,2491,1672,819,67.12,32.88,179,1493,61,758,240,2251,10.7,7.4,9.6,"25% - 50% P.O.C.","$78000 or more"
"37183053725","Census Tract 537.25, Wake County, North Carolina",4994,80679,4064,307,0,166,0,131,81.4,6.1,0,3.3,0,2.6,18.6,2146,1399,747,65.19,34.81,81,1318,31,716,112,2034,5.8,4.1,5.2,"Less than 25% P.O.C.","$78000 or more"
"37183053726","Census Tract 537.26, Wake County, North Carolina",2936,60833,1702,751,0,28,0,397,58,25.6,0,1,0,13.5,42,1336,556,780,41.62,58.38,15,541,68,712,83,1253,2.7,8.7,6.2,"25% - 50% P.O.C.","$56000 - $78000"
"37183053803","Census Tract 538.03, Wake County, North Carolina",3646,165313,3116,211,0,132,0,135,85.5,5.8,0,3.6,0,3.7,14.5,1240,1198,42,96.61,3.39,123,1075,10,32,133,1107,10.3,23.8,10.7,"Less than 25% P.O.C.","$78000 or more"
"37183053804","Census Tract 538.04, Wake County, North Carolina",3402,131985,2902,274,0,133,0,82,85.3,8.1,0,3.9,0,2.4,14.7,1175,1001,174,85.19,14.81,121,880,22,152,143,1032,12.1,12.6,12.2,"Less than 25% P.O.C.","$78000 or more"
"37183053805","Census Tract 538.05, Wake County, North Carolina",1853,159583,1688,42,0,36,0,60,91.1,2.3,0,1.9,0,3.2,8.9,668,660,8,98.8,1.2,56,604,0,8,56,612,8.5,0,8.4,"Less than 25% P.O.C.","$78000 or more"
"37183053806","Census Tract 538.06, Wake County, North Carolina",2982,128116,2872,18,0,48,0,12,96.3,0.6,0,1.6,0,0.4,3.7,1085,1077,8,99.26,0.74,87,990,0,8,87,998,8.1,0,8,"Less than 25% P.O.C.","$78000 or more"
"37183053807","Census Tract 538.07, Wake County, North Carolina",3987,138836,3328,297,22,136,0,147,83.5,7.4,0.6,3.4,0,3.7,16.5,1531,1202,329,78.51,21.49,105,1097,10,319,115,1416,8.7,3,7.5,"Less than 25% P.O.C.","$78000 or more"
"37183053808","Census Tract 538.08, Wake County, North Carolina",5114,166603,4439,142,9,353,0,99,86.8,2.8,0.2,6.9,0,1.9,13.2,1866,1843,23,98.77,1.23,204,1639,0,23,204,1662,11.1,0,10.9,"Less than 25% P.O.C.","$78000 or more"
"37183053900","Census Tract 539, Wake County, North Carolina",9283,127930,7820,538,0,166,0,386,84.2,5.8,0,1.8,0,4.2,15.8,3187,2979,208,93.47,6.53,363,2616,28,180,391,2796,12.2,13.5,12.3,"Less than 25% P.O.C.","$78000 or more"
"37183054001","Census Tract 540.01, Wake County, North Carolina",4734,44074,3444,762,10,0,0,455,72.8,16.1,0.2,0,0,9.6,27.2,2548,1230,1318,48.27,51.73,16,1214,0,1318,16,2532,1.3,0,0.6,"25% - 50% P.O.C.","$42000 - $56000"
"37183054004","Census Tract 540.04, Wake County, North Carolina",5043,50253,2792,1458,0,71,0,538,55.4,28.9,0,1.4,0,10.7,44.6,2487,1310,1177,52.67,47.33,5,1305,32,1145,37,2450,0.4,2.7,1.5,"25% - 50% P.O.C.","$42000 - $56000"
"37183054006","Census Tract 540.06, Wake County, North Carolina",3314,63000,1843,846,0,98,0,482,55.6,25.5,0,3,0,14.5,44.4,1322,683,639,51.66,48.34,31,652,86,553,117,1205,4.5,13.5,8.9,"25% - 50% P.O.C.","$56000 - $78000"
"37183054007","Census Tract 540.07, Wake County, North Carolina",4332,64692,2758,956,2,23,0,516,63.7,22.1,0,0.5,0,11.9,36.3,1943,1108,835,57.03,42.97,78,1030,64,771,142,1801,7,7.7,7.3,"25% - 50% P.O.C.","$56000 - $78000"
"37183054008","Census Tract 540.08, Wake County, North Carolina",7475,42558,1403,3744,0,663,0,1400,18.8,50.1,0,8.9,0,18.7,81.2,2869,631,2238,21.99,78.01,109,522,126,2112,235,2634,17.3,5.6,8.2,"75% or more P.O.C.","$42000 - $56000"
"37183054011","Census Tract 540.11, Wake County, North Carolina",2834,103029,2363,135,0,229,0,57,83.4,4.8,0,8.1,0,2,16.6,1099,1028,71,93.54,6.46,68,960,7,64,75,1024,6.6,9.9,6.8,"Less than 25% P.O.C.","$78000 or more"
"37183054012","Census Tract 540.12, Wake County, North Carolina",3860,96955,3269,356,28,109,0,65,84.7,9.2,0.7,2.8,0,1.7,15.3,1549,1157,392,74.69,25.31,70,1087,17,375,87,1462,6.1,4.3,5.6,"Less than 25% P.O.C.","$78000 or more"
"37183054013","Census Tract 540.13, Wake County, North Carolina",13315,110602,10369,1418,0,293,0,596,77.9,10.6,0,2.2,0,4.5,22.1,4991,3920,1071,78.54,21.46,295,3625,58,1013,353,4638,7.5,5.4,7.1,"Less than 25% P.O.C.","$78000 or more"
"37183054014","Census Tract 540.14, Wake County, North Carolina",13810,69029,3061,6087,0,1292,0,2903,22.2,44.1,0,9.4,0,21,77.8,4739,2959,1780,62.44,37.56,434,2525,136,1644,570,4169,14.7,7.6,12,"75% or more P.O.C.","$56000 - $78000"
"37183054015","Census Tract 540.15, Wake County, North Carolina",4320,56470,1645,1452,0,159,0,791,38.1,33.6,0,3.7,0,18.3,61.9,1813,556,1257,30.67,69.33,13,543,95,1162,108,1705,2.3,7.6,6,"50% - 75% P.O.C.","$56000 - $78000"
"37183054016","Census Tract 540.16, Wake County, North Carolina",6200,93529,4754,1047,0,77,0,167,76.7,16.9,0,1.2,0,2.7,23.3,2672,1944,728,72.75,27.25,95,1849,13,715,108,2564,4.9,1.8,4,"Less than 25% P.O.C.","$78000 or more"
"37183054017","Census Tract 540.17, Wake County, North Carolina",2807,61875,1718,775,0,6,0,251,61.2,27.6,0,0.2,0,8.9,38.8,1191,523,668,43.91,56.09,44,479,6,662,50,1141,8.4,0.9,4.2,"25% - 50% P.O.C.","$56000 - $78000"
"37183054018","Census Tract 540.18, Wake County, North Carolina",3198,51484,801,1726,21,367,0,273,25,54,0.7,11.5,0,8.5,75,1590,120,1470,7.55,92.45,0,120,60,1410,60,1530,0,4.1,3.8,"75% or more P.O.C.","$42000 - $56000"
"37183054104","Census Tract 541.04, Wake County, North Carolina",12003,71574,3333,3987,15,660,37,3511,27.8,33.2,0.1,5.5,0.3,29.3,72.2,3944,2860,1084,72.52,27.48,366,2494,258,826,624,3320,12.8,23.8,15.8,"50% - 75% P.O.C.","$56000 - $78000"
"37183054105","Census Tract 541.05, Wake County, North Carolina",13895,80992,6686,4530,0,568,0,1710,48.1,32.6,0,4.1,0,12.3,51.9,5073,4080,993,80.43,19.57,300,3780,52,941,352,4721,7.4,5.2,6.9,"50% - 75% P.O.C.","$78000 or more"
"37183054106","Census Tract 541.06, Wake County, North Carolina",8017,62356,1789,3920,0,356,0,1386,22.3,48.9,0,4.4,0,17.3,77.7,2843,1478,1365,51.99,48.01,177,1301,97,1268,274,2569,12,7.1,9.6,"75% or more P.O.C.","$56000 - $78000"
"37183054108","Census Tract 541.08, Wake County, North Carolina",7913,49114,2565,2750,0,160,0,1877,32.4,34.8,0,2,0,23.7,67.6,2635,1960,675,74.38,25.62,123,1837,75,600,198,2437,6.3,11.1,7.5,"50% - 75% P.O.C.","$42000 - $56000"
"37183054109","Census Tract 541.09, Wake County, North Carolina",3575,97600,1969,1098,27,7,0,393,55.1,30.7,0.8,0.2,0,11,44.9,1270,1144,126,90.08,9.92,88,1056,22,104,110,1160,7.7,17.5,8.7,"25% - 50% P.O.C.","$78000 or more"
"37183054110","Census Tract 541.10, Wake County, North Carolina",10609,94226,5648,2359,0,493,0,1750,53.2,22.2,0,4.6,0,16.5,46.8,3426,3012,414,87.92,12.08,225,2787,80,334,305,3121,7.5,19.3,8.9,"25% - 50% P.O.C.","$78000 or more"
"37183054111","Census Tract 541.11, Wake County, North Carolina",2481,64841,1200,507,7,49,0,634,48.4,20.4,0.3,2,0,25.6,51.6,933,743,190,79.64,20.36,36,707,6,184,42,891,4.8,3.2,4.5,"50% - 75% P.O.C.","$56000 - $78000"
"37183054112","Census Tract 541.12, Wake County, North Carolina",4410,60439,1640,1650,0,43,0,986,37.2,37.4,0,1,0,22.4,62.8,1468,1038,430,70.71,29.29,156,882,39,391,195,1273,15,9.1,13.3,"50% - 75% P.O.C.","$56000 - $78000"
"37183054113","Census Tract 541.13, Wake County, North Carolina",3894,66899,1628,1638,0,102,0,476,41.8,42.1,0,2.6,0,12.2,58.2,1569,761,808,48.5,51.5,72,689,101,707,173,1396,9.5,12.5,11,"50% - 75% P.O.C.","$56000 - $78000"
"37183054114","Census Tract 541.14, Wake County, North Carolina",6271,76985,2679,2059,0,171,0,1188,42.7,32.8,0,2.7,0,18.9,57.3,2300,1794,506,78,22,155,1639,97,409,252,2048,8.6,19.2,11,"50% - 75% P.O.C.","$56000 - $78000"
"37183054115","Census Tract 541.15, Wake County, North Carolina",8963,67440,3963,3643,8,158,0,1096,44.2,40.6,0.1,1.8,0,12.2,55.8,3422,2364,1058,69.08,30.92,174,2190,28,1030,202,3220,7.4,2.6,5.9,"50% - 75% P.O.C.","$56000 - $78000"
"37183054203","Census Tract 542.03, Wake County, North Carolina",3561,141818,3074,86,0,79,0,315,86.3,2.4,0,2.2,0,8.8,13.7,1238,1196,42,96.61,3.39,101,1095,8,34,109,1129,8.4,19,8.8,"Less than 25% P.O.C.","$78000 or more"
"37183054204","Census Tract 542.04, Wake County, North Carolina",5199,76250,3768,848,0,49,0,241,72.5,16.3,0,0.9,0,4.6,27.5,1849,1214,635,65.66,34.34,117,1097,54,581,171,1678,9.6,8.5,9.2,"25% - 50% P.O.C.","$56000 - $78000"
"37183054205","Census Tract 542.05, Wake County, North Carolina",5764,55114,3567,1623,10,52,0,311,61.9,28.2,0.2,0.9,0,5.4,38.1,2213,1254,959,56.67,43.33,90,1164,46,913,136,2077,7.2,4.8,6.1,"25% - 50% P.O.C.","$42000 - $56000"
"37183054206","Census Tract 542.06, Wake County, North Carolina",6323,63544,4871,882,0,92,0,277,77,13.9,0,1.5,0,4.4,23,2540,1286,1254,50.63,49.37,117,1169,93,1161,210,2330,9.1,7.4,8.3,"Less than 25% P.O.C.","$56000 - $78000"
"37183054207","Census Tract 542.07, Wake County, North Carolina",9565,114071,6777,1250,0,481,0,680,70.9,13.1,0,5,0,7.1,29.1,3586,2279,1307,63.55,36.45,196,2083,49,1258,245,3341,8.6,3.7,6.8,"25% - 50% P.O.C.","$78000 or more"
"37183054208","Census Tract 542.08, Wake County, North Carolina",9074,67099,7072,1219,0,30,0,553,77.9,13.4,0,0.3,0,6.1,22.1,3594,2080,1514,57.87,42.13,163,1917,27,1487,190,3404,7.8,1.8,5.3,"Less than 25% P.O.C.","$56000 - $78000"
"37183054209","Census Tract 542.09, Wake County, North Carolina",12559,101408,7140,3428,9,432,24,950,56.9,27.3,0.1,3.4,0.2,7.6,43.1,4136,3480,656,84.14,15.86,355,3125,152,504,507,3629,10.2,23.2,12.3,"25% - 50% P.O.C.","$78000 or more"
"37183054210","Census Tract 542.10, Wake County, North Carolina",11313,85897,7401,2590,11,125,0,789,65.4,22.9,0.1,1.1,0,7,34.6,3886,3189,697,82.06,17.94,460,2729,36,661,496,3390,14.4,5.2,12.8,"25% - 50% P.O.C.","$78000 or more"
"37183054211","Census Tract 542.11, Wake County, North Carolina",13997,114005,11018,1399,0,282,0,875,78.7,10,0,2,0,6.3,21.3,4672,4110,562,87.97,12.03,635,3475,93,469,728,3944,15.5,16.5,15.6,"Less than 25% P.O.C.","$78000 or more"
"37183054301","Census Tract 543.01, Wake County, North Carolina",6381,82518,3646,1387,4,14,0,1123,57.1,21.7,0.1,0.2,0,17.6,42.9,2403,2126,277,88.47,11.53,122,2004,70,207,192,2211,5.7,25.3,8,"25% - 50% P.O.C.","$78000 or more"
"37183054302","Census Tract 543.02, Wake County, North Carolina",7998,52597,3511,2916,0,62,0,705,43.9,36.5,0,0.8,0,8.8,56.1,2624,1629,995,62.08,37.92,248,1381,264,731,512,2112,15.2,26.5,19.5,"50% - 75% P.O.C.","$42000 - $56000"
"37183054402","Census Tract 544.02, Wake County, North Carolina",6306,71078,4051,1231,11,0,0,944,64.2,19.5,0.2,0,0,15,35.8,2304,1796,508,77.95,22.05,188,1608,77,431,265,2039,10.5,15.2,11.5,"25% - 50% P.O.C.","$56000 - $78000"
"37183054403","Census Tract 544.03, Wake County, North Carolina",3521,66875,2205,848,0,0,0,468,62.6,24.1,0,0,0,13.3,37.4,1215,943,272,77.61,22.39,109,834,8,264,117,1098,11.6,2.9,9.6,"25% - 50% P.O.C.","$56000 - $78000"
"37183054404","Census Tract 544.04, Wake County, North Carolina",6861,55750,3767,1834,15,37,0,1062,54.9,26.7,0.2,0.5,0,15.5,45.1,2345,1508,837,64.31,35.69,298,1210,26,811,324,2021,19.8,3.1,13.8,"25% - 50% P.O.C.","$42000 - $56000"
"37183054500","Census Tract 545, Wake County, North Carolina",10774,55338,4999,3313,0,523,0,1507,46.4,30.7,0,4.9,0,14,53.6,3851,1911,1940,49.62,50.38,29,1882,222,1718,251,3600,1.5,11.4,6.5,"50% - 75% P.O.C.","$42000 - $56000"
"37183980100","Census Tract 9801, Wake County, North Carolina",0,NA,0,0,0,0,0,0,NA,NA,NA,NA,NA,NA,NA,0,0,0,NA,NA,0,0,0,0,0,0,NA,NA,NA,"N/A","N/A"
"37183980200","Census Tract 9802, Wake County, North Carolina",0,NA,0,0,0,0,0,0,NA,NA,NA,NA,NA,NA,NA,0,0,0,NA,NA,0,0,0,0,0,0,NA,NA,NA,"N/A","N/A"
"37185950101","Census Tract 9501.01, Warren County, North Carolina",2145,55417,1861,194,0,14,0,4,86.8,9,0,0.7,0,0.2,13.2,967,906,61,93.69,6.31,38,868,8,53,46,921,4.2,13.1,4.8,"Less than 25% P.O.C.","$42000 - $56000"
"37185950102","Census Tract 9501.02, Warren County, North Carolina",1265,54327,789,377,39,4,22,10,62.4,29.8,3.1,0.3,1.7,0.8,37.6,621,493,128,79.39,20.61,13,480,0,128,13,608,2.6,0,2.1,"25% - 50% P.O.C.","$42000 - $56000"
"37185950103","Census Tract 9501.03, Warren County, North Carolina",2720,38417,533,1162,837,14,12,99,19.6,42.7,30.8,0.5,0.4,3.6,80.4,944,757,187,80.19,19.81,47,710,22,165,69,875,6.2,11.8,7.3,"75% or more P.O.C.","Less than $42000"
"37185950200","Census Tract 9502, Warren County, North Carolina",5814,33639,2368,3250,16,10,0,98,40.7,55.9,0.3,0.2,0,1.7,59.3,2427,1574,853,64.85,35.15,102,1472,0,853,102,2325,6.5,0,4.2,"50% - 75% P.O.C.","Less than $42000"
"37185950300","Census Tract 9503, Warren County, North Carolina",4239,32560,1073,2685,89,16,0,306,25.3,63.3,2.1,0.4,0,7.2,74.7,1456,972,484,66.76,33.24,123,849,39,445,162,1294,12.7,8.1,11.1,"50% - 75% P.O.C.","Less than $42000"
"37185950400","Census Tract 9504, Warren County, North Carolina",3715,30903,1005,2297,28,41,0,233,27.1,61.8,0.8,1.1,0,6.3,72.9,1371,997,374,72.72,27.28,56,941,62,312,118,1253,5.6,16.6,8.6,"50% - 75% P.O.C.","Less than $42000"
"37191000101","Census Tract 1.01, Wayne County, North Carolina",7459,51389,5276,1141,46,8,0,715,70.7,15.3,0.6,0.1,0,9.6,29.3,2838,2172,666,76.53,23.47,41,2131,123,543,164,2674,1.9,18.5,5.8,"25% - 50% P.O.C.","$42000 - $56000"
"37191000102","Census Tract 1.02, Wayne County, North Carolina",6617,76250,5116,961,34,42,0,279,77.3,14.5,0.5,0.6,0,4.2,22.7,2501,2064,437,82.53,17.47,201,1863,6,431,207,2294,9.7,1.4,8.3,"Less than 25% P.O.C.","$56000 - $78000"
"37191000200","Census Tract 2, Wayne County, North Carolina",3049,46971,2119,676,13,0,0,211,69.5,22.2,0.4,0,0,6.9,30.5,1327,818,509,61.64,38.36,54,764,28,481,82,1245,6.6,5.5,6.2,"25% - 50% P.O.C.","$42000 - $56000"
"37191000302","Census Tract 3.02, Wayne County, North Carolina",5780,39309,3154,1783,0,46,15,459,54.6,30.8,0,0.8,0.3,7.9,45.4,2435,1731,704,71.09,28.91,132,1599,12,692,144,2291,7.6,1.7,5.9,"25% - 50% P.O.C.","Less than $42000"
"37191000303","Census Tract 3.03, Wayne County, North Carolina",6812,63166,5045,909,0,162,0,578,74.1,13.3,0,2.4,0,8.5,25.9,2597,1941,656,74.74,25.26,121,1820,77,579,198,2399,6.2,11.7,7.6,"25% - 50% P.O.C.","$56000 - $78000"
"37191000304","Census Tract 3.04, Wayne County, North Carolina",5290,47848,3544,1136,45,0,0,459,67,21.5,0.9,0,0,8.7,33,2159,1553,606,71.93,28.07,104,1449,14,592,118,2041,6.7,2.3,5.5,"25% - 50% P.O.C.","$42000 - $56000"
"37191000401","Census Tract 4.01, Wayne County, North Carolina",6233,67794,4173,1224,8,42,0,646,67,19.6,0.1,0.7,0,10.4,33,2376,1923,453,80.93,19.07,151,1772,116,337,267,2109,7.9,25.6,11.2,"25% - 50% P.O.C.","$56000 - $78000"
"37191000402","Census Tract 4.02, Wayne County, North Carolina",4655,42336,2482,1374,0,95,0,582,53.3,29.5,0,2,0,12.5,46.7,1804,1103,701,61.14,38.86,120,983,95,606,215,1589,10.9,13.6,11.9,"25% - 50% P.O.C.","$42000 - $56000"
"37191000500","Census Tract 5, Wayne County, North Carolina",3058,43315,1779,479,29,194,25,257,58.2,15.7,0.9,6.3,0.8,8.4,41.8,799,8,791,1,99,0,8,84,707,84,715,0,10.6,10.5,"25% - 50% P.O.C.","$42000 - $56000"
"37191000601","Census Tract 6.01, Wayne County, North Carolina",4615,31071,1207,2276,0,5,0,1093,26.2,49.3,0,0.1,0,23.7,73.8,1760,1134,626,64.43,35.57,61,1073,134,492,195,1565,5.4,21.4,11.1,"50% - 75% P.O.C.","Less than $42000"
"37191000602","Census Tract 6.02, Wayne County, North Carolina",8694,38558,3498,1289,0,0,0,3829,40.2,14.8,0,0,0,44,59.8,2913,2129,784,73.09,26.91,400,1729,127,657,527,2386,18.8,16.2,18.1,"50% - 75% P.O.C.","Less than $42000"
"37191000700","Census Tract 7, Wayne County, North Carolina",2804,39787,811,1480,27,0,0,81,28.9,52.8,1,0,0,2.9,71.1,1131,597,534,52.79,47.21,9,588,67,467,76,1055,1.5,12.5,6.7,"50% - 75% P.O.C.","Less than $42000"
"37191000800","Census Tract 8, Wayne County, North Carolina",2669,46944,1515,741,0,20,0,362,56.8,27.8,0,0.7,0,13.6,43.2,884,655,229,74.1,25.9,60,595,14,215,74,810,9.2,6.1,8.4,"25% - 50% P.O.C.","$42000 - $56000"
"37191000901","Census Tract 9.01, Wayne County, North Carolina",5335,49730,2707,1816,0,33,0,735,50.7,34,0,0.6,0,13.8,49.3,2100,1361,739,64.81,35.19,31,1330,129,610,160,1940,2.3,17.5,7.6,"25% - 50% P.O.C.","$42000 - $56000"
"37191000902","Census Tract 9.02, Wayne County, North Carolina",5042,37797,2290,1155,25,15,0,1436,45.4,22.9,0.5,0.3,0,28.5,54.6,1981,1429,552,72.14,27.86,155,1274,61,491,216,1765,10.8,11.1,10.9,"50% - 75% P.O.C.","Less than $42000"
"37191001000","Census Tract 10, Wayne County, North Carolina",4386,46549,3784,331,0,0,0,254,86.3,7.5,0,0,0,5.8,13.7,1712,1365,347,79.73,20.27,58,1307,18,329,76,1636,4.2,5.2,4.4,"Less than 25% P.O.C.","$42000 - $56000"
"37191001101","Census Tract 11.01, Wayne County, North Carolina",7442,49709,5378,1159,79,42,9,744,72.3,15.6,1.1,0.6,0.1,10,27.7,2598,2013,585,77.48,22.52,181,1832,19,566,200,2398,9,3.2,7.7,"25% - 50% P.O.C.","$42000 - $56000"
"37191001102","Census Tract 11.02, Wayne County, North Carolina",3486,64805,2737,474,2,0,0,221,78.5,13.6,0.1,0,0,6.3,21.5,1227,914,313,74.49,25.51,99,815,0,313,99,1128,10.8,0,8.1,"Less than 25% P.O.C.","$56000 - $78000"
"37191001200","Census Tract 12, Wayne County, North Carolina",3704,36397,1648,1586,15,136,0,113,44.5,42.8,0.4,3.7,0,3.1,55.5,1698,735,963,43.29,56.71,80,655,26,937,106,1592,10.9,2.7,6.2,"50% - 75% P.O.C.","Less than $42000"
"37191001301","Census Tract 13.01, Wayne County, North Carolina",6270,55226,2509,2734,0,327,0,445,40,43.6,0,5.2,0,7.1,60,2521,1287,1234,51.05,48.95,117,1170,20,1214,137,2384,9.1,1.6,5.4,"50% - 75% P.O.C.","$42000 - $56000"
"37191001302","Census Tract 13.02, Wayne County, North Carolina",3807,37079,2118,1123,25,192,0,209,55.6,29.5,0.7,5,0,5.5,44.4,1887,645,1242,34.18,65.82,38,607,44,1198,82,1805,5.9,3.5,4.3,"25% - 50% P.O.C.","Less than $42000"
"37191001400","Census Tract 14, Wayne County, North Carolina",6167,26738,1344,4183,0,68,0,405,21.8,67.8,0,1.1,0,6.6,78.2,2681,1159,1522,43.23,56.77,52,1107,66,1456,118,2563,4.5,4.3,4.4,"75% or more P.O.C.","Less than $42000"
"37191001500","Census Tract 15, Wayne County, North Carolina",2314,30893,146,2048,0,0,0,110,6.3,88.5,0,0,0,4.8,93.7,1016,336,680,33.07,66.93,14,322,44,636,58,958,4.2,6.5,5.7,"75% or more P.O.C.","Less than $42000"
"37191001800","Census Tract 18, Wayne County, North Carolina",2233,19107,346,1708,0,0,0,3,15.5,76.5,0,0,0,0.1,84.5,1025,237,788,23.12,76.88,13,224,14,774,27,998,5.5,1.8,2.6,"75% or more P.O.C.","Less than $42000"
"37191001900","Census Tract 19, Wayne County, North Carolina",4716,21796,1072,3039,14,42,0,299,22.7,64.4,0.3,0.9,0,6.3,77.3,1929,628,1301,32.56,67.44,44,584,164,1137,208,1721,7,12.6,10.8,"75% or more P.O.C.","Less than $42000"
"37191002000","Census Tract 20, Wayne County, North Carolina",966,22303,235,684,13,10,0,0,24.3,70.8,1.3,1,0,0,75.7,444,95,349,21.4,78.6,5,90,0,349,5,439,5.3,0,1.1,"75% or more P.O.C.","Less than $42000"
"37195000100","Census Tract 1, Wilson County, North Carolina",3831,33333,817,2434,0,0,0,548,21.3,63.5,0,0,0,14.3,78.7,1342,339,1003,25.26,74.74,0,339,112,891,112,1230,0,11.2,8.3,"75% or more P.O.C.","Less than $42000"
"37195000200","Census Tract 2, Wilson County, North Carolina",1213,19267,93,890,0,0,0,214,7.7,73.4,0,0,0,17.6,92.3,385,62,323,16.1,83.9,0,62,37,286,37,348,0,11.5,9.6,"75% or more P.O.C.","Less than $42000"
"37195000300","Census Tract 3, Wilson County, North Carolina",2231,28285,301,1514,0,0,0,415,13.5,67.9,0,0,0,18.6,86.5,811,246,565,30.33,69.67,42,204,112,453,154,657,17.1,19.8,19,"75% or more P.O.C.","Less than $42000"
"37195000400","Census Tract 4, Wilson County, North Carolina",8326,38859,3251,4325,188,56,0,79,39,51.9,2.3,0.7,0,0.9,61,3580,1524,2056,42.57,57.43,21,1503,72,1984,93,3487,1.4,3.5,2.6,"50% - 75% P.O.C.","Less than $42000"
"37195000501","Census Tract 5.01, Wilson County, North Carolina",3704,79419,3025,570,0,27,0,19,81.7,15.4,0,0.7,0,0.5,18.3,1558,1404,154,90.12,9.88,53,1351,28,126,81,1477,3.8,18.2,5.2,"Less than 25% P.O.C.","$78000 or more"
"37195000502","Census Tract 5.02, Wilson County, North Carolina",4971,65503,2671,2041,0,178,0,52,53.7,41.1,0,3.6,0,1,46.3,2083,1340,743,64.33,35.67,98,1242,139,604,237,1846,7.3,18.7,11.4,"25% - 50% P.O.C.","$56000 - $78000"
"37195000600","Census Tract 6, Wilson County, North Carolina",7821,44267,3367,3361,0,193,0,579,43.1,43,0,2.5,0,7.4,56.9,3199,1857,1342,58.05,41.95,175,1682,62,1280,237,2962,9.4,4.6,7.4,"50% - 75% P.O.C.","$42000 - $56000"
"37195000700","Census Tract 7, Wilson County, North Carolina",4853,26587,271,3239,0,0,0,1019,5.6,66.7,0,0,0,21,94.4,1971,791,1180,40.13,59.87,14,777,136,1044,150,1821,1.8,11.5,7.6,"75% or more P.O.C.","Less than $42000"
"37195000801","Census Tract 8.01, Wilson County, North Carolina",1740,16307,27,1237,0,18,0,458,1.6,71.1,0,1,0,26.3,98.4,821,170,651,20.71,79.29,29,141,44,607,73,748,17.1,6.8,8.9,"75% or more P.O.C.","Less than $42000"
"37195000802","Census Tract 8.02, Wilson County, North Carolina",3809,30938,705,2114,0,7,0,901,18.5,55.5,0,0.2,0,23.7,81.5,1403,487,916,34.71,65.29,24,463,161,755,185,1218,4.9,17.6,13.2,"75% or more P.O.C.","Less than $42000"
"37195000900","Census Tract 9, Wilson County, North Carolina",4311,46333,3199,725,0,0,0,307,74.2,16.8,0,0,0,7.1,25.8,1498,1230,268,82.11,17.89,135,1095,66,202,201,1297,11,24.6,13.4,"25% - 50% P.O.C.","$42000 - $56000"
"37195001000","Census Tract 10, Wilson County, North Carolina",1586,41071,809,679,0,0,0,50,51,42.8,0,0,0,3.2,49,674,486,188,72.11,27.89,13,473,12,176,25,649,2.7,6.4,3.7,"25% - 50% P.O.C.","Less than $42000"
"37195001100","Census Tract 11, Wilson County, North Carolina",1505,38300,769,547,0,0,0,181,51.1,36.3,0,0,0,12,48.9,622,390,232,62.7,37.3,22,368,45,187,67,555,5.6,19.4,10.8,"25% - 50% P.O.C.","Less than $42000"
"37195001200","Census Tract 12, Wilson County, North Carolina",3473,40343,1785,1078,21,4,0,508,51.4,31,0.6,0.1,0,14.6,48.6,1404,975,429,69.44,30.56,69,906,12,417,81,1323,7.1,2.8,5.8,"25% - 50% P.O.C.","Less than $42000"
"37195001300","Census Tract 13, Wilson County, North Carolina",5530,41891,3180,2060,14,18,0,229,57.5,37.3,0.3,0.3,0,4.1,42.5,2229,1651,578,74.07,25.93,64,1587,33,545,97,2132,3.9,5.7,4.4,"25% - 50% P.O.C.","Less than $42000"
"37195001400","Census Tract 14, Wilson County, North Carolina",9398,67972,5718,2810,0,89,0,677,60.8,29.9,0,0.9,0,7.2,39.2,3693,2461,1232,66.64,33.36,188,2273,98,1134,286,3407,7.6,8,7.7,"25% - 50% P.O.C.","$56000 - $78000"
"37195001500","Census Tract 15, Wilson County, North Carolina",5686,68750,3483,729,7,66,0,1262,61.3,12.8,0.1,1.2,0,22.2,38.7,1989,1421,568,71.44,28.56,101,1320,78,490,179,1810,7.1,13.7,9,"25% - 50% P.O.C.","$56000 - $78000"
"37195001600","Census Tract 16, Wilson County, North Carolina",3491,46912,2063,765,14,14,0,523,59.1,21.9,0.4,0.4,0,15,40.9,1132,830,302,73.32,26.68,140,690,58,244,198,934,16.9,19.2,17.5,"25% - 50% P.O.C.","$42000 - $56000"
"37195001700","Census Tract 17, Wilson County, North Carolina",3956,44651,2714,694,13,5,0,409,68.6,17.5,0.3,0.1,0,10.3,31.4,1620,1254,366,77.41,22.59,48,1206,35,331,83,1537,3.8,9.6,5.1,"25% - 50% P.O.C.","$42000 - $56000"
